abababadbadbddccdadc	FALSE
abcbccdbccabadbdbddc	FALSE
abdbabcabdbcddbccdcd	FALSE
acabdddcdbdcbabddaba	FALSE
acbcabcdccaccbcbadcd	FALSE
accbcbacabcbaccbdabd	FALSE
acdbcadadcababdaccdb	FALSE
adaccbdacddbcbcdbccb	FALSE
adbdabcddcbacdcbadab	FALSE
adcccddabcdacabaddcd	FALSE
addcabadcbabcadbddcc	FALSE
babccbddbcddccccdbdd	FALSE
bacbdcddccdcadcbddbc	FALSE
badbadccabdbdbddbdcc	FALSE
bcacabcbdbdcbabccacb	FALSE
bcbcaccdddbddbadadca	FALSE
bccbaccdabcccaddbcbd	FALSE
bcdacdbdcbabcdaddcad	FALSE
bcddbdddaddddbcbacbc	FALSE
bdadcccbdabcddbddcba	FALSE
bdbddcbdabacdacdccac	FALSE
bdcdcbcbacbaccdcdddd	FALSE
bdddcdadccdcdddacacc	FALSE
cacbabccbcdcbacdbcad	FALSE
cadbdabdddaddaddccda	FALSE
cbabdbaddacbdccddacb	FALSE
cbcbcccbcdabcdddddcd	FALSE
cbdacdacccbdbacbdcac	FALSE
cbddcbdbdadcdadbcbac	FALSE
ccaddcadadaccdccccca	FALSE
cccabcbdbdabcababadc	FALSE
cccddbdbabccadbccdbc	FALSE
ccdddbadcddcbaccaccd	FALSE
cdaddcccddabdbdacccc	FALSE
cdcacdbacbabcabddaca	FALSE
cddaccabccacacdcbccb	FALSE
dababcabcdadbcabddac	FALSE
dacadcbddbdacdcdbcbd	FALSE
dadadbcabcdbadbcbadc	FALSE
dbabdccdabddbdabdacb	FALSE
dbccabcacdcbdbadabad	FALSE
dbdbdbdccccccbcbabdb	FALSE
dcaccccdcbdadaddbcdd	FALSE
dcbdacbdcdbdccddbcbc	FALSE
dcccbadcbdcbcddbdddb	FALSE
dcdbdbcbadbadbdddada	FALSE
ddabcdcbcadbdabacbcd	FALSE
ddbaccacbcadadcddadc	FALSE
ddcadcbdaddbdcbacbdb	FALSE
dddacccbabdbcbddccad	FALSE
aaaaacbbdcbbcbdccdab	TRUE
aabbcdbabcbbbbabdbad	TRUE
aaccabcaccbabaadabcd	TRUE
aaddacaddbabadacadcd	TRUE
abadcbddbbbcababddbb	TRUE
abcaaddaacdddbddcaaa	TRUE
abdaddbabcbaacdcdbcb	TRUE
acadbcdcdabdacbbcaad	TRUE
accadaaddddaddcccbad	TRUE
acdbcccbdaadddbdadbd	TRUE
adacdaccababbbcccbdc	TRUE
adbddcdadbbacccddadb	TRUE
addbcabbdabbdacdbbcc	TRUE
baabcbcbcdcacbddcccc	TRUE
babbbabcdbdaccddacaa	TRUE
baccaabcdccbbdbcaddc	TRUE
bbaaabcdccbaccaccdac	TRUE
bbbadddabcaabdbacdbb	TRUE
bbcbcadbbcdacdcbdccd	TRUE
bbdcadbdabcaaabcaacd	TRUE
bcacabbaadbdaabbcacd	TRUE
bcbccbdbcbcccdaadadd	TRUE
bcdadabccbaaddccabda	TRUE
bdabcdddbdabdcdbabbd	TRUE
bdbbdbddadcaddbabdbd	TRUE
bdcdbabcadcdabcbbdac	TRUE
caaaaaaccbabcdbadaab	TRUE
cabacdacabbddabacadc	TRUE
caccabdbaacaabdababb	TRUE
caddccadbbbcdbccdcba	TRUE
cbbadccbbdbcadccbadc	TRUE
cbcbdcbcbbdbcaccddaa	TRUE
cbddbbdbcdcadacbcccd	TRUE
ccbadacadddaaacdbaac	TRUE
cccbcaadddbabcbbccdd	TRUE
ccdcdbdabbabadcdcadc	TRUE
cdbabbcbcaadcbdbccaa	TRUE
cdcbdacdaaacdcdabdbb	TRUE
cddccdaabddbbbbdcddc	TRUE
dabaabaddcdddabcbaba	TRUE
dacbaaccdaccddddabad	TRUE
dadbddbaadcabddccaaa	TRUE
dbacdaacdcdcaabcadbc	TRUE
dbbddcdddabbbacdbdcd	TRUE
dbdcbadaacccaacddcbb	TRUE
dcaddacdccaaccdcddbc	TRUE
dccbaaccbbcaacdcdadb	TRUE
dcddbdcbbbccabacbaca	TRUE
ddbbccacdcbcabbbccda	TRUE
ddccadcacacbcbdaacaa	TRUE
abababdcaccbdbadbddba	FALSE
abcadcdbcadbdbcbdddcc	FALSE
abcddaccccdadccabcccb	FALSE
abddcbdbcccddabdacbcd	FALSE
acadcccdacdcbdadacacb	FALSE
acbddbdbddadccbcccbcd	FALSE
accddacdcbcabdddbdcdc	FALSE
acdcdcadbdabdbadbcacd	FALSE
adadcbcadabdbadbacada	FALSE
adcacbcbcaddcbdbcdddc	FALSE
addaccaddabadadbcacda	FALSE
addddddadbabaccacdcba	FALSE
bacadbabddbdadcbccdac	FALSE
badacbddcdacdcccadbac	FALSE
bcabcdbadbdbdbacddcbd	FALSE
bcbacadaccadbcbcadbdb	FALSE
bccadbcacccddacdbcbdc	FALSE
bcdacdccaccdbcabadddb	FALSE
bdabcabddbcccdbdddacc	FALSE
bdbcaccabdcdbdadcbdbd	FALSE
bdcbacabdddbccdcddcbd	FALSE
bddadcbaddcbccdbdcbac	FALSE
cabcacdccabdabcbabdcb	FALSE
cacbccbabadcdacddcbcd	FALSE
cadbcaccacacababdbcac	FALSE
cbabddcdaddcabdadccbd	FALSE
cbcbcadcbadcdddacdbcc	FALSE
cbdaddbccdadbdcacccbd	FALSE
ccabcdabdcbadbacdadac	FALSE
ccbadbaccacaccbddacac	FALSE
cccadbdacdbabcbccaddd	FALSE
ccdadddabccacbccdcbcc	FALSE
cdabadcbcacabdadbdbdd	FALSE
cdbadcabdabaddcbcbcbd	FALSE
cdccacbaccbadcbcbcadd	FALSE
cddbcadcdadbacacbadad	FALSE
dabadbdadccddcadccbdb	FALSE
dacacdcacdcbcbcddddcb	FALSE
dadadadbacdacbacdccdd	FALSE
daddcdddcabddababaccd	FALSE
dbaddcadbdccddccddabc	FALSE
dbdabacadcbadcbdcdaca	FALSE
dbdddcdbccaccadcbcccd	FALSE
dcbacdbdaddababdcbdad	FALSE
dccadcadcdbdcabcdcdcc	FALSE
dcdacccdccbacbcbdbcbc	FALSE
dcddcdcbcabacaddbdacb	FALSE
ddbabcbdddddadabaccda	FALSE
ddcadcdcababddadabcca	FALSE
dddacbcbdcdaddbabcacc	FALSE
aaaaaabacdacdbacdcbdd	TRUE
aabacadadacababccadba	TRUE
aacbddcdadcdbccdcbccd	TRUE
aadcbdccbdbabbcbaacdd	TRUE
abbaacadcbadbdbcccdad	TRUE
abcabddaacbdcaccbcdcd	TRUE
abdbcadcddbaccaaccaaa	TRUE
acaddbdbddbaacdcaaadb	TRUE
accaccaadbbbbacdaccdd	TRUE
acdcadbacdaaaadbcadac	TRUE
adadabcddadcdcbcacaad	TRUE
adcaacaacdcaccbccabcb	TRUE
addbcdcbadcacdbbcddcb	TRUE
baacadbdcaacccddabadb	TRUE
babdcdbacaabddcabdbba	TRUE
badbbdcddcdbbbdbacaad	TRUE
bbacdbaaadcdbdaddbbaa	TRUE
bbbdbaddcaadcdcbccdcd	TRUE
bbdacaccadbdccbbccdbb	TRUE
bcaadbdbbbadbdabddbcb	TRUE
bcbbccccdadbdbadacaab	TRUE
bcccccbabbaddaadbdcdc	TRUE
bcdcbcbccadcabaddabba	TRUE
bdadbbdaacdcbdbaabbcc	TRUE
bdcaadbbccddababbadab	TRUE
bddcbcaabcdadaadbabcd	TRUE
caaccdccdacbddabdaccb	TRUE
cacaacbcdccaddaadbdcc	TRUE
cadbacdbcddcddaadadca	TRUE
cbacbbacdbbbdcaddcbac	TRUE
cbbdccadcddcbddbaaacc	TRUE
cbdbbcdbddcdbadbddaaa	TRUE
ccadadbcbcdcaccababbc	TRUE
ccbddbbbdbcccabdbdcbb	TRUE
ccdbacdbbcabcdacacadb	TRUE
cdacbcbbdbbcacacaddbb	TRUE
cdbddcabdbdbbddddbdad	TRUE
cddbbacbabbcadabbaaab	TRUE
daabdabbacccccaabdbaa	TRUE
dabcbbaadcdabbccacaaa	TRUE
dadabadcddbdbacaabdab	TRUE
dbacabdaacadaaccadcbd	TRUE
dbbdbccadadbacdbdbbbc	TRUE
dbcddccccbdbcabccbbcb	TRUE
dcaadaccacbdaacdbdddb	TRUE
dcbcaccdbabadbccdbbcc	TRUE
dccdaccccaacdcddbcdbd	TRUE
ddaabbacaccacdbdbcbab	TRUE
ddbcacadbbdcbdaaddbca	TRUE
ddccbbdccddbcbdabbbcb	TRUE
abababacdbacdcbccadccd	FALSE
abcaddddbdadacabdcdcdb	FALSE
abdacccaccdcccdcbdcaca	FALSE
abdddcadcdaccdbdbadbab	FALSE
acbaccdcbcacbadacbcdbd	FALSE
accbacddbcabcccaddccac	FALSE
acdbdacbaddbcacdddadcd	FALSE
adacbdbdadbcdbccbdadac	FALSE
adbccbddbdcbdddadddbdc	FALSE
adccabdaddcabadacdadcd	FALSE
addbdadbccbdcabdcdbacd	FALSE
babdacadcdbabdbcbacddc	FALSE
baccccbdcccdcdbcccbdbd	FALSE
badcaddacdcccddadcbcac	FALSE
bcacdcbcacdccabdcdcbcc	FALSE
bcbdcadccdbddbcbcdccab	FALSE
bccdcdbdcdbdabacddbccd	FALSE
bcddcccaddccbaddbddada	FALSE
bdbacacdcdadabaccbaddb	FALSE
bdcadabdababdadddddcdb	FALSE
bddaccbaccccdadabacdda	FALSE
cabaccddadacbdcdccabda	FALSE
cacadcbdcdaddbddabddda	FALSE
cadaddacbdcabdadcacacc	FALSE
cbabccacdcdddaddabddca	FALSE
cbcbcacbddcddacdacbccb	FALSE
cbdacddccdcdadabcccbab	FALSE
ccabacadcbcccdbaccadba	FALSE
ccbadaccddbccccbdbdccb	FALSE
cccadbaccaccacdcdddaca	FALSE
ccdabddccabdcbacaccadb	FALSE
cdabababacdbccbaccbacc	FALSE
cdbcabdddadabcdbcdadac	FALSE
cdcbcbccacbccdacbadddc	FALSE
cddacacdcacdbaddddabca	FALSE
cddddabcccadcabdbcdbcb	FALSE
dacacabdbddcccabddbdbd	FALSE
dacdcdaccbdcdddddbdcda	FALSE
daddbcdbcaccccdcacbcdb	FALSE
dbadccdbcadabdcddcacdb	FALSE
dbcdccaddababaddcdbcda	FALSE
dbddbabddadcdddddbddca	FALSE
dcadadcadccdccccdddcab	FALSE
dcbdadcaccdadcccacaddd	FALSE
dccbddbdabcdacddadabdc	FALSE
dcdbcbadddcbdcbcaddbcd	FALSE
ddabcbccbcabccadcacbca	FALSE
ddbadddadaddaccabdbdba	FALSE
ddcadcdccdadadcdabdbdd	FALSE
dddadcdbadcbaccddcdacc	FALSE
aaaaaaacccabcdadcabdaa	TRUE
aabaccbcdbdcbdadbdabdb	TRUE
aacaddbbaabdaabdccadbd	TRUE
aadcacdabdcbdbadbbddac	TRUE
abbaabcddcaaacdbcdcdab	TRUE
abcbaadbddccacbaddcddc	TRUE
abdcdcaddcdddaaaccccdc	TRUE
acbacdbddddbadadbaacaa	TRUE
accbdabcaaabacabbacacc	TRUE
acdcdbaddbaaadadabbcbc	TRUE
adbaacbcbadcbcdcdccbaa	TRUE
adcbadbbdcaddccbbcbbca	TRUE
addbddcbabcaabdbddaada	TRUE
baadbacbcadacbaadbbcda	TRUE
bacabaddcdaccbaaaacdbb	TRUE
badbbcacacadadbbcbbcac	TRUE
bbacadabacdaccdaabaadd	TRUE
bbbdbbbdaccaabcaabddca	TRUE
bbdaabbdaccbacaabddacb	TRUE
bcabdadbdaaaccdccdaaab	TRUE
bcbcbcacdcbbdbdcbaddad	TRUE
bccccdbbdccddcadadadcb	TRUE
bdabbbdcaadaabddaaaacb	TRUE
bdbdaddacbdacbbabbcdcd	TRUE
bddacdbbdcabddacacabad	TRUE
caabdcdcadddcccbdbccda	TRUE
cabcbadadbdcaccbbccdda	TRUE
caccdbcbbcbbdbcbbaccaa	TRUE
cbaaacbbbadcccdccbcbcd	TRUE
cbbbbadacbcdadaddaacab	TRUE
cbcbdbbadcadcbcaaacaba	TRUE
cbdccdaadcadccbbddcadc	TRUE
ccaddabccdaddccdbbbabb	TRUE
cccaabddcaacdadadbadac	TRUE
ccdadaadaccaccaacbabba	TRUE
cdaccbbddddabbacdccbad	TRUE
cdbdcadaddddcacddaadbc	TRUE
cddbacabacaaaacbbcdbbb	TRUE
daabccbdddbddbadbcadcc	TRUE
dabdadcaadbadbbcdabaca	TRUE
dadababdbaccbcdcabaaca	TRUE
dbaadaaadcababddcdacba	TRUE
dbbcacccadacdbcbcddaac	TRUE
dbcdcdaacbcbbadbaababa	TRUE
dcaadadadcbdcaacdcbabc	TRUE
dcbcbdabbcbbabacacbddb	TRUE
dcdaaacabddcdbdcdbadbc	TRUE
ddaaddccdcbbcbacacbbda	TRUE
ddbbcbbbdaaadabbdbabac	TRUE
ddccdbdcbbcbddbcccaacc	TRUE
abababdabdbaddcabdcabdc	FALSE
abcaccbddddccacdcbcccda	FALSE
abcdbcadaccdcadbcacbccb	FALSE
abdccacacaccdbccdacbcad	FALSE
acacdcbddbdcaddbccacbdd	FALSE
acbdbdbdcdacdddadcbdbda	FALSE
accdbccacbcdadacbdbcdcc	FALSE
acddadccccbccbaccdcbcdc	FALSE
adadcabacbacacdacaddbad	FALSE
adbdcdadcddbddcadaccbcb	FALSE
addabcacacddacdbaddadab	FALSE
addddbabaccababddbcccba	FALSE
babddadcbadcbacdabadddb	FALSE
bacddcccdddadbccbcbcdac	FALSE
baddccdbdbcddcdcddababc	FALSE
bcbabcbcdccabaccdabcbab	FALSE
bccabdddcdcadadbdccddcc	FALSE
bccddccdacbddccdacdcaba	FALSE
bdabacbdddbcbdabcaddcdc	FALSE
bdbacbcddbddcabdbccadcb	FALSE
bdcbacbcdbabdddbddcccdd	FALSE
bddadcbacdbacbcaccdcdbd	FALSE
cabadabaddaddabaddbcdbd	FALSE
cacbcdadabdcdbdbdbdccbd	FALSE
cadbccbccdcbcdadcadccbc	FALSE
cbacacbcdcadcaccacddbcd	FALSE
cbcbcbcdccdabdabadabdba	FALSE
cbdadcbcadadddadddcccab	FALSE
cbddddccaccabddadddcdad	FALSE
ccbadbadcdacadddadcaddc	FALSE
cccbaccbddccaccaccdbcac	FALSE
ccdadadcdaccdadcabcabab	FALSE
cdabaccdbddbdbabddccdca	FALSE
cdbabdddcadabccdadbdbab	FALSE
cdcbcdbaccacadadacdbdcc	FALSE
cddbaccbdcdadbdcdccbadd	FALSE
dabacccaddddabacbdbabad	FALSE
dacbcdbdabcdcadbdddacad	FALSE
dadacbddcbcadbddbcccabd	FALSE
dbabcbaddadbdbacddabacb	FALSE
dbcadaddbdacadbcadcbcda	FALSE
dbdadccdbdacccdbaddddcb	FALSE
dcabccdcddadcddcddcdcac	FALSE
dcbaccdcbdcdcdbaccddcad	FALSE
dccabddadcdbcddbacbcbad	FALSE
dccddbddccbacacabcacdac	FALSE
ddabacbddbacbccbcbdaccc	FALSE
ddbaddaddadbdcccaccccad	FALSE
ddcbadbddadcccdcdbaddbc	FALSE
dddacbdbadadcdddbcdcdab	FALSE
aaaaaabdbaabcbbbcadcabb	TRUE
aabadcaacadadcbbdbbcaad	TRUE
aacbcabcdbddccbbddbacbc	TRUE
aadcbbaccdacbbccaabadba	TRUE
abbadbdcdacdabbdcbbdcca	TRUE
abccacbdaadadadcdcaaddc	TRUE
abddbaadbcdacdbdcacbdbc	TRUE
acbaadbdbcbdcacadbddabb	TRUE
accbdcbdabbccddbdcdadab	TRUE
acddcbabaabdcccbbdbbbbd	TRUE
adbacabccbaaabddcbddccd	TRUE
adcbbbdcabcdccaacbacbdc	TRUE
addcdaadcacddcaadcabdbc	TRUE
baadcbbcacbcdcaaacdccdd	TRUE
bacacbddbabbcaaabccbabb	TRUE
badccbacacbdbabbbbbbdbc	TRUE
bbacddbcddcadddaddbdcba	TRUE
bbcaabcaabdacdabcabdbcb	TRUE
bbdacbdbaabbbacbdabdbcc	TRUE
bcaadbadccaabcdcaadcdcb	TRUE
bcbdacbaacbbdaccadaaadc	TRUE
bccdcccaabbccbabadadcba	TRUE
bdaacaccdccbabdddbabbdb	TRUE
bdbcaccbacaaacccaaaccbd	TRUE
bdcdbcbdbddbbcabdbbcabc	TRUE
caaabbdaabcccdbccacadbc	TRUE
cabbbcddacacddabcdbabbb	TRUE
caccbbccbbcdaabdccaccbb	TRUE
caddbdcbbcddaaadccabbcb	TRUE
cbbadbcbbabdacccccababd	TRUE
cbcadcbabacaabccaddccdc	TRUE
cbdbbddaaadbaddcacdbdbd	TRUE
ccadcadccdaaccbbcbdbcbb	TRUE
cccadbbcbcdaadabadcbbdd	TRUE
ccdbdcbbbdbcdccbcaaabcd	TRUE
cdaccbadccbbaabcabdbccc	TRUE
cdbddcabbbadbaccdaaccdc	TRUE
cddbbcdcbaccbadabbacbba	TRUE
daadaabcaacdacdbcbbadbd	TRUE
dacaaaccabcbdcbcbdcbbab	TRUE
dadbbdabbdaaccbdcacabcc	TRUE
dbadaaaccadadcdcddddccd	TRUE
dbbddbdbadcbabcbcbdbbad	TRUE
dbdbadbaabccadcdacbbaca	TRUE
dcacaaccbaadbabbbddbcba	TRUE
dcbdaccccccbadbaadddddd	TRUE
dcdabbdaaabdaddddbdbdac	TRUE
ddabdaaccabcabadccbccdd	TRUE
ddbcbdcbaadbcaacbdbaddc	TRUE
ddcdacaccbdddaaacbcbdad	TRUE
abababacbdbcbaddddcdcdbc	FALSE
abcadcccdacabdabddcdacca	FALSE
abdababacacdadadbabcadad	FALSE
abddccbabdbcbdadccccdbac	FALSE
acadddddccaddddbdabcdcbc	FALSE
accadddcdbdbcccddcadcdcb	FALSE
acdaccacdcdddabaccdbdcad	FALSE
acdddcbddbddcacddacccbda	FALSE
adbacbccbccdabcccbdcdccb	FALSE
adcbacabdbccddbdaccddbcd	FALSE
addadacbadbcacbadccddcab	FALSE
adddcddddacacbcbdddcbabd	FALSE
bacacacadcbacdbcdddbcada	FALSE
bacddddbdddacabccbdcaccb	FALSE
baddbddbdbcbcaccacddbcbd	FALSE
bcadcdcbcbabcacddcbddcbc	FALSE
bccacdaddccadadcdbdcdcca	FALSE
bcdadbcbccbcdbacadbcccba	FALSE
bdabacdcaccdccbcacabacdb	FALSE
bdbcabacdabcccbddabadcac	FALSE
bdcbcdbabadadbadabddcbda	FALSE
bddbcadcabdbabdadabcdabc	FALSE
cabcababdbacddcabaddbdcc	FALSE
cacbccbccdadadabdcdbdbdc	FALSE
cadbdcaddacbdddaccddcdcd	FALSE
cbacbccbddbacddbdcdbdbac	FALSE
cbcbdadcaddadbddacdcbdbd	FALSE
cbdbcbcddccadbcbcabcdbcb	FALSE
ccacabacadcabddacbcccdba	FALSE
ccbcdabaddbdcccbdcbccddd	FALSE
ccccacdacabccdcbdbabaccb	FALSE
ccdbdbdcdccbaddddcbcabac	FALSE
cdabcdccccdbdcddcdbdbdad	FALSE
cdbccddddccacbdddaccbadd	FALSE
cdccdbaccadccbddddbccddc	FALSE
cddcacdddadadcdccdbdddcc	FALSE
dabcdbdbdbdccbacddbcddab	FALSE
dacbdadbaddcccccbabdbdac	FALSE
dadacbccbdcabccabdbdacac	FALSE
dbabccacccbdccabcddbddcc	FALSE
dbcadbddccdddcbacdcdcddc	FALSE
dbcddcbcbdcadcaccbddcbca	FALSE
dbddcadbdcbcccbdacddadac	FALSE
dcbaccbdacbacbdabddbcbab	FALSE
dccbaddabccdcacdaccadbad	FALSE
dcdbabacbcbddcbacdbddddc	FALSE
ddabdbadbaddbcdbabdcccca	FALSE
ddbacacdbccabdbccdbdbdcb	FALSE
ddcadaddadcbaddcdbcdacba	FALSE
ddcdddcdcaccbababadabccd	FALSE
aaaaaaaabbbdacbadbddddca	TRUE
aabababbddbbaadccdcabbda	TRUE
aacaddaaadcadaaaccbdcdbd	TRUE
aadbbbacdadcccbcdcdddada	TRUE
ababdddacacabdbbbcabddca	TRUE
abbccacdbddaacabcacbdabd	TRUE
abdabbcadcbdcbbabbbcbaab	TRUE
acabddaacdbcdcbabaaccbda	TRUE
acbdcdccbadbdbbabdddadca	TRUE
acdbaaddcbacbcbddbbadbdc	TRUE
adacabdbabbaddabdadbbdba	TRUE
adbdbacdcaaaaadaaddadbca	TRUE
addaccbdbdbbaadbaddbadbb	TRUE
baaadcdabaabcbccabcdcbda	TRUE
babbabdcabbcaaddadadbdcb	TRUE
baccadaabbbbadccbccdabdb	TRUE
baddadcbbaddcaaddbbbdacb	TRUE
bbbacaaaadddbcdcdabaabab	TRUE
bbcbaaddabcddbaaabcacdbb	TRUE
bbdbdcbaaaaadccbcbdbdbcd	TRUE
bcbaaaabcabbdbabddaaabca	TRUE
bccbcbabcbbcabbbbcbddccc	TRUE
bcddacccdccddaadbabbaabb	TRUE
bdbaaaccadbdaddcbbdbcccb	TRUE
bdcbdacaaaccdcdabbabadcb	TRUE
bdddbdbccccdbbcacbddbcdd	TRUE
cabbbcbdddcbacaaabbcbcab	TRUE
cacdabbbadacbbadcabdbdab	TRUE
caddbdbbdaadaadaaccaddad	TRUE
cbbacabbacbbabbbbcddbdac	TRUE
cbcbbcbacbaaabddadabcbba	TRUE
cbdcdcdcdddbcadbbcacbadc	TRUE
ccbaaaacacabcddaabbcbbca	TRUE
cccbbcadbdcbaababbcbbbbb	TRUE
ccdcdaaaaaacdbcaddbdcadc	TRUE
cdaddadbdbaabaabacbbccca	TRUE
cdccabcdbcddbabdcacccbba	TRUE
cddcdacabbcddddacdabccdc	TRUE
daadbdbdbcabaadbcaaaaaac	TRUE
dacaadaaccdbbcaaadcdddaa	TRUE
dadcbdbdcdcbadabdaaadccd	TRUE
dbaddbacddbdbbadbddccdaa	TRUE
dbcaadbbcdaccccaaadabcaa	TRUE
dbdbcdbaaaadacbadccadbdd	TRUE
dcadbcacaaccdccddbaabdaa	TRUE
dcbddabbbaccdbddcabcabdc	TRUE
dcdbdabddcbabcbbdbadddac	TRUE
ddacbbccdadcdaddcbdabdcc	TRUE
ddbcccabcbcbdcdccabdadbb	TRUE
ddccccccadcaabddcbdbbcdd	TRUE
ababababdabacbdccbabcbddd	FALSE
abcaddaccdbdbdbdabdddadbd	FALSE
abdadbcdbccabcbcbcdcabacd	FALSE
acabccdabcabcddadcdcbdddd	FALSE
acbaccddcbddddbcccbcbadba	FALSE
accbadddcbddccddadbcbabda	FALSE
acdabdadadadbddadccbddbcd	FALSE
acddcaddcdccbadddcccdbabc	FALSE
adbabcabadbcddacccbdabdbd	FALSE
adbddddbabdbdccbdccccbddb	FALSE
addabacacbcdcacddcdbdadac	FALSE
addddcdbcabdcdcdbaccaccab	FALSE
bacacabdacacacbcdbdbddacc	FALSE
bacdcccabdbccccdadbacbacc	FALSE
baddadbdddbcdbcbacbcbadcd	FALSE
bcbabdbcbaddadbdcababaddd	FALSE
bccacdbcdadcdddabccddcddd	FALSE
bcdabaddcdcbddacbcdcbcccb	FALSE
bdababcaddccccccbddcccbab	FALSE
bdbcacbaccacadadbddcadcda	FALSE
bdcbacddaccacddcccdbccbca	FALSE
bddacdbdccbdcacdcbcacdacc	FALSE
cabadabcbdbaddcaddcddbcdd	FALSE
cacbadccadddadbdacdddabdb	FALSE
cadbacacbddcdabcdacdbdcab	FALSE
cbabcdaccddcbdbcdacccaddd	FALSE
cbcbccccbccbadbccadcdddba	FALSE
cbdadabadcbcccccacdbdcddd	FALSE
ccabadbccccccacddacdcdbab	FALSE
ccbacbcbcdacbdadbcbcadccb	FALSE
cccadadbcbadacdbabaccdaca	FALSE
ccdaddcbddcddbccbadcadbcd	FALSE
cdabddbdccbccbcddcaddbcca	FALSE
cdbcccdcddacdbacbdabcadba	FALSE
cdcccadbcbdcdacadbcddcadc	FALSE
cddbddbaddbccacbcdccbdaba	FALSE
dabcbadabdacbdadbacddbdcc	FALSE
dacbcccbaddbdddadabcdabca	FALSE
dadaddcbdddacdabdadbacabc	FALSE
dbabdcbccbdcccbadccdcbdbd	FALSE
dbcbacdbdadbacdcdbadbabcb	FALSE
dbdabdaccccbcbcdcbdcadaba	FALSE
dbddcddcddddbaccdccacbdcc	FALSE
dcbcaccbcccbacccddccbdbad	FALSE
dccaddadbcadbccadadabdccc	FALSE
dcdacccababaccbacdaccacbc	FALSE
ddabadbcccbdcddbcbccbdadb	FALSE
ddbadaccadcbcccbdadbcbdac	FALSE
ddcbababddacbddbdacacdccb	FALSE
dddabdbacddcdadbcdacbdcca	FALSE
aaaaaaadacbadbbadbabcacad	TRUE
aabaadddbaabdcdbbabacdbcd	TRUE
aacbaaaccaddccadbbaadcaaa	TRUE
aadccacbccbacdabbcdbbadcd	TRUE
abaddacabcaabcccddaddacac	TRUE
abcadabcbadccbdccbabadbba	TRUE
abdbbaccacbabbacbcbcacabc	TRUE
acadadbdbcdcaddcaabacbaaa	TRUE
accaddbaccdacccaacbdbdcdd	TRUE
acdbbcbacacbbaabbacaccdad	TRUE
adacbcacddbccbbcacdcdcacd	TRUE
adbcbddaccabbdcbabbdddbbc	TRUE
adcdaacbdcddddcbbbcdbadbb	TRUE
baaaabadcddababdccbabadda	TRUE
babbbbcabcbcacdbcdddcdada	TRUE
baccccdddcbbdcdbbbbbdbcca	TRUE
bbaacdddbcbbccabcccacdcba	TRUE
bbbbcabbcdddaabcdacdaabcb	TRUE
bbccdddcabdbcddcadabddaab	TRUE
bbddadabacccabaccbbdabddb	TRUE
bcbaadbbcacbacdcaaccdadca	TRUE
bccbacbdcbbdbcbbcdcabbcad	TRUE
bcddbcbadacaaacbdbcacadbd	TRUE
bdbacbcbccddbdbabaacddbdb	TRUE
bdcbbcdcdbbacdddccdadcadd	TRUE
bddcadbacaadabbcadabbddad	TRUE
caadadbaabccbdcacabcabbcc	TRUE
cacaacbbaacaaababbdcdaddc	TRUE
cadadddcabcabaabbcdacbaca	TRUE
cbacadbacdbbcaadccadaadab	TRUE
cbbdccbdaacaacbadcbadcadd	TRUE
cbdadaacccdaacdadbccacccd	TRUE
ccacabccbbdbabcddacccdcbc	TRUE
ccbdaacadaadbbbaadbcbbbbc	TRUE
ccdadccaddccaaccdcdaccbad	TRUE
cdabbadaabddbaacadaaccbab	TRUE
cdbbbcaadddbddcdabdddcbda	TRUE
cdcdbbabddccacdddbadadbbb	TRUE
daaabcccdcdaccdbdbdbaaaba	TRUE
dabcacdcbaabcbdbdacbbdaaa	TRUE
dadaabbdabdacddbddddcbcca	TRUE
dbabbdcaccddabbbabcacadab	TRUE
dbbcbdaaaabcbddcbbcaacccc	TRUE
dbcdbdadbadbcccbaaacacbcc	TRUE
dcaadabbcdbcbadbacbccbdcc	TRUE
dcbbdddddabdabdadaddbbbdc	TRUE
dcccbbcaddccdcbadbdbdabac	TRUE
dcdddccbcadadabdadbbacbca	TRUE
ddbbbcbdbdcabdbbabcaabcdd	TRUE
ddccbabcccbadcaabdccccbac	TRUE
ababababdcddabacabdadddaca	FALSE
abcacccdacaddcccddcacdbaba	FALSE
abcdccadadbadcbcacabadcdbc	FALSE
abddbcbdcaddadbacccdadaccc	FALSE
acbadddcbcaccbdaccbaccddad	FALSE
accbadddccbaddcbdddbcdcbac	FALSE
acdaddbacbcdadbdccdbccccbc	FALSE
adabadbadcbccdddacadbacabd	FALSE
adbadbddaddadbdcdbadabdbdd	FALSE
adcacccccabacbcadcabddccab	FALSE
addabcdcabccacdabcdbdacbdd	FALSE
addddbccacadbdbabdccddcadb	FALSE
babddccdccaddbadacbdadbcba	FALSE
bacddcddccacadbdcabacccadc	FALSE
baddadadbcdcbdcadaddadadca	FALSE
bcbacaddbcdcccbdacadadddcd	FALSE
bccacbcdbcacaccddbcccabadc	FALSE
bccddabacdcaccddabdcdddbdc	FALSE
bcddacdcdacaddcabdbcacddcd	FALSE
bdadcbcaccababacdbdabababc	FALSE
bdbddadadcbacacbdbddddcbcd	FALSE
bdcdabdcbdadcbdbadadacdabc	FALSE
bdddabcdabaccdaddccdddccad	FALSE
cabdbadabdbcdabcdadbdddadd	FALSE
caccddddddbdbacababaddcacb	FALSE
caddacaccdcdcbdbcadacbcccc	FALSE
cbcabadbccdcdcbadcbdbccddc	FALSE
cbcdadbaddcccdcaccdbddddbc	FALSE
cbdcccbcabaccbcbabcabccdab	FALSE
ccadacccbcbcbdddbcdcaddacc	FALSE
ccbdbcabacabccbacabdababcd	FALSE
cccccdadbdcddcdccbabdcbdda	FALSE
ccdccbdacccccdcbabcdadbddd	FALSE
cdadbcbcccbcaddcccdabccddd	FALSE
cdbdaddaddccabcddddadcbcdb	FALSE
cdccdbacdaccdccddbabdccbab	FALSE
cddcbacbcddadbdabcacbddcac	FALSE
dabccbdbddccdcdabccccccbad	FALSE
daccaccadddabcdcdbddadbcac	FALSE
dadbdbcdbdbcbadccacacacbcc	FALSE
dbacbccdbabccdbcabacdddcdc	FALSE
dbcdaccabccdcdcadcacdbcdbc	FALSE
dbdcdcdcabdcadbacdbccabccc	FALSE
dcadcdabdbcddcddbdbabddbcc	FALSE
dccabcdacdabdcddaccabcdaca	FALSE
dccddcccdcdacdacbcddcaddbd	FALSE
dcddcbabdacbdacdcabdacbacb	FALSE
ddbacabddadccddcbacbcbdbad	FALSE
ddcaddbdcccccccbdbabddcdac	FALSE
dddaccbdbadccdcacabddaccad	FALSE
aaaaabddcdbabdddddbcadabac	TRUE
aabadbabdacaabcaadbbaccaab	TRUE
aaccbdccdcaabdacacabcbacdb	TRUE
aaddabbbcaddaddabcbbbddcbd	TRUE
abadccdcbcaddbcaaddbbbdaaa	TRUE
abcaabbbabcbcdadaddcdcacdb	TRUE
abdbdbcacdbdbbaababcabdcda	TRUE
acbacaadababbdcdcdabaddaaa	TRUE
accbdcdbbdddbbddcaccdbabbd	TRUE
acdcbddcadacbbdacabbbdccbb	TRUE
adadcaccadaabcbdbaddcaccdb	TRUE
adcbbabbccbacbcbddacddacab	TRUE
addccaadcadadddbdbcbaabadb	TRUE
bababbcbabdaabccaaaaddaabc	TRUE
bacbbbacbacccaacbddcdacdbc	TRUE
badccdbbbcccddcadabdcdccad	TRUE
bbadacbdbbddbcbabbcddbacad	TRUE
bbcabcbdacdbdcaddbdbdbccdc	TRUE
bbdbbaacaacaabcbaabdcccdbc	TRUE
bcacdaababdcccccabaadddcab	TRUE
bcbdacbcbadadaaacadcabbbbd	TRUE
bcdabbaaadccddacdbcccccccb	TRUE
bdaacdabdcacdacddaabdadcad	TRUE
bdbbdddadcccabbbbcbdcbbada	TRUE
bdcccdcdbadcaabccdabddcbcd	TRUE
caaaadaadacdccdbadbbdddcda	TRUE
cabaddbbaaaababddbbcbcbcba	TRUE
cacbddaacadcdbaddbdcbcdbbc	TRUE
caddbbdcddaaacbaaccdadcddb	TRUE
cbbacdaccabacacddabcabcbca	TRUE
cbcbbdadcaacbbbcdcaabdcada	TRUE
cbdcbacaabacbdddacacbacdcb	TRUE
ccadcacddaacbbabbcabcabdad	TRUE
cccbbcddbcdbbccbacbddbbdab	TRUE
ccdcacbbabaaadaadbbbccdddd	TRUE
cdaddbdaaddcacbcdccdbdbbdd	TRUE
cdcabddcbaaadbcbbacbdcddcb	TRUE
cddbadacddddbacdabbdacaaab	TRUE
daaccbcddddbcdbdacdaabcdaa	TRUE
dacaacadccabddbdbdcadcadac	TRUE
dadbabddcbbdadcdaadccccccc	TRUE
dbaccbddaddbaabcbccddddbda	TRUE
dbbdaccacbbdcdcccdbbdbabaa	TRUE
dbdacbbcbadcbcddbdabdcacbd	TRUE
dcacabdcabbcdbddadcdaacabd	TRUE
dcbdaaccdaaadbadbbcdddabdb	TRUE
dcdbbbbdacbdabaaccdcaadbca	TRUE
ddabdcadcbccccdcbaddaaadcc	TRUE
ddbcbbbcbdbdbaabadbddbddca	TRUE
ddcdabadccbdaaacbbabbdccbc	TRUE
abababadcadabacbddccddadbcc	FALSE
abcabcddbdadadacbdacabdaccd	FALSE
abcdcbdbcdddabccdabddcadcdb	FALSE
abddbcbcddcdbcdadccddccabdc	FALSE
acadadbdcbccccdabddddacacbd	FALSE
acbdcdbabddadcccdbcababddda	FALSE
accdcbacbcadbcbccdcbdbabdcd	FALSE
acdcdcdcbccdbcddbcddbaccacc	FALSE
adacddcdccbadbabdcbcadcbadd	FALSE
adbdcaccddccbadbcaccbadcabc	FALSE
adccddddbdadddcabdccddbccbc	FALSE
addccbaddacccacbdbcddacadab	FALSE
babcbdbcbabcdbcacdcdcdabcda	FALSE
bacccadacbabdbccacbdabacdad	FALSE
badcbacbdcadbccbadcddcdccac	FALSE
bcacbddacbcdcbdddddaddacccd	FALSE
bcbccbacacccacaccddcdcabcbd	FALSE
bcccbdbacbaccbddbdbacddddbd	FALSE
bcdbcabcbddaccbabdbddcacaba	FALSE
bdabcdabdacbcdcaddaddadbcdb	FALSE
bdbadbdcdcdabadbacbacdccaca	FALSE
bdcbdbdcacbacbddbabcddccdca	FALSE
bddadccdcdcabcacdbabcbddcdb	FALSE
cabaddabaccbdbccbacddddddcb	FALSE
cacbdadabdabddddbdadcdcccba	FALSE
cadbcbcddbddabdddadddbacbac	FALSE
cbabdbdcdaccabddbcadaccccdd	FALSE
cbcbccacbdcbdbcabdcdabcbdcb	FALSE
cbdbcddccbabacdcddcbcadddcc	FALSE
ccabdcdddcadccdccdbadddcdbc	FALSE
ccbcbcabccbdcadcddcbadabacb	FALSE
cccbddbcbadadcbadcdcccdbcca	FALSE
ccdbdbdddddcadabcbccbddcbdb	FALSE
cdacbabddddcdbdbdddcacaddca	FALSE
cdbccbcacadcacacabadabcbdbc	FALSE
cdcbdcbdcdbccbcdacabadcdadb	FALSE
cddbdbacdcadbccddbadadaddcb	FALSE
dabdabddcdaccbccccbabcababd	FALSE
dacdbcadbacbabcbcbdacadccbd	FALSE
daddacabdcdcccbabccccacccad	FALSE
dbcabcddbcabcccabadddbdbdca	FALSE
dbdabcddabdabddabddbdccdddd	FALSE
dbdddbacddcbabdacddabcdabad	FALSE
dcbacbcdacdacccdacaccdcadbd	FALSE
dccbacdaccdbacbdbdcccbcdbac	FALSE
dcdaddadbddbdacdddccbabdddb	FALSE
dcdddcbacccddacbccdcbcddadb	FALSE
ddbacbcdddbdcadcbcddcccdddd	FALSE
ddcaddbddbdbdadadabccabacda	FALSE
dddabcbabccbcabaddadcabcbdc	FALSE
aaaaabbbacbbabdabbdbbaaccbc	TRUE
aabadbcbdcdcccbadadbdadbbbc	TRUE
aacbbddacbbdccddbadddcabadd	TRUE
aadccabbdbbccadbbdccbbddadc	TRUE
abaddbdabbaadbbdaccdaabcdaa	TRUE
abcaddcbbbabdcabdcbadbcdbda	TRUE
abdbdbcaaddadbaabcccbadaaac	TRUE
acaccacbbbddddbdbbccbbacddb	TRUE
acbdaccbcccbabcbacdabdaacba	TRUE
acdaddadbdaabccaaacabaacccc	TRUE
adabbddcdacabaaaccaacbdbcca	TRUE
adbcdaddddadadcddbbbbcdbabb	TRUE
addaadcbdbddbdddaabcddadcdd	TRUE
baabbdbdadabbcbcadbdcdbadbd	TRUE
babbddccddbcaacccdbdabbacaa	TRUE
baccdcdbcdbcddaabadbacbbadb	TRUE
baddddacaaabccdabbdddcddcda	TRUE
bbbaaccbdcbdabccbbcbbdabcba	TRUE
bbcbcbcacaabbadbcddcdddcbbc	TRUE
bbdccabadcacacccaaddaddbbbb	TRUE
bcaddcacaddacbbcbcdbcbabdad	TRUE
bccabddacacbdadcbddbbcbbdbd	TRUE
bcdbbbcdddaaddaacdcdddccaac	TRUE
bdacdcbbbdbcaacddacdccbdcca	TRUE
bdcacdccdbcaacbbccaccdbddcc	TRUE
bddcbbdcddbddcdaddbddabbddd	TRUE
caaddacacddbbddddcbaaacdddc	TRUE
cacbacccacbbdabbcbccacdcccb	TRUE
caddacddadbcbbdacacccadadba	TRUE
cbbabadabbadcaaddbdacdbaaaa	TRUE
cbcbcaabcabdbdaccadbccadabd	TRUE
cbdcbcbbbdbabcddaaadadcdcaa	TRUE
ccadcbaacadabcdaabddbbdbabc	TRUE
cccbaabbcbdddcdddbaacdbcadc	TRUE
ccdbddabbdddcbacddbdbcbbcbd	TRUE
cdadacbdbbbabbbbcadcababaca	TRUE
cdcbaccacabbbccabbbbbcaabad	TRUE
cddcacabdbbbcdbcbacabaddcad	TRUE
daacabcadcabcbbddbbcbbaddda	TRUE
dabcbacdadabdaaabbabcdcadca	TRUE
dadabcddbbbcccccdbccdbabadc	TRUE
dbabbbcddaacdabdbbbdddacdaa	TRUE
dbbcccdbacccddcdcdbacaacabd	TRUE
dbcdcddccbccaacaabcbcabbcca	TRUE
dcaacbbabacacbabcbdbdbaadac	TRUE
dcbbdbdaacdcabaddcadbdadbba	TRUE
dcccccbbacaadbcbccbdddbcdbc	TRUE
ddaabbccbdbcdacacaaaacaaddd	TRUE
ddbbbacccccacbdcdccbcbbabcc	TRUE
ddcdabdaabacbcabcdaddabcbba	TRUE
abababacabcaccbabadbacacdadc	FALSE
abcacdbabdacddddbacccacadbab	FALSE
abdaccacdcbdabcdabcbdabccbcb	FALSE
abddcddccbdcdbdacadcabddcacd	FALSE
acbacbdacacccababdbaddccdbca	FALSE
accbabcacddabccabddcdccdccdd	FALSE
acdabcacdadabddacaccddccadac	FALSE
acddcdabcadbcabcdacabadaccbd	FALSE
adaddaddacdbabcbdcdacbdddcdb	FALSE
adcaddbddcddabccbcdbdbcacacb	FALSE
addacdcccccdcbabcbcddbdabdcd	FALSE
addddcdbdbddabcbcbddabcbdcab	FALSE
bacadddccccacbdbcbcbcbddcadc	FALSE
badbacbaddbcbccadabcdacacbad	FALSE
bcabadccababababccdabcddcabd	FALSE
bcbcadcdaddcccdacddcadcccbcd	FALSE
bccbadcdccbdcddbdbcacdbabcdb	FALSE
bcdbcaccbdabcdabdabcdbcddcac	FALSE
bdabdbdbdbccddaddbaccbdcddca	FALSE
bdbcadbacbadbddcabdabadbdcca	FALSE
bdcbdccbacacddcadadbacbddcab	FALSE
bddcabddbdbcabccdbadbcaccbda	FALSE
cabccabddacbaddabccccadacdda	FALSE
caccaddadcdacdbcdbadbcddacdb	FALSE
cadbccccbacadcadbadcbadddbac	FALSE
cbabdbdbdbdddbadabaccdbadbac	FALSE
cbcbddcdbabcbabadddadacccacb	FALSE
cbdbdacddbadaddcadcacbcacdcb	FALSE
ccabdbcdabdbcdadbdddbddcdbdb	FALSE
ccbadbccabdabcbdcbddcccbadbd	FALSE
cccaddddabddcacacdcaccaccdca	FALSE
ccdadcbccabccdbadadcddddbadc	FALSE
cdabdbccbdccdcdabdcbaddddbca	FALSE
cdbcacadcccdbdcbadccbdcdcdcd	FALSE
cdcbccdddaddcddbcdcabaccccac	FALSE
cddbcbabacbdcddbccacdabccbcb	FALSE
dabadadcacacbdbcadcadddcbcca	FALSE
dacbcbcccbadaddbcbdadcddcacc	FALSE
dadbacbadabaddccdadadcdbdcba	FALSE
dbacadbacabcacacadcdbdbdbadb	FALSE
dbccacdbdadcabadabdbacdacabd	FALSE
dbdcadcdadbdbdabaccbcaddaddb	FALSE
dcacacddbdcdcacbcbabacdacbcc	FALSE
dcbccaccdbcaddddcbabacadbabd	FALSE
dccbdcabacdacbadccbadbadcaca	FALSE
dcdbcabacdcdbccabdabcadadbca	FALSE
ddabddbdabccbcadbcdddabdcadb	FALSE
ddbcbccccabcdbccccacbcddbdcb	FALSE
ddcbdddcdadadabaddadadadcbcc	FALSE
dddbabcddddccddbddddccbaddcc	FALSE
aaaaabaadbbbadcbbdccbcaaddcc	TRUE
aabbcdbbcdcbdccbdbcbccabbaab	TRUE
aacdbdcdabacabcdccacbabdbbaa	TRUE
abaaaaabaacbaababacadcbadcbc	TRUE
abbbcadaccccdccdcddcbdadacdc	TRUE
abcbadaabddacdccddaabddbbbcc	TRUE
abdbdabccdddbbbdaadccccadcba	TRUE
acacbbbbbbdcbadacbddbbddabcc	TRUE
acbcdbcdcbaaabcdaaaadadddacb	TRUE
acdabdddbdbaadcacbaacaddbcdd	TRUE
adabbdbcbcbdbaabcdcacaaabcad	TRUE
adbccccdddaaddddadaadcdbbbaa	TRUE
adcdcddbcdadbaaaddbacbbababb	TRUE
baaabbaccbbdacdbddccdaadbcdb	TRUE
babbbadabdaddaddccabcabdabcc	TRUE
bacdaaacccddbccbdbbddddadaad	TRUE
bbaacbbdccdbcccbdcddcabbccac	TRUE
bbbbaddacddaadccaddbacaacbcc	TRUE
bbcbccdcbcdbaccabcdbbbbbdabc	TRUE
bbddcacabcadcdcaadcbcabdabdc	TRUE
bcbbdbbaadcbadbcdccbbddbabab	TRUE
bcccccbcbcabdcbccbbdaadcbbad	TRUE
bcddcbdcacaadddbaacdabdcddbd	TRUE
bdbaccaddabbdddaabbacbdcadbd	TRUE
bdcbbbdddcddcaccdddbabaadbcb	TRUE
bddcdabbacacbaacaccdbabacadd	TRUE
caadbdabbddbbdcdcbaccaccbcdc	TRUE
cacbbddddddcdbabccbabcdbbdaa	TRUE
cadcddcabddbccccbbadcacccbbc	TRUE
cbadcabacdbcadababdaacadccdd	TRUE
cbcbadddabaaabdbcdadcddacabc	TRUE
cbdcaccaabbbbaabbadbdbdcaaaa	TRUE
ccaddcacaadcaabddbdcdcbddaca	TRUE
cccbbcdadcdbcddaadccabaccbbc	TRUE
ccdbcddbdaaddabaadacbbbcacca	TRUE
cdadcbacbbcdbdadddcbacdbcacc	TRUE
cdcadadbadcbbcaabddbcccbccda	TRUE
cddbbbdacabcddabcacbcdacddcb	TRUE
daaccdadccbaabcaccddacbacacb	TRUE
dacabcadbdcdcbdaabbcddbaccdd	TRUE
dadbcddbcbabdbccbaddbaaabdac	TRUE
dbadadbbdacbaddbbacddadaaddb	TRUE
dbcaabbaacbcadcdbdcdcbaaddda	TRUE
dbdadddcabadaaaabbbabdbbbbad	TRUE
dcabcadbbddbcddacbaccbadcaca	TRUE
dcbccddddbacbccdbdbbbdcabdda	TRUE
dccddaadaddbabaaabbabaacaaac	TRUE
ddaabcaadcbacdaaccdccbcdbccb	TRUE
ddbbacbbdaaadcadaadabcbbbbda	TRUE
ddccabaaadacabbcbacbcbcdadaa	TRUE
ababababccadadcdbadabdddcccdc	FALSE
abcbacbcdacadbcaddbacabdcbdbd	FALSE
abdabcdcddadccacabcdabacdbcad	FALSE
abddcbcdbccddcccccbabcbdcdbcd	FALSE
acadcccabdcccacabcbddddbdcccb	FALSE
acbddabddcdbcbcbdbcdabdabdaca	FALSE
accdcdaccbdadaccaddcabcccbaca	FALSE
acdddbddcbcdccabcdaccbabdccbc	FALSE
adbacdadcbccadcabccccccbadbad	FALSE
adcadcbcccdbcacdbacddbcdacdda	FALSE
addacdaccbcaddcbcacdabcacbddd	FALSE
adddccaccdabccccdbcadbcadadcc	FALSE
bacabcdcaddcbadccbcacddcabcbd	FALSE
bacdccddccdcabcbcbaddcacdddcc	FALSE
badddabdccbcdbadacacdacacbddb	FALSE
bcbabaddbabdcdaccdbcababcdbab	FALSE
bccbabadcbcacaddcacabcaccbcad	FALSE
bccddccacbddaccbacadacacadcdb	FALSE
bcddbdddddcddbaddcbddcdbaddbd	FALSE
bdadccdabddbddbdbabcbcccdbdbc	FALSE
bdcabdbcdbcdccdbddbcbadadadcd	FALSE
bdcddbcbdcdbcddddabadacdababd	FALSE
bddddcabcadcacdbdddccbdcaccac	FALSE
cacadbacacdadcbcdadadbccbcdac	FALSE
cadacdbcacacbabddddddadcbdcdb	FALSE
cadddacadabcddcdcadbddcddccca	FALSE
cbcaccbaddbdbacacbdcdadadcbab	FALSE
cbdadcbdcdbdddcbcacccdcacadac	FALSE
ccabcadcabddabcadbaccacdcabab	FALSE
ccbadcacbaccccbabdcaddadabdcb	FALSE
cccbcbabcdccbdbacdbcbadbcbcad	FALSE
ccdadccaddbdccdbccacdbcbddadb	FALSE
cdabcbccbccccdcadcdddcacadbcd	FALSE
cdbacdadbacddbdbcdbdbadcccddb	FALSE
cdcbccdacacddacccccdcddbcabad	FALSE
cddacdcdacacbcadcaccdcbcadadd	FALSE
dabaccabadbabdbcbcccacadadddc	FALSE
dacacadddccadcddcabddabcbddcb	FALSE
dadabdaccccbcdcabdbaddbdddccd	FALSE
daddccbacbcccbcbaccdbccababab	FALSE
dbcabcacdadcccddbccacddbdacbd	FALSE
dbcddddbaddccadbacdcbccabcdbd	FALSE
dbddcbcdcadccbccdcdacadddaddd	FALSE
dcbabdcaddaddadacdddcbddccccc	FALSE
dccadadabccdadbababdadabadccb	FALSE
dcdacccbdcdadbdbdccadcabddddc	FALSE
dcdddccdacdcccdbdabdcccbabdcd	FALSE
ddbacdcaddacdcadbabadddabaccc	FALSE
ddcbacbdcabcdcdbacbabcbccdcdb	FALSE
dddbaddabacdadddcdacdbcdcdadc	FALSE
aaaaaacabcadcdaadcadcdccdcdda	TRUE
aabbacddbcbcbdcbcaddabaccdcdb	TRUE
aaccbbaaaadbdadabbcdaccdcddbb	TRUE
aaddcbaabaccaadbdadbddbbcaaab	TRUE
abbaacacdcdbcdccadcbcaabcbabb	TRUE
abcbbbdabcadbdaaddcaadadbacca	TRUE
abdcdbcbbdbaacbdccdbacdbacdab	TRUE
acadcabcabdaccdcbccadadbdbbbd	TRUE
accaccdacbbabbabcbaaaadacadcb	TRUE
acdbdbdabbbcaddccbbbaabbbdcca	TRUE
adadaadbbadccddbadabbabadccca	TRUE
adbdbddcccdaacdbacccabdcdddbd	TRUE
addacbdbbdaaaaaacbccbdabaaccb	TRUE
baacaacdccdbacddadddccdaacabc	TRUE
babdabadbbbacddbccbcdbbbdcbba	TRUE
badabccacbbbaadabbbcdbaadbdda	TRUE
bbaacdaddacbbabdcadcaaddabdad	TRUE
bbbbbcbababbdbaababdbaaabdcbd	TRUE
bbccbdcdccbddaddccccaadcaacaa	TRUE
bbddcbddacdcdbbcaacadaccdbdad	TRUE
bcbacdacbbbbadaddaddadacbaada	TRUE
bcccadddcadcabdbcdddabbcaacca	TRUE
bcdcdddadaaaabcccbccdbbcabdcb	TRUE
bdaddbcdcbbaaadcabaaabcacbaac	TRUE
bdcbaddbbadbbadcdcadbddaacaac	TRUE
bddcadcabababcbaddccbbcdccadd	TRUE
caacabbbcbdaadddbdcbadadaadad	TRUE
cacaaaabbaaaaaddbacddadbbcdcc	TRUE
cadadaabdccdadaddbaaccdddcdbb	TRUE
cbacabcdaabdcdcbcbddcdddcbdba	TRUE
cbbdaadbabdbccbadacbacdacccab	TRUE
cbdadabaadbcbcdabbbcbbddadcbb	TRUE
ccacadddadcadcaaadaaabaacdaca	TRUE
ccbdbdbbcaaccdbdcaddcabdcdabd	TRUE
ccdadcabbbdcdcbcbcdcbbcabcddc	TRUE
cdacbcaaccadadbccabdabdaaccbc	TRUE
cdcaadabadabcdaaabbadbcacadaa	TRUE
cddcabaaaacdaacbacabdaabcacbb	TRUE
daaccbcdbdadaaaacbdddbcbaaddb	TRUE
dabdcccdabcccacaadbbadcbbcdba	TRUE
dadbdaacdadacbcdbcbcaabdadacc	TRUE
dbabcbcbbdaabdcaacccdbbaababa	TRUE
dbbdacbcaacbbbcacccdddbccadca	TRUE
dbcdcacdacbccccabbbaaccbadbcc	TRUE
dcababadddddbabcaaababbabaadb	TRUE
dcbcbadbbadbcaacdaccadaabcdcb	TRUE
dccdbbbcacaadcbccaabdcdbadabb	TRUE
ddaabcddccaadbadabdcbdbadbdcc	TRUE
ddbaddcababaaadbadabcbdddabbb	TRUE
ddccadcdaadccdcdccdbbabdadddb	TRUE
