aaaaaacaacdbcbccbcdc	TRUE
aababdbacaabbbacdcac	TRUE
aacbacdcbcaccdcadaac	TRUE
aadbddadcdcacbdcddbd	TRUE
abaddbbdabaddcbbbccb	TRUE
abcadcbbbccbdbddbdaa	TRUE
abdbbdddbcbaadbaacbc	TRUE
acacddbbcdaadcabdcda	TRUE
accabaccacccababbcbb	TRUE
acdcbbdadbbbdcddbcba	TRUE
adbaadcccacadccdbccc	TRUE
adcbadcdbcaaababbbdb	TRUE
adddcdcdccdaaddbabdb	TRUE
babbcabbaddcacddbabb	TRUE
baccddabdadcdacbcbad	TRUE
bbaaddadacdaabbbcdca	TRUE
bbbbabdacdccdcdcbcbd	TRUE
bbccabcacdbbbdddddac	TRUE
bbdccaabdcacbcdadaaa	TRUE
bcbaccbdbaddadbcaada	TRUE
bcccbaadccbcaadbdbaa	TRUE
bcdcdbbcadaadcaaadac	TRUE
bdadbddadadbcbcbabac	TRUE
bdcacbbcbccbbbbaacbd	TRUE
bddbadaddbbcacbccdba	TRUE
caacaabaabddbcaddddb	TRUE
cabdddadbaaacdadbbdd	TRUE
cadbaadbdcbbdadacada	TRUE
cbabddbdcbcbcbdddcdc	TRUE
cbbcdaadcbbabcacacba	TRUE
cbcddccdbaaabcdccccd	TRUE
ccaabbcbacddbcdabbac	TRUE
ccbbcabdcabdcacacaba	TRUE
ccccdbacaddbcbdaacbd	TRUE
ccddddccbdaccdacbccb	TRUE
cdbadcbbbbdcadcdaaad	TRUE
cdccbbdabbdcccbcdbcb	TRUE
cddcdbdddcbbbbcadbdc	TRUE
dabbabbdcadbadadbaab	TRUE
dacbddcbbdddadcbaabc	TRUE
dadcacbbcdcacaacccdb	TRUE
dbadbdaaaddbcccbdcaa	TRUE
dbcaaccdddbbcddadaad	TRUE
dbdabdcababdbbdbdaca	TRUE
dcabbcabcdbbbaabbadd	TRUE
dcbcdbddbddbcccbabda	TRUE
dccddbabbbaccaadcacd	TRUE
ddababccddbadbaabaac	TRUE
ddbccbadadcdcbcaddca	TRUE
ddcdbabdbdddaaabdcab	TRUE
aaaaaaabdaddacbddaac	FALSE
aaadaddadcdaacadcdac	FALSE
aabddadbaddbdabaabab	FALSE
aacdaadcababaddaaabd	FALSE
aadccaccbdacadbdadbd	FALSE
ababaaabaccddaaaaabd	FALSE
abdadaaadcbadccdcdca	FALSE
acacdcdadcddcababdaa	FALSE
acbdddaaccaacaabacad	FALSE
acccddcbaccdccdbdaab	FALSE
acdccbdaddbaadcadcdd	FALSE
adabacadadaadcdcddcb	FALSE
adbababadddccabaaabd	FALSE
adccaaddcddddcdccacc	FALSE
addacaddabacddabadab	FALSE
addddccdaccaaaacacdd	FALSE
baacdadacdddcacccada	FALSE
babdacdaaaacdcccabda	FALSE
baccddbaabaacbddacdc	FALSE
badcaabaaadacdcadacb	FALSE
bdaadbdacacdddddbaca	FALSE
bdadddccdbacadcaadba	FALSE
caabadbdaaaadabaaaac	FALSE
cabaccaacdddcadadcbd	FALSE
caccdcddabdadaacbacb	FALSE
cadccaadabadacabdadc	FALSE
cbabdadcaadbddaccdab	FALSE
cbdadcbacdcaaabdddad	FALSE
ccacbddaaaadcbabacbd	FALSE
ccbaddddbdaadabddaaa	FALSE
ccccdbadaacdcbabadbd	FALSE
ccdccdaaabaccaabdacc	FALSE
cdabadbdacddacdcbdaa	FALSE
cdbadabddadcabaaacdc	FALSE
cdccbdaaddacdcbdaccb	FALSE
cddaddadabadcbaadccb	FALSE
daaaacccccdadaaaaaba	FALSE
daadadcddddacbaddbaa	FALSE
dacadabadddddddccaca	FALSE
dadabaacccbaacacaaac	FALSE
daddddcacdcccacbabaa	FALSE
dbadacccdaadbaadaadd	FALSE
dcaadacbabdabadaccda	FALSE
dcaddddacaacddaaddba	FALSE
dccbacbadaccaacccaba	FALSE
dcdaaddaaccccdaaaccd	FALSE
ddaaaaaaadacdadadddd	FALSE
ddadbacacdcdaacdccdb	FALSE
ddcbdaadaacacaadaaca	FALSE
dddaccaabacccdacccdc	FALSE
aaaaaabacdbbdbbaabdbd	TRUE
aabbdcdacadabdbcbbddd	TRUE
aacdaaddacdadcacabcba	TRUE
abaaabddcdabdddbcadcb	TRUE
abbbbcdbcaacbccbacaba	TRUE
abccccbdcdcddbaddabab	TRUE
acaabbacadddbdacdcacc	TRUE
acbbdbdbdcacbccbbbabc	TRUE
acccbbdaddbacaddcaaac	TRUE
acddcbbcccacabddaddbd	TRUE
adbabbbcbddacdcacbaac	TRUE
adcbbdbadadbabacdddab	TRUE
addcbacbbadbbaabbcbac	TRUE
babaaadbddbcbcccadcad	TRUE
bacbbaadcbaddbccaabdc	TRUE
badbbdbddcbddcbbdcbca	TRUE
bbadaacdddddabbcaaaad	TRUE
bbbdcdbbddbacbabbbaba	TRUE
bbdacaacbdbbacaaadabc	TRUE
bcabcabbbacabbacbacca	TRUE
bcbcbcdbbdddcadcddccc	TRUE
bccccbbaccbbbcadddddc	TRUE
bcddcaccbcadadadbddcb	TRUE
bdbabcaaabbdbbbbcbada	TRUE
bdcabdcbaaaabdddacbad	TRUE
bddbbdcbcbcaabbdadcda	TRUE
caacbdbdbcabadcdbcccd	TRUE
cabdcdaddadcbcdbbdbbc	TRUE
cadaccabdbabadcbcbdad	TRUE
cbabbbbddaacbabcbcdbb	TRUE
cbbcdbcadcadaadbccaaa	TRUE
cbcdddadcabcdcdccbadb	TRUE
ccabbbbaadccdcddddbac	TRUE
ccbdbddcadbcaadabddab	TRUE
ccdaabdddaccdbabadbcd	TRUE
cdababbbbdbddacccacca	TRUE
cdbbdbdabdadacbbdadaa	TRUE
cdcdabdadbbbaacccabdb	TRUE
daaaccadbbbccbaaaddac	TRUE
dabbcdbcbbbccbdaddadd	TRUE
dacdabdbdccbdccdcbdcc	TRUE
dbaadcccbcacacdbdddbc	TRUE
dbbdacacdaddcadcaadcc	TRUE
dbdaaadacbccbdbcccdaa	TRUE
dcacabaaaabbaccacabab	TRUE
dcbdabbcadbccbabccdca	TRUE
dccdddcccaaadabcbdddd	TRUE
ddaadaccdcbbadbaccbda	TRUE
ddbbdbcdbdcbabbbbbbba	TRUE
ddcccdbcdbdbcadddadbc	TRUE
aaaaaacdccdccbaadddab	FALSE
aaadbadadadcddcdcabad	FALSE
aacaddbaacdadcdadaadb	FALSE
aadaaaacaaccacdccaadd	FALSE
aadcddbdaadddbddabdad	FALSE
ababddacccabadbdaddda	FALSE
abddaabadaccacacdbaad	FALSE
acacdbacacccdabaacddc	FALSE
acbdadcccdaacacaddccd	FALSE
accdbdaaaaaddacdbadcd	FALSE
acdcccccadacbacadcbac	FALSE
adacacdcbdacaaadaaacc	FALSE
adbadbacadddaaabacdad	FALSE
adccddbdadcaddcbdaaaa	FALSE
addbadcdddaaabaaaaaaa	FALSE
baaaacaddabacbdacbaba	FALSE
baadbdaddcdcdccbaaadc	FALSE
bacaccbacacaccdaacaaa	FALSE
bacddcdbaaddcdadadcdc	FALSE
badcdcaadadddccdaaabd	FALSE
bdacaababdaacbabacaca	FALSE
bdddaaaadacbaadcaaaca	FALSE
caadaccbdaddcdadaaccd	FALSE
cacaabaccabdacaaaaddd	FALSE
cacdccaacdccabdabaacd	FALSE
cadcdbaaadcdadcacadaa	FALSE
cbacabacdcacccaadcbab	FALSE
cbddaaccdccddcccdcccc	FALSE
ccadacacdaccccbddacdb	FALSE
cccaabaccddaacccaddda	FALSE
cccddaaaddcaddcccaaca	FALSE
ccdccdaddadbddacadccb	FALSE
cdacabacbacaabaacddcc	FALSE
cdbababacabacaaaddccb	FALSE
cdcbddacddcadadbaabad	FALSE
cddadccdddbdadddcdaab	FALSE
daaaccadcdcaaadcacaad	FALSE
daadabaccbacdcdacacbd	FALSE
dacaadacabacacbaaccaa	FALSE
dadaaccabadcadadacccc	FALSE
dbaaaacdccbaddadcdcbd	FALSE
dbadadadadcacacbabdac	FALSE
dcaacddcadcabacccaaca	FALSE
dcaddacdadaccddddbddd	FALSE
dccbabdddabababadabaa	FALSE
dcdabdaaccdcacddcaada	FALSE
dcddcccdddaacddcdcdcd	FALSE
ddadaaccbadaccaadccac	FALSE
ddcacacccbaaabacddaad	FALSE
ddcddccccabdabadaddcb	FALSE
aaaaaabcdbccbaabbbddba	TRUE
aabcbbacdcbdadbdbbabaa	TRUE
aadaacdacaabbbcdcbbadd	TRUE
ababbcbdddababbcdccdab	TRUE
abbcabddbbcbabaacadccb	TRUE
abcdaabbdabacbdaabdaaa	TRUE
abddbcbdbabccbcdadcadc	TRUE
acbadaabccddbbbcbaabdc	TRUE
accbddddbdccaacbdadcda	TRUE
acddccbdcbbbbaddcdccaa	TRUE
adbacdbdcdccbbdbbcbbca	TRUE
adcbcaababbadcdbaabacc	TRUE
addcbbbcbdccbcbcabaaad	TRUE
baadbbaddbcbdbdcbcccca	TRUE
bacaccccababcdabbcaadc	TRUE
badaddcbbaabdcbdbadcdc	TRUE
bbadbaacabccdcbacbaddc	TRUE
bbcacbdabccbbcbcdbdcba	TRUE
bbdacbcbcbddddddcbcdac	TRUE
bcaabdcbbcbbdbbcddcdcc	TRUE
bcbaddddaaacabcbdcacbd	TRUE
bccbbdcddaadcbcbdddadb	TRUE
bcdccabbccdadbcbaccbca	TRUE
bdbaccaacbcbcaabcdccab	TRUE
bdcbbdbbaadbdaddbcdadc	TRUE
bdddacbdcadbcbbaaccacb	TRUE
cababadaacddbdcabaadcc	TRUE
caccaccdaabcbdcccdcbbc	TRUE
cadcdacbaabbdabcacaccd	TRUE
cbaddbddcaacdccbaacccb	TRUE
cbcadcdbcabbadacdaabaa	TRUE
cbdbbcabccdbbbadaddaad	TRUE
ccacbcbbcdbccbaadccaaa	TRUE
ccbdbadbcadabaaadcbbaa	TRUE
ccdaaccabcacbddbcbbddb	TRUE
cdabbcacaacaaabccbdcbc	TRUE
cdbbbbccaddbdbadbccbcc	TRUE
cdcdbaabdcaccadccdccca	TRUE
daabdbbbacbbbadcaaadcc	TRUE
dabdcaabcccaaabbbdabaa	TRUE
dadacacabcbbbdbbbcbbdb	TRUE
dbabbadbbbadcddaabbbba	TRUE
dbbdbcabdaadccadacbaba	TRUE
dbdababddcccdabadbadbd	TRUE
dcabdcabbbdcddbaddbcab	TRUE
dcbcabccbbbbacdddabdcb	TRUE
dccddcdbcdbdccdaacacbc	TRUE
ddabdcababaadcdacacdac	TRUE
ddbcdcccdcdcdbaaaddccb	TRUE
dddaaadbccaaaacbddddca	TRUE
aaaaaaccbddabaaddbacdc	FALSE
aaadaaaaccdadadaacdcac	FALSE
aacaaccddabdacccadaaca	FALSE
aacdbdacdaaddcaacdaaaa	FALSE
aadcaddcabacaadaabaacb	FALSE
abaacddbadcadddcdacddd	FALSE
abdaadacbaccaddcadacdc	FALSE
acabddaaaaadaadaaadbaa	FALSE
acbdaaaccbacbdaaadcadd	FALSE
acccdaacbdacdacdabaddd	FALSE
acdcccbacacacbaadbaaac	FALSE
adacaadccdbacdaaccbddd	FALSE
adbdaacdcbdadaacdddddc	FALSE
adcdadbaaddccadaccacda	FALSE
addcdaaacdbdaadccbabdd	FALSE
baacaaacbaaacdababacba	FALSE
babadaaccaacccdacbdada	FALSE
baccccccacabddadadadda	FALSE
badcaacccadbacdacddcad	FALSE
bdaaddbdaacbadabacabaa	FALSE
bddaadacddadadcdcadacd	FALSE
caabdaaccdadcabdadacac	FALSE
cabaacdcbdaacaaaaaddda	FALSE
caccbadacadcbdacdbdaca	FALSE
cadacdcbaadbadacaaabdd	FALSE
cadddaacdddccaaccdadad	FALSE
cbadacdbdacaddaccabacd	FALSE
ccaaabaddcdacaddccbaba	FALSE
ccadcadcacbaaacacaabac	FALSE
cccbacdaadadcddddabaaa	FALSE
ccdadadcbaccdcaabaddad	FALSE
cdaacdccddadacadacdcbd	FALSE
cdbaaabdabacbadcacdbad	FALSE
cdcbadcdacabaddaacaaab	FALSE
cddaadabacccdbabacdcad	FALSE
cdddbaccaccbdddaaaadac	FALSE
daacdccbddadbabaccccad	FALSE
dacabaccddacbaccdaabdd	FALSE
dacdccbacccdcadcbaaccd	FALSE
daddacbabdaacaaabaddda	FALSE
dbacacdcddcccddaaacddc	FALSE
dbddacddaaadaaacacacaa	FALSE
dcacccaacdcbdacbdaaabd	FALSE
dccaacddcacaabddacdccb	FALSE
dccdbadcabaaccdadcacdb	FALSE
dcdccccacaaaccadaaddba	FALSE
ddabdaacdabdaabdabacdc	FALSE
ddbaaddddccddccaaaabac	FALSE
ddcbddaccdcccbaaddbdaa	FALSE
dddabacddcaabaacccdcbd	FALSE
aaaaaabbbcddbacddaaadcd	TRUE
aabadacabccbbccdcbbcbcd	TRUE
aacbbbaddcacdabcaddbdcd	TRUE
aadcddbccdbcadddacadbac	TRUE
abbacbdcabcccbbcccbcbdd	TRUE
abcbdcbcbacccacaabdbbdb	TRUE
abddbacaaabbdbcaccbbcdb	TRUE
acbaadaacbbabacdccaacaa	TRUE
acccabcdcdccaccddaccccb	TRUE
acddacbcddbddabcddcdaba	TRUE
adbacaabdcccddcdcbacabb	TRUE
adccdbbadabbcaddbaaadbb	TRUE
addddbbbcaacdbaaccdbdaa	TRUE
babbccdbdababdacddbcdcd	TRUE
bacdbabdbcbaaccaccbaaad	TRUE
bbaacddabdcccddbdcdaaba	TRUE
bbbcaddadadcaccdbcaaacb	TRUE
bbccccbdcbbadbdddbbcddd	TRUE
bcaaabdcbbbaabdbacaabca	TRUE
bcbbbbbababacacddbcdacd	TRUE
bcccbadbcaccccbcbbdabdb	TRUE
bcdcdbccaacbaaddadacaac	TRUE
bdadabdbbbbbaadcdaacaca	TRUE
bdbddbbdcbaacccacdbcaba	TRUE
bddadbddbcbcdbbbddbbbba	TRUE
caabddcbddbccccababbcbb	TRUE
cabdcacadbdaababccdbdbc	TRUE
cacdddaddddccadbdddccac	TRUE
cbaacdbcadaadbcbcddbbcd	TRUE
cbbbcddadbdaccaabcbdddd	TRUE
cbcddabcbaaaaaaaccaabbb	TRUE
ccaabcabcbdcbadcdaabaad	TRUE
ccbbddbbdddbaaccddcacdc	TRUE
cccdbaabcccdaabdbdbbdaa	TRUE
cdaacacabbcdddbbcccacdc	TRUE
cdbcabbddacaabdadddccad	TRUE
cdccaadadabbcddbccbaccb	TRUE
cddccddaddaabccccbdcdad	TRUE
daadcdaadaabbdcbbdadbac	TRUE
dacaccbdcccbaabdabdbaca	TRUE
dadbbccdbaabbdcaabbdcdd	TRUE
dbacabddaabcbcccccddbcc	TRUE
dbbdcdbddbcdcbbabbbbbca	TRUE
dbdababcccddddcbbbdabab	TRUE
dcabbcaaccbdcbcddbddcaa	TRUE
dcbcacadcbdddccadddbbcb	TRUE
dccdbbbadcbdcbdaccdacdb	TRUE
ddaaabbdbabbbbababdbacc	TRUE
ddbbdbbcabbbcbcdaabbaab	TRUE
ddcccbaccbcaadabbbadddb	TRUE
aaaaaaacbdadababdddadac	FALSE
aaadaddcacaddcdcdaddbad	FALSE
aacabacaaccdaccaadcdccc	FALSE
aacdcadccccbdadcdadaccb	FALSE
aadcbaaacaaacbdacacbddd	FALSE
ababdadccdccaabadcacaca	FALSE
abddadbaacccbddabdaddcb	FALSE
acadaabaacbacacdbaabacb	FALSE
accaabdacaaaaddaadcaabd	FALSE
accdcaacdaadabacdcaddab	FALSE
acdccaddaacadaaaccdadcd	FALSE
adaadddadadaadcabddaccd	FALSE
adbaacaacdcdddcdcabdadb	FALSE
adcbdacdbdaccccdaadaccb	FALSE
addabdabdaaaccacccabdad	FALSE
adddcdadbadadabadaacccc	FALSE
baaccbaadbdadadcddbadab	FALSE
babdaacdddddccdadadabaa	FALSE
bacdaacaaadcbaacddddddd	FALSE
badccdcbaadddcbdadcadda	FALSE
bdacacccddcadbddaaaaaaa	FALSE
bddadddaacdcaccccccaddc	FALSE
caaccadabaddcadcddbaddd	FALSE
cacaaabacaaccdbaddccdac	FALSE
cacdaacbabaabdadabaccad	FALSE
cadcdbdaacddbaaadcccbac	FALSE
cbabdacbdddadaccadccddc	FALSE
cbdabaaacdaababaaddcabd	FALSE
ccacaacaddcdcdcddddabac	FALSE
ccbddacdaccaaaaacaaaaba	FALSE
cccdacbdaaabacadbddddaa	FALSE
ccdcdcaaaadcddcdcccbacb	FALSE
cdacaaaadaaccacbdaccbaa	FALSE
cdbacccbaaaabdaaaacdccc	FALSE
cdccccaadcbddadaacdbdab	FALSE
cddcaaaabacbdaadaccaccb	FALSE
daaaddadabdacaaaabdabad	FALSE
dabaaccbdadccaccddadbdd	FALSE
daccaacddcccabaccaddaaa	FALSE
dadbaadcdddcdadccccaacb	FALSE
dbaababacbdadaacdcadada	FALSE
dbadcacadcdcdaacdcbdaca	FALSE
dcaacabdddaaadabaacaaca	FALSE
dcbaaaadaccdacadcaabacc	FALSE
dccbaacbadcdaaabacddbac	FALSE
dcdadbabdabacadaaccaccb	FALSE
ddaacabaccaddcbddadacdd	FALSE
ddbaaadaaddcccddccdcddd	FALSE
ddccbaacdadadccdadcaadc	FALSE
dddadaccacadadcacaaaddb	FALSE
aaaaaacdbbdadccddacaaaab	TRUE
aabbcddcbaabdbdcbadcacad	TRUE
aacccaadacbddcbaaddcdada	TRUE
aaddbbcccdcbccbdcdabccdc	TRUE
abbaddcacacdcaadaacbdbba	TRUE
abccccdaadbaadbdddbdcbdc	TRUE
abddabcbaacdabdaaaadddad	TRUE
acadadddabcbccbabcbddaba	TRUE
acbddcdbdbdbbdbdbadbdcab	TRUE
acdcaaacdcbddbacbacddaba	TRUE
adaddbdcadbacbdbdcaabddb	TRUE
adcbdcaddaabadabaaaddddd	TRUE
addddaaaaaaaaacdadacdbba	TRUE
baaddccdcabbbdbabdcaaaab	TRUE
bacaddbcbcbcbcdddbdbacac	TRUE
badcbdcdadaabccaadcaddad	TRUE
bbadaacbbddbaabacaacbdca	TRUE
bbbdcccacddccbcdcbcaaabb	TRUE
bbdabaccdddacdddcdaadaca	TRUE
bcabacbdddbcbababbabdccc	TRUE
bcbcabbbbdbdddadddcbdadd	TRUE
bccdbabdbbabaabbaaacaddc	TRUE
bdaaaadadbcddcacbdbbcdab	TRUE
bdbacadccdcbaddadccbccca	TRUE
bdcbcbdcbccccbdccbcadbda	TRUE
bddcddabcddbdcdbddbbacbd	TRUE
caaddcabbccdbcccdbdbdaac	TRUE
cacbbcbacdbbcdadccacbbcb	TRUE
cadcabccddcdcdaadbaaaccc	TRUE
cbacdbddcaaddcaaddbbbcda	TRUE
cbcababdacacbbcdcaadabac	TRUE
cbdbbbddaccbbcdcdacdcbcb	TRUE
ccaccaabcabccddbbacddbcc	TRUE
ccbdadcccddcadbcdabdbdcd	TRUE
ccdacaccaabacdcaadcbcacd	TRUE
cdacadbbaabadcacdbadcdcd	TRUE
cdbddcbccaacddbcdaccbcdb	TRUE
cddacddbdddccccbbdabdaad	TRUE
daabdadaaaadbaadaaacdbba	TRUE
dabcddbbdcacaacbcaddbdbc	TRUE
dacddbddcdadadabdaddbabb	TRUE
dbabbdbddcbbabbdddddcccd	TRUE
dbbcbccddcccbadbaadcdcba	TRUE
dbcdcacbcaaccdbacdcaadba	TRUE
dcaadbcaababbcdddbdacbad	TRUE
dcbbbbacabbddadcdbbddaba	TRUE
dccdbcbcbdddaccbbbcacbca	TRUE
dcdddbbabddcdbbbbcabaada	TRUE
ddbadccabdcaacbbdbdacccb	TRUE
ddccadbbadaababdbbccacaa	TRUE
aaaaaaaadbadaaacaddccaba	FALSE
aaadccacacdabadcaadabadd	FALSE
aacababacccdcccccddccddc	FALSE
aacdadcddaddacdcacacadcc	FALSE
aadcddadbaccccdbadacacca	FALSE
abacaadbaacaabacaaadccba	FALSE
abddaccccdbabaddaabaccdc	FALSE
acbaaadacaadccbabdaacabd	FALSE
accbabdacbdacdadadccabda	FALSE
acdaccaabdddacacdcdddddd	FALSE
acddbdabaacddbabacaddaac	FALSE
adaccdabadddadcdcacadacd	FALSE
adcabaccaadbaaadabacdacd	FALSE
adcdccccacbdddaacadcdacd	FALSE
addccacdaadcbacbdaacacdd	FALSE
baabddaaddbaddaadbadcdda	FALSE
bababacccdbaaaaadabacacc	FALSE
bacccadddabacaadaadaacdc	FALSE
badbaadaccdadaadbaacddcd	FALSE
bdaaccbaddbadcdcddadccaa	FALSE
bdadbdadcccdacaaaabadcdb	FALSE
caaabdaaacdaddcbdaabdaac	FALSE
caadabaaccbdacddabadcdaa	FALSE
cacaacbaaaccaadadccbdadc	FALSE
cacddacdaccdaadadcdbddab	FALSE
cadcdacdbaacbadbdadaaddc	FALSE
cbabdabdddddaaadccaacdca	FALSE
cbdaccaaadccaccacabaacdb	FALSE
ccaccddaacdddacddbaaadda	FALSE
ccbdadccdaddddabacaddaca	FALSE
cccdbacaccaddaddbacdcdcd	FALSE
ccdcccadddacdcdacadaadcd	FALSE
cdaadcbacbaacdcdacaaacba	FALSE
cdbaacdadcaabaacdccdadda	FALSE
cdcbabaddaaabdadaaddbadb	FALSE
cddababdacdcccddccadacdc	FALSE
daaaaadaccddcddddccddadd	FALSE
daadcdacacdddcddadadccaa	FALSE
dacbdadcdccdaabadabaaabd	FALSE
dadacaacddccbacdaadbacdb	FALSE
daddccacaddccccccbaddaac	FALSE
dbacdaacdaddaacccaccdacc	FALSE
dbddddaadddaacdaaccdcddd	FALSE
dcadacccdadadcdacdadccda	FALSE
dccadabacacbadcbdaccbdaa	FALSE
dcdacadccaadccadadabaddc	FALSE
dcdddcbaadaaddcddcacadca	FALSE
ddadcadbadacdcdacdacacab	FALSE
ddcadcdacacabaaadaabdadc	FALSE
dddabaddcbaadcbaaabadaac	FALSE
aaaaacddcadadacabcadbbbdc	TRUE
aabbbdcaacbbadaaadacbabbd	TRUE
aaccadbbaddccccbdbcadaaac	TRUE
aaddbdddcbccdadccdddaaabd	TRUE
abbadcaacacabddcdbacddccb	TRUE
abccdadcadadbbacccbcbaaab	TRUE
acaacdaaadabcdaabbccacabc	TRUE
acbcbccbadabddcdbcacadbaa	TRUE
accdddcbacbdcadbaacbabacc	TRUE
adaabadbcbddcccabbabccaca	TRUE
adbbabaaadcbddacbaaaddccb	TRUE
adcbcbbdbbbbacabadbabcdab	TRUE
adddcccbcddacdcababbcdbdc	TRUE
baadddccdbdbdbadcacbaadbd	TRUE
bacacaaabdcacbbaddcabcbdc	TRUE
badabcbdbddbcddbbadccbccd	TRUE
bbabdacacbacdaabbbbbbcaba	TRUE
bbbdbbdcbdacacdcbacccabcd	TRUE
bbcdcababacdcdcdccbbcaaad	TRUE
bcaaccbacddabccddbcabacba	TRUE
bcbcbaaacddddcacddbdadaab	TRUE
bcccdddcbbdcdbdbdacaaaddd	TRUE
bcddcbadacbaaabbbcababddb	TRUE
bdbbcbbbddbacaddaaabcdadc	TRUE
bdccbbadbadaccbddddbdacaa	TRUE
bddcdbcccacbbdcacacabbbbd	TRUE
cabaabaddadabbbbaccabdcdb	TRUE
cacbbacadaabadddbaadcdbac	TRUE
caddaddbdbcadcadbddbbabcb	TRUE
cbbaadacbacbbbadadabbcacc	TRUE
cbcacddaddbbddabadacdadda	TRUE
cbdbdbabbaabaaacbdaaabaad	TRUE
ccacbdaddadbddcbccdcdaaaa	TRUE
ccbdcadbddcadabdacbdbaddc	TRUE
ccdaaddcddaadcbcbbaccadbd	TRUE
cdabaacaadbddcdabaabcdacc	TRUE
cdbbddaddbaccddbdcadadbca	TRUE
cdcdaccccdbddbbadcdccbbad	TRUE
daaaabbadcbdcbbbcccbaacac	TRUE
dabacacacccddabcdcaadbdba	TRUE
daccdddcccadcdbcbcbadccba	TRUE
dbaadbcbdbadcddbbcccddcdd	TRUE
dbbcbcaabbabddabdddcdaabb	TRUE
dbdabaacbdadaacccdabdcccc	TRUE
dcabcbaaaacdbddbbbdcbadca	TRUE
dcbccadbcddacdcdcbadbbbca	TRUE
dcdabacaccaccbdbbdbabbbdd	TRUE
ddabadbcccaddabbbddaaccad	TRUE
ddbcacdadbbaaaadbbbbacbcb	TRUE
ddcdcbdbcdbcaddcdabbdadac	TRUE
aaaaaabadaaacadbacddacaba	FALSE
aaacdacdaadbaddaabadcadca	FALSE
aabddabaaacdcccccdbddadad	FALSE
aacdabaaaccaaccacdddcdaaa	FALSE
aadcbdddaaddbaacaaaccaaba	FALSE
ababadabaadbadddcadcabddd	FALSE
abdacaadccddadccadaddccad	FALSE
acacaababadccccacbaacddcb	FALSE
acbaccdbacdcddacabaacdadb	FALSE
accccadbdadabaddaaaadcdab	FALSE
acdbadccaabababadacaaddab	FALSE
adabaabadabaaabacdaccabab	FALSE
adbaadaadddcdbadccadaadbd	FALSE
adccaccdcdaadcdccadcaccdb	FALSE
addcacaadbaadbabaacccdddb	FALSE
baaacdaacdabadacaacccadcc	FALSE
baaddaaabddabddddacdcadba	FALSE
bacbaccaabadcaaaaaabaadca	FALSE
badacaadaacaacccaabadaddd	FALSE
baddccadbaacbaddaddcababd	FALSE
bdacaccaacbabddaccddccccc	FALSE
bdddaabaacdccaddbadacacca	FALSE
caacdccdcbaaabadccadaccca	FALSE
cacaaaadddddddadcdbdacbad	FALSE
cacdcdcbaacccabdadabdacbd	FALSE
caddacddcaccacdcaaaacacda	FALSE
cbacbddabdacacadcadabacdc	FALSE
cbddaaabaadbdaddcaaaccdcc	FALSE
ccadaacaccaaaddbdaaaadadd	FALSE
cccaaccddccadaaaaabacdcab	FALSE
cccddaababddadcdcdcccdccc	FALSE
ccdcdcbacccddadaacddacddc	FALSE
cdabdaccdaddadadaccaadcda	FALSE
cdaddddcadadaccabacdadcab	FALSE
cdccbaccaccbdaccdcadadbac	FALSE
cddbaaaadaacdccdacdaabaac	FALSE
daaacbacddcdcadccbadbacad	FALSE
daadbacdccbacaaddddacdada	FALSE
dacbdacbadaaaccdccaadbacb	FALSE
dadbaacaadcaacadadacdabab	FALSE
dbaabadabaaadbadcacadacdb	FALSE
dbadaddadaaccaadccdddbaca	FALSE
dcaacaabacadbaacbaccaccdd	FALSE
dcaddbadcacdccccbacbaadda	FALSE
dcccaacadcdaacacadbacbaaa	FALSE
dcdadadcabaadcadbadabaccd	FALSE
ddaabaddadddacbdacaadcccc	FALSE
ddadbdacaabaccddaddcadddb	FALSE
ddcadbdabacaacaaadccdaaad	FALSE
dddacccacddcacaccdccaacca	FALSE
aaaaaabdaabccdbcbadddbabaa	TRUE
aabbcbcabcbaacabaddddbcaad	TRUE
aacccbcabcbdddcaabbadadaad	TRUE
aadddbbabdcaacbcbacbadbbdd	TRUE
abbabccddaccbaadadbddbbddd	TRUE
abcbdbbcbbdbdcadcbbabcabbb	TRUE
acaaaaddabadcbaaabdcacbabb	TRUE
acbaddababbcccccbcabdaabba	TRUE
acccbbadacbbcacdbdbbaaacad	TRUE
acdcccbabddcacdacbdadbadac	TRUE
adaddcccbbccbacbdbbadcdadd	TRUE
adcbacbaaadcacdacdabbadcbd	TRUE
addbacaacddccadbbbdcaaacbc	TRUE
baacbdcaddabdcdcadcbadbdad	TRUE
babdbdddbadcaddcbacdddcdca	TRUE
badbccbabbccaaddbbcbadbadb	TRUE
bbacddcccccacadaacbdbccbcd	TRUE
bbcaccbdadbadbddcaabdccbdb	TRUE
bbdcbacccdabdcbabadbbbcdaa	TRUE
bcadcabacdadcbcdbdccaaacdc	TRUE
bccacbabbdcbcbccadcaaccdba	TRUE
bcdbcccbaaddcacaadddbcddba	TRUE
bdaddbdbccbdacdccacadaadad	TRUE
bdcbaaccbcadccdccbdcdcbdcb	TRUE
bddbcdbbbdbaadddbdcaddcbad	TRUE
caacdacbccdadbcbacabadbbad	TRUE
cabdccabcaacbbdcabbbaadbca	TRUE
cadbadbdbbddcbdccdcadbcdda	TRUE
cbaccccbdaacabacccaabbbacc	TRUE
cbbdcdccbcdbcddbbabbbdbadb	TRUE
cbdbabbabcbcccdbdbacdbdadb	TRUE
ccabddbbdbaaccdddaaadddadb	TRUE
ccbccaadbbdbddabdcdddbbbda	TRUE
cccdddbdcdaabbabadaababbbb	TRUE
cdaacdacbaccbbcaadcdbcdcda	TRUE
cdbcaadbbdccccadcbacabcaac	TRUE
cddaabbbbabbddccdcdcaddcaa	TRUE
daaaacdbdcabddcdadacbbcddb	TRUE
dababaaabdbaacadccaddacbad	TRUE
dacadcdbdacbbdaabadacdbacd	TRUE
dadbcddbabbcccbcbaacbcadad	TRUE
dbacbcdbdbbccadacddbcadccb	TRUE
dbbdcccdaddbccdaacdbdbadca	TRUE
dbdbacbadacdbdbacaddbaccca	TRUE
dcabddaddadbaabbbcddaaaddb	TRUE
dcbdcdcbcadadbadbcdacabddd	TRUE
dcdacbacdcbbacaacdccbaadad	TRUE
ddabbdbdcbadaadaaddbacccdc	TRUE
ddbccbbcccddbdaccabddddacb	TRUE
ddcdcdcdddbcdbaadaccbbcadb	TRUE
aaaaaacccbdacacababdaccddd	FALSE
aaacdddcddccdaddacadbadcaa	FALSE
aabddddaddbaddacccddddcbda	FALSE
aacdacacbaccddcccddadbabab	FALSE
aadbdddadcdbacadddcdaabadd	FALSE
abaabacbacddcccbacbdadcdaa	FALSE
abadbdaaacccaaaddcadddcada	FALSE
acaacccadddaadadaaccabdddd	FALSE
acadddadaaadcbacccddaccadb	FALSE
accbaccbadccaacaacccccacca	FALSE
acdacdcddcacabadcaaaababda	FALSE
adaaacddccbacdddcaaadbaaac	FALSE
adadcbacdadcbaddccaadcbadb	FALSE
adcbaddaadacccdddaccccaacb	FALSE
addacdddbaaaaccabaacabaaaa	FALSE
baaacabdadcdddaacacaddaadb	FALSE
baadbdaaabaddacccccdccdddc	FALSE
bacacccadccccdadaccddacaba	FALSE
badadadcdaacddaabacdbacbda	FALSE
bdaadaadbaaaaccaaddbaadacd	FALSE
bdadccaaddcdaaaaddccacbacd	FALSE
caaacdccbddacbadccdabdadcc	FALSE
caaddbababaccaacaddccdddcc	FALSE
cacadadaabddaaaacdddaddccc	FALSE
cadaaacddaacdccbdddaaabadb	FALSE
caddadbdacdabddddaccccaadc	FALSE
cbacbdacccaaadccadacdcabda	FALSE
cbdadcccccabdaacacbaccabdd	FALSE
ccacddbabaaddccdddaaabaacb	FALSE
cccaadaaaccbaaccccdacacadc	FALSE
cccdcacccddbadacaccdacccdb	FALSE
ccddabdabaadbadcdbaadbadbd	FALSE
cdacaccdaaccccccdcacddabad	FALSE
cdbadacaddccbaadcadccaddba	FALSE
cdccdadacbadadbdddaaddadad	FALSE
cddccaabadadddcdddacaddadb	FALSE
daabacbabacdacdccdcbddacdc	FALSE
daaddcbacbaacccaaadaccdacc	FALSE
dacbadadacdabaccacdadcacda	FALSE
dadacbadbaaacadcdadaabacdc	FALSE
dadddcccaaadbdddaddabacadb	FALSE
dbaccdcadcadacdbdabacbdaac	FALSE
dcaaaccaadccacbaadddcdddaa	FALSE
dcadbdaadbadacaccdaabaabda	FALSE
dccadacdccacadcccacdaabacc	FALSE
dcdacaddcbaacaadaaaacdccbd	FALSE
ddaabaadacaaadcacbabdacaac	FALSE
ddadcbadabdaddddacacdaddad	FALSE
ddcbabadadaabadbacacbacdda	FALSE
dddacdbdaccaadcccdcdccccdd	FALSE
aaaaaccaddbcbadadbacbcdddcb	TRUE
aabbbcbbddabaadaaabccbabbac	TRUE
aaccbccdbaaabaacdbacdbdcabd	TRUE
aaddadccbcccaadccccbcbcbdbc	TRUE
abbacbdddadddadddabddbcdbda	TRUE
abcbbdbcbbdcacddadadabccdbd	TRUE
abdccbcaacdcdcbabbabadabbab	TRUE
acaddbcdcbcdcddbcbdacbaabbc	TRUE
accabadccadaabaccbdccbbdcdc	TRUE
acdbdbdcbcbcdbdddadabdadcbd	TRUE
adacdcdcaaaacdaabccbbccddbd	TRUE
adbdbacccdcbdddabaabaccbcbb	TRUE
addbcbbddddcbbabaccdbdcacac	TRUE
baaccbdacbbbdcaacdadadaabca	TRUE
bacbadaccbddabcbbddbcbbddcb	TRUE
badccbdacdcdbdcdcbbababadaa	TRUE
bbadaddabaadaccdbddcaddabbb	TRUE
bbcabdccaaacdbbdacbddbcadab	TRUE
bbdbddacabdcbcdadaaadbadcab	TRUE
bcadabbccbaccdbabadacababca	TRUE
bccadbbdabdbddcbadbcadadddc	TRUE
bcdbccbbcbbbcbbbacdadbacadc	TRUE
bdaccbddadbbabcbbbadaacacdc	TRUE
bdcaaccddcaabcbccbdadbdbcba	TRUE
bddbabcaadccacaadbcbaaccacb	TRUE
caacadacccdbcbabbbdbbabdddb	TRUE
cabdaddbbaadcddccdbabcdadcd	TRUE
cacdbdbbcaadadccccaaabdbdcc	TRUE
cbabaddaccbbbdabbbbacbcabcc	TRUE
cbbccabdccccabdbccabdbdcadb	TRUE
cbcdbcdbdaaabcabccabdabbadc	TRUE
ccaabcbcddabbbcabaacccbbbdb	TRUE
ccbbdaddbdcabccdaccdbbbbbad	TRUE
cccdaacabbbddaaadbbbbcaddac	TRUE
cdaabbdbbdcbbdbcbcbcdcabacb	TRUE
cdbbbbdcbabccaadbddcdbaccab	TRUE
cdcccaadadcadbbbcbdddcdbbda	TRUE
cdddaddaadaacbcacbadbbbaccd	TRUE
daadcdadccccaacdbadccbcdaca	TRUE
dacbadbdddddcbaccbbbaadccbb	TRUE
dadbcacaaccadbbddbadadabddd	TRUE
dbacbdcdccababccbcdaadbddca	TRUE
dbbdaaadbdbbadbdcdabaaacabd	TRUE
dbdaabbbdcdcacaaccbdadbcbda	TRUE
dcaadadbddcdbdaaabddbbaccbc	TRUE
dcbdaadcadbddbacbcbcacabbdc	TRUE
dcdaaacacbadacadabacdbbdcda	TRUE
ddabcbbaddacacdadbbbcabdcaa	TRUE
ddbcbccbdddbadcbdbdcbbdacbd	TRUE
ddccdcaddcbcbbcbaabbadcdbbd	TRUE
aaaaaaaaacddacbdacccacaddaa	FALSE
aaadaccdbaababadabdddacdbaa	FALSE
aacabaaccdaddadbdaccadcadca	FALSE
aacddabadacbadcdadddcaabdda	FALSE
aadcdbdaadcaaacadcddbaddcdd	FALSE
abacadcacdcdaadcaadcaaccada	FALSE
abdddaaddacdbacddddbdaaddac	FALSE
acadcdadaacdaaddcdadcadcddb	FALSE
accbacbabdaadcacbadcccdbaba	FALSE
acdacdcdbadcaaacdcdbaddabab	FALSE
adaaacacddcadadadbaacacabdd	FALSE
adadcaddccdadcddccacdacaccc	FALSE
adcaccadbacdaacaabadcadaadb	FALSE
adcdcaadccbacdaaababadccaac	FALSE
addccabaadaaabadcccacdcccca	FALSE
baabaaadacbababaddcaabaccdd	FALSE
babaadbaaaccadddaacdaccbabd	FALSE
baccaacaccdaaaaaddabaacadcc	FALSE
badaccdbaaddcbdacbacdacadcd	FALSE
bdaaadcacccacdadcaddddccaac	FALSE
bdadbaadbaadabaabddacddcdcb	FALSE
caaadcaddabadbadddddabacdaa	FALSE
cabacccadaacacadadbadadddca	FALSE
caccdabdadadddabdacdaababad	FALSE
cadcadaadaaccadddabaaccdcad	FALSE
cbabdddacaaaccdabacdbaccbdd	FALSE
cbdacdaadddaabacbacdacbaaad	FALSE
ccacaaadccacccdcadcbddaaaad	FALSE
ccbacdddbabacdacccaacbaccdb	FALSE
ccccdbadcabdddacaaaaaddcccc	FALSE
ccdccdacddbdacacbdacacdaaca	FALSE
cdabaddabaaadaadacaddcaaaac	FALSE
cdbacdabdaccddcdcaaacaaacac	FALSE
cdccadbaacaabdabacaabacadcd	FALSE
cddaddccabddadccddcdcccbaaa	FALSE
daaabdadddacabaadadadddcacd	FALSE
dabaaaacaabadcdbaddbdadacba	FALSE
dacbadbadcacccbaccaddaadddb	FALSE
dadadccadcbdadbaacabddaccbd	FALSE
dbaabaccaacacccaccdddbaacdb	FALSE
dbadcadcadadaacadcdacabdaaa	FALSE
dcaabdaddaabaddccabaabaccaa	FALSE
dcadbabacdbaccddaaaddccdcdb	FALSE
dccadbadadadacbadcbacacbabd	FALSE
dcdaaaacbaddaabadddcdbaaadc	FALSE
dcddaabdaccaabddddaacadacba	FALSE
ddacbaacdbadbddadaddcadaddb	FALSE
ddbaccadcacadbaacadacacddca	FALSE
ddccacadaddddbdaacacccadbdd	FALSE
dddadcadadcdabddaccabadacdc	FALSE
aaaaaaacadaddcbbbcacbdabdaaa	TRUE
aabbccbcbcddabacdccdabcbabcc	TRUE
aaccbccacbbbacaddbdadcacdcdd	TRUE
abaabcaadaccddaccbddbbdcccdb	TRUE
abbbcadaacaddacdbccdacdadbaa	TRUE
abcbddaadcacdcababddcdbcddaa	TRUE
abddaaaaadabcdbbbcddcacbaacd	TRUE
acaddaaddcabdbbbbaaacbcdaacc	TRUE
accaaccbdadaabbdadbcdbbcdddd	TRUE
acdadcabdbccbbccbcbaadbddabc	TRUE
adacbadbdbbddcddaaddddddcbbd	TRUE
adcaabbaaadaaabaacdbadcbbbdc	TRUE
addaddaadccacabddaacddadabba	TRUE
baacbddcbccccaaddcacdbccacca	TRUE
bacaabdcccbbcabdbcdabbdaadca	TRUE
badbccbdadaaddaccacbcbbdcdab	TRUE
bbaccbaadcdadcbdcadbbaacaada	TRUE
bbbdbcbbabbdbbbbbcbdddccbbda	TRUE
bbdaadddacbbcbdcdbcbddccadac	TRUE
bcaadcbacbbbcccccccbccdabcca	TRUE
bcbbdbbccdcbdccbbabbacbdccac	TRUE
bccccbbddddccbcbbcbccdbcacda	TRUE
bcdcbcbbdbbcabdabdadacbacabb	TRUE
bdadcabdbacabaaaadbddaccdacc	TRUE
bdcaabdcbdabccabdbbadbdcadba	TRUE
bddbccdabdddbaddccbcbadbacba	TRUE
caadbaadcbbbadddacbdacbdaccc	TRUE
cacaaacccdbbacbddaccbbbcdbad	TRUE
cadbddcdbadbdaadadcadbbacdbc	TRUE
cbacdccdabccdbacdacbdbabddbb	TRUE
cbbccbadbddacadacbbcccbbcaaa	TRUE
cbdabcadccddccaadadbdbbbdabb	TRUE
ccabdcaddddabccbabcddacddbbc	TRUE
ccbdadadbcbbaddbdbdbbbbabbdc	TRUE
ccdaadcbddcaddbdbcccdbdcaadb	TRUE
cdabcbccdbdcccabacdcdbcacdbb	TRUE
cdbcccbdacbcccaaccddcdacabba	TRUE
cddacdbdaadadbbddcdcbdcacaba	TRUE
daabcdddacbaacbbbbaabbcababc	TRUE
dabcbccccdbabbbbacdbaddacdcc	TRUE
dacddbbdddbbbbccbbacbbbcaacc	TRUE
dbaadadddbbcabccbcdddbbbaccb	TRUE
dbbcbcddbddcdcabbbaaadacaaaa	TRUE
dbcdddadcacdccddaaccacdcbadd	TRUE
dcabbcdadcbabbbbaccddacdddac	TRUE
dcbcbacdabbcccdcacdbbabdacad	TRUE
dccdabcdcabacabddbdcbbbdddcd	TRUE
ddaacacddabccbcaccdbbcbcabda	TRUE
ddbbcbacaacdbbacdcbcacdbbdcc	TRUE
ddcdbbaddbacacdaddbdddcadddc	TRUE
aaaaaabaadadbacccddcdcdabdaa	FALSE
aaadabacbaddcdcccabacbddaadd	FALSE
aacacaccdcccbacccddacddddcdb	FALSE
aadabdabaaccddaaaadbacbadbac	FALSE
abaaacdacadcacddaabadcadbdaa	FALSE
abacdcbddddadcaadcddadcaabda	FALSE
acaaacdacdcddbdababaabadadbd	FALSE
acadcdaadcaccaabadacacbaacba	FALSE
accadaadacadbaddddcadacdaaab	FALSE
accdddaacbabacccccdcaaacaddc	FALSE
acddacdaaadbaabacdcdbacdcdac	FALSE
adacbdacccadddbaaccdcaccadcb	FALSE
adbddaddccdaabdddadacadaaacc	FALSE
adcdacccdbaddaddacdcadabaddc	FALSE
addccaddccabadbdadacdcadcdcc	FALSE
baaaddacbaadddddabadcabadcdc	FALSE
baaddadddbdadcacabddaacacada	FALSE
bacbdaacdbabdacdbaccbdacadcd	FALSE
badcaabaddbadcadaadaddddadad	FALSE
bdaacbddadaabdaadcbaccaddaba	FALSE
bdaddccdcdccccccddcbaadccaaa	FALSE
caaadabadadbacabacaaadcbacba	FALSE
caaddacbacaddddadbacdaacdadb	FALSE
cacbacdbddadadabdaaddcaaaaac	FALSE
cadacdadcdadabddaaccacdccacd	FALSE
cbaaadcdbddacbaccbaddcaccabd	FALSE
cbaddaaaaabaadccddaddbadcacd	FALSE
ccabaaccadadcbaaccbacabaaddd	FALSE
ccbaabdabdaccbaccbaacabdaddc	FALSE
cccbaddaadccddccdcddcdcdaabd	FALSE
ccdadddadcacabdadccacddadaac	FALSE
cdaabadddaadacbdaddccdbdabda	FALSE
cdbaaaaadddddadadbdaddacdcaa	FALSE
cdcaddaccadadbababadcdadaddc	FALSE
cddaaaaadccadddaababacddbaab	FALSE
cdddaddddaadcdacaaaddcddacbd	FALSE
daaccdacaccdadaacccbddaadcbd	FALSE
dabdadaadcaaccccbaccacdddacd	FALSE
daccdcacccaadaddcdcdacddcdcc	FALSE
dadcadaddcccaadbdaaadcdbaadb	FALSE
dbaaddbadccdbabdaadadabacbac	FALSE
dbdababaccacacdcccaccaaacdcc	FALSE
dcacbadbaccdddddccaacccacccb	FALSE
dcbddacaabddddadcdcdadaabaaa	FALSE
dccdacddaddbaacccccabaccbaca	FALSE
dcdccaccacdcababadbacadcadad	FALSE
ddabaddaddddddcaaddadadcdcab	FALSE
ddbabdaabadcdcbadaccbddaacab	FALSE
ddccabaadacccabaacbdaccaddaa	FALSE
dddadcdaddaadbdadacaaddbaccb	FALSE
aaaaaacccbaabaaabddbdacadbbaa	TRUE
aabbcbcabbcdbccbbbdacbbdcacac	TRUE
aacdbbbccdcaadcacdacdbddcbbda	TRUE
abaadbcaacbcaabcbcccccaaaccbc	TRUE
abbcbddcadcacaadacacddaabccab	TRUE
abcdbccabadaabddcccadcaabaaca	TRUE
acaacddbccdcabcadbbcccdddbdbc	TRUE
acbbcaadaddbcabdddbbbcadccbdd	TRUE
acccaaddacabaaaacdcababdcbddd	TRUE
acdcdbdacbbdcadbaaaaacccadcaa	TRUE
adadccdaddadadccbbbbbadbacbca	TRUE
adcabcdbabacdbdadbadabddaaada	TRUE
addbaabaaadabbaddbaaaabdbbbcc	TRUE
baabcdbdcccbaaacddadbcdacabca	TRUE
babdaacabbcdadcbdbcbccabcbcbd	TRUE
bacdddaaccacadaddbabbddddcacd	TRUE
bbabdbcdacdbaabcddadbaaacadcd	TRUE
bbbdadbbccabcbddbcddacbaaaadc	TRUE
bbdabbdbdcdadadcbdbbbacdaacdb	TRUE
bcabcdccabcacbbcdbaccbdcdbaac	TRUE
bcbdabcccccbbcbadbaddddbacbcb	TRUE
bcdacbcbdccdcaccbbdadcadddaab	TRUE
bdabbddcdcabdabaaaaacaabaaadb	TRUE
bdbcbdbcabadacbbbdcdbacdbcabd	TRUE
bddaccaabcdabcdaacdaadcacccbb	TRUE
caacacbccbacdcdbddaccaacdbbbd	TRUE
cabcbadaadbccabdccabadbbdadda	TRUE
caccdabdddbbbccbbdabccdcacccb	TRUE
caddcbdabcadadabbbcabaccccdca	TRUE
cbbbabcbadcdbacccaacdddabcccb	TRUE
cbcbcbbcabddadbdbacbdcaddccbc	TRUE
cbdcbcbbacaabbbdbbbbccbabddcb	TRUE
ccadcbbdcaaccbabbcbdcddcadacb	TRUE
cccbbdbcadacddbdaacbdcbbadacc	TRUE
ccdcdbcadbddbdcabcadddddbbcbb	TRUE
cdadcbddacbcbabcaddddbccbbbbd	TRUE
cdcbaccdcaccbabadcbbddaacddca	TRUE
cddcddbdadcccbbddbbbddaaabbca	TRUE
daadabdbbbdcbdabcbcdddcccabdc	TRUE
dabddccdcccababcadbbbadcdddcb	TRUE
dadadbbcdbbbbbbdbdacddbacdadc	TRUE
dbabdcaabdcacaaacbbaaccaacdab	TRUE
dbbcdcaabbcbdcbcdadbdcbddbbdb	TRUE
dbcddcbccdadabdbdbccabcbbbaba	TRUE
dcabadaddbaabccdabcdaabacabda	TRUE
dcbbbdadddaddbacddbdbdcdbaacd	TRUE
dccdbacdcbcabddbbbadccdbdbdcb	TRUE
ddaadaaaacbcbaccddcdaccabbcac	TRUE
ddbaddccccdaaddcccbdcacbaddbb	TRUE
ddcbddaadcdbadcdccbcdcbbcccbc	TRUE
aaaaaadaddcdcbdaadbabdacdccdc	FALSE
aaadbadcacdccddcbaabacddacbaa	FALSE
aacacccbaaaddddbabaddcddcaddd	FALSE
aacddbdadcdbaaccddabacdabdaaa	FALSE
aadcdcacdacbaddcbdadabadbdaba	FALSE
ababdadcdaddcbadacddacaadaaab	FALSE
abdaaccdcaacaddacacbaccaddcdd	FALSE
acacaacccaaadddaddacdddcbdadd	FALSE
acbacddcdbaaaccbacccaaccacadb	FALSE
accccdacadcbddadcadaacadbadcc	FALSE
acdccdbadddbaabadddbdddadacbd	FALSE
adacaaddcdbaacadadcdaddcccdca	FALSE
adbacccddccaadddcbabaacddbdab	FALSE
adccdbaddbadcbaaddadaaadcdabd	FALSE
addbddaacddadddaaadadcddacbda	FALSE
baaadcdddccccdacbaadbddabaccc	FALSE
baaddaddddbaaccadcdddcaaaadac	FALSE
bacbacdcbadbddddaadadaacddddb	FALSE
badadaaaaaddddcccabdadcaddcac	FALSE
badddbabadbdacbdaadcbaadcaddb	FALSE
bdadcbdaaacdcdccdcbaacacddacd	FALSE
caaadcacdddbdaddcdadcdbaadadc	FALSE
caaddcbadcacbacdcdcdacadccbdd	FALSE
cacbacdabaacccdcbabacdbdadcdd	FALSE
cadacdabacddcbabacacdaadabaab	FALSE
cadddcdbaaccaddacddcadcdcdccc	FALSE
cbadbacbaadaadcddaddadccbaaba	FALSE
ccaaaddddaabdadcdccbddadadcba	FALSE
ccadcddcaccdccdbdaacdaccdddcc	FALSE
ccccaadcccaacbabaccbaccdcaadb	FALSE
ccdacaacdacaaccacccdacdcaacda	FALSE
ccddccacccccccabdacaabdadcdad	FALSE
cdacdcbadccdadaddcacccaddcccd	FALSE
cdcaadccccaaaadbdaacdadaadaab	FALSE
cdcdabaaadaaaaadcbadccadcdaba	FALSE
cddcacccadcadcccaaacaccabaaca	FALSE
daabadcbdadadcccaccacccaddcba	FALSE
dabaccaaaacdaccddbadaaadcdddc	FALSE
daccdbaddadcacacbabddaddcaddd	FALSE
dadcaacdacbdadcdbaabacddcadca	FALSE
dbaacdacdddaadaccaccacacddcba	FALSE
dbaddbddaaadccdabacddbdaaddda	FALSE
dcacaadcdbaacddabaaddaacdacda	FALSE
dcbadbaadcacdddabaacdccccacda	FALSE
dcccdddcddabdaadddbacadadacdb	FALSE
dcdcacbdabdddddaadaddcccdacdc	FALSE
ddaadbadccabadbddadddbddacaba	FALSE
ddbaaaaaacbaadbaaacbaccdaabad	FALSE
ddccacdabddadddaacadcdacdadac	FALSE
dddacaddacaacccaaacdacbadaccb	FALSE
