aaaaabbbbcabddcbdaacbbbdbcbdcdd	TRUE
aabababbddadadadccbdaaadaddbddc	TRUE
aadbadaadbdddcccdcdcadaaacbddbc	TRUE
abcbadadcddacadaacaaddcdcbaacac	TRUE
acaccdcdabaadcaacacbaaabbbdcdbc	TRUE
acdbbadcbbaaadababcbaabcaadadbd	TRUE
adbddcccbcddaadbbaaabacabbdbdcd	TRUE
baaadbdbcbbcdbaaaccaccadabaaccc	TRUE
badaaadbdbabbdbaaadcabcddbaacad	TRUE
bbbdcccbccbdddcaaabbdcbacacbaac	TRUE
bcababbadaddcadcaaacabdaabadadb	TRUE
bccddbbcaaadabacddaadadacdadddd	TRUE
bdbbaaaccaabcdacadcdaddbabdcbbc	TRUE
bddcaddddddadacbacbbadbbbcaaacb	TRUE
cacaaaadbabbbabcaccbccbdcbcbcdc	TRUE
cbadcabdbacccdadcbacccccaccabaa	TRUE
cbddccccacdbccaaababaaabdbcddaa	TRUE
cccddadabacdccdbcaaaddcabbcdbac	TRUE
cdbaaaadccbdcdbcacdcabbbbcbdbca	TRUE
daaabbadcddccccbabbbddddddadcdb	TRUE
dacbbbdcaabcbaaacbcadbcabbddbac	TRUE
dbadcbdbadbbbcaaaddadbddbcdccdb	TRUE
dbdcaacacdabacbbcccbddaaadaddcb	TRUE
dccbdaaadbbddaaccdccaabccbbdcdd	TRUE
ddbbababacddabdbdbacbdadbacaaba	TRUE
aaaaabbabbcabddcbdaacbbbdbcbdcdd	FALSE
aabababbddadadadccbdaaaadaddbddc	FALSE
aadbadaadbdddcccdcdcadaaaabddbc	FALSE
abcbadadcddacaaaacaaddcdcbaacac	FALSE
acaccdcdabaadcaacacaaaabbbdcdbc	FALSE
acdbbadcbaaaadababcbaabcaadadbd	FALSE
adbddcccbcddaadbbaaaacabbdbdcd	FALSE
baaadbdbcbbcdbaaaaccaccadabaaccc	FALSE
badaaadbdbabbdbaaaadcabcddbaacad	FALSE
bbbdcccbccbdddaaaabbdcbacacbaac	FALSE
bcababbadaddcadcaaaacabdaabadadb	FALSE
bccddbbcaaaadabacddaadadacdadddd	FALSE
bdbbaaaaccaabcdacadcdaddbabdcbbc	FALSE
bddcaddddddadacbacbbadbbbcaaaacb	FALSE
cacaaaadbabbbabcaccbccbdcbcdbcdc	FALSE
cbadcabdbacccdadcbacccccaccaaaa	FALSE
cbddccccacdbccaaababaaaadbcddaa	FALSE
cccddadabacdccdbaaaaddcabbcdbac	FALSE
cdbaaaadccbdcdbcacdcacbbbcbdbca	FALSE
daaaabbadcddccccbabbbddddddadcdb	FALSE
dacbbbdcaabcbaaaabcadbcabbddbac	FALSE
dbadcbdbadbbbcaaaaddadbddbcdccdb	FALSE
dbdcaacacdabacbbcccbddaaaaaddcb	FALSE
dccbdaaaabbddaaccdccaabccbbdcdd	FALSE
ddbbababacddabdbdbacbdadbaaaaba	FALSE
aaaaaadabbcbcabddbcdbcbdcadccbda	TRUE
aabaabadabddaabadbbaaabdcccbadca	TRUE
aadccdcababcbbaacbcbadaaabacaabb	TRUE
abcadddbcacaaaccbcacdadbcdcacdad	TRUE
acacdccaddcdacccddbcaaabbbcaaadc	TRUE
acdcbdaadaadbaabcacbbaaaddbcbbcd	TRUE
adbcdbaaaddcaacddabbbccabaabadad	TRUE
baaabbbdccadcbbdcabdcddbadddbdcc	TRUE
bacdbddadccabdcaccbacdaaaddbdaba	TRUE
bbbbccabddccbcccbbdaaaadddcadbcd	TRUE
bbdddcacaaabcdaddbcccbdbabdcdccd	TRUE
bccdaaadaacaaaddddbccccbbdbabdcd	TRUE
bdbcccadcbbcabdbaaaddbbbddcccdbc	TRUE
bddddbadcaddaadbbbcabaababbaaaba	TRUE
cabccddacbcaadaaadbbadadcbaddabb	TRUE
cbababaaccadbbaddddcdadaccbcaaab	TRUE
cbccdcdbdcaaabadcdaadbabbadcaada	TRUE
cccaabddddbdacdbbcbbaaadbdbcdabd	TRUE
cdadbdcadaaacadcdbaaadaacbbcadba	TRUE
cddcababcdbacbcaaabbcababcdcbcad	TRUE
dabcdacdbdadacaaadaccddbdaccbabb	TRUE
dbacddaaddcacdbdbdddcdaaaabbbbdd	TRUE
dbdadcaddcaabcabbdaaacabddaabdbd	TRUE
dcbddaaabcaadadbcdbdacdbbddcdcdd	TRUE
ddadcdadcbaaacdcaabddabdababdbbb	TRUE
aaaaaadabbcdcabddbcdbcbdcadccbda	FALSE
aabaabadabddaabadbaaaabdcccbadca	FALSE
aadccdcababcbbaacbcbadaaaabacaabb	FALSE
abcadddbcaaaaccbcacdadbcdcacdad	FALSE
acacdccaddcdacccddbcaaabbbcaaaadc	FALSE
acdcbdaadaadbaabcacbbaaaaddbcbbcd	FALSE
adbcdbaaaddcaacddabbbccabaaaadad	FALSE
aaaabbbdccadcbbdcabdcddbadddbdcc	FALSE
bacdbddadccabdcaccbacdaaaaddbdaba	FALSE
cbbbccabddccbcccbbdaaaadddcadbcd	FALSE
bbdddcacaaaacdaddbcccbdbabdcdccd	FALSE
bccdaaaaaacaaaddddbccccbbdbabdcd	FALSE
bdbcccadcbbcabdbaaaaddbbbddcccdbc	FALSE
bddddbadcaddaadbbbcabaaaabbaaaba	FALSE
cabccddacbcaadaaaabbadadcbaddabb	FALSE
cbababaaccadbbaddddcdadaccbcaaaab	FALSE
cbccdcdbdcaaaabadcdaadbabbadcaada	FALSE
cccaabddddbdacdbbcbbaaaadbdbcdabd	FALSE
cdadbdcadaaacadcdaaaadaacbbcadba	FALSE
cddcababcdbacbcaaaabbcababcdcbcad	FALSE
dabcdacdbdadacaaaadaccddbdaccbabb	FALSE
dbacddaaddcacdbdbdddcdaaaaabbbdd	FALSE
dbdadcaddcaabcabbdaaaabddaabdbd	FALSE
dcbddaaaabcaadadbcdbdacdbbddcdcdd	FALSE
ddadcdadcbaaaacdcaabddabdababdbbb	FALSE
aaaaabcadcaccdabcdcdcbcdcaabbbbad	TRUE
aabaccadabcabcdccdbcaacabaabbaccb	TRUE
aadbacadaabbddbbdcbaaabbbdadabdcb	TRUE
abbdcaacbaabadbacdcdbcbabcacadaad	TRUE
acacabadbcdddcdabacaccdacbadaaadd	TRUE
acdaaaccbbbacaabcbbdabbbcadacddcb	TRUE
adbdcaacacacddbbacadaadadddddcacb	TRUE
baabababbacddbcaaadcdbbcbabdbddac	TRUE
badbcbdccbacacdaccbcbaddaaacaaada	TRUE
bbccaaabbbdcdbcbadcbaaacddbccadad	TRUE
bcbabdcbdaabacadbdbcbbaaadaddbcca	TRUE
bdaabdcaddcabbaaaccabcacddddcbadd	TRUE
bddaacaaabbacbcaacbbabdbbadbdcbdd	TRUE
cabbabadcccdbaaaccadcaaacdaddabba	TRUE
caddcbbbbaaaacdbbadbcdabcbbccadda	TRUE
cbcccccddadcbcdadacabbcbcaaaaabbc	TRUE
ccbadbbcccaaccbbcdbabcbccbbddaaaa	TRUE
ccddbbcddcddabababbaaaccbccbadbac	TRUE
cdccdaaccccddabdaaacabcadddbbdbdd	TRUE
daadaaccabcabbadbbcccdababaaababa	TRUE
dadbaaadbadbcdcbdadbcbdcbdbadbcba	TRUE
dbbcddbadccaadadcdbdcdccaaabddcca	TRUE
dcacbbdcaadbbcaccdcabcbbdddcbaaca	TRUE
dcdadbadbaacacdcbbacdbadcdbbccbdd	TRUE
ddbccbdddbbbacccaaacabbcbdddccaaa	TRUE
aaaaabcadcaccdabcdcdcbcdcaabbbcbad	FALSE
aabaccadabcabcdccdbcaacaaaabbaccb	FALSE
aadbacadaabbddbbdcbaaaabbdadabdcb	FALSE
abbdcaacbaaaadbacdcdbcbabcacadaad	FALSE
acacabadbcdddcdabacaccdacbadaaaadd	FALSE
acdaaaaccbbbacaabcbbdabbbcadacddcb	FALSE
adbdcaacacacddbbacadaaaadddddcacb	FALSE
baabababbacddbcaaaacdbbcbabdbddac	FALSE
badbcbdccbacacdaccbcbaddaaaacaaada	FALSE
bbccaaaabbdcdbcbadcbaaacddbccadad	FALSE
bcbabdcbdaaaacadbdbcbbaaadaddbcca	FALSE
bdaabdcaddcabbaaaacabcacddddcbadd	FALSE
bddaacaaaabbacbcaacbbabdbbadbdcbdd	FALSE
cabbabadcccdbaaaaccadcaaacdaddabba	FALSE
caddcbbcbaaaacdbbadbcdabcbbccadda	FALSE
cbcccccddadcbcdadacabbdcbcaaaaabbc	FALSE
ccbadbbcccaaccbbcdbabdcbccbbddaaaa	FALSE
ccddbbcddcddabababbaaaaccbccbadbac	FALSE
cdccdaaccccddabdaaaaabcadddbbdbdd	FALSE
daadaaccabcabbadbbcccdababaaaababa	FALSE
dadbaaaadbadbcdcbdadbcbdcbdbadbcba	FALSE
dbbcddbadccaadadcdbdcdccaaaabddcca	FALSE
dcacbbdcaadbbcaccdcabcbbdddcbaaaa	FALSE
dcdadbadbaaaacdcbbacdbadcdbbccbdd	FALSE
ddbccbdddbbbacccaaacabbcbdddcaaaa	FALSE
aaaaabbcabbddcccadcbcbcdaaaacacabd	TRUE
aabaaadcbdcdaaacbdaaabbbcacdaadbbd	TRUE
aadbdabbcddabbbbdcaccbaaaabdacacbc	TRUE
abcaddcccdaaaadcacddcbcbbbbdbccddd	TRUE
acacbddddadddacaaccdcbbabcaaacbcad	TRUE
acdcaabadcdcbbbabadabbddbaaadbaabd	TRUE
adbddccddbdadbdacdbadbaabacbbbaaac	TRUE
baabaaabcdcdcbdcbdbbadbbccbaadcbdb	TRUE
bacdcccccdbaaabdbabcdcdaababbdaddd	TRUE
bbbbbaddccabdcbaaaadacdbabdbaacacc	TRUE
bcaaabdcbdbbdaabdcdcdddcdaccbaadaa	TRUE
bcccadcbaaaaadabcbcbbbaabcbdaababb	TRUE
bdbaccccbacdabaaacbbbdcddaddbbbdbc	TRUE
caaabcbdbcdaadbccbbbadccadbabbdabc	TRUE
caccaabccbcabdbdbcdcabbbaaadaacaaa	TRUE
cbaddadacccbbdadaacdbaccaddbbbaabb	TRUE
cbddddacdbaaacabcaaddddcadcbbacbca	TRUE
ccccdcdaacdbcaacccdbcccaaacbdbadda	TRUE
cdbccabdbbcbcaaaadaddcadcdcbcbbacd	TRUE
daaaaadbcbbcbccccadcaddaddacbcbabc	TRUE
dacbadacbdcbccbdabaadbdadaaacbaadc	TRUE
dbbaaabaabccbddbadccabdbaacabccdba	TRUE
dcaaacbccdbcdddbaadaaddddaaccddddc	TRUE
dccdcaabdcdddcbaddddbabcdcdcaaaccd	TRUE
ddbbcbcabdbdcdcabbddbaaaaaabcabcbb	TRUE
aaaaabbcabbddcccadcbcbbcdaaaacacabd	FALSE
aaaaadcbdcdaaacbdaaabbbcacdaadbbd	FALSE
aadbdabbcddabbbddcaccbaaaabdacacbc	FALSE
abcaddcccdaaaadcacddcbcbdbbbdbccddd	FALSE
acacbddddadddacaaccdcbbabcaaaacbcad	FALSE
acdcaabadcdcbbbabadabbddbaaaadbaabd	FALSE
adbddccddbdadbdacdbadbaabacbbbaaaac	FALSE
baaaaabcdcdcbdcbdbbadbbccbaadcbdb	FALSE
bacdcccccdbaaaadbabcdcdaababbdaddd	FALSE
bbabbaddccabdcbaaaadacdbabdbaacacc	FALSE
bcaaabdcbdbbdaabdcdcdddcdaccbaaaa	FALSE
bcccadcbaaaaadacbcbbbaabcbdaababb	FALSE
bdbaccccbacdabaaaacbbbdcddaddbbbdbc	FALSE
caaaacbdbcdaadbccbbbadccadbabbdabc	FALSE
caccaabccbcabdbdbcdcabbbaaadaacaaaa	FALSE
cbaddadacccbbdaaaacdbaccaddbbbaabb	FALSE
cbddddacdbaaaacabcaaddddcadcbbacbca	FALSE
ccccdcdaacdbcaacccdbcccaaaacbdbadda	FALSE
cdbccabdbbcdbcaaaadaddcadcdcbcbbacd	FALSE
daaaaadbcbbcbaccccadcaddaddacbcbabc	FALSE
dacbadacbdcbccbdabaadbdadaaaacbaadc	FALSE
dbbaaaabaabccbddbadccabdbaacabccdba	FALSE
dcaaacbccdbcdddbaaaaddddaaccddddc	FALSE
dccdcaabdcdddcbaddddbabcdcdaaaaccd	FALSE
ddbbbcabdbdcdcabbddbaaaaaabcabcbb	FALSE
aaaaaabccbddcbbaddddbcbccbababdabca	TRUE
aaadcdcacbdaaacbccbaccadbbcdcdaaabd	TRUE
aadabbcdbadcaadaaccbcbbbbddacbbaaaa	TRUE
abbaccacdddaaaddccbbaddbbcdabdabbbc	TRUE
acaabcabdcbcbdcacbbacababccbbcdaaab	TRUE
accbcccccabdcbbaadbbabcaaacbdcdcbab	TRUE
adadbacccbcacbcddcdababacdaaabdcbac	TRUE
addbcbcadccbacdccdcacbbcbaaaaddcbaa	TRUE
bacaaabdacbcdabddabbcdacbbbdabaabbb	TRUE
bbacccdcccacbcdccbddbaaacdbccdacbaa	TRUE
bbdccbcccdcaaabdddabbdacbbadbbbcacc	TRUE
bcccaccadbcdddcaaabcabdbcbbaacdccbd	TRUE
bdbbdaccaccdaaaccdddddcccaacabcbdca	TRUE
caaaccacbdbababddcabbcadbbcdcaadabd	TRUE
cacccdaaaadddcdbbbbbbddbbdbabaccbad	TRUE
cbadcaabadaaabdbbabbbdbcdcbcbacacaa	TRUE
cbdddacabbbddaabaacbdccaadbbacaadcd	TRUE
ccdaabcdbdcddcabddbddabcbadbbbcaaac	TRUE
cdbccadacaaadbbaabdbacbbddadacdbcab	TRUE
daabbcdbabdacaaacbabadabcbbdbbdbdda	TRUE
dadaaababadaccaddbddbccdcadddabccdc	TRUE
dbbcbdbbaaabcadcdabdcababbdcdddbddb	TRUE
dbddbcbdbbcdbadaaadaadabbbcbbacbdbc	TRUE
dccdadbbaaaaacbccdadbbbbbdccbdcbbcb	TRUE
ddbbccdcaaabcabadbadabcbdbdbabdbadc	TRUE
aaaaaabccbddcbbaddddbcdbccbababdabca	FALSE
aaadcdcacbdaaaacbccbaccadbbcdcdaaabd	FALSE
aadabbcdbadcaadaaccbcbbabddacbbaaaa	FALSE
abbaccacdddaaaaddccbbaddbbcdabdabbbc	FALSE
acaabcabdcbcbdcacbbacababccbbcaaaab	FALSE
accbcccccabdcbbaadbbabcaaaacbdcdcbab	FALSE
adadbacccbcacbcddcdababacdaaaabdcbac	FALSE
addccbcadccbacdccdcacbbcbaaaaddcbaa	FALSE
bacaaaabdacbcdabddabbcdacbbbdabaabbb	FALSE
bbacccdcccacbcdccbddbaaaacdbccdacbaa	FALSE
bbdccbcccdcaaaabdddabbdacbbadbbbcacc	FALSE
bcccaccadbcdddcaaaabcabdbcbbaacdccbd	FALSE
bdbbdaccaccdaaaaccdddddcccaacabcbdca	FALSE
caaaaccacbdbababddcabbcadbbcdcaadabd	FALSE
cacccdaaaadddcdbbbdbbddbbdbabaccbad	FALSE
cbadcaabadaaabdbbabbbdbcdcbcbacaaaa	FALSE
cbdddacabbbddaaaaacbdccaadbbacaadcd	FALSE
ccdaabcdbdcddcabddbddabcbadbbbcaaaac	FALSE
cdbccadaaaaadbbaabdbacbbddadacdbcab	FALSE
daabbcdbabdacaaaacbabadabcbbdbbdbdda	FALSE
dadaaaaabadaccaddbddbccdcadddabccdc	FALSE
dbbcbdbbaaaabcadcdabdcababbdcdddbddb	FALSE
dbddbcbdbbcdbadaaadaaaabbbcbbacbdbc	FALSE
dccdadbbaaaaacbccdadbbbcbdccbdcbbcb	FALSE
ddbbccdcaaaabcabadbadabcbdbdbabdbadc	FALSE
aaaaaabcbcbacdacacccdabcbadddbaaadaa	TRUE
aabadbabdbabdbcbdbbdccddadbacaacadbb	TRUE
abaabaacdadbbcdcaabccbdabbbaccdaabad	TRUE
abcacdcaacdaaddcacaacaadababbaccbbdb	TRUE
acadbadaadadabdadbaccaadaabcaaacdcbc	TRUE
acdcaabbccdccacbadbcdbaaadcdabadbdab	TRUE
adbdddbbbbddcbbbacdaaaabcddbbaacaddb	TRUE
baabaaacdcbcdacaabccbdbadddddbbbcbaa	TRUE
badacbdcadbddbbaadcadcbacdcddbdaaaba	TRUE
bbbdbacdbacabcbabcbadcaabdaabacaaadc	TRUE
bcbaaadbabadbbbcccccdaccccacbbbdccdc	TRUE
bcdcaddacaadadddcabbdbadbdccbbdbbdbd	TRUE
bdcbbabcadbcacdbabcbbbadcadaaabbbdbb	TRUE
caacdbdbbcdccdbabbdabbcaaabaccbacaba	TRUE
cadabaabdadbccdbbddabbdaaadccdaaadcb	TRUE
cbbdcacbddabdabbbdcabccbcddaaacdabca	TRUE
ccabbbccdddddbddbcdcbbdaabddaacaddda	TRUE
cccdbabdabbbabbabaaacaaddcccabbddcaa	TRUE
cdbcaaddccabddcabbaaacaaadcddaacdaaa	TRUE
cddddabcdbccdaacaaddccbabdddccdbcbdc	TRUE
dacdadbacadbbcaabbbaaabcddcbdccaaaca	TRUE
dbbaababbdcadcabccabacdcbaddbbddcbcc	TRUE
dbdddbccccacdbdacaaacdcaaadbbcabbdbc	TRUE
dccdbbadbdbcabbbcbbcaaadcccacaaacbac	TRUE
ddbddbcdaaabccdbaddcdabbccadbaaacbaa	TRUE
aaaaaabcbbacdacacccdabcbadddbaaadaa	FALSE
aaaadbabdbabdbcbdbbdccddadbacaacadbb	FALSE
aaaabaacdadbbcdcaabccbdabbbaccdaabad	FALSE
abcacdcaacdaaddcacaacaaaababbaccbbdb	FALSE
acadbadaadadabdadbaccaadaabcaaaacdcbc	FALSE
acdcaabbccdccacbadbcdbaaaadcdabadbdab	FALSE
adbdddbbcbbddcbbbacdaaaabcddbbaacaddb	FALSE
baabaaaacdcbcdacaabccbdbadddddbbbcbaa	FALSE
badacbdcadbddbbaadcadcbacdcddbdaaaa	FALSE
bbbdbacdbacabcbabcbadcaabdaabaaaadc	FALSE
bcbaaaadbabadbbbcccccdaccccacbbbdccdc	FALSE
bcdcaddacaaaadddcabbdbadbdccbbdbbdbd	FALSE
bdcbbabcadbcacdbabcbbbadcadaaaabbbdbb	FALSE
caacdbdbbcdccdbabbdabbcaaaabaccbacaba	FALSE
cadaaaabdadbccdbbddabbdaaadccdaaadcb	FALSE
cbbdcacbddabdabbbdcabccbcddaaaacdabca	FALSE
ccabbbccdddddbddbcdcbbdaabddaaaaddda	FALSE
cccdbabdabbbabbabaaaacaaddcccabbddcaa	FALSE
cdbcaaddccabddcabbaaacaaadcddaacdaaaa	FALSE
cddddabcdbccdaaaaaddccbabdddccdbcbdc	FALSE
dacdadbacadbbcaabbbaaabcddcbdccaaaaca	FALSE
dbbaaaabbdcadcabccabacdcbaddbbddcbcc	FALSE
dbdddbccccacdbdacaaaacdcaaadbbcabbdbc	FALSE
dccdbbadbdbcabbbcbbcaaadcccacaaaacbac	FALSE
ddbddbcdaaaabccdbaddcdabbccadbaaacbaa	FALSE
aaaaaabbbbcbacdbdcbaddadcadaabddbcbbd	TRUE
aabbbdabaadaadcbbcddbbabbbaaadbbddddd	TRUE
abaaacacccdccabacdbcbbdcabbbddabaadba	TRUE
abcbdcbabcbadcddcadcbaaabbdbbdbbbacad	TRUE
acbaacadcbaacadbdbccdccccdaddaadaabdb	TRUE
adaaadbbbcbbadbcaddbcbdbcdcccbadcaaab	TRUE
adcbcaddbccacdabbbbddccabaaaacdbddbbd	TRUE
baaddacabbbdccaaacccbadacaaccddaddaca	TRUE
badccbbcdcaacdabaaddcdadbccaacaaacddd	TRUE
bbccdcacbbaaadadcdacabddbbcbabbdccbbb	TRUE
bcbbccaaaccaabcacacbbcabdbadbbcddaccc	TRUE
bdaaccddabccbccbdaacbaadbbadddaaadadc	TRUE
bdcdacacaacbbcdbbaacabcabdbdbcdcabaaa	TRUE
caacdcadcbcacccbbdcbdcaabaaabadbbadba	TRUE
cadbbadcbdaabadbddbdadcdaaaccacbacddb	TRUE
cbbbdcabaaacdddcddcdbbdbbdbacdccdcdbb	TRUE
ccabacaabdaaadcbddbacccaddbcbbcddcbad	TRUE
ccdaababcabaabdcdabbabadcdcdcbbcbddbd	TRUE
cdbbbddccdbbcdcadcbbaacadcaacaaaccaba	TRUE
cddddcabcdbccddbaaacacccabbccdacabaab	TRUE
dabdbcadccdccccbdaabaccdddadbdaaadbcc	TRUE
dbadbbadacbaddadbacdabdbbaabbadcaaacb	TRUE
dbddabacaabdadbcbdcdaaadcbdcbdbbcacab	TRUE
dccccbaabccdcdaaabaddbccddbcddcddbcab	TRUE
ddbadbdbacadbbacccadaaaddddabadaabaaa	TRUE
aaaaaabdbbcbacdbdcbaddadcadaabddbcbbd	FALSE
aabbbdabaadaadcbbcddbbabbbaaaadbbddddd	FALSE
abaaacacccdccabacdbcbbdcabbbddaaaadba	FALSE
abcbdcbabcbadcddcadcbaaaabbdbbdbbbacad	FALSE
acbaacadcbaaaadbdbccdccccdaddaadaabdb	FALSE
adaaaabbbcbbadbcaddbcbdbcdcccbadcaaab	FALSE
adcbcaddbccacdabdbbddccabaaaacdbddbbd	FALSE
baaddacabbbdccaaaacccbadacaaccddaddaca	FALSE
badccbbcdcaacdabaaddcdadbccaacaaaacddd	FALSE
bbccdcacbbaaaadadcdacabddbbcbabbdccbbb	FALSE
bcbbccaaaaccaabcacacbbcabdbadbbcddaccc	FALSE
bdaaccddabccbccbdaacbaadbbadddaaaadc	FALSE
bdcdacacaacbbcdbbaacabcabdbdbcdcabaaaa	FALSE
caacdcadcbcacccbbdcbdcaabaaaabadbbadba	FALSE
cadbbadcbdaabadbddbdadcdaaaaccacbacddb	FALSE
cbbbdcabaaaacdddcddcdbbdbbdbacdccdcdbb	FALSE
ccabaaaabdaaadcbddbacccaddbcbbcddcbad	FALSE
ccdaababcaaaabdcdabbabadcdcdcbbcbddbd	FALSE
cdbbbddccdbbcdcadcbbaacadcaacaaaacaba	FALSE
cddddcabcdbccddbaaaaacccabbccdacabaab	FALSE
dabdbcadccdccccbdaabaccdddadbdaaaadbcc	FALSE
dbadbbadacbaddadbacdabdbbaabbadaaaacb	FALSE
dbddabacaabdadbcbdcdaaaacbdcbdbbcacab	FALSE
dccccbaabccdcdaaaabaddbccddbcddcddbcab	FALSE
ddbadbdbacadbbacccaaaaddddabadaabaaa	FALSE
aaaaaabcbcaaabacacabdabaabadbbbdcbcdad	TRUE
aabacaabcdacdacabdccbccdacaaabacbbccdb	TRUE
aadbbbbabbadbadcaabccacaaaabddcbdcacba	TRUE
abbdcbddbbcabbcbcdbdadcbddacabdbabaaaa	TRUE
acaaccbcbaccccbbbbddaaaabbbdbdcacbacab	TRUE
acccaaabaadabaabcbdaadcbcaacbdcaadaaab	TRUE
adbabbddcbdbabdaaadbabbacddcaddcacacab	TRUE
baaaccdccbdddbbcdbddbbdddabaacccbcadda	TRUE
bacbabcbaaadaabbbabacbdbaabbdaadacbabc	TRUE
bbbbaadcbaadbdccaaaadbddbdddcacbacdbad	TRUE
bbddbadccabbbaaabbacacaddbcbdacbcaadac	TRUE
bccbcccdadabdacddbddbbbcdcbdaaabaaadcc	TRUE
bdbbaccdddacaacaacaaabdaabddadbbcccccc	TRUE
caaaaadabaabdacbadcdbdcdbaacaacbcbcaab	TRUE
cacdaacbdbcbbaaabddbabbdacbdaacaccdcba	TRUE
cbbbadaaabbdadadcabccddbddacdddbcdcbcd	TRUE
cbdcadaaaacbbbbaaaaabdcacbacdcdaddcbdc	TRUE
cccbacaaacdbabcbbdddbbbdccdddddaddddbd	TRUE
cdadaabbaaccacbadbbaaacdabcbaccccdcbaa	TRUE
cddbbaaabcabcdcbccbabdbcaaacabadccaadb	TRUE
dabcbcadcbaddadbcbadccddcaddddcbbaaaab	TRUE
dbadababcaddcbcadabaacbcbcbbaaaacdcbca	TRUE
dbdbabcbadbcbbaadccabbdbdcacbcbcdaaaab	TRUE
dcccdccacabbbdcdcdbdddbbadadcacaabbccc	TRUE
ddbbcdabcdaddaaaaddccbadabcdcbbbbcacad	TRUE
aaaaaabcbbcaaabacacabdabaabadbbbdcbcdad	FALSE
aabacaabcdacdacabdccbccdaaaabacbbccdb	FALSE
aadbbbdabbadbadcaabccacaaaabddcbdcacba	FALSE
abbdcbddbbcabbcbbcdbdadcbddacabdbabaaaa	FALSE
acaaccbcbaccccbabbddaaaabbbdbdcacbacab	FALSE
acccaaabaadabaabcbdaadcbcaacbdcaadaaaab	FALSE
adbabbddcbdbabdaaaadbabbacddcaddcacacab	FALSE
baaaaccdccbdddbbcdbddbbdddabaacccbcadda	FALSE
bacbabcbaaaadaabbbabacbdbaabbdaadacbabc	FALSE
bbbaadcbaadbdccaaaadbddbdddcacbacdbad	FALSE
bbddbadccabbbaaaabbacacaddbcbdacbcaadac	FALSE
bccbcccdadabdacddbddbbbcdcbdaaabaaaadcc	FALSE
bdbbaccdddaaaacaacaaabdaabddadbbcccccc	FALSE
caaaaadabaabdacbadcdbdcdbaacaacbcabcaab	FALSE
cacdaacbdbcbbaaaaddbabbdacbdaacaccdcba	FALSE
cbbbaaaabbdadadcabccddbddacdddbcdcbcd	FALSE
cbdcadaaaacdbbbaaaaabdcacbacdcdaddcbdc	FALSE
cccbacaaaacdbabcbbdddbbbdccdddddaddddbd	FALSE
cdadaabbaaccacbadbaaaacdabcbaccccdcbaa	FALSE
cddbbaaaacabcdcbccbabdbcaaacabadccaadb	FALSE
dabcbbcadcbaddadbcbadccddcaddddcbbaaaab	FALSE
dbadababcaddcbcadabaacccbcbbaaaacdcbca	FALSE
dbdbabcbadbcbbaadccabbdbdcacbcdbcdaaaab	FALSE
dcccdccacabbbdcdcdbdddbbadadcaaaabbccc	FALSE
ddbbcdabcdaddaaaaddccbadabcdcbbbcacad	FALSE
aaaaaabaacbdaccdbadaabbdbcabcbcddbacbda	TRUE
aababaccdbdaaabadbbadbdacacccacbbdbaabb	TRUE
aadddbcacdbbdabddcbbdabdcdcaabbcaaabbbc	TRUE
abcdbccbbabcbdbbacdabccaaaddcbdbaabdcdb	TRUE
acbcdbdacbcbdaabbbdaacaabaacbabadccbacc	TRUE
adabcdbbbaadbbacdcbbdadbabcccdadaaabdad	TRUE
adcdadcdbdadcacbbbabccadacdbdccaaaddaac	TRUE
baadbccccabbbbdbacbcabcbdaaaadadbccbdca	TRUE
badacbabcdbbacbabddaaacdcabbabbbacdddda	TRUE
bbbcadcabacaaabcbbddbadcbcddaaccbdcacdd	TRUE
bcaaabacdbcbcbabbdddbbdcbabacaaaaddabdc	TRUE
bccbdcabadbdabdccabacaabcaaadcadcbbbcad	TRUE
bdbadbbdadcadaaadacacbadabaaacbbdccbcac	TRUE
caaaaccdacadaaabbdabbbbabcdbdbdbcdaadac	TRUE
cacbaccbcbdbccadaccdaadddadcabbaabaabba	TRUE
cbbaccddcabacccaaabdabcbacccbbddaacbaaa	TRUE
cbddbbbcdadbaadcadccaaabbcdcbaaccbccabc	TRUE
cccabcabaacaaadbaabddbbaccbacadadbaaacc	TRUE
cdadbcbadabdbcaccadcaaaccbacabadbadcccb	TRUE
daaabcbdcdcdcbbdbcdcaacadbcaacadadcadda	TRUE
dacbddbbccabddaaddaaabaaccccddbdbccdcdd	TRUE
dbbabaadbddbbddcabdccaabdbabaaabdcbccdd	TRUE
dcaacdddabcaccaccdcbbacaaadcdacdbccaaad	TRUE
dccdacbaadcbdcbcbaaadbddcabcdabdbdbddcc	TRUE
ddbaccdccabdabcaababcdacdacadcccdabaabd	TRUE
aaaaaabaacbdaccdbadaabbdbcabcbdddbacbda	FALSE
aababaccdbdaaaabadbbadbdacacccacbbdbaabb	FALSE
aadddbcacdbbdabddcbbdabdcdcaabbcaaaabbbc	FALSE
abcdbccbbabcbdbbacdabccaaaaddcbdbaabdcdb	FALSE
acbcdbdacbcbdaabbbdaaaaabaacbabadccbacc	FALSE
adabcdbbbaadbbacdcbbdadbabcccdadaaaabdad	FALSE
adcdadcdbdadcacbbbabccadacdbdccaaaaddaac	FALSE
baadbccccababbbdbacbcabcbdaaaadadbccbdca	FALSE
badacbabcdbbacbabddaaaadcabbabbbacdddda	FALSE
bbbcadcabacaaaabcbbddbadcbcddaaccbdcacdd	FALSE
bcaaabacdccbcbabbdddbbdcbabacaaaaddabdc	FALSE
bccbdcabadbdabdccabacaabcaaaadcadcbbbcad	FALSE
bdbadbbdadcaaaadacacbadabaaacbbdccbcac	FALSE
caaaaccdacadaaabbdabbdbbabcdbdbdbcdaadac	FALSE
cacbaccbcbdbccadaccdaadddadcabbaaaabba	FALSE
cbbaccddcabacccaaabdabcbacccbbddaacbaaaa	FALSE
cbddbbbcdadbaadcadccaaaabbcdcbaaccbccabc	FALSE
cccabcabaacaaaadbaabddbbaccbacadadbaaacc	FALSE
cdadbcbadabdbcaccadcaaaaccbacabadbadcccb	FALSE
daaaacbdcdcdcbbdbcdcaacadbcaacadadcadda	FALSE
dacbddbbccabddaaddaaaabaaccccddbdbccdcdd	FALSE
dbbabaadbddbbddcabdccaabdbabaaaabdcbccdd	FALSE
dcaacdddabcaccaccdcbbacaaadcdacdbccaaaad	FALSE
dccdacbaadcbdcbcbaaaadbddcabcdabdbdbddcc	FALSE
ddbaccdccabdabcaababcdacdacadcccdaaaabd	FALSE
aaaaaaadaabcadabdabbbbdaccccaadaabcbddcc	TRUE
aabaddcdbaacabdaadddaacdbcddaacaaabaabdc	TRUE
aaddccbccdcbbbcacabaacaddcbbabbdcbdcacbd	TRUE
abccdaacccaddcdbdadbdbaacaadccabaacbabba	TRUE
acbbaadabbbabaacddcdccdadcbcbaddbbaccbcc	TRUE
acddcddbbdddbcbcdcdcdacdbbdadcbaaaacccdb	TRUE
adcdcccdaccdbbaaacadbbcbabdbbaadabcbdaba	TRUE
bababdbcbaaabdaabddcbcdcdbaabcdcaadcbcbd	TRUE
bbabccabdbbbbdadddddcaaaadbadcabcccddabb	TRUE
bbdadacabcdaaacacbbabdadddabcdaacbbcdbab	TRUE
bcbccaddaccababcaaddddcacbbaaaaabccdbbac	TRUE
bdaaacbcabacabdbdaacacabadabdbacdaccadad	TRUE
bdcdbacaaaaccbadddbaaccdcbbbbbccacbabaaa	TRUE
cabaaadcbacbbccbbaaacdbdbdbcaddccacdbacb	TRUE
cadcaadbaddcbcbcccbdbcaacaaaaddaaddbbadb	TRUE
cbcbaacaddbaabbcbcddddadcbcaabcabacaaaac	TRUE
ccabdbbcdaaacadccbbcacccddacbdcadabbddbc	TRUE
ccdaccaddaadddccccabbaabbdddaccaaacbbdda	TRUE
cdbdbdabccdcabaccccbcaddccbaaabacdaddcac	TRUE
daaaccdcdcddcbabbcabdaccabbdbdadbcbbcccb	TRUE
dacccddcabaadaaaaabbcbbadbcbacaddbcbcaba	TRUE
dbbdccddaacccdcacaadbbdcadbdbddbcddbdbaa	TRUE
dcabbdbabaadcaaacbdcbacbbbcbacbbdcdcadbd	TRUE
dcccadaaddaadaddbbadaaabdacccbcdbbdddcac	TRUE
ddbadbbadccbbbccaaccadbacacaaaaaddadbcbc	TRUE
aaaaaaadaabcadabdabdbbdaccccaadaabcbddcc	FALSE
aabaddcdbaacabdaadddaacdbcddaacaaaaabdc	FALSE
aaddccbccdcbbbcacaaaacaddcbbabbdcbdcacbd	FALSE
abccdaacccaddcdbdadbdbaaaadccabaacbabba	FALSE
acbbaaaabbbabaacddcdccdadcbcbaddbbaccbcc	FALSE
acddcddbbdddbcbbdcdcdacdbbdadcbaaaacccdb	FALSE
adcdcccdaccdbbaaaacadbbcbabdbbaadabcbdaba	FALSE
bababdbcbaaaabdaabddcbcdcdbaabcdcaadcbcbd	FALSE
bbabccabdbbbddadddddcaaaadbadcabcccddabb	FALSE
bbdadacabcdaaaaacbbabdadddabcdaacbbcdbab	FALSE
bcbbccaddaccababcaaddddcacbbaaaaabccdbbac	FALSE
bdaaaabcabacabdbdaacacabadabdbacdaccadad	FALSE
bdcdbacaaaaccbadddbaaccdcbbabbccacbabaaa	FALSE
cabaaaacbacbbccbbaaacdbdbdbcaddccacdbacb	FALSE
cadcaadbaddcbbbcccbdbcaacaaaaddaaddbbadb	FALSE
cbcbaacaddbaabbcdcddddadcbcaabcabacaaaac	FALSE
ccabdbbcdaaaadccbbcacccddacbdcadabbddbc	FALSE
ccdaccaddaadddccccabbaabbdddaccaaaacbbdda	FALSE
cdbdbdabccdcabaccccbcaddccbaaaabacdaddcac	FALSE
daaaaccdcdcddcbabbcabdaccabbdbdadbcbbcccb	FALSE
dacccddcabaadaaaaabbcbbadbcbacadddcbcaba	FALSE
dbbdccddaacccdcaaaadbbdcadbdbddbcddbdbaa	FALSE
dcabbdbabaadcaaaacbdcbacbbbcbacbbdcdcadbd	FALSE
dcccadaaddaadaddbbaaaabdacccbcdbbdddcac	FALSE
ddbadbbadccbbbccaaccadbacacaaaaaddadbcdc	FALSE
aaaaaabcdccdbbbbbaaabbabbabdddbcaaadbdbdb	TRUE
aabbcddbbcddccbdadccaaadabbbabdbcbacaccbd	TRUE
abaadaacacbacaadcbdaaddaacdaaacddcdccdbac	TRUE
abdbcddddcdadcacaaaccadcacbdbccdcabccbcca	TRUE
acbccbaacaacaaabaadbcbdddcccccdbdaccbdccb	TRUE
adaaccdbcaadcabcaadcdddbadbcccacbddbdbccb	TRUE
addabbddadaccdcaaddbcdaaacdbbbcdbacdaccab	TRUE
babacabadcbdbcbbbdcbaaddaaacbddcdcdbdcbaa	TRUE
badddcacddcabbcbbcbdabbcbdabaaababacdbddb	TRUE
bbcacacbabaaaddccaccbbcbcdabacaccddbdaaaa	TRUE
bcadaddbbcbaddaaadddacddcbdcdbdcccdcadcac	TRUE
bcdacbdbdcbaddbbdcbbaaacbcacddbcccdddadcc	TRUE
bdbccbccbcdbdcabdbdbaaaddddcbdaadababdadd	TRUE
caaabbabdbccccbbcbdababadbcdacabbaddccbaa	TRUE
cacabbacdcbbcdbaabacaccbcddaaddcaacdbdddd	TRUE
cbadaadcdbaaabcbcbaaccabcdadbbbcaaaabaccd	TRUE
cbdbaaacbbdacdbadadcccadccccbbacabcaacdca	TRUE
cccbbddcabbacaaacdaaabacaacdddbbcbdbcaddc	TRUE
cdaddccadcaaacabdcadbcadcbacdbaddcbccaaab	TRUE
daaabcbbcbbccbdaabddddadaaabdbaabbcdadbcb	TRUE
dacacddadadcddadaaacabddbacccacadcbddcacb	TRUE
dbbadcdbaaabbbaaddcbadbddcaabadaccdbcbada	TRUE
dcaaaccbaabaddcdadbacbdccbbabddabaacdaacc	TRUE
dcccaccbcddabacbdcbcbbbcdbaaabbacdaabacca	TRUE
ddbaacbccddcaaabbcccccaccacbcddacadbcaadd	TRUE
aaaaaabcdccdbbbdbbaaabbabbabdddbcaaadbdbdb	FALSE
aabbcddbbcddccbdadccaaaadabbbabdbcbacaccbd	FALSE
abaaaaacacbacaadcbdaaddaacdaaacddcdccdbac	FALSE
abdbcddddcdadcaaaaccadcacbdbccdcabccbcca	FALSE
acbccbaacaacaaaabaadbcbdddcccccdbdaccbdccb	FALSE
aaaaccdbcaadcabcaadcdddbadbcccacbddbdbccb	FALSE
addabbddadaccdcaaddbcaaaacdbbbcdbacdaccab	FALSE
babacabadcbdbcbbbdcbaaddaaaabddcdcdbdcbaa	FALSE
badddcacddcabbcbbcbdabbcbdabaaaababacdbddb	FALSE
bbcacacbabaaaddccaccbbdcbcdabacaccddbdaaaa	FALSE
bcadaddbbcbaddaaaadddacddcbdcdbdcccdcadcac	FALSE
bcdacbdbdcbaddbbdcbbaaaacbcacddbcccdddadcc	FALSE
bdbccbccbcdbdcabdbdbaaaaddddcbdaadababdadd	FALSE
aaaabbabdbccccbbcbdababadbcdacabbaddccbaa	FALSE
cacabbacdcbbcdbaaaacaccbcddaaddcaacdbdddd	FALSE
cbadaadcdbaaabbcbaaccabcdadbbbcaaaabaccd	FALSE
cbdbaaaabbdacdbadadcccadccccbbacabcaacdca	FALSE
cccbbddcabbacaaacdaaaaacaacdddbbcbdbcaddc	FALSE
cdaddccadcaaaacabdcadbcadcbacdbaddcbccaaab	FALSE
daaabcbbcbbccbdaabddddadaaaabdbaabbcdadbcb	FALSE
dacacddadadcddadaaaabddbacccacadcbddcacb	FALSE
dbbadcdbaaaabbbaaddcbadbddcaabadaccdbcbada	FALSE
dcaaaaccbaabaddcdadbacbdccbbabddabaacdaacc	FALSE
dcccaccbcddabacbdcbcbbbcdbaaaabbacdaabacca	FALSE
ddbaacbccddaaaabbcccccaccacbcddacadbcaadd	FALSE
aaaaaaacbccaaacabdaaabddbcbaadccbdcbabcbcd	TRUE
aabadbbcccabbdaacdbcaabbdbdaaabbcddcabddda	TRUE
aadcaacbcdcbccdbadacbddabbdddabaabaacaabcc	TRUE
abcaacbcadbbacdbaaaacbddcacdabaccbcbccabac	TRUE
acacabdccccaddcdbadbbacdbcbdabddbaaacdbaaa	TRUE
accdbbccbbdaaacccdbbbacdaabbaadcddbaccccad	TRUE
adbacdaacadaddbcbaddbaadcbbdcdaabcbbacabca	TRUE
baaaacbabdadbabdcbaabccacacddbcacdbbbbdbbd	TRUE
bacbcbaaabbcdadadbdaaccbacdbcacdadcccddcaa	TRUE
bbbacdcacbababcaaacdcddccadbcddbddbdaaccab	TRUE
bbddddcbadacbdccdcbbbaddbadddcbbaaabacccdc	TRUE
bccbdaacaaadcccdacdaadcbabdacaccdcacddbbdb	TRUE
bdbccabaadbdddddbdacaabdaaabbbabadcbbaaadc	TRUE
caaacabbdabbaacbabdcdbaadaaadadcccbdabdcbd	TRUE
cacacbbbaaadbdcbdaddacbdbdaabdcbccbcdaaadc	TRUE
cbacbcbbacccdcabcbbcdbcdccbaaadbcabcdbdaca	TRUE
cbdbddcdcdbdcaaacadbcddbadbcbbbacdcabdabaa	TRUE
cccabdbadbaacdabbdbcbcbabcbaadbaacbabdaaaa	TRUE
cdbaaacacddcccdccdaaddcccdbbababaaacbcaacc	TRUE
daaaabacbddccaaddbbbbccacdbcadbadbcacdddac	TRUE
dacadaccbdbdbccddbddabcacabcaaacabbacbacbd	TRUE
dbadddacdcbadcccbaacbdcadaabdcbbcabaacbccc	TRUE
dbddbbaadaababbaaddaadcddcbcacaccbabbdcbca	TRUE
dccbaaacbbbdbccbccaabcdbdcaaabacccdcbadbaa	TRUE
ddaddcabbcdaaadcdbaacaabcbccaaaadacbdddbdc	TRUE
aaaaaaacbccaaacabdaaabddbcbaadccbdcbaccbcd	FALSE
aabadbbcccabbdaacdbcaabbdbdaaaabbcddcabddda	FALSE
aadcaacbcdcbccdbadacbddabbdddabaabaaaabcc	FALSE
abcaacbcadbbacdbaaaacbddcacdabaccdcbccabac	FALSE
acacabdccccaddcdbadbbacdbcbdabddbaaacdbaaaa	FALSE
accdbbccbbaaaacccdbbbacdaabbaadcddbaccccad	FALSE
adbacdaaaadaddbcbaddbaadcbbdcdaabcbbacabca	FALSE
baaaacbabdadbabdcbaabccacacddbcacdbdbbdbbd	FALSE
bacbcbaaaabbcdadadbdaaccbacdbcacdadcccddcaa	FALSE
bbbacdcacbababaaaacdcddccadbcddbddbdaaccab	FALSE
bbddddcbadacbdccdcbbbaddbadddcbbaaaaacccdc	FALSE
bccbdaaaaadcccdacdaadcbabdacaccdcacddbbdb	FALSE
bdbccabaadbdddddbdacaabaaaabbbabadcbbaaadc	FALSE
caaacabbdabbaacbabdcdbaadaaaadadcccbdabdcbd	FALSE
cacacbbbaaaadbdcbdaddacbdbdaabdcbccbcdaaadc	FALSE
cbacbcbbacccdcabcbbcdbcdccbaaaadbcabcdbdaca	FALSE
cbdbddcdcdbdcaaaacadbcddbadbcbbbacdcabdabaa	FALSE
cccabdbadbaacdabbdbcbdcbabcbaadbaacbabdaaaa	FALSE
cdbaaaacacddcccdccdaaddcccdbbababaaacbcaacc	FALSE
daaaabacbddccaadddbbbccacdbcadbadbcacdddac	FALSE
dacadaccbdbdbccddbddabcacabcaaaacabbacbacbd	FALSE
dbadddacdcbadcccbaacbdcaaaabdcbbcabaacbccc	FALSE
dbddbbaaaaababbaaddaadcddcbcacaccbabbdcbca	FALSE
dccbaaacbbbdbccbccaabcdbdaaaabacccdcbadbaa	FALSE
ddaddcabbcdaaadcdbaacaabcbbccaaaadacbdddbdc	FALSE
aaaaaaadabdcbcaacbbbbaaddcabcdddbddcdbaadda	TRUE
aabdcbaacdcdbaccdbdbabaadbcccacddaabdbadabb	TRUE
ababadbbbcbdbccaddbbdadccddbbbccacadaaadbba	TRUE
abccacaaddcaaabcdbaaadcbdadcbbaccbababdddac	TRUE
acbadcdbadaddbcadddcdcbcacccbaaacabbaccdccd	TRUE
acdcdacababcbcdccacccdaadbddabacaaaacdadddd	TRUE
adbdacbbabadaaccbddbccbdbddadacabdcbacaaddb	TRUE
baaacbbdcbabbddcddcbadbbabbcdaaddcacbdaaabd	TRUE
bacdbdacbddbaaaccbddadcaabdabaaacabbccaadad	TRUE
bbbbdbddcbddcaccaaaaabbcccdabaadbaaabcbaadd	TRUE
bcaaacbdaddcdcbccddcaaacbcbdbaddcdbdddcbbbd	TRUE
bccddaaacddbaacddbdabccdadacabbddabadccbbdd	TRUE
bdcacacbcacbaccddbdabddcbbbaaaadadcbcbcccdb	TRUE
caabcdcbbdcabaddbbaadadbaaaddcacabcdabbcdbd	TRUE
cacdacacaadcbcabbdcbaccaacadbcccaccbbcdccad	TRUE
cbbcbaaacbaadcdadbdcdccaabddadcaccaaaccbbda	TRUE
cbdddcdbadaaadbbdaccabcdbabaddcbdacbdddcddd	TRUE
ccdbacbacacadcdcbadaccaccdabcbdbaabaccbbaac	TRUE
cdbcbbcbcadccacaaaadadbdbbcbdddbabadbacabaa	TRUE
daabaaadaacdbdabdccadcbbcbbadbadabcaadabdcd	TRUE
dadbabaaacbbaddabdcabadbdaabacaccbadaccccba	TRUE
dbbcccdabdbdabaadabcbbddcdaaadbdcdabcbbdddd	TRUE
dcabababcddabccadcaadddadacdbabccbddabdbaaa	TRUE
dccccaddcdadabaabaaaccacdbccccbacdaabdadbcb	TRUE
ddbacbccdbdcababbadcaaabacdabdbaabddcbbdcca	TRUE
aaaaaaadabdcbcaacbbbaaddcabcdddbddcdbaadda	FALSE
aabdcbaacdcdbaccdbdbaaaadbcccacddaabdbadabb	FALSE
ababadbbbcbdbccaddbbdadccddbbbccacaaaaadbba	FALSE
abccacaaddcaaabcdbaaaacbdadcbbaccbababdddac	FALSE
acbadcdbadaddbcadddcdcbcacccbaaaacabbaccdccd	FALSE
acdcdacababdcbcdccacccdaadbddabacaaaacdadddd	FALSE
adbdacbbabadaaccbddbccbdbddadacabdcbaaaaddb	FALSE
baaaabbdcbabbddcddcbadbbabbcdaaddcacbdaaabd	FALSE
bacdbdacbddbaaaaccbddadcaabdabaaacabbccaadad	FALSE
babbbdbddcbddcaccaaaaabbcccdabaadbaaabcbaadd	FALSE
bcaaaabdaddcdcbccddcaaacbcbdbaddcdbdddcbbbd	FALSE
bccddaaaacddbaacddbdabccdadacabbddabadccbbdd	FALSE
bdcacacbcacbaccddbdabddcbbbaaaadadcbcabcccdb	FALSE
caabcdcbbdcabaddbbaadadbaaaadcacabcdabbcdbd	FALSE
cacdacaaaadcbcabbdcbaccaacadbcccaccbbcdccad	FALSE
cbbcbaaacbaadcdadbdcdccaabddadcaccaaaaccbbda	FALSE
cbdddcdbaaaaadbbdaccabcdbabaddcbdacbdddcddd	FALSE
ccdbacbacacadcdcbadaccaccdabcbdbaaaaccbbaac	FALSE
cdbcbbcbdcadccacaaaadadbdbbcbdddbabadbacabaa	FALSE
daaaaadaacdbdabdccadcbbcbbadbadabcaadabdcd	FALSE
dadbabaaaacbbaddabdcabadbdaabacaccbadaccccba	FALSE
dbbcccdabdbdabaadabcbbddcdaaaadbdcdabcbbdddd	FALSE
dcabababcddabccadcaadddadacdbabccbddabdaaaa	FALSE
dccccaddcdadabaabaaaaccacdbccccbacdaabdadbcb	FALSE
ddbacbccdbdcababbadaaaabacdabdbaabddcbbdcca	FALSE
aaaaaaddadabcddadaddaabbbbadcbacaddaadbcdcdb	TRUE
aabdbbcbacdcddabdccdccdaccabaacccdaaaddbcddc	TRUE
ababbcdbcdccaaacadddbbbccacdabbdbaadabcadcdb	TRUE
abdabacaadacbcdadcdacccbbbcaccbadddcbcbaaadd	TRUE
acbbbaaadbbdddbdddbdbdcabcddbccdadbcaddbccbd	TRUE
adaabaaadbdabbdbdcadbaacccbacadaaadacdbbcabb	TRUE
adcbcbbbddcdcadcbdcbddbdcabaabcbbcccdbddadbd	TRUE
baacadbaccdadbbdbbabbddabbdbcbdbdcacccbbbdbd	TRUE
badaaaaddabdaddcbbbccaabcbcdabbadadbcaaabaaa	TRUE
bbbcdcacadadbaaabacbdabadddcdbcbbdcbbddcdbbc	TRUE
bcababcbbacdacabddacddbdacddbdcccadcaaacddba	TRUE
bccdcbaccbddaacacbdcbcabdaacaadaddbadbacbdcd	TRUE
bdcabcccadbaadcaaaccaddbbabcabddbadcaccddadb	TRUE
caaacabadbbdbcabbbaabbcaabcaacbdcbbdbdcaddaa	TRUE
cacdbaaabbcabcadbbccaaabaabdddbbcbbbcbadcdca	TRUE
cbbabdcdaacabaaaccacbacbdaadaacddccaacdbadba	TRUE
ccabbdbcccdacdcbaabbccdacaddbadaadbacaaaccda	TRUE
ccdabccdcbdbbcbaaabdacaacbbbddbacbcacddbacbc	TRUE
cdbbacbbddccdaabaabdccbcaaaabccbdbabcbcaadcc	TRUE
daaacbcddbacaccadccccadcdcbaaaddddbddacadddb	TRUE
dacccddcdbbbcaaacabbdbcdddccbaddcaccaccbcbac	TRUE
dbbbcdcadbbcdddcaaabdcbdaabbaacabbdbdcbdbaac	TRUE
dcabdcdbaaacbcccaaadcdaabddadbcabcddcaadcaaa	TRUE
dcdaabddaacdabcbbaaacbadcdcddbbdcccccaaaddcd	TRUE
ddbcaaabdbdaacdabaddbaaacdcacbccaaccbcaddcbc	TRUE
aaaaaaddadabcddadaddaabbbdadcbacaddaadbcdcdb	FALSE
aabdbbcbacdcddabdccdccdaccabaacccdaaaaddbcddc	FALSE
ababbcdbcdccaaacadddbbbccacdabbdbaaaabcadcdb	FALSE
abdabaaaadacbcdadcdacccbbbcaccbadddcbcbaaadd	FALSE
acbbbaaaabbdddbdddbdbdcabcddbccdadbcaddbccbd	FALSE
adaaaaaadbdabbdbdcadbaacccbacadaaadacdbbcabb	FALSE
adcbcbbbddcdcadcbdcbddbdcaaaabcbbcccdbddadbd	FALSE
baaaadbaccdadbbdbbabbddabbdbcbdbdcacccbbbdbd	FALSE
badaaaaddabdaddcbbbccaabcacdabbadadbcaaabaaa	FALSE
bbbcdcacadadbaaaabacbdabadddcdbcbbdcbbddcdbbc	FALSE
bcababcbbacdacabddacddbdacddbdcccadcaaaacddba	FALSE
bccdcbaccbddaacacbdcbcabdaacaaaaddbadbacbdcd	FALSE
bdcabcccadbaadcaaaaccaddbbabcabddbadcaccddadb	FALSE
caaaacabadbbdbcabbbaabbcaabcaacbdcbbdbdcaddaa	FALSE
cacdbaaabbcabcadbbccaaaabaabdddbbcbbbcbadcdca	FALSE
cbbabdcdaacabaaaacacbacbdaadaacddccaacdbadba	FALSE
ccabbdbcccdacdcbaabbccdacaddbadaadbacaaaaccda	FALSE
ccdabccdcbdbbcbaaaabdacaacbbbddbacbcacddbacbc	FALSE
cdbbacbbddccdaabaabdccbcaaaabccbdbabcccaadcc	FALSE
daaacbcddbacaccadccccadcdcaaaaddddbddacadddb	FALSE
dacccddcdbbbcaaaabbdbcdddccbaddcaccaccbcbac	FALSE
dbbbcdcadbbcdddaaaabdcbdaabbaacabbdbdcbdbaac	FALSE
dcabdcdaaaacbcccaaadcdaabddadbcabcddcaadcaaa	FALSE
dcdaabddaacdabcbbaaaacbadcdcddbbdcccccaaaddcd	FALSE
ddbcaaabdbdaacdabaddbaaaacdcacbccaaccbcaddcbc	FALSE
aaaaaacdcadbabcdbddabbbbabcbabdaabcacddbacbdb	TRUE
aabbcbdccabbaccdaddcdbddbadccdbadbabdaaabcbba	TRUE
abaaabbbbacccbabbcacbdbcdadaabbaadcbcccaacada	TRUE
abcbdaaacadadacadbabcddaddadadbdaddcdcddcdcdc	TRUE
acaccadaaabdadacbcaddabbdaabbcbdaddaddcddcaab	TRUE
acdacbbaaabdcdcdcddabbbadbaaadbdbbcddaaabddad	TRUE
adbcbccddbcabbbcddcdaddbdccbddbbdacbdcdcaaaaa	TRUE
baabaaccdaddcdaddddbdabaabaaccbacadcabadcdcbd	TRUE
badabbcbcabbabccaacbcacaaccbacabbcabaaaaadacb	TRUE
bbccbaacddbabbadaaacacdbcddadcddcbbddaaadbcdc	TRUE
bcbaabdbaadaacccdccdcdaacaddcdddabdddbcaaabac	TRUE
bdaaabbcdadbccaacaadccbacbddacddacadbcdbadaaa	TRUE
bddaadaabbdaddbccddadddcdcadcbdddddcdddaabaaa	TRUE
cabdcaaabdaaadabaaacdacabdcdcbacacbbaaabaccaa	TRUE
cbaaabccacdbdaccaabddbdadddbddcbdadbddccdccac	TRUE
cbccaadaaaccbabacaacbdaadadbacabbaaacbacddabd	TRUE
ccbbabaabcdcbbccaabaccaadcbaddbaabbdcaddbcaac	TRUE
cdaaaccaddcbdacacdaccaaabcdbabbdbadacbcdacbab	TRUE
cdccaaabacdcaaccbbccdababadbcabcaabbaabdcddba	TRUE
daacbacbcabcddbdbaacdbbabcbdbbdbbdaaaacdbbbbb	TRUE
dadacdccabacdadddacadaaacadbabccbaabcdbabcbab	TRUE
dbbbaadccdbddcacbddaaabbbcccdabaaababdadcabdb	TRUE
dbddadbcdabdbcddddddcbdccaaabaadbdbaddabdadac	TRUE
dccbcdbcacdccaccaacabccbacaaabdabaccbacacaaac	TRUE
ddbbacaacaaadbbadbdcacbbddadcdacaabbdaadadbad	TRUE
aaaaaacdcadbabcdbddababbabcbabdaabcacddbacbdb	FALSE
aabbcbdccabbaccdaddcdbddbadccdbadbabdaaaabcbba	FALSE
abaaaabbbacccbabbcacbdbcdadaabbaadcbcccaacada	FALSE
abcbdaaaaadadacadbabcddaddadadbdaddcdcddcdcdc	FALSE
acaccadaaaabdadacbcaddabbdaabbcbdaddaddcddcaab	FALSE
acdacbbaaabdcdcdcddabbbadbaaaadbdbbcddaaabddad	FALSE
adbcdbccddbcabbbcddcdaddbdccbddbbdacbdcdcaaaaa	FALSE
baabaaccdaddcdaddddbdabaaaaccbacadcabadcdcbd	FALSE
badabbccbcabbabccaacbcacaaccbacabbcabaaaaadacb	FALSE
bbccbaacddbabbadaaacacdbcddadcddcbbddaaaadbcdc	FALSE
bcbaabdbaadaacccdccdcdaacaddcdddabdddbcaaaabac	FALSE
bdaaabbcdadbccaacaadccbacbddacddacadbcdbadaaaa	FALSE
bddaadaabbdaddbccddadddcdcadcbdddddcdddaaaaa	FALSE
cabdcaaabdaaadabaaaadacabdcdcbacacbbaaabaccaa	FALSE
cbaaaabccacdbdaccaabddbdadddbddcbdadbddccdccac	FALSE
cbccaadaaaccbabacaacbdaadadbacabbaaaacbacddabd	FALSE
ccbbaaaabcdcbbccaabaccaadcbaddbaabbdcaddbcaac	FALSE
cdaaaccaddcbdacacdaccaaaabcdbabbdbadacbcdacbab	FALSE
cdccaaaabacdcaaccbbccdababadbcabcaabbaabdcddba	FALSE
daacbacbcabcddbdbaacdbbabcbdbbdbbdaaaacdbdbbb	FALSE
dadacdccabacdadddacadaaaaadbabccbaabcdbabcbab	FALSE
dbbbaadccdbddcacbdaaaabbbcccdabaaababdadcabdb	FALSE
dbddadbcdabdbcddddddcbdccaaaabaadbdbaddabdadac	FALSE
dccbcdbcacdccaccaacabccbaaaaabdabaccbacacaaac	FALSE
ddbbacaaaaadbbadbdcacbbddadcdacaabbdaadadbad	FALSE
aaaaacbdbcacadaccabbbaacaaadacdacabbaaaadcbcbc	TRUE
aabcbaadabccacadccaaadcdcaccccbacdccddcdbbabad	TRUE
abaaabddcadddaacbaaacbaccbcbabcbbacaaaccadbbcc	TRUE
abcbccabdaaabdbaccdadbcdccaaaabdaaaadcbbabcbba	TRUE
acadcbbdcbaaaddbcdcacbbdbdadbadbbcddbdabcbbcad	TRUE
acdbcddbddbdcddadbbbbacdbaacdbdaaaaacdcbcccdad	TRUE
adcaabdccdcbbaccdcaddbcbdbcaacaaacabcabdcdbdbc	TRUE
baacbcabbdcbbcbbbbcbabbabcdddacdccbdcabdaaaadd	TRUE
badbddcacccabccaddcbaadbbbaaacdaabaabaacabbcda	TRUE
bbcacaaacddbccbcbbbddabbcccbbccdcbaddbcdacadab	TRUE
bcacbbaabbdcdbadabdbccbcbacbcbdaacabadbadcaaac	TRUE
bcdcacacbbaacdcaacdadcabdaadaabbdacaabaadcaaba	TRUE
bdccaaadbcbbaacdddadabccaabaaabcbbcbacbddccabd	TRUE
caadddcbbcddabbbddadcbccbbabdcadcbbcaacadbccbc	TRUE
caddbabdbccaaaaddadadddacdddccccdbcbcbababdbdb	TRUE
cbccacdcdcdcdcdacccaaccddabcdddbdadaaddbcaaada	TRUE
ccbacddbdcabaaacacdadbcccbdcdacddadccadddabaca	TRUE
cdabbadcbbdbababcaaddaacbabaacacccabbdbdaaaccc	TRUE
cdcdcababccbbccddcdabdaadbbdaacacdddadabcdbaab	TRUE
dabaacacdbcdcbacacdbbcacaacdbaaaabaaaacadabcbc	TRUE
dadaddbddbddcdcacbdacdbaacabbdbdbaccdbaaabacbb	TRUE
dbbdadddbacdcabbadabaccdbcadbadbaabdaddacaaddb	TRUE
dcabbbaabcbacccbadbccbccccccdbcabbbaaadabcaabc	TRUE
dcdababcacabbccabaddbaabadcbdccaadabccabbdbaad	TRUE
ddbbbbdacaaccbaacababdcdbdaccddcccbabccaaaadac	TRUE
aaaaacbdbcacadaccabbbaacaaadacdacabbaaaadcbcac	FALSE
aabcbaadabccacadcaaaadcdcaccccbacdccddcdbbabad	FALSE
abaaaabddcadddaacbaaacbaccbcbabcbbacaaaccadbbcc	FALSE
abcbacabdaaabdbaccdadbcdccaaaabdaaaadcbbabcbba	FALSE
acadcbbdcaaaaddbcdcacbbdbdadbadbbcddbdabcbbcad	FALSE
acdbcddbddbdcddadabbbacdbaacdbdaaaaacdcbcccdad	FALSE
adcaabdccdcbbaccdcaddbcbdbcaacaaaacabcabdcdbdbc	FALSE
baacbcabbdcbbcbbbcbabbabcdddacdccbdcabdaaaadd	FALSE
badbddcacccabccaddcbaadbbbaaaacdaabaabaacabbcda	FALSE
bbcacaaaacddbccbcbbbddabbcccbbccdcbaddbcdacadab	FALSE
bcacbbaabbdcdbadabdbccbcbacbcbdaacabadbadcaaaac	FALSE
bcdcacacbbaacdcaacdadcabdaadaabbdacaaaaadcaaba	FALSE
bdccaaadbcbbaacdddadabccaabaaaabcbbcbacbddccabd	FALSE
caadddcbbcddabbbddadcbccbbabdcadcbbcaaaadbccbc	FALSE
caddbabdbccaaaaddadadddacdddccccdbcbdcbababdbdb	FALSE
cbccacdcdcdcdcdacccaaccddabcdddbdadaaddbcaaaa	FALSE
ccbacddbdcabaaaacacdadbcccbdcdacddadccadddabaca	FALSE
cdabbadcbbdbababcaaddaacbabaaaacccabbdbdaaaccc	FALSE
cdcdcababccbbccddcdabdaadbbdaaaacdddadabcdbaab	FALSE
dabaacacdbcdcbacacdbbcacaacdbaaaabaaaacadabacbc	FALSE
dadaddbddbddcdcacbdacdbaacabbdbdbaccdbaaaabacbb	FALSE
dbbdadddbacdcabbadabaccdbcadbadbaabdaddaaaaddb	FALSE
dcabbbaabcbacccbadbccbccccccdbcabbbaaaadabcaabc	FALSE
dcdababcacabbccabaddbaabadcbdccaaaabccabbdbaad	FALSE
ddbcbbbdacaaccbaacababdcdbdaccddcccbabccaaaadac	FALSE
aaaaaaabcacbcadadbaabaadccbdaadaabbbcddadbcbcdd	TRUE
aabadddabdcccbadacdabbabdcbdabbdcaaacddbdbcccaa	TRUE
abaacadaaacddaccdbbbdbdcbddccaabcbbdaddcabddada	TRUE
abdadbbacabadcaaabdabcbadadaaaddacbdabaabbdbbdc	TRUE
acbcdcabdadabdaaacddabacddadbcddcccbbbcbadbcccd	TRUE
adabcdcadacdacdabaaadacbcacddbbaacabcacdcdcccad	TRUE
addbaaccbddcacccccabbcaaadcabdbdcbcadccdabbccca	TRUE
babdbadaccbcdbccbbabdcbbddaaacabbdbcddcdbaadacb	TRUE
bbabbababddbbaaadadbcdcdabcabddcbddccbaacdbdabc	TRUE
bbcdbabbdcddbcbacdbddcbadccbdadaaccbaaaadbbcbcc	TRUE
bcbbacacacbdddbacbaadddbbcbdadabaaabadccadacaad	TRUE
bcddbcaaaccccccbddbcdadbbcacdcbacccbccbdcccacac	TRUE
bdcacaabaaaacadaaaddbbabdabbbddbccabbcbcacdbcaa	TRUE
caacabbcabacbdccabaaacdaaacaadacabdaadccaacbcbb	TRUE
cadbabadabbacacbdddcdaadaabdbcaccdbdaccbbabadbb	TRUE
cbbcbbaabcaaaaccadcdabaacbdbcdccbcbccbaaaabdabc	TRUE
ccabccbbccbbabacdacdddadbccdbacdcaacaacbcabadba	TRUE
ccdaaaabbcacaaccbbadbcabcbcabbdbbdcadcabacdbccc	TRUE
cdbadadbdddaccaaacdcaabaddbdcabcadabdacaabaddad	TRUE
daaaabcbabaccbadddcdcaadbcbccdadbdcbcdabccaabdc	TRUE
dacaccdadaacccdbbcbdaaccaaabbdcabbbadabbacbbcda	TRUE
dbbaacbcbadabbababccaddababccbacabbabdacaaaccda	TRUE
dbdcdbbcbcbaddadcdbabaddadabbcbadbaaaabacabbbda	TRUE
dccdaadbbbcdbcaaaddadcacddaadbccdcacbabdadadaca	TRUE
ddbbccaaacdcbdaaaabbbcddbdabbdcccabcbccbbccbcba	TRUE
aaaaaaabcacbcadadbaabaadccbdaadaabbbcddadacbcdd	FALSE
aabadddabdcccbadacdabbabdcbdabbdcaaaacddbdbcccaa	FALSE
abaacadaaaaddaccdbbbdbdcbddccaabcbbdaddcabddada	FALSE
abdadbbacabadcaaabdabcbadadaaaaddacbdabaabbdbbdc	FALSE
acbcdcabdadabdaaaacddabacddadbcddcccbbbcbadbcccd	FALSE
adabcdcadacdacdabaaaacbcacddbbaacabcacdcdcccad	FALSE
addbaaccbddcacccccabbcaaaadcabdbdcbcadccdabbccca	FALSE
babdbadaccbcdbccbbabdcbbddaaaacabbdbcddcdbaadacb	FALSE
bbabbababddbbaaaadadbcdcdabcabddcbddccbaacdbdabc	FALSE
bbcdbabbdcddbcbacdbddcbadccbdadaaccbaaaadbbdcbcc	FALSE
bcbbacacacbdddbacbaadddbbcbdadabaaaadccadacaad	FALSE
bcddbcaaaaccccccbddbcdadbbcacdcbacccbccbdcccacac	FALSE
bdcacaabaaaacadaaaddbbabdabbbddbccabbcabcacdbcaa	FALSE
caacabbcabacbdccaaaaacdaaacaadacabdaadccaacbcbb	FALSE
cadbabadabbacacbdddcdaaaaabdbcaccdbdaccbbabadbb	FALSE
cbbcbbaabcaaaaccadcdabaacbdbcdccbccbccbaaaabdabc	FALSE
ccabccbbccbbabacdacdddadbccdbacdcaaaaacbcabadba	FALSE
ccdaaaabbcacaaccbbadbcabdbcabbdbbdcadcabacdbccc	FALSE
cdbadadbdddacaaaacdcaabaddbdcabcadabdacaabaddad	FALSE
daaaabcbabaccbadddcdcaadbbbccdadbdcbcdabccaabdc	FALSE
dacaccdadaacccdbbcbdaaccaaaabbdcabbbadabbacbbcda	FALSE
dbbaacbcbadabbababccaddababccbacabbabdacaaaaccda	FALSE
dbdcdbbccbcbaddadcdbabaddadabbcbadbaaaabacabbbda	FALSE
dccdaadbbbcdbcaaaaddadcacddaadbccdcacbabdadadaca	FALSE
ddbbccaaacdcbdaaaabbbcddbdabbdcccabcdccbbccbcba	FALSE
aaaaadadbabbbdcaaaabaccdadaaddabdcbccaddcdcbcbcc	TRUE
aabcdcdbcdabbdcddddacbdabcdbaddbcbacbbadaabdbcac	TRUE
ababaadadbbdbdcbbcaddaadaabdaddacddacdcaacabacdc	TRUE
abcdcdaaaddbddcddbdbcacdbbbcddccbadbdabccddacbca	TRUE
acbaccabbaacdcdbbacaaaddbdbdacadddaabbaacbdcacaa	TRUE
acddbadcddcdbcbadaabadabaacaadaaddbacddddbadccac	TRUE
adcbcdccabbcdcadbabacadcddbadacbadbcdccaaabbaacb	TRUE
baabbdaacacaddbbbbcaaaaccaaabbaaabbcccbabdcdacdc	TRUE
baccdcccbbacbadaaacbdccaacaaacddbdcbcbdccacdaddd	TRUE
bbbccdacaaaacbddadacaaadbbbabcbccaadbacbccdbacbb	TRUE
bcabcdacabaccddcaaaddccbbaaaacbcbcbaacbabdcabaca	TRUE
bcdadbdcabaaabaacdcddaddbabddaaaadaabbcbcbdadabc	TRUE
bdcabdabbcadcaaacbcdacaddaacabcabbbcabcdddbbdbdd	TRUE
cabbabccaacaaddcbaddbbabddcbcadaccabdadbdbcaaacb	TRUE
cbaacbdbdcdabbddcdcadcdcbabcaaacadbdcdcabadcaadd	TRUE
cbcbbbabaddbaddbdadcdcbdcdcdcabcdadcabaabdbdcadd	TRUE
ccbabccacaadbaaccbabcaabcddbaaabbabbaccdaddddbcb	TRUE
ccdbacdaccdcabccabddadadaaacdcddcbbbbdaaaacdbdcd	TRUE
cdbbbacaaaabcbbbbbbacaddabcbbabbcdacdadcdddcbaca	TRUE
cdddcacdcaababbcdcbcddbabcabcdbdcccbaddaabacaacc	TRUE
dacadbdabcbbaadbcdaaacdaacdcbcbaacacaaabdbddbcdd	TRUE
dbbbcdddabaddcddbacbcbdcadaacaaccbdbbcaadbcaddbb	TRUE
dcabbdacdbbcabcaabacddaadcdbbbcdddbbbabbaacaaacc	TRUE
dccdadcadcbaaaaacdddabbccaabcbcadddcccdaaccbaadd	TRUE
ddbbadadabbabbcacbbcadaacbdadbddbbaddabbcadabddc	TRUE
aaaaadadbabbbdcaaaabaccdadaaddabdcbccaddcdcbcdbcc	FALSE
aabcdcdbcdabbdcddddacbdabcdbaddbcbacbbaaaabdbcac	FALSE
ababaadadbbdbdcbbcaddaaaabdaddacddacdcaacabacdc	FALSE
abcdcdaaaadbddcddbdbcacdbbbcddccbadbdabccddacbca	FALSE
acbaccabbaacdcdbbacaaaaddbdbdacadddaabbaacbdcacaa	FALSE
acddbadcddcdbcbadaaaadabaacaadaaddbacddddbadccac	FALSE
adcbcdccabbcdcadbabacadcddbadacbadbcdccaaaabaacb	FALSE
baabbdaacacaddbbbccaaaaccaaabbaaabbcccbabdcdacdc	FALSE
baccdcccbbacbadaaaacbdccaacaaacddbdcbcbdccacdaddd	FALSE
bbbccdacaaaacbddadacaaadbbbadcbccaadbacbccdbacbb	FALSE
bcabcdacabaccddcaaaddccbbaaaacbbbcbaacbabdcabaca	FALSE
bcdadbdcabaaabaacdcddaddbabddaaaadaabbcdbcbdadabc	FALSE
bdcabdabbcadcaaaacbcdacaddaacabcabbbcabcdddbbdbdd	FALSE
cabbabccaacaaddcbaddbbabddcbcadaccabdadbdbcaaaacb	FALSE
cbaacbdbdcdabbddcdcadcdcbabcaaaacadbdcdcabadcaadd	FALSE
cbcbbbabaddbaddbdadcdcbdcdcdcabcdadcaaaabdbdcadd	FALSE
ccbabccacaadbaaccbabcaabcddbaaaabbabbaccdaddddbcb	FALSE
ccdbacdaccdcabccabddadadaaacdcddcbbdbbdaaaacdbdcd	FALSE
cdbbbacaaaabcbbbabbbacaddabcbbabbcdacdadcdddcbaca	FALSE
cdddcacdcaaaabbcdcbcddbabcabcdbdcccbaddaabacaacc	FALSE
dacadbdabcbbaadbcdaaaacdaacdcbcbaacacaaabdbddbcdd	FALSE
dbbbcdddabaddcddbacbcbdcadaaaaaccbdbbcaadbcaddbb	FALSE
dcabbdacdbbcabcaabacddaadcdbbbcdddbbbabbaacaaaac	FALSE
dccdadcadcbaaaaacdddabbccaabcbacadddcccdaaccbaadd	FALSE
ddbbadadabbabbcacbbcaaaacbdadbddbbaddabbcadabddc	FALSE
aaaaaabaddcbcabadbcdabbadadbcbadabdadcbcbcbcddbab	TRUE
aabcaacddacadbbbcddbbcaacaacdbbaadacdcddccdacaada	TRUE
abababdabcabcdddbaaaddcccdbbbacbaccdadbdbcacbadab	TRUE
abcddddcacdcacabcdbcacaabbdbddaacddbbddbadbbbdaaa	TRUE
acbbdbaadddbdcbdcbacbcdaaaddadaadcaaababdcccabaaa	TRUE
adaacbbdcacdccaadccdcaaadbbbdcbdaddbbdadbddbcacda	TRUE
adccbadbcacdabcdddddddcccaadacacaabbaaadaabddcddc	TRUE
baadbccbbbcabbddbadccdccbabccbaaadbcccadcadbddbba	TRUE
badccabbadcccacbdbbbbcacbadcccdbdbbdabcaaaaddcaba	TRUE
bbbdbdaaccadcdddabaacbbadcaabdaaccdcadcaaabdadbdc	TRUE
bcacadddbbabbddbdcddaaadadddadaadcdabdcdbcdcddbab	TRUE
bcdadbcdbbacaacbdbddcbaddbbbaaadbadccacabacabdadc	TRUE
bdbdbbbbdbcaabdbbbdbaaaabdadcdbbdbdabcaaddbdbbdbc	TRUE
caabbdbabbadddadbbcdbaabcdbaaabcdcdbbdcdabbbcdabc	TRUE
cadadccbaaabcbdabcaaaabadddcaacabbbbcaadbcdcbbacc	TRUE
cbbdabbaaabadbbacbbbaadbdcbddddaaacccdabacdcbacab	TRUE
ccaadbacbacacdbbdaadcadbcbcaacddbaadbdaaaaacabddb	TRUE
ccccdbadcccddcbddaacabddabddbabacacadcadbaaacacbd	TRUE
cdbbadadadbbddbcdacdabccadcdbaaddadbaabdbbcaaadbb	TRUE
cddddddcdbdabaadccdbdcdbbbdbccadbdbcccdcdbacaaadd	TRUE
daccbdcbbddbdbcdbaaadcadbcdcdbdaaccccccccdbdddadc	TRUE
dbbbabbaacdabddaacaacacdabacddbdbaaccdbcdabbddabd	TRUE
dbdbdaadbadbdcdcadaadabaacdaacddbacadaccacdbaaabb	TRUE
dccabbaadcdbcbbaadaacacbbadcaddbaadacdaaadcddccac	TRUE
ddadbcdcaaadccccabbbacdccacbcdbcdcbcbdabbdabaabcd	TRUE
aaaaaabaddcbcabadbcdabbadadbcbadabdadcbcccbcddbab	FALSE
aabcaacddacadbbbcddbbcaaaacdbbaadacdcddccdacaada	FALSE
abababdabcabcdddbaaaaddcccdbbbacbaccdadbdbcacbadab	FALSE
abcddddcacdcacabcdbcacaabbdbddaacddbbddbadbbbdaaaa	FALSE
acbbdbaadddbdcbdcbacbcdaaaddadaadcaaababdcccaaaa	FALSE
aaaacbbdcacdccaadccdcaaadbbbdcbdaddbbdadbddbcacda	FALSE
adccbadbcacdabcdddddddcccaadacaaaabbaaadaabddcddc	FALSE
baadbccbbbcabbddbadccdccbabccbaaaadbcccadcadbddbba	FALSE
badccabbadcccacbdbdbbcacbadcccdbdbbdabcaaaaddcaba	FALSE
bbbdbdaaccadcdddabaacbbadcaabdaaccdcadcaaaadadbdc	FALSE
bcacadddbbabbddbdcddaaaadadddadaadcdabdcdbcdcddbab	FALSE
bcdadbcdbbacaacbdbddcbaddbbbaaaabadccacabacabdadc	FALSE
bdbdcbbbdbcaabdbbbdbaaaabdadcdbbdbdabcaaddbdbbdbc	FALSE
caabbdbabbadddadbbcdbaabcdaaaabcdcdbbdcdabbbcdabc	FALSE
cadadccbaaabcbdabcaaaabadddcaacabbabbcaadbcdcbbacc	FALSE
cbbdabbaaabadbbacbbbaadbdcbddddaaaacccdabacdcbacab	FALSE
ccaadbacbacacdbbdaadcadbcbaacddbaadbdaaaaacabddb	FALSE
ccccdbadcccddcbddaacabddabddbabacacadcadbaaaacacbd	FALSE
cdbbadadadbbddbcdacdabccadcdbaaddadbaabdbbcaaaadbb	FALSE
cddddddcdbdabaadccdbdcdbbbdbccadbdbcccdcdbacaaaadd	FALSE
daccbdcbbddbdbcdbaaaacadbcdcdbdaaccccccccdbdddadc	FALSE
dbbbabbaacdabddaaaacacdabacddbdbaaccdbcdabbddabd	FALSE
dbdbdaadbadbdcdcadaaaabaacdaacddbacadaccacdbaaabb	FALSE
dccabbaadcdbcbbaaaacacbbadcaddbaadacdaaadcddccac	FALSE
ddadbcdcaaaadccccabbbacdccacbcdbcdcbcbdabbdabaabcd	FALSE
aaaaaadcaddcdbccabcdacbcabdcdabdadbdadbdbbbbbbddaa	TRUE
aabbaaccbbcbdbddcdbabcdcacccbcdbaadcddacdbbabaaabb	TRUE
aadcdadbcbaddcacbdccccccbdacaccabbaaadccbbbcababaa	TRUE
abcaabbdbcbabcbdbccdcbaccdabbdadbcdbcaaadbdcacbdab	TRUE
acaacbbabbdadcbccabdcbcdaaadbcadaadadbccdccdabbcaa	TRUE
accdbabbdabccaaacddbbadcbdcdbbabacabdcdbccacaabdbc	TRUE
adbacadbbcddcaaddacccddaaadddbbbcadcbcabbaaadbdcda	TRUE
baaababdcabdcdacabcdccccadacdbacdcabdaccaddaaacccc	TRUE
baccaddbbbaaabdaabaacabaaabcabacabaadccdabdbdcdddb	TRUE
bbadcdccbdcadcaaadbadcdabccabacbdbaaddcabdbabbbabd	TRUE
bcabdadacddcdadcbaaadcadcdddddabdcbdbadbcaabaaaccb	TRUE
bccdbddadccbbcbccbaaabddddaaacaddcaaaadaaabcbbbdcd	TRUE
bdbbcdcaacabbadbbcdcdcacbbcacaaabbabdcdcbcaaababda	TRUE
caaaccbdcddbabddaabdbccccbabaacbddadbcbddadcccdacc	TRUE
cacdbadcccbaaadbaaacaddccbabdadbcddcbbccbbadddacca	TRUE
cbbcbdbadcbcdcdcbcccdbcaaacccdcbdcabaadadacbbacadc	TRUE
ccacbadaaabbadcadbcadbcaaacddaabcabcbadddacabbabba	TRUE
ccdccaaaccbcbacdcacccddaccdbcbddaaabdccdaddbbdccca	TRUE
cdcbdddbcdbbddbbdabdabaacbdacaadcbcdaaacddcddbbdbb	TRUE
daacabdaabaaacbcdacbbabaacdbddbbbdbcdabaaacdcabbda	TRUE
dadaaacbbbdccdadbccddcacbaddbdcbaabcdbddaccadcadba	TRUE
dbcadbdaadabbcaddcacaadddcddabdddadbbcbdbadbcbadad	TRUE
dcaddbbbabdabaaacbcdaaadddadcdadcbddbddccadacbacbc	TRUE
dcdaabadbadaacdbbbcaacbbaabddadadbbcccacbaacabdccb	TRUE
ddbcbabcdabacbccdaabacbaccbcbacdaacadaaabacaaccbda	TRUE
aaaaaadcaddcdbccabcdacbcabdcdabdadbdadbdbbcbbbddaa	FALSE
aabbaaccbbcbdbddcdbabcdcacccbcdbaadcddacdbbaaaaabb	FALSE
aadcdadbcbaddcacbdccccccbdacaccabbaaaaccbbbcababaa	FALSE
abcaabbdbcbabcbdbccdcbaccdabbdadbcdbcaaaabdcacbdab	FALSE
acaacbbabbdadcbccabdcbcdaaaadbcadaadadbccdccdabbcaa	FALSE
accdbabbdabccaaaaddbbadcbdcdbbabacabdcdbccacaabdbc	FALSE
adbacadbbcddcaaddacccdaaaadddbbbcadcbcabbaaadbdcda	FALSE
baaababdcabdcdacabcdccccadacdbacdcabdaccaddaaaacccc	FALSE
baccaddbbbaaaadaabaacabaaabcabacabaadccdabdbdcdddb	FALSE
bbadcdccbdcadcaaaadbadcdabccabacbdbaaddcabdbabbbabd	FALSE
bcabdadacddcdadcbaaaadcadcdddddabdcbdbadbcaabaaaccb	FALSE
bccdbddadccbbcbdccbaaabddddaaacaddcaaaadaaabcbbbdcd	FALSE
bdbbcdcaacabbadbbcdcdcacbbcacaaabbabdcdcbcaaaababda	FALSE
caaaaccbdcddbabddaabdbccccbabaacbddadbcbddadcccdacc	FALSE
cacdbadcccbaaadbaaaacaddccbabdadbcddcbbccbbadddacca	FALSE
cbbcbdbadcbcdcdcbcccdbaaaacccdcbdcabaadadacbbacadc	FALSE
ccacbadaaaabbadcadbcadbcaaacddaabcabcbadddacabbabba	FALSE
ccdccaaaacbcbacdcacccddaccdbcbddaaabdccdaddbbdccca	FALSE
cdcbdddbcdbbddbbdabdabaacbdacaadcbcdaaaacddcddbbdbb	FALSE
daacabdaaaaacbcdacbbabaacdbddbbbdbcdabaaacdcabbda	FALSE
dadaaaacbbbdccdadbccddcacbaddbdcbaabcdbddaccadcadba	FALSE
dbcadbdaaaabbcaddcacaadddcddabdddadbbcbdbadbcbadad	FALSE
dcaddbbbabdabaaacbcdaaaadddadcdadcbddbddccadacbacbc	FALSE
dcdaabadbaaaacdbbbcaacbbaabddadadbbcccacbaacabdccb	FALSE
ddbcbabcdabacbccdaabacbaccbcbacdaaaadaaabacaaccbda	FALSE
