aaaaaaaaabcccbaabacb	TRUE
aaaaaacaaccadabdadca	TRUE
aaaaabaacacbaaddaabb	TRUE
aaaaadadbdabdcaaaabc	TRUE
aaaabbaabdaaddbaaacc	TRUE
aaaacaaaaadadcccccda	TRUE
aaaacbdadcddaacaabaa	TRUE
aaaadaacbddaadbbbcaa	TRUE
aaaaddacdcdddaacaaaa	TRUE
aaabcaadaaaabaddacdb	TRUE
aaacdaaccaaaabdcccaa	TRUE
aaadabccaaabaadbadab	TRUE
aaadcbaadbaaaaaaccdb	TRUE
aabaaacaacabaacddada	TRUE
aababadaaaccbccaaaaa	TRUE
aabbaacdaaddddaaaaba	TRUE
aabcadcaabaacaadbcaa	TRUE
aabdbaaaaddcddadacaa	TRUE
aacaaadadbaadccaadba	TRUE
aacabaaadbadacbdaaaa	TRUE
aacbaabbbaabaacbaabb	TRUE
aaccacaaaabaacaaddca	TRUE
aacdaccaadbaaccbaaaa	TRUE
aadaaaaccdccdbbaaaad	TRUE
aadaadacaadbdaadbaac	TRUE
aadaddbadacaaadaadda	TRUE
aadbcadaaaaaaadcaddb	TRUE
aadccdbdaaddccaaaaaa	TRUE
aadddaaabbaaaadaaacc	TRUE
abaacdcaadaabadaadad	TRUE
abbcddaadadadaaaaada	TRUE
acaaaadbbaaacacdaaaa	TRUE
acbaaaaaadddbcaabbaa	TRUE
adaaaaaaaabcddcaabbb	TRUE
adaaabbcaadaabdcbaaa	TRUE
adaacaaaaaaacaadcbbb	TRUE
adabaadacadadbaaaaad	TRUE
adacaabaacbccaaaacbb	TRUE
adadaaaadcaacdaadaab	TRUE
adbaaadabbaacaadbaac	TRUE
addaaadbaabaabaacbbc	TRUE
adddbaabaadbcbaaaaaa	TRUE
daaaacaadbbcaadadcaa	TRUE
daaadaadbacaaaabaada	TRUE
daabcaadaabadabbbaab	TRUE
daacdaacdddbdaaaacaa	TRUE
daadccbaaaabdacaaaac	TRUE
dacbbaaaddaaacaabaab	TRUE
dadadcacaacaadaacbaa	TRUE
ddaacbccaaaabaaadacc	TRUE
aaaaaacabdccabbacdaa	FALSE
aabaccdaccaddcdcaacc	FALSE
aacbaadaccadccbbdcdd	FALSE
aadcbacbbddbcdbadbda	FALSE
abadcacbcacbbacbbbdb	FALSE
abcaccbbdabcbacaadba	FALSE
abdbcbddbacabdccbcbb	FALSE
acacadcadadbdbbcaabc	FALSE
accacccbcdabdcbaadac	FALSE
acdadcaabbadbababadd	FALSE
adabdcdcdbacabddcabb	FALSE
adbccdbcabbddbbabddb	FALSE
adcdbbdbcbcbddbaccaa	FALSE
baaacbccabdabcbacbca	FALSE
babcaadadbacddaadbdb	FALSE
bacdbcbaaccaddcbdacc	FALSE
bbaabdbaccadbccadcad	FALSE
bbbbddbbbdbbddacbacc	FALSE
bbcdaadadbcdbbacbdda	FALSE
bbddbacccbbbcccbbabc	FALSE
bcbacabcdabcaaabbddb	FALSE
bccbddbdccccadbcdbbc	FALSE
bcddaabdabddbadcbbdc	FALSE
bdaddcbcdaaaddbaadbb	FALSE
bdcadbbbbccbdcdbaacc	FALSE
bddbddbbcbcaaccdaaac	FALSE
caadaabddadabbbcbbab	FALSE
cacaccdaacbdcbccacbc	FALSE
cadcdcccddcdbababaaa	FALSE
cbadaadbddcbdbdbdadc	FALSE
cbcacaaabbddaaabdbcb	FALSE
cbdbbdcdacdcccddbcdb	FALSE
ccacdbbcdddbbcbacdcd	FALSE
cccacdccaabdaadbdaad	FALSE
ccdbbccccbabbdddbbcb	FALSE
cdaccaacddaacdacaaca	FALSE
cdcabcddcdaadbadcaca	FALSE
cddbbbabbdbdbabadcbd	FALSE
daabdcddacacbbbbddac	FALSE
dabdadccdbcddbbcdadd	FALSE
dacdddaddacabdabbbbb	FALSE
dbabadacdbdcdabdccba	FALSE
dbbcadaaababcadbdbba	FALSE
dbcdaabcddcabbbdbcdd	FALSE
dcaabcdcacbbcddddbbb	FALSE
dcbbdbbbccdadbaacdbd	FALSE
dccddbdacbacabadaaad	FALSE
ddaaddcadcaaabddbacb	FALSE
ddbcabbcdcdadaacdbad	FALSE
ddccdbdbcccaabadbccc	FALSE
aaaaaaaaabbcdaddabadb	TRUE
aaaaaacaccdabcdaaaaba	TRUE
aaaaacaaadddaaababcac	TRUE
aaaabaaaaadbbacbaddab	TRUE
aaaabcaaaadaadddbddbb	TRUE
aaaacadaaaccaaccaaaad	TRUE
aaaacddaabccacbaaaaba	TRUE
aaaadcaaaacdaadbabcad	TRUE
aaababaaaabcdaadaacbb	TRUE
aaacaadbdaaccaaccadda	TRUE
aaadaaadcbbaaaacacddc	TRUE
aaadadadadbaddaaabbad	TRUE
aaadddbbaaaaaaaaacbdd	TRUE
aabaacbaabaaaabbcbcbb	TRUE
aabadaaadcadaaccddaaa	TRUE
aabbbdaddaacacaabaaaa	TRUE
aabccaacaaaaaacbbaaaa	TRUE
aabdcaaaadbaaaaadcdaa	TRUE
aacaabaddabaaadaaaada	TRUE
aacacbbdcaabbbdaaaaaa	TRUE
aacbbcbaaadaadddaaabb	TRUE
aaccbbaabaaaadcaacabb	TRUE
aacdaddabaabaddababaa	TRUE
aadaaacaacaaaaddaccdd	TRUE
aadaadadabadabcaaabab	TRUE
aadadbdaaaacbaadaabbd	TRUE
aadbcaabadcdaaadaadaa	TRUE
aadcbcaaaaccbbaaaadcd	TRUE
aaddcadaabaacccaaaaca	TRUE
abaadadaaddaaaccccaaa	TRUE
abcaaaacaabbcdadaaadc	TRUE
acaaaacacaadaabacdcaa	TRUE
acadaaacbaaaabaaadaad	TRUE
acccaacaaaacaabdaaaac	TRUE
adaaaaadcbaaabcbabaaa	TRUE
adaaadadcdbbbaaaabaac	TRUE
adaaddadbaadbaacaadbc	TRUE
adabddbaaaadaacdaadbc	TRUE
adadaacadabadaaddabac	TRUE
adbaccaaaacaaaacdaadb	TRUE
addaaacadddadcaaaddad	TRUE
adddadbaabdaacacadaaa	TRUE
daaaacadadbcbbdaaadac	TRUE
daaadacaabaacccaaabaa	TRUE
daabbbaabdaaaaadaddcc	TRUE
daacbcaaccdaadaadbaac	TRUE
daadcdaaadcbaabaabada	TRUE
dacdaaaaaabbbdbaaaadd	TRUE
dadadaaabadaaaaccaaac	TRUE
ddaabbdaabaaadacbcbaa	TRUE
aaaaaaddcdadbacabdaca	FALSE
aabbbbadacddbaaaaabcb	FALSE
aaccababbcbabaddbbbaa	FALSE
abaaaabcdabdccbaacbda	FALSE
abbbbacdbcccadabbbbaa	FALSE
abcdadbcabcbabbdccdab	FALSE
acaacabddbddcaadcdcab	FALSE
acbbdabacccaabbbcdbdb	FALSE
acccbadadabaaaaacddab	FALSE
acdccbcbbcdacdcaaddac	FALSE
adbaacabbcdadbcbaddaa	FALSE
adcbbdcbdddbcbcdcdcad	FALSE
adddaaddaacdaacbbcbbc	FALSE
baaddcbdbbbdcbaaabdda	FALSE
bacacbcadcacbdcaaccca	FALSE
badbbddabccacdacccdca	FALSE
bbabcbdcbdcdcdbacaabd	FALSE
bbbcabcbcbabcdcddcaca	FALSE
bbccdaabdddbadbabddbc	FALSE
bbddddbaabcbccbdccaac	FALSE
bcbaddbabcdabaaabadac	FALSE
bccbbabcbaaaaadababca	FALSE
bcdcbbbcbcbacbdbddbaa	FALSE
bdacdbdcadcadcbbcdccd	FALSE
bdcaccbacddacabbbdcba	FALSE
bddccbacbabaaacacbacc	FALSE
cabacbdbdddacbaaacdca	FALSE
cacbbaaabacbaccadbada	FALSE
cadcdadcdbaadcacccdbd	FALSE
cbbadcadababcbadbaada	FALSE
cbcbcccadbddddbaccddc	FALSE
cbdcdcbabdbcabcbcdcdd	FALSE
ccbabbbdcbcdcbaddabcc	FALSE
cccaddcbdbbbdaacaaccb	FALSE
ccdcaadbdcbddbccdcadb	FALSE
cdaddbcdddbbdccbbaccb	FALSE
cdcbbbbcddbdbbbccabcd	FALSE
cddccaaddbcdbabbcccca	FALSE
daadbacdabddadadabbba	FALSE
dacabcabbbdaacccacabc	FALSE
dadbccbdaccccaacababc	FALSE
dbadacbbbbddcbbdddabd	FALSE
dbbdadccddbdadcddadad	FALSE
dbdbaaabcccbcdbddaacc	FALSE
dcabaaabdabbadcbbadbb	FALSE
dcbbdbaabbabaccdddccb	FALSE
dccdccccaaacdccadbaca	FALSE
ddabaaaccbdcbcacaddbc	FALSE
ddbccbddadddbcaabbaac	FALSE
ddcdadabbbadcccbbbdbc	FALSE
aaaaaaaaaaddabbccacccb	TRUE
aaaaaacdaabdabbbbcdada	TRUE
aaaaadacccbaaadadadccc	TRUE
aaaabbaaccccbccaacdaad	TRUE
aaaacaacadacccccdcaacc	TRUE
aaaacdadbababaaadacaab	TRUE
aaaadbdcccdadaccdaaaab	TRUE
aaababdaadcddaadaacdaa	TRUE
aaacacaacabaaaaacaadba	TRUE
aaadaadaddaabdaccdcaad	TRUE
aaadbbddaadccaaaacdaab	TRUE
aabaaabcaaaadacdbdadda	TRUE
aababaabbaabcadaccbcaa	TRUE
aabbaabbdaaccaadbbadda	TRUE
aabcaaadadbaabadaacabd	TRUE
aabdaaabacaaaabaadaaab	TRUE
aabddbcdadadaaadaaabdb	TRUE
aacaacaadcadadbacaaada	TRUE
aacadaaaaabcdadacacddc	TRUE
aacbcaaaddadaabdaddacb	TRUE
aacccaaaaabccdccaacdaa	TRUE
aacdbaaddcaabaadcadacc	TRUE
aadaaaddacbcaaadaacaba	TRUE
aadacaacbadaaaabccadad	TRUE
aadbacabdaacaaacbadaaa	TRUE
aadcabccaddddaaaaadaab	TRUE
aaddaddaaacccadabbdbaa	TRUE
abaaaadadaddadbadaadda	TRUE
ababadaaabaaaadcdaabad	TRUE
abbdbdbaaaacacdaaaaada	TRUE
abdcbbcaaabaaaaaacbada	TRUE
acaadadaaaadbbaaabbcaa	TRUE
acbcbaabadabcccaaaabaa	TRUE
acdcaaaaabbbaadaadaaab	TRUE
adaaacddaaacaaadbbccaa	TRUE
adaadadddbaaabbbaabbaa	TRUE
adabcccacadaaacadadcaa	TRUE
adaccaadaaddcaacbddcaa	TRUE
adadccacadacbaacadaaac	TRUE
adcaadddaaabaadaaaacbb	TRUE
addaccddaabaabaaaadcbc	TRUE
daaaaaadcaaaabaccdddcd	TRUE
daaaaddadaaabaacccbcaa	TRUE
daaaddaddaabaabdcabcaa	TRUE
daabdbbadaadaddddbaaaa	TRUE
daadaabaabacaaadadbacd	TRUE
daadddddaaccaadbbaacaa	TRUE
dadaaaaacbadbdabaadaaa	TRUE
dadbcaabaadbaaaaaadbdb	TRUE
ddaacbaaadaadbccaaadac	TRUE
aaaaabbcbbcdacadbaddba	FALSE
aabbabccacabaababcdcba	FALSE
aaccbaaaddddddcbabdcad	FALSE
aaddbdabbacadbbacdbddb	FALSE
abbaaabdacabbcbcbdaadc	FALSE
abcabbcdababbbddaaddba	FALSE
abdacdddcbddacccddacdc	FALSE
acacbcdbdcabcddbdbcacc	FALSE
accaabccdbaddbcbdabddd	FALSE
acdbdbdcdcabcbaaadabba	FALSE
adaddcbbaaacdbcbccddbd	FALSE
adcbbcdbaacdcdbbaaacad	FALSE
addcccbdbadcaaabbdadad	FALSE
baadbddcaabdddaddaabcd	FALSE
bacabbcddcabcbcbbdabad	FALSE
badadbccdcadbbadcacbdb	FALSE
bbacbdcabdcdddacdacdba	FALSE
bbbdabcbcaadddacbddcbd	FALSE
bbdacadaaccbcdccccddbb	FALSE
bcababccabbabccbcbddcc	FALSE
bcbbbbbdcdcbcddadaacda	FALSE
bcccbdbadbbbccbcdaabbb	FALSE
bcddbcdaaadccaddcbaccc	FALSE
bdbacdaddcacdaccaaaabc	FALSE
bdccbadbcadbbdbaabdcab	FALSE
bdddcddbabbbbacbdadbdb	FALSE
cabbdcddccbdaacbadabdc	FALSE
caccbbddcccaadacbddabd	FALSE
caddccdbaadaccdbddcbbc	FALSE
cbbbaccdcbcdcbcabdaddd	FALSE
cbccbdddaadcdaaabcbaba	FALSE
cbdcdadcdbbbbcddcabbab	FALSE
ccadcddcadabbcabcdcaab	FALSE
cccbcbaabcbccbbcbacdac	FALSE
ccdccadcaadaddbacbdaca	FALSE
cdadddabddccacccadacdd	FALSE
cdcbbdbbccbadabbadbbaa	FALSE
cddbdabdaccddaadcccaab	FALSE
daadbadbcbccbbccdddabd	FALSE
dabdcdbaddddcdbddccddb	FALSE
dacddacbcabaaccadcadad	FALSE
dbaadaacdadcddbcadccbb	FALSE
dbbcbadbacbadcabdaddac	FALSE
dbdaadbdaccdccbaabccba	FALSE
dcabaccaddcbccccbbadcc	FALSE
dcbbdcbcabaadcadbbdcbc	FALSE
dccdcabcadbbbbbddabbba	FALSE
ddaacbdacccacdbbdbbbcc	FALSE
ddbbcbbdaabbaacdcbaabd	FALSE
ddccddcdacdaddbdddcbdb	FALSE
aaaaaaaaaababcdbabaddac	TRUE
aaaaaadcaaabccaaadbccdc	TRUE
aaaaaddaaadadaccadaddac	TRUE
aaaabdadacaabdaadbaaadb	TRUE
aaaacbdaadcdcdcbbbaaaad	TRUE
aaaadbaaddbbbaaabaadddc	TRUE
aaabaaddccdbdbaabadabaa	TRUE
aaacaacccaaddcdaaaadcab	TRUE
aaadaaaadaadcabcaccaaaa	TRUE
aaadadaaaaabbaddbcacaac	TRUE
aabaaaaaaabcccdddbdacaa	TRUE
aabaacdcbdcbaabdadbaaaa	TRUE
aabadcaaaaadcbcdaacdbaa	TRUE
aabbddadadaabbaadbdddaa	TRUE
aabcdcddaadcbacadaaaada	TRUE
aacaaaaababbaaabaabdcbd	TRUE
aacaadadcdcbaadbcaaaaab	TRUE
aacaddacaaaddacbcaabcca	TRUE
aacbdaaccbdaadbaccbaaaa	TRUE
aacccdbbaabbbaaddaaaacc	TRUE
aacdccdaaaaaddacaaacdbb	TRUE
aadaabddcaacdbadaaadccd	TRUE
aadadaaacccbabaadcbaacb	TRUE
aadbbccbccbaacdcaaaabaa	TRUE
aadcbaaadbbabaadcaaaadc	TRUE
aaddbccaaaacbbddbbaaaad	TRUE
abaabdabcbdbaaaaaadcada	TRUE
abbaddadaacccaadaabcaaa	TRUE
abcdaabdaacdcaabdaaadab	TRUE
acaaacdaadaaaacccaaaabc	TRUE
acaddacadadbaadaaaadaac	TRUE
accdaaaaaabacdabccaaaab	TRUE
adaaaaaccaabdaacddbcdaa	TRUE
adaaadccdaaaaaaddabdcca	TRUE
adabaaccdadadaaadcdaaca	TRUE
adacabdaaadabacbadaaaab	TRUE
adadaaddcdadaacdaccaaaa	TRUE
adbaacbcaaaaaabcdcddada	TRUE
adcdddaacbbaddaaadbaaaa	TRUE
addbaaadabaabcaaaaabbab	TRUE
daaaabcadaaadacbcbaadbc	TRUE
daaadaaacaacbdaacabaadc	TRUE
daabbaddaaaaaaadbccabab	TRUE
daacacaabdaaacaadbbccaa	TRUE
daadaaadacadaadcadcdaac	TRUE
daaddbaadcddaaaacacdada	TRUE
dacadcdcdaadadaaaaaaada	TRUE
dadabbdaaacdaaaacadabbb	TRUE
daddadaacbcaadbadabcaaa	TRUE
ddaaddaaaaabacadacaadcc	TRUE
aaaaaaaaabacbadccddbcdd	FALSE
aabcbbbacbdadcabbcdbdca	FALSE
aacdcaacacbaabdaabcabcb	FALSE
abaacacbcaaaaacaddbbcba	FALSE
abbcbccbbdcbbdcaccaacda	FALSE
abcdacccbbcbacccdcbdacc	FALSE
acaabdbaacdccaaacacdbcc	FALSE
acbbadcbabccbcadacbcadb	FALSE
accbddcabacdbcbcddbaccd	FALSE
acddbabcaabcbaccaddaacc	FALSE
adbbaadcccbabaaacddcdaa	FALSE
adcbcaabddcdaccdddabbbd	FALSE
addcccdaadbbccacbbbbbdd	FALSE
bababbdcbdbbdbabcaccacd	FALSE
bacbbdddadacbbabcaacdaa	FALSE
badcababbdbcbbcbddadaba	FALSE
bbadcacdbdddadbbcaccacd	FALSE
bbcacbddccdbbdbdcbdbbaa	FALSE
bbdbbadbcbabcdbddcccaad	FALSE
bcaccdbbdbdcbcddaaaacab	FALSE
bcbdbccbbdbccdaaabddbca	FALSE
bcdabdacbaabbabbbdbcccb	FALSE
bdabdaabacddcdcbacdaaac	FALSE
bdbcbdddcddbddcdbddaaab	FALSE
bdccdcdaccdaacddbccdbab	FALSE
caaacacaacdadcdccacdada	FALSE
cabbaacaddbabcbcbdcdbdb	FALSE
caccdbcadacddbcddaaccab	FALSE
cbaadadababbbcaabdabacc	FALSE
cbbbcbddaacdccdadbaaddc	FALSE
cbcdcdcbcabddbdcbaddbdb	FALSE
ccaabcacadcdbcbaabaaaab	FALSE
ccbbcabcbaabaabcdbccccc	FALSE
ccccccabdbbaabdcbcddbbc	FALSE
ccddcaabacabbcabbcbdbad	FALSE
cdbaadcbaabbddaabbacdcd	FALSE
cdcacdbcbcddbcbbddbdbab	FALSE
cddaccdccadbacacdddcbad	FALSE
daacabaaaddabbdcbacbaab	FALSE
dabcdabacddddbbaccbbcdc	FALSE
dadaadcacaccaaadbdcdadd	FALSE
dbabbbabbbbcabcdaddbcdd	FALSE
dbbdbbbaccadcddbcabaaaa	FALSE
dbdaadddcddadcdbdccdbdd	FALSE
dcabbdaacacbbcdaddcdcbc	FALSE
dcbcccdcdcadaddcbdcbacc	FALSE
dccdccbadaccabcaacdadbb	FALSE
ddabaadbcaacbbccaaabaac	FALSE
ddbbcabdcaaadbdcbabaddd	FALSE
ddccdbccbcadacaadadadda	FALSE
aaaaaaaaaabddbdadcdcdacd	TRUE
aaaaababadcaacaaaaabdacb	TRUE
aaaaaddcdcdddbaaaaadaacb	TRUE
aaaabdaaddaabcabadcdcdaa	TRUE
aaaaccbcadaccaacaacdccbb	TRUE
aaaadcaadcbaaaacdccddcdd	TRUE
aaabbbaaaaaacccaacacaada	TRUE
aaacaadadbaaabbdaaaddadd	TRUE
aaadaabadcaaabaadbaaadac	TRUE
aaadbccaaaaddaaaaacaccda	TRUE
aabaaadaabcaacbabaddcaac	TRUE
aabacabbdaaacaadbadabbaa	TRUE
aabbbaadbdabdaaadabbdcaa	TRUE
aabcbdbbaabaaaabbadacbda	TRUE
aabdbaacbdbdaaaddabbdaad	TRUE
aacaacaabccadadabdaababb	TRUE
aacadaaddaacaccacaaddaac	TRUE
aacbbdaaddacaabdacdaaaac	TRUE
aacccaaaadbaabadaddcbacb	TRUE
aacdbaadbabaaccaaabdbdaa	TRUE
aadaaaccdadaadaabbdaaaad	TRUE
aadabdddaabaabbbbbadaaaa	TRUE
aadbbbaaacdbdaaaaabdbaac	TRUE
aadcadadddaaaadcdbaabbba	TRUE
aaddadaccddaadccdbaabdaa	TRUE
abaaaaccdaabaabbcdadabbd	TRUE
abacaababadaacaaaaaacabc	TRUE
abbcbcacccdaacadaaaaaaab	TRUE
abdaacaaaadcbaaabbabcaab	TRUE
acaabbaabbdaabaaaacbdbad	TRUE
acadacbccaadaacaaacbcaab	TRUE
accaabaaaaaaacdbcbbaaadb	TRUE
acdcddaaabaacadacaacabaa	TRUE
adaaacdbadacccdaaacaaaaa	TRUE
adaadbacbccaacaaadaccaac	TRUE
adabdaadcacacdccadaaabaa	TRUE
adaccddaadccbbaadaaadadd	TRUE
adadcdbdadacaaddaabbdaac	TRUE
adcaaaaacaaabcdaabadabda	TRUE
addaabbbdcccaddabaaadaaa	TRUE
adddaadaaabcbdcdaddabaaa	TRUE
daaaacddaaaaabbbbdbadacb	TRUE
daaaddaaaaacaaaacbdacadd	TRUE
daabdaaaccaadcaaaababcad	TRUE
daaccdccaacacaaadcbaabaa	TRUE
daadbdbadadaaaaaddcbdaaa	TRUE
dacaaaacaaddcbbadacdaaba	TRUE
dadaacaadbdcaadacaaaddac	TRUE
daddaacacabbcaacaaaaaadc	TRUE
ddaaccbdaaaabbaaccdaddda	TRUE
aaaaacbccdccbacbabdcbdcb	FALSE
aabbbacdcaacbbcdcbdddccb	FALSE
aaccdcdddbdbbdbcabccbbba	FALSE
aadddabadaabdccadacaadad	FALSE
abbacadbaccbddbaaabbdaaa	FALSE
abcccabdacabaaadccdcbccb	FALSE
abddbbdbabdbdcbadacabdca	FALSE
acbadbcadabbabaabbacdccb	FALSE
accbabccbcabcdddbbdbbbca	FALSE
acdccaadaaadbcbccccaacbb	FALSE
adadbcadaabcbbaaccbadcdc	FALSE
adcbaabadbcbcddcbcddabda	FALSE
addbcabddccaabddaaadcaac	FALSE
baadbcadabcacaadbcaaddcc	FALSE
bacacbddcaacccdacdcbdbdb	FALSE
badbddbacbdbaccacdbcddca	FALSE
bbaddaaddcaaaddddcabcdab	FALSE
bbcacbdbcaaaadaaaaacbaca	FALSE
bbdbaacdaaaaaaadddddbdad	FALSE
bcacbbbbbcacdcaacbbaccbc	FALSE
bcbcdbaaaddababbcadcabaa	FALSE
bcdaabcbadcddcbacddbabca	FALSE
bdaaddaabcbabcabcbddadba	FALSE
bdbbbdbbbbcbaaabdabaacbd	FALSE
bdccdbbcacdabaadbdcbddaa	FALSE
bdddbbbbcacccddaccbcdcaa	FALSE
caadcddacbdbadddddbdcacb	FALSE
cacabaddcaddccbdabdaabcc	FALSE
cadcaddcacbadbcbacbaadda	FALSE
cbadaaddbcacaaababbdbbac	FALSE
cbcabbdaadbaaccbccbbccdb	FALSE
cbdbdabbcbacacbcbadaadcb	FALSE
ccaccdbbbcaabbcddaadcbad	FALSE
ccbdddddadbccdbbcbadbbbb	FALSE
ccdbadbbaababdadbadbabad	FALSE
cdacbbbcccaaadbaabccdadc	FALSE
cdcaaadababbabbabdddbdbd	FALSE
cddbbdaaadabbabadddcdabd	FALSE
daacaccddadacdcabaccdddc	FALSE
dabdbbabccdddababaddadda	FALSE
dadadcdbabdaacdcadaadcab	FALSE
dbacdbdcddbdcacccaaccbcd	FALSE
dbbdbbdddbcbbcbccbbbdbba	FALSE
dbdbbaccadbccdbcbdbabddd	FALSE
dcaccdcddddbdbbadacbaadb	FALSE
dccaaaabbdbdccadcabdbcad	FALSE
dcdacdbdbcbcdbcddabbcadb	FALSE
ddabcdbbccbcacdaabcbbbac	FALSE
ddbcbdaddbcabcbbccddccda	FALSE
ddcdcccdbadbcacdcaaababa	FALSE
aaaaaaaaaaaadccbaccbadcba	TRUE
aaaaabaaadaaabbdaabddadbd	TRUE
aaaabadacbdaadbaaacbaaccc	TRUE
aaaacadaacbdcaaaabaccbcdc	TRUE
aaaadaabaaddddadbbabdbaab	TRUE
aaabaabaabccbbaddacdccbaa	TRUE
aaacaaadbbdaabadacdadaacb	TRUE
aaadaaaadbddaabacaacaaabc	TRUE
aaadadcbaacdaaadaacaaabab	TRUE
aaadddabcbbadacddbddaabaa	TRUE
aabaadbcadbbddaaaacbacbaa	TRUE
aabadbdbddacdaabcaadaacaa	TRUE
aabbdaaaaaabcddbcdbdbadad	TRUE
aabcdbdacaaadaaabcaabbabb	TRUE
aabddaadddcddaadcaabaabbd	TRUE
aacaaddaadbcbccdabdbaaaad	TRUE
aacbaadbbabadaaadaaaaaccc	TRUE
aaccaaaccacdbcdaabaaaaccc	TRUE
aaccddbcaabcdadaaacccdaad	TRUE
aacdccdbdadaaacdcbaaaadda	TRUE
aadaabdcabcaaadddbcaaddaa	TRUE
aadadabddaaaddadacaadacbd	TRUE
aadbcadabaabcaccdbbdaaaab	TRUE
aadcbcaaaabbbdadaacabaaca	TRUE
aaddbabbaacaabdbbccaaaaac	TRUE
abaaadbbbbcbbaaadadaaaadd	TRUE
abadcaadcaabbaadaaaccaabc	TRUE
abcaadbbaacbdaabcddbaaaab	TRUE
abdbdcddaabaaaabbdaadaabd	TRUE
acaadaadadaaacacddbabbcaa	TRUE
acbaaddaacaddadaaadaacdbd	TRUE
accdaaacbdaaaaccbaaabaaac	TRUE
adaaaaabcabbabaacbccccaab	TRUE
adaabaaaaadaacaacccaacbbd	TRUE
adabaaaddaaaccacbcadaddca	TRUE
adacaaaaabaacddacdcbccaaa	TRUE
adacdbdadadaabddcbaaccaab	TRUE
adaddbcbaacbcaaadacacaadd	TRUE
adcacadbdbaacaaaaadabcbaa	TRUE
addabdddbbcadadddaacaacaa	TRUE
adddadccbaadcdcdaaaaaaddc	TRUE
daaaacdbaadadcdaaaabaaadd	TRUE
daaaddabdddbdaadaaadbbaac	TRUE
daacaaadadcbdcabdaadaadbc	TRUE
daacdccacdcaaaabdbaabaabc	TRUE
daaddcbabacaadacbacaaaaaa	TRUE
dacbacbacaaaaccaabbaadaad	TRUE
dadacaabaadabbaaaaacddbdc	TRUE
dadddcbbacaddbaaaaaaaaaad	TRUE
ddaadcdbaadcaadcaabdcddaa	TRUE
aaaaaadabcbbcddbdbabcaacc	FALSE
aabbdccdbcdaadaccbbadaadc	FALSE
aacdabddbbddacdaaddacdcaa	FALSE
abaaacadacaccccbcddcadbab	FALSE
abbaddbdddbbdcbaccbaddaaa	FALSE
abccbaaccaaadbcdcbdccbccd	FALSE
abddcabddcdcbdaadbcadcaac	FALSE
acbacacdbcaaccabdaadccbbd	FALSE
accbcbdbdadcbabcbccdacabd	FALSE
acdcdbcadcabdcabddbdacabc	FALSE
adaddbcadbbcaaccbadbccdbb	FALSE
adcadbbbaccdbcdcdcbdcdbad	FALSE
addcabdbbcdabccabacdacbdb	FALSE
baacdbbabbcadabbddaadcdda	FALSE
bacacbbddbcbcbcccdbdcaccb	FALSE
badcbbdbddacccbbabdcbaccb	FALSE
bbacdabbdadcccadcdcbaacbb	FALSE
bbcaabbddccbcacdbbcddbbbd	FALSE
bbdacdbcacdbaaddcdbcacaab	FALSE
bcadbbcaddadadabcbaaadadc	FALSE
bcbddabbaacabbdbacddcbcdb	FALSE
bcdbabbcddadacbcbdacdcdcb	FALSE
bdacbabbdbcbbcbcaaccbaddb	FALSE
bdbdccdabcccdddbccabbddbb	FALSE
bddbadcccddabccabdbacdbaa	FALSE
caacadcbcacaadabcbdcbdada	FALSE
cabdaacdbdabdbbcbbcdcaadd	FALSE
cadaabbadcacbabacdcaadbda	FALSE
cbabbadabbbdabcdbbdaccccc	FALSE
cbbdbdddadcbcdcbbddbcdbcd	FALSE
cbdbcadacacacbcaccbbabaac	FALSE
ccacaadaabacaaabbccbabacc	FALSE
ccbcccbbbdaddadcaddbddbdd	FALSE
cccdbdbccddcbcdbbdcbdcbca	FALSE
cdaabbcdacacacaccbbdbbada	FALSE
cdbaddcddacdbbdbabdcabddc	FALSE
cdccabbbbccacbdbdbbbcabad	FALSE
cdddabdacadaaaaddbdddcbaa	FALSE
dabadbdbcdbbadcaabbbddbaa	FALSE
dacdadccbcbddacdddaabbcba	FALSE
dbaabdabddabaddbcdabbbdbb	FALSE
dbbaddddbbdcaaabcdbabbcbd	FALSE
dbcbacacdbcdbadaccdcbaabd	FALSE
dbdcdaccbbbdcdccaaadbcbca	FALSE
dcadbcbcbcdbbcadbddbcabcd	FALSE
dcbdbbbbabdabcdcaaaddbadb	FALSE
dccdbacbdacdbcbbbbabdaaaa	FALSE
ddaabdaaadbacbadcadbcbcbd	FALSE
ddbbdbadddcdcacacbaaddcdd	FALSE
ddccaccababcaabadcbdcbdaa	FALSE
aaaaaaaaaabcdcbdcdbcbdadda	TRUE
aaaaabdcaadcaadcccdcadacdd	TRUE
aaaabbaadabbcaaadabdaaddad	TRUE
aaaacaccddaacaaddccacdaadd	TRUE
aaaadadcdbcaadaacdccdbddaa	TRUE
aaabbaaabddabaacdbaadbaadd	TRUE
aaacaadcdbaaabbaaccacaaacc	TRUE
aaadaacadaaaddaccacaacdadb	TRUE
aaadbdaaaabddcdcaccdaaaadd	TRUE
aabaaacbcbadccaadbaadaaadb	TRUE
aababcaddacbaaaabdcdbaaabc	TRUE
aabbababdddaaaaaaaabaabbbb	TRUE
aabcacaabaddaccdcdcbaacaad	TRUE
aabdadabaddccaaaaddaaddaca	TRUE
aacaaacbaabbababbaabdacaab	TRUE
aacabcaaadabdaacbccdbdaacd	TRUE
aacbbaabcbacbdcbbaaaaadaac	TRUE
aaccadcaabbcddaaadabbdadab	TRUE
aacdadcbaabcaaadbcacaaaadd	TRUE
aadaabadcbdbcdcdbdaaaaaaab	TRUE
aadabcadadbddcaacaaadaaacd	TRUE
aadbadaabdcaadbdaaccadaccd	TRUE
aadcbaaaadbacdcababdaaaadc	TRUE
aaddadaaddadbabdbcaaadddda	TRUE
abaaadbadabcaadacadababaac	TRUE
abadaaaaabaadaacddabcdaaaa	TRUE
abbdcdaadbcbbcaadaaaaaacaa	TRUE
abdaddbcbaaaddacaabaaaabcd	TRUE
acaadaabaadbadbaacbccdaaaa	TRUE
acbaabdcaacbaadcdbbdaaacaa	TRUE
accacaacacaabaabacaaddabaa	TRUE
acdadddcbbddbaaaaaacaabaad	TRUE
adaaabbcabcacaadaddabaccaa	TRUE
adaadabaaadbaabbdadbaadbad	TRUE
adabccdaadcabaaaccaabcaacb	TRUE
adacdaadcdadaaaacbbcddcdaa	TRUE
adadcddaaadadadaaacdacbcad	TRUE
adcaaaabdaadddcbaaabccdaab	TRUE
addaabddcaaaadadaabaacdbca	TRUE
addcaaabbcaaaabaadbbbbaaac	TRUE
daaaaccaaaacccccbabaadcadd	TRUE
daaadacddcbbdbdbbadaaddaaa	TRUE
daabbddaaaacacaacaabbcbdad	TRUE
daacadabadcacbaababdadadaa	TRUE
daadacdaacbabbcddcaaadaaab	TRUE
dabaaaccaadaacdcdabbaaaaad	TRUE
dacadacdbdaabaabaaaabbdaad	TRUE
dadababdccaaccdbcaaadacada	TRUE
ddaaaaccbcbcaaaabbbdadcaad	TRUE
ddabcbacaaaacadababbadaada	TRUE
aaaaaaddccddcbcbdabcddcbbb	FALSE
aabacdcbadcbdadccdbdcbacdd	FALSE
aaccbbacdbbabbaaaccbdddaca	FALSE
aaddbbdaccddadbdccdcabdbca	FALSE
abbacaddadaabaacdbabddcacd	FALSE
abcbcbcdbccdbddadababbccaa	FALSE
abdcdcdadabdabaabcdaadbaca	FALSE
acbabcccaabcdbaaacadbccbbc	FALSE
acccaadcbcdbbabdaacabcadac	FALSE
acdcbcddcaabdbccbcbbdaaddc	FALSE
adaddccccccaaddddabcbbdbbc	FALSE
adcabccdabbbcddbabcddcccbc	FALSE
addadddcbddcddbbbbacaaadcb	FALSE
baaccbbcbccadcabcaabbdaadd	FALSE
babdbadccadbdaddabadddccdb	FALSE
badadbddbabdcdaddcbacddbdb	FALSE
bbacbbcddadddaadbadddaccbc	FALSE
bbbdbbdbdbcbcbabbcdbddbacc	FALSE
bbcdcbcbdbaabbbbabdddbbbaa	FALSE
bcaacacbcdaabbddcbaabddbdb	FALSE
bcbbdbbaabcdadadacdcbcbcba	FALSE
bcccdcbccbdbaabddbbcccadcc	FALSE
bdaacccdcdbdbbbadcddbcadbc	FALSE
bdbbbacacdddbcbcaaabadaddb	FALSE
bdcdaaaaccdaaadcdacddbddad	FALSE
caaabcbcaadaccddbdaaaacadd	FALSE
cabadacadaadcaabadcbadcbdb	FALSE
caccaacabbbbcccabcabcaacba	FALSE
cadcddccbabbacaddcacaacaba	FALSE
cbaddccbdbdbbdcbacbdcddbad	FALSE
cbcbacdabbcddbccaddccaadbb	FALSE
cbdcbacbdcabddbdcdddbccbbd	FALSE
ccaccbdabccaabdbadaabdbbad	FALSE
ccbdbcdbdbbcadbacaddcaccac	FALSE
ccdaabccaabbabbbdaaacbcdbb	FALSE
cdabccbbadcdbaadacbaaacbba	FALSE
cdbdddbdcabcbbbabbabbdbbcd	FALSE
cddbbdbabaccaadbccdabcaccc	FALSE
daacdccdadbadaaccabdadadda	FALSE
dabdcaddcbdcdcdacbbcaadcdb	FALSE
dadabcaccabbbbdacdbcdbabba	FALSE
dbabaabcddccdaddcbcaaddadc	FALSE
dbbcbaaadcdaccabccbabddcdd	FALSE
dbcdbbdddbacddabdbbacbaaaa	FALSE
dcababdbadccbaaacdbaccabba	FALSE
dcbcddcaadaddcbdcbbcbacacc	FALSE
dcdaaccdcabaacdacdccbbbbba	FALSE
ddaabcdcabdaaadbcddaaccabc	FALSE
ddbbbdbbcbdaddddbddacdacba	FALSE
ddccbbdadcdbbcccbababbabab	FALSE
aaaaaaaaabcddabddaabacacdad	TRUE
aaaaacaaabccbddddcadddaabaa	TRUE
aaaabbcbaaaabbaadacdaccbcdb	TRUE
aaaacbcaabaaaddadcabcdbbcdc	TRUE
aaaadbdabaabbbdbadabcdaddaa	TRUE
aaabcabaddacaababaacddaadcb	TRUE
aaacbaaacadcdaabdbddbaaaaca	TRUE
aaadabaaacdbadbaaadbdadabdb	TRUE
aaadcbbbbdbaaddbcaabcbaaaab	TRUE
aabaabdbaddcbdabaaaabccdcaa	TRUE
aabadbabadaaaadaabbdadcaabb	TRUE
aabbccdaaabaaccccacaaadabdd	TRUE
aabcccdddadaadaaadaadcddabb	TRUE
aabdcbaabaadcaadbdadadbbaba	TRUE
aacaacaccdbaaaaabbacccbccaa	TRUE
aacadaaadcbbadcbacaddaaabbb	TRUE
aacbdacadddbbacaacbcaacaaaa	TRUE
aaccdaaccbccdadaccaabcdbaac	TRUE
aacdddaaaaaaddaadbccacbdcdb	TRUE
aadaadbdddaadaccdcbcdaacaaa	TRUE
aadbaaaacadcbaacddabadaaaac	TRUE
aadcaaadbdaddadcaacdadaaadb	TRUE
aaddaaaccaaabbacadaadaacdbd	TRUE
abaaaaaddadcdbacacaacaddaac	TRUE
abaadadabbbcdabadaddbaaaabb	TRUE
abbaabadaddddaadabaaaadddab	TRUE
abcaacbbcaaaaaababaacdbbbdd	TRUE
abdabcdaaabdaaaabddaadbcada	TRUE
acaaaddaabdcdccddaacdadadaa	TRUE
acacdbdcaaaabbcdaaaadbdabaa	TRUE
acbdcaabcaabdaacadaadcdacaa	TRUE
acdaacdaacdbaadbccadaaaaadc	TRUE
adaaaadcdbacbbdadaaabdbaaaa	TRUE
adaacccaaaaaadcdaaaadbacaca	TRUE
adabbdcdaaaacccbadadcdccbaa	TRUE
adaccbdbcadaaabbdaddaacaabd	TRUE
adadcdcabbcaaaaaaabadabbbaa	TRUE
adcaaadaccbcdccacbaacaaaabd	TRUE
addaaadcaaadadcaaacabbcdbba	TRUE
addbbbbddbaaaaccccbaacaaaad	TRUE
daaaabbaaccbaddacdbadaddbbc	TRUE
daaaccaaadcaabbdcaadcdadaab	TRUE
daabbddddaaaaaaababdbbcdaaa	TRUE
daaccbaaaaabdcbadabacaadbbb	TRUE
daadbdaadaaacabaabcaabbacdc	TRUE
dabcacaaaaadbdaccbaaabaaaac	TRUE
dacdaaddaaaaaaddaaddcabbdba	TRUE
dadadbbbaaaaaabdccdacadaccc	TRUE
ddaaaadcaaaccdbcaaaadcabaac	TRUE
ddabcdaacaabadadaabbcbcaaab	TRUE
aaaaabdabcdabadbccddccadbaa	FALSE
aabbdbdbcabddbaacbaabdababb	FALSE
aaccddabbdbcdccbbbdddacdbbc	FALSE
aadddabaccaacbcbaadbaddaccd	FALSE
abbbacdcaacbbaadbcaacddadcd	FALSE
abccbdbaaacdacddbcdbcbadaab	FALSE
abdddabdcadabddabbbaacdaddb	FALSE
acbabdcbdcaacaadbdadabaaadb	FALSE
acccaabbaaadadddbcccacdcdad	FALSE
acddbdcbcdcbdababcadcdcaadb	FALSE
adbbbbbdcbbaadaddbabaaadccc	FALSE
adccadcdaadbdabddcbadbbbccb	FALSE
adddbadbabcbddbdbbacbdaabbd	FALSE
bababddacbbdcaaadbcdcdcdcba	FALSE
bacbaccbbcbadacaddbadacacbd	FALSE
badcabbdadcacacbacaccddacdd	FALSE
bbadddcaddcbbdccdbaaabacdad	FALSE
bbccbdbdcacdacddaacacbcbdac	FALSE
bbddbacacbcdabbccddaacabcab	FALSE
bcbacababdcccbddabdcbadccdc	FALSE
bccbdcbacccbccdbcbdacbcacca	FALSE
bcdcbbcbcabcdaccccaccccadbd	FALSE
bdacdcabcbcbcaaaabbcdbbdaca	FALSE
bdbdbacdbcabccccdcdacbbbbab	FALSE
bdcdcbacdcbccddadbcbdbbdaca	FALSE
caaaddbdaccbcccabaadadccabd	FALSE
cabbdbcdbcaacadcdacdddccabc	FALSE
caccadbcbadaddaddccdbbddaad	FALSE
caddaabacbbcccbabdcaabadaaa	FALSE
cbbabdadcbdcbdddccdacddcddd	FALSE
cbcbaddbaddcdcccdbdaaaabaaa	FALSE
cbdbdbccaabacdabcbdabbdbcda	FALSE
ccacdabababdabdcbbdcadacdaa	FALSE
cccaabddabcacbcdccddbbcbcac	FALSE
ccdadabcddccdbbdabdbbabacbc	FALSE
cdabcbbcbdaccbdcbccadaddbcb	FALSE
cdbdababcdcaadbcbabdcaabdab	FALSE
cddacdbccddcddadbccadbbddac	FALSE
daabdabbddaaaacbacaabdabaca	FALSE
dabdaaddadcadddddddcbddabcb	FALSE
dacdcdcacccbccabdbdacdbdaca	FALSE
dbabaddaccacbddadacadcdcccc	FALSE
dbbdabddbbdbdadaaaaadabbdad	FALSE
dbdacbbdbdabbbbcabccbbaabcd	FALSE
dcabbacdbccbbbbcdbddcbbabdc	FALSE
dcbcbbcdddadbbbdbccaabddada	FALSE
dccddcbacacccdaabdbdadbcbbc	FALSE
ddaacbadadadcadcddbcbbccddb	FALSE
ddbcbacadcadadcdabcccddddcd	FALSE
ddccdddbaadcbcdbddbcbbbbbda	FALSE
aaaaaaaaabcacdccdaacbddacccd	TRUE
aaaaadacadaccadabcdbccbbbddd	TRUE
aaaabdacabaddadaadcbcbcdaabc	TRUE
aaaacdbdaabbcdaaaadbdaadddca	TRUE
aaabaaaabccabbdcaaaabddacbad	TRUE
aaacaaccdbaaacaaddadacbbbdcd	TRUE
aaadaaacdbbabcbaabacdcdbaabd	TRUE
aaadbcadccdbbaaaaadabcccadaa	TRUE
aabaaadadddacdcaaddcbcdcaadb	TRUE
aabacacbadaaacaacccbdaacacbd	TRUE
aabbbcadaaabadaadadbccbdbdcd	TRUE
aabcadaaadadbbbacbcdaacaaabb	TRUE
aabdaabaabaacadcbcddaacabbbc	TRUE
aacaaaaaaaddbdbcbadaddadbdbb	TRUE
aacabcaadacadadcbdaaaadcacdd	TRUE
aacbaaddabbcabccbabaadadacaa	TRUE
aaccabadadccaaaadbadacbbbbdb	TRUE
aacdabaabcaadcccdbbbdaabcaab	TRUE
aadaaacdcadcaacdcbdaabccaacb	TRUE
aadacaacbaaabacbcdadabaadbdb	TRUE
aadbacbdcdbadabaacbadaaabcdd	TRUE
aadcacaadcaacaadccaaacbadcda	TRUE
aaddaccaabaacdabadddaccaadad	TRUE
abaabaacaaadbabdadaaabbddabd	TRUE
abadadacbcbbdaaaacbaaaccaaad	TRUE
abcaaaaaabaccdacadacdacdddaa	TRUE
abdaaadadbbcdaabcdacacadaaac	TRUE
acaaacaabaaccccbdaabaaaccbad	TRUE
acabcbcaacddabaabadabdaacaad	TRUE
acbbaabcadadcadbaaaacaadabdc	TRUE
accbaddddadaadaaadbabaacaaab	TRUE
acdcacadaacaaaadcdadaabbaada	TRUE
adaaaccbabcaadabaacaabddbbba	TRUE
adaadcdcaaabdbbaacabaaaaccac	TRUE
adabccadacdaaaaacbacaadbbaba	TRUE
adacccdcaaaaaabdccdacaacdcbd	TRUE
adadccdadaaabdacaaacababcaad	TRUE
adcaaaabaaaaacbdbaaaadbaccdb	TRUE
addaacddacccaabbbddbadaadaaa	TRUE
adddaaacaddaabbdcaaaccacaadc	TRUE
daaaacbcdaaabaabcaaabdcdaddb	TRUE
daaaddacaaaabbdbbdacdaaabdda	TRUE
daabdadabdbbdbaddaaabddabaab	TRUE
daaccdbaacbbbaaccbcdaadcbaac	TRUE
daadcbdcdcaacdddacaadcaadaaa	TRUE
dabccbadcdccabaadaaaacaaaadb	TRUE
dacdaabcaacbadabbaaacbbcaadc	TRUE
dadadcdbaadaaddbbbdaaadabaca	TRUE
ddaaabcddcbaaaaabaabacdcaacc	TRUE
ddabcadaaaddadabcbaaddddcaaa	TRUE
aaaaabbcabdbccbbcddddaacdbad	FALSE
aabbadbcddbadbabbcbcaccddadb	FALSE
aacdabccccbbabdccabdaadbccbb	FALSE
abaaccbbdccbabcddadaabcadcbd	FALSE
abbbdccbcdaccbbabbdadbddbddd	FALSE
abccdccaadabbccbcadcabccadcc	FALSE
abddbdcdbcbccbdcaaadbbbccadc	FALSE
acbbabdbcbbbbacbaddabdcbcddd	FALSE
acccabcacdacdcabdcabdbbaadbc	FALSE
acddcbbcbbadccdcddabcbcadadd	FALSE
adbadddcabdcdddbcccdadaccaaa	FALSE
adcbbdddcaccbddbbaababdcabdd	FALSE
addccaabcadacdddccbddaaacbdc	FALSE
babaaccacbaccabcdadbadbccaaa	FALSE
bacadaaaadaacbcbddaabdadcbac	FALSE
baddbcbcacacbbbadbbdbcaabdab	FALSE
bbbadcddbbbbdbbbdbbadaddadbc	FALSE
bbcccbacdaaaadbcddaddabaddca	FALSE
bbdcdbbdadaccaddaacbddbaadad	FALSE
bcadddacbcbccdbdaabbdbaddccd	FALSE
bccabcbdabccccbabcdddbccabcc	FALSE
bcdcaccdccadaadadbbcbdbdcbda	FALSE
bdadabbabaddccadaabddbbbabbb	FALSE
bdcaccccbacdacdcdbabdcaacdba	FALSE
bddbbdcabcddddaabaababbbbccc	FALSE
caaccaabcbddcccbddabbaacbccb	FALSE
cacacccccdcccdaabbaadccbcddd	FALSE
cadbccaccbbabacabddacbbdbbab	FALSE
cbadabcddacccbdcbabcdcdcbabd	FALSE
cbbddbbbbaccbccaadccabadbdac	FALSE
cbdabbcddacdaddccdbabadabcaa	FALSE
ccaacbdccbacdbdccbbbbabdcaaa	FALSE
ccbbadbacbdbcbdbdbdbcdcabccb	FALSE
cccbdcbdbbaadaccadaddcdcdaad	FALSE
ccddbbcbcccdbdbbaaaabbcbadab	FALSE
cdbabdbbacbcaccbdbacaacabbba	FALSE
cdcaddcdbabdacbbdbdccdcadbbd	FALSE
cddbaacaabaaccbbdccbadcadcda	FALSE
daabddacccaadabacaaddcdbbccd	FALSE
dacaaaadabbcdccbccccbbbcdbdb	FALSE
dadbbbdbbabbdbdaacbababcdcda	FALSE
dbabdcccababcdccbcaaccdadacb	FALSE
dbbcdcbbbddccddcbbbabbdacbac	FALSE
dbcdcabbabcdcabcabbdbdcbcadb	FALSE
dcabcabadccbcccadcbddadadcdb	FALSE
dcbcccabdcbaddcbccdadabdcaad	FALSE
dcccdccadccdacbabdcbbdbcadca	FALSE
dcddccdbdcdbcababcaabcccccaa	FALSE
ddbbbaabccbcaccaabddadabddcb	FALSE
ddccdbadccacddccdadcaaccbccb	FALSE
aaaaaaaabadcbdadaaddbcbacdcdc	TRUE
aaaaadccacbcdaacaaccbacdaabab	TRUE
aaaacaaccdcccbcdcccaadbbaacad	TRUE
aaaadabddbcddaadadddccaadbada	TRUE
aaabaacacbaacabcaaacadbcaaabb	TRUE
aaabdddccadaaacaacbdcdaacaacc	TRUE
aaacdbcaacdadabcdaacccaacccba	TRUE
aaadadcccabddaaaaddaddacaaaab	TRUE
aabaaaadddbaacbbdcaacbcbacddb	TRUE
aabacbcaaaaaababbccaddaddbcdd	TRUE
aabbbaaaabddaacaadddcaccadbbb	TRUE
aabcaddacabdacbaadcdaaadaaddd	TRUE
aabdbbbadaaaacbcdaadbadabadcb	TRUE
aacaaccadaaadcbbaacccdabdbdab	TRUE
aacbaacabaaabcccdadaabbacacaa	TRUE
aaccaabdbacaacbadcbcdacaadaab	TRUE
aacdaaaaddbdbdadabcaabadcdcbd	TRUE
aadaaaacdaababbcdabddabcaabdb	TRUE
aadacaacabdbcbaadccaabddaaaab	TRUE
aadbbcacbacbaaaacbaddacaaabdc	TRUE
aadcbdcddbcaaadaabacaccaaaacb	TRUE
aaddbbcaaccbaabbccadabccaaccc	TRUE
abaabcaaacadbbbdaadaabcbbdbaa	TRUE
abadaccdaddaaabaaaaaacbcbbacb	TRUE
abbdaacaaaaacbadaaadabcccaabb	TRUE
abdaaaadcbaacbcdaabaacbacdbcc	TRUE
abdddabaaacdddabbaadbaaadacaa	TRUE
acaaddacbacccbaaaabaaabbdcaab	TRUE
acbabddaaaabdaadcadacdcadacba	TRUE
accbacbdcdaacbaadcaadcadaaadd	TRUE
acdcbbcaddaaddcadaaaaabddbaaa	TRUE
adaaacdbaaacbacadaaadaaacdaba	TRUE
adaadcaaaaccaddacbcaacadacacc	TRUE
adabdcaaccbcaaccaadccccaadcaa	TRUE
adacdaadadaadaccbbcaadbcbadbd	TRUE
adadcabcaabbbbdbddaacaaaacccd	TRUE
adbcaacaaadbaacaaabbaaacaaccd	TRUE
adccaabcbdaadbabcaaaacccbbdaa	TRUE
addababdaaaacdbbdaadccaaacccd	TRUE
addcdaaaabddabddccdaaadabcada	TRUE
daaaabddadabbadabadabddcdcbbc	TRUE
daaadacbaacaabbbdcbccbdbbaaca	TRUE
daabcaadcccddcdbaadaaaacdbada	TRUE
daacbcaaabbbcaadcddaadadadcdd	TRUE
daadcababbdbaaaadddbbdcbaaaaa	TRUE
dabcaadbcbcddaabbdbaaaaacaaba	TRUE
daccddaaaaaaddaabbdaabcadcacc	TRUE
dadbacbdbcbdaaacaabaabadaaadc	TRUE
ddaaabccabbcabaabaddaaabbadaa	TRUE
ddacbaaaabbbcaacdaabbabdaaccb	TRUE
aaaaaaaddddbabcbacaaabcdadcdc	FALSE
aabbbcbbcaadbcabddccdcadbbacd	FALSE
aacbccbdbbdaaaabbbdddcbddcaac	FALSE
aaddcbccabadcddbdabbcdbccaccc	FALSE
abbbacbbbbdbdcbccdbdabcdcbadb	FALSE
abccdcaacddcaacdccbdbacbcbcba	FALSE
abdddcadbaabaddcddbddcaccdaac	FALSE
acbbbcdbdacbdbddbbdddcacdcbda	FALSE
acccbdcaadcccbbddbcdcbcbcbadd	FALSE
acddddcdbdcbbbaadbcbbadadccdd	FALSE
adbadbdadbbbacaaaabdbdadcadad	FALSE
adccadaabbbadbdbdcbcbbaaadcdc	FALSE
baaabacabadcacabacbadcdabdbda	FALSE
babcbaccabccacdddaaaddabbbaaa	FALSE
bacdabaadddcdbabcabbcdaabadda	FALSE
bbaabccbbcddaacdadcccadadbdca	FALSE
bbbbbbdacaacacdcadadcddcdcbba	FALSE
bbccbaadbbdcbbaabdbacdbcbdabd	FALSE
bcaabcdbdaabcbcdaddabdbdadcbb	FALSE
bcbbcaadcabcacdcdaadbbbcabdca	FALSE
bccbddcdcdaacaacadcadccdbbbcc	FALSE
bcdcccbdacccbcaacadacabbbacdc	FALSE
bdadccdadcacbabacbacbdbbadaaa	FALSE
bdcabdababaaccdbccbccdacdbdcc	FALSE
bddbacbdbaaccddadcaaabccbbdca	FALSE
caabdcbcdcdbaadddbcbbcdbccada	FALSE
cabcdbaabddcdccdddbabcbcccbaa	FALSE
cadaabccdbddbdabdbbaacdabdabd	FALSE
cbababaacbaaabcaaadaabddaddcc	FALSE
cbbbdcbdbbbdcdbaacdaddabbacbb	FALSE
cbcdaccbddababbabdcdddcbbdadb	FALSE
ccaacbdcdacbcccdddcccddddbcad	FALSE
ccbbbdaddcccaacdbabaccccaacdd	FALSE
cccdbdaccbbadbaccddcbbbbbcada	FALSE
cdaaaccbdaddcaccdbcdbcccdadbc	FALSE
cdbbadbdbbdcadabbdcccabcddddb	FALSE
cdcbdadddbdddbbadcbdbbdabcccc	FALSE
cddcdbbadbdacaacdaaaaddcabcdb	FALSE
daaddcbdcddcdddbddbaaacdcbcdc	FALSE
dacadbcacacdabdabbacaddbcdbcb	FALSE
dadcbbaabacabadaabcacdcabbbbc	FALSE
dbadcccdadbcddabbcaddbccdccbb	FALSE
dbcadcadaaddccbabcabadccbacda	FALSE
dbdbdadbbdbcddddcdccbbcdbabad	FALSE
dcabdcdaabddccbabdacacdbdccaa	FALSE
dcbcdabbbcabccbbddabcaddadcbb	FALSE
dcdaaaaccadccabadcacdcabdcbca	FALSE
ddababdcccacdcbddccaddcaacdbb	FALSE
ddbcacbbbdadccdcbaaabcaadccab	FALSE
ddcccdbaccdaaadcadcddaddabdaa	FALSE
