aaaaabaaaaacdbbbdbbcadcadbbdbbd	FALSE
aaaaabacabcdccbadabdcbcdaacdbdd	FALSE
aaaaabbaacdcaababdcdbabdadaacba	FALSE
aaaaabbcaaddddaaabccabccadbdabd	FALSE
aaaaabbddcccbddabbcdcdbdccadcaa	FALSE
aaaaabcbcccdadcdccacbdacddcdabb	FALSE
aaaaabcdddcdaaabdcbcccabadaadda	FALSE
aaaaabdbddddddadacabbbccbcdccab	FALSE
aaaaacaaabccacaacabbadbbbbccdca	FALSE
aaaaacacabdcbabcadbbcdaccadacca	FALSE
aaaaacbaabddaaabaaddbadcabbccac	FALSE
aaaaacbbcdcdabdaddadcacccddbbcb	FALSE
aaaaacbdbdbcaaadccbddacbbcddabd	FALSE
aaaaaccbbbdbadadcdaacbbbbbacdab	FALSE
aaaaaccdbbcdbdbcbaddacbcabdadcb	FALSE
aaaaacdbadbdbdddcdacaabbcdadaaa	FALSE
aaaaacddaacbcdcacdccadccdcdccdd	FALSE
aaaaadaaddcabddbcaaaaadcddcbcac	FALSE
aaaaadaccdacdbcacbcbdbdcbbbadad	FALSE
aaaaadbacababdbadaabbaccaddbcbd	FALSE
aaaaadbcbbcbbdaaadddadddbbcddab	FALSE
aaaaadcabbaaabbdaabcabdaddcdbba	FALSE
aaaaadccbdcdddadbcdddbbdaccdcbc	FALSE
aaaaaddababadcaadaadbabbdadacbb	FALSE
aaaaaddcaddbacdcdadbbaaacdcbdca	FALSE
aaaabcdaaabdadbcddbccbdddabdabb	TRUE
aacbdcdcbbccdcdcadcaaaabbcbbbda	TRUE
abbbadaacccdaddababbcccdbdbdaac	TRUE
acabbaaababbacabdbababadcddcccc	TRUE
acdacccdbaaadacbbaaadccabaabcdc	TRUE
adcaadadcdcbcdbcbbdaacbdaaaadcb	TRUE
baacbbbabdccdadadadddadbbabdabb	TRUE
badabcddbabdacdbbbaccaacabcbcda	TRUE
bbbdcdccdbdccbaacabcaaccbacbcdd	TRUE
bcaacdcaacaadbaabcadbbdabcdcaab	TRUE
bccbdbccdbbccaddaacdaadcccaadcc	TRUE
bdadddabdcdcbbacdcaacccddcbbdab	TRUE
bddbbdddbbdcaacaaabddcbdbdadaba	TRUE
cacbdccdadcadbddbdcabdacadaadcd	TRUE
cbbaccbbdbccdadddaddbababadacba	TRUE
cbdbcdddaddcccbaaaabadcbcbccbdb	TRUE
ccbdbddccdddcabdbcbcaabbbdbbcbc	TRUE
cdaaadbcbdabcdbbbbacdaaacdbdcdd	TRUE
cdccaaaacacaabcccdcacccbdababba	TRUE
dababccaadbcdcbadcccccbdccbdcba	TRUE
dadbbbadcccabdaaaacbddaaabcdbdc	TRUE
dbbddcacaaabdccdbbbcaaacdcabcca	TRUE
dcacbbaabbbbaacbabdaccccbbdaccc	TRUE
dcdbbabcbcdacabbcdbbdcaabbabadc	TRUE
ddbdbdacdcbbabdbcadacdccddbdbbd	TRUE
aaaaabaaaabadacddaacdaacbdadacdb	FALSE
aaaaababdcbbcdbbacabbadcabbcbbba	FALSE
aaaaabaddbaddcabbdabbbcdbaacbcda	FALSE
aaaaabbbcbacdddaaaadadbacdadbbdb	FALSE
aaaaabbdcababdabbcccccddccddbdca	FALSE
aaaaabcbcddaccbdddddccabcadbaadd	FALSE
aaaaabcdbdccaccaadacdcaabacbabca	FALSE
aaaaabdbbbbdcdadbbaaaadcbcadbccb	FALSE
aaaaabddacabdbaacbcabcbbcbcbbdbc	FALSE
aaaaacabacddbbccdabadbddccdccdab	FALSE
aaaaacadabdddacccddbbbbbacdaadcb	FALSE
aaaaacbbbbccbaccbbdaddabbcaacccb	FALSE
aaaaacbdaddcaacbcaccdbbdcdddadca	FALSE
aaaaaccbabcccaadacbcdbdacbbbbdbd	FALSE
aaaaaccdabaddddadcdbbbccdabcbcba	FALSE
aaaaacdbaaacacbcddbcbccbcbcbacdc	FALSE
aaaaacdccddbacacbbbcdddaabddbabd	FALSE
aaaaadaabacbcddbccadabacbacbcdbd	FALSE
aaaaadacbcddddcdabbdccdababcbcca	FALSE
aaaaadbabcbadbbacbdcaaacaccaacbc	FALSE
aaaaadbcbadccdddadbdddbbabacbcad	FALSE
aaaaadcaacadbbabdcdbaabdccbcadab	FALSE
aaaaadcbdcbbcccacdcbbcbbabaaabac	FALSE
aaaaadcddcddccccddbbcaabcbaadbcc	FALSE
aaaaaddbcdcdddddaddbccaddcbababd	FALSE
aaaaaadcdbdddbccbcdbdcdbcbbbbdab	TRUE
aacdabcddbbcabaacbaadcdaccdaacbc	TRUE
abaddcbcbbbbbbaddadabdcaabdbacdb	TRUE
abdcaddddbaaabdabaadbbacaacdbada	TRUE
accaacacaccabadbaccbcbcbabdcbcad	TRUE
adacccddccbaacdddabbddcdcdbccaac	TRUE
addaabacbbbacbaacabbbcddbbcbcdcd	TRUE
babbbcbdaadbdbdbdcdcdcbbdaaadaba	TRUE
badddadbdcddcccccacbbaddbadacccc	TRUE
bbcbcdccdabadbbbabbaccaccddbbbbb	TRUE
bcaddcccccddadbbbbaabadbbaddbcca	TRUE
bcddbbabcbaabbbabbabbbcadaddcdcc	TRUE
bdcbaccdacddbaabbaddabbddcdbabbb	TRUE
caadbaaacacddbbbdbaadcaabbbaccab	TRUE
cadbacbadababdcdabcaddbcaaccccbd	TRUE
cbbbdaacbcdbbbcddbacbdacccaabdbc	TRUE
cbddaddcdcacbcdcdaaaadbbbbabdabd	TRUE
cccbdbccdcddaaddbcabdaaddddbbbcb	TRUE
cdbcbbaabcbdadbcabddbdabddabcaba	TRUE
daacdabadbabcdacabcdabcbdacbbcab	TRUE
dadaacaccbabddddcccccdcbbdcbaaaa	TRUE
dbbcbabcbbcbdbcadacacbdacacbccbc	TRUE
dcacaaabadbacdaacdccbabbacdddbbc	TRUE
dccdbbdcdccddabaddbcadaabbcbdcba	TRUE
ddbcbbadbbcacdabbccbabddabacddab	TRUE
aaaaabaaaaabccbccbbcdabdccaddbabd	FALSE
aaaaababddccdccdcaadcdccdcccccaad	FALSE
aaaaabadcdccaaaabbacdbabcccbccacc	FALSE
aaaaabbbcdabacccbccdddccdcdccdabd	FALSE
aaaaabbdcdcbcaaaaddddccbaddaddbca	FALSE
aaaaabcbbdadacbcadccaccaddddaccbb	FALSE
aaaaabcdcacaaddadacbcdbabcdddcaba	FALSE
aaaaabdbbddaddcbabbcbbabacdcbbada	FALSE
aaaaabddadadacdcbdbdcacbbadbabddd	FALSE
aaaaacaadbdbbcadcadabbdccdbaabadb	FALSE
aaaaacacccabbdbcbaccccaaabdaddcad	FALSE
aaaaacbbaaadbbbbabdabdddacbddbcbd	FALSE
aaaaacbcdbdbcbaabcdcdababdbcaadad	FALSE
aaaaaccaccacabdbbcaddadabababdcad	FALSE
aaaaacccbcdacacabdcacadabbdbaaacd	FALSE
aaaaacdabbbcdddadcababccdacaacdbb	FALSE
aaaaacdcacbbdacaccabdcccabcadbcba	FALSE
aaaaadaaaacadabcdacdcdcbcdbcababd	FALSE
aaaaadacbddaababaddbaccbdaadccdba	FALSE
aaaaadbabadabaddadbabbbbaacddbcaa	FALSE
aaaaadbcadcbdbcdbbbdbddcbaabaadaa	FALSE
aaaaadcabacaddcadcbdbbdacdcbbddbb	FALSE
aaaaadccbbdabcabaabbaabacbdacadcd	FALSE
aaaaaddaabcbbddadbccbdcacbabddbca	FALSE
aaaaaddcababbdbcbcbcccadadddacada	FALSE
aaaaaadcddddcbdaaaccdcacaaccaacaa	TRUE
aacdbccbbbbbbbbdbbcbbcdcccddbacab	TRUE
abbcdcdddabdbcdbadacdddbcaaccaddd	TRUE
acaabbcbaaadacbcbcbdaacabaaddbdcb	TRUE
acccaddcadcccbcdccaccaccdccccddcc	TRUE
adbaccabdbcbccbbdbbdacacdacdcdaaa	TRUE
addcdadaddcaadbbdbadbdcaaabbdbadc	TRUE
bacacbddcbbdbcbabdbccdadbdcaccbbc	TRUE
bbaddccddbabcabdcdddabcbdcdadabcd	TRUE
bbdcbdaacdadacacdbbdddccdcdbbabdd	TRUE
bccbdcdadacdaabddbaadbcdbacbacaab	TRUE
bdadbccbabbbbbdbbdcddaddbbcbdabad	TRUE
bddbbdaddbdccbacabddcadaaaabddacc	TRUE
cabcccbdbbababdcaccbdabdbcccbcbdd	TRUE
cbabacddaadbbbbcbcadaaccccabcbdcd	TRUE
cbcdddacabadccaddabaabcccabdccccc	TRUE
ccbaacdbbcddddbbbbbbadbbababcdccd	TRUE
ccdadbacaacccbdcdbcbdcabdabaddcdb	TRUE
cdcaabaaacabccabadcacacacacbadbcb	TRUE
daabcbacaccdaccbccbdcabadddbacada	TRUE
dacddccdccbbbbabdadbdcbacaaadccbb	TRUE
dbbbcbbdacdddacbdabbdaacabddbcbaa	TRUE
dcabbddbabdbddbcaddbaadaabadcddba	TRUE
dccdabddbdbacccdccdddabdabccbadaa	TRUE
ddbbdaacaadddbcadadddbdbdaadadbbc	TRUE
aaaaabaaaabdddccccbbdacaaaaccbacac	FALSE
aaaaababcdccaaababbcadddbabbbabcbc	FALSE
aaaaabadbbcdbadddbadccbadbbcaccdca	FALSE
aaaaabbbbccabdbccdbcabbcbbdaadcdcb	FALSE
aaaaabbdbccbdddbbcbadddbcccdbaabbb	FALSE
aaaaabcbbdccbaacdbdbaccdaaabadcaaa	FALSE
aaaaabcdcbcbabbbcadbcdcbcbcbabdacb	FALSE
aaaaabdbbabdacacacadabcbdadacbaacd	FALSE
aaaaabddaacccadabcbbcdcadcaacdbcaa	FALSE
aaaaacabbdacaddccabbdadaabdbbddcdd	FALSE
aaaaacadbbcbacacbdacddababbcbaccbb	FALSE
aaaaacbbbbddbcadbcbbcababbadbccbcb	FALSE
aaaaacbdaabbabddaadddabbcaabcddbcc	FALSE
aaaaaccaddabbaaddbaccbabcadcaadbdd	FALSE
aaaaacccdccadbabcbabcaacaddddbbbcd	FALSE
aaaaacdadbacdcccbabbbadadddcccdbac	FALSE
aaaaacdcdbaabaabcaabcdbdacdabdbcbd	FALSE
aaaaadaadbabdcadabdcddbdacbcacacdc	FALSE
aaaaadacbcbabbdabcddadcaaaddbaabda	FALSE
aaaaadbaacbbdcdaabaccdbbdddaccccbb	FALSE
aaaaadbccbadbdcdbbdaaacdddbdadcbdc	FALSE
aaaaadcabdabddaadcdabadcdacbacccab	FALSE
aaaaadccadcacdbcbabbddcbcbddacadbd	FALSE
aaaaaddaadbbadddcbcacaddabcbcddbdc	FALSE
aaaaaddcbaabaadbacdcccdcbcbaabdcbb	FALSE
aaaaaaacbacadccbdacadbcbaddacbabcb	TRUE
aacccbbabdcdddbaaadaccdadbacbccdbd	TRUE
abbccabcadacacdadacdbacaabaddcbdab	TRUE
acabcbdbcbbccbddcbadaaadbbdbcaaada	TRUE
acdadddddcdabdbaaaacdcbdbacbaabcca	TRUE
adbcaadbcdcaabadcbdbbdacccaccddbad	TRUE
adddbcbcdcbacccdaacdacbaccbbdadabd	TRUE
bacabdddacaabbbdccddbdbbadacccaddd	TRUE
bbadbabacdcabcddcbccacbdadaadcabba	TRUE
bbdbcbcbacbcacddacddabdcabdcadbbdd	TRUE
bccaaccaddacdcacdaacccbabcaaaabdac	TRUE
bdabbacbabcbcdadbcadcabbcdcaaaddbb	TRUE
bddaabbbdbbcdbcacdacadcbbbbacddacd	TRUE
cabdcabdcbbaadadcdcbbcbabdbacaadcd	TRUE
cbaacbbbcbcbbaaaacccddbbdbaacbdcbb	TRUE
cbcccadbccaadbdbdbcdbdbcdbcccccaca	TRUE
ccbaaacddaddddaacacbcacbbcbbdcccac	TRUE
ccdcadcdccbcccdaabadbdaccdcbacacbb	TRUE
cdcadabdadcdccaabdddcccdadbacbabcb	TRUE
daabbddaacbcccbcbbdcddaacbddabcdac	TRUE
dacdcbdbcdaccaaaacadcaaddddaaaadaa	TRUE
dbbcabdbbacabaabacaddbbccbcabcabdd	TRUE
dcabbbcaabbddccaabdaabdbaabadccbdb	TRUE
dccddaccbccdbccdcacccacabdddcacada	TRUE
ddbbcaadddbbacdbbcadcbccbdcbabdcdd	TRUE
aaaaabaaaaacddadddbdadacddadaabdbbd	FALSE
aaaaababdccdbcbabaabcabcbadcbaadcac	FALSE
aaaaabadddaaadadadcaccbbabcabacbdab	FALSE
aaaaabbbcbaacddaccbbcabdabbdbdacaaa	FALSE
aaaaabbdcacbbddbdcabcdbccdbdbaacacc	FALSE
aaaaabcbbccddbdddcbccabcaddbdbdcabd	FALSE
aaaaabcdaacccdddbccbadccbddaabdbccd	FALSE
aaaaabdbbbdcbadbcdaacaacabdabdddabb	FALSE
aaaaabddbabbbabccabbacbbbdddabccacd	FALSE
aaaaacaadddccdaccabcbbdabcbcbdbaada	FALSE
aaaaacadacccbdbccaabaaaaccbdcccdddb	FALSE
aaaaacbbaabcbdcbbacadddbcaddcaccbbd	FALSE
aaaaacbcdbdaddccddbbbadbdcdbadbbabd	FALSE
aaaaaccbabcacbabddcbdbcbabbbcdbbadc	FALSE
aaaaacccddacdbcbddbbdbcbbdcbbabbcbb	FALSE
aaaaacdadaadccdaddbdcadbdddbaacbbac	FALSE
aaaaacdccdcaddbaaabbadcccdcbdadabbc	FALSE
aaaaadaacdcbddddabcbabccabbacaadacc	FALSE
aaaaadacccccbcdabcbdcaddacbadbdcdad	FALSE
aaaaadbabccabaaddabbcabccdacadaddda	FALSE
aaaaadbcacacbacccdbbdbcabadaaaccbda	FALSE
aaaaadbddbbcbacaaccdaccbdaccddbcabd	FALSE
aaaaadccaaccbcacdbccbcacbcbdbcbdbbc	FALSE
aaaaadcddccabbcddbabddaadbcccbdabdd	FALSE
aaaaaddcabacbcdcccdccababbbcaaabbcd	FALSE
aaaaaadcddadadbccacaacbddddddcbacca	TRUE
aacbdddaaaabcccbcdbcbcabbccbdddcaca	TRUE
abadbcabdacbaaadcbbbbbcccbacdbacdbb	TRUE
abdcaacddcadcbbccdcbbcabadbcaaccaad	TRUE
acbdabcbcdbcadccdbcaadcacbccaacddcd	TRUE
adabcdddcacadcaaaabcdaccaccddccdbbd	TRUE
adccccdbbadadabbaccbadaaaddaaadddad	TRUE
babaccdaadcaccdcadaadaddbabbadcbbca	TRUE
badcdccaddabccdcaaacccbbccdcdacaadb	TRUE
bbbddaaadbabdaaaccdbddcbccabdbccabc	TRUE
bcabbbabdbddacaddcaacaddcbdbbdabbba	TRUE
bcdaadccbaabbcddbdabdbdbddadccdbcac	TRUE
bdbcadadaddadcaacbbbcdcbccdbadbbdda	TRUE
caabbcbccdcbcbcbcdabcdaaadbddcbabdc	TRUE
cadbdccacdbaccbdbbdaacbccabbcdadddd	TRUE
cbcbbacaabbcaaaaaadbaabdbdadbdbbbbd	TRUE
ccaccbcbbcbcacdccadbddadcacbbaabdcd	TRUE
ccdacdddddadcdbbddabddcabcababddaba	TRUE
cdcabdcbdadbcbacdbccdbaacbaabaccabb	TRUE
daadacbacbdbcdbdbbdadbbbbdcadacabdd	TRUE
dadacddbcacdbdcadaabbaabcbcbaddabda	TRUE
dbbcabccbddccadabbaacbbcacacbbcadbd	TRUE
dcabbbaaabdcdcdccccddcdbdaabdcdaacb	TRUE
dccdcbdacccdcaddbbadabadbdbbaaadcdc	TRUE
ddbbbacadcbabacbbadcdabdbddbdddaacb	TRUE
aaaaabaaaabdaacccacdcadcadbbbdbdbaca	FALSE
aaaaababdbccaadaaacaaabacbccdacbbabd	FALSE
aaaaabaddccbbbaacacdcbccabadcdaadaab	FALSE
aaaaabbbdbccaddbbbcbcaaaadbacccbbcdd	FALSE
aaaaabbdcdbaaccacadddbdacaccdcdddaab	FALSE
aaaaabcbdbcaccbacbacdaacdacbdbbdabbd	FALSE
aaaaabcddbcbabbbcdbccdaccadabdbcbada	FALSE
aaaaabdcaacadbaabaddaaaaacbdbbdadbdb	FALSE
aaaaabddcdbaabcdcccbcdbabdbdbacaaacd	FALSE
aaaaacabcabacbdccacdddaadadbcddbaccc	FALSE
aaaaacadbcbadddcdabbadbcddccadacbddb	FALSE
aaaaacbbbbacaaacccdbdaabdabcbbddabad	FALSE
aaaaacbdaccaacdcbacaacaabaabbabcdbaa	FALSE
aaaaaccbabbdbbcaabacaadadabadbbdaddd	FALSE
aaaaacccdbccadabadddcdbaadadbcccdbad	FALSE
aaaaacdadcadadbdabaababdacacadbccabc	FALSE
aaaaacddaaaaccadbaabcaaccbdcaaadbdca	FALSE
aaaaadaadcdacadcabbbcaccdccdbccadabb	FALSE
aaaaadaccbadccbbcabbccccbdcbaaadcdba	FALSE
aaaaadbabcacdabacdcbccabadccbcbadcbb	FALSE
aaaaadbcacbaccbabbbdbbbdcbbbacdbdbac	FALSE
aaaaadcaaababacadddcabbbadbbccaacbdb	FALSE
aaaaadcbddddbccccaadbbaccbbdabcbcdab	FALSE
aaaaadcddcccbccbdbacbdbbbcbdbdcdcdca	FALSE
aaaaaddbdccdaabbacddabdcaddadcbdbbac	FALSE
aaaabcdbcdbbaccdacdabbbcdbcabbcdbddd	TRUE
aadaacbbaddbbabbbdcccddaadcbdcdcadcd	TRUE
abbabadbdcbadbbdddbcdaadccdbaacccbad	TRUE
abddabadcaabdcbdcbcdbacabbacccacaabc	TRUE
acccababdcbcbbcadccadbaddadcdabdaddc	TRUE
adacbdccbcbbbabdbdcdccadbcbdbcbcdaba	TRUE
addbcbabdccacaccddacdddaaddacaaccbaa	TRUE
babccaccbbccbadbdacadcadaddcadabcaad	TRUE
baddcdccbacdadcbcddddccddcdaadcddcbc	TRUE
bbcbdaccabcaddbbaabcbdbcacabcaacdaac	TRUE
bcbadcaabbdacbcddcbaddccddadacababdc	TRUE
bcddcbbacccdaccccbbabdccbdaccaadcaad	TRUE
bdcdcadcaadbdcddcbdccbddaddcacaababb	TRUE
cabbacbbcbaacbaadccbbdcdabdaccccaccd	TRUE
caddaddbcdbbddcaadabdbddacbbabcbccdc	TRUE
cbcadccbbbbdabbaabcbaaabcaacababdbab	TRUE
ccaccdabdbcbdcdaabbdabcacbdcaccaacbd	TRUE
ccdcaccacbdccbaacbacbcabdacdaadaacdd	TRUE
cdbdaadbbadaaacaabacabbbadbccddccbcb	TRUE
daaccadbcbbabbbadcabbadadbaaacbdabbc	TRUE
dadaaabaacdbbbbabbcbaddbacbbabdcdaad	TRUE
dbbbabcdbabcbbcaadcddcdddcaacdabaaba	TRUE
dcacbabddbdbccbccdcccddbabdadcbbaadd	TRUE
dcdbacddcccdadbddbbdbbcadcbbcadabdad	TRUE
ddbdbbdbcccbaadcdaccbadabccbbcaaccca	TRUE
aaaaabaaaaacbabcadbbdddbbdcbabbaabccc	FALSE
aaaaababdadcbacacdaaccdabbdcdccbabdac	FALSE
aaaaabadcdddbdccdcbddcddcbbabaadadbbc	FALSE
aaaaabbbbdddcadcaddccadcbbdcbdbbbacdb	FALSE
aaaaabbdbdcaccbaaadbdcaaacddbacabdbbd	FALSE
aaaaabcbcbacbadbdbccccaacacbbcdbbcdbd	FALSE
aaaaabcdccadccdddabbdddcddccacdbabbab	FALSE
aaaaabdbbcccdacdcbddaacdadcbdccbabdab	FALSE
aaaaabddbdaddbdadccdbdaacdcadbaaabcdd	FALSE
aaaaacabacadddacbacdbbacdbaabcbcddabc	FALSE
aaaaacadaadaaccaacbcccdcababcccbcbbdb	FALSE
aaaaacbadccccccdaabddcbbdcccacdbacddd	FALSE
aaaaacbcdababbdadcddbaaccbacbbcadcaca	FALSE
aaaaaccadccaacdacccbdbccaccdcdbcabdba	FALSE
aaaaacccdacacbccacdacdcbddcacbdbdaadc	FALSE
aaaaacdaccbacdddabbdabdcaddbcbcbbdbab	FALSE
aaaaacdccacabacadacdbdacabddddbadaccc	FALSE
aaaaadaaadabbddadbbaadcccccbbcdbdccdc	FALSE
aaaaadacadbcbcaabdddaccddcdbacccbcbad	FALSE
aaaaadbaccddbcbdbbdaabdbdbabdccaadaca	FALSE
aaaaadbcbcbdcbbaabdddadccccacdcaabcaa	FALSE
aaaaadcabdbcacccccacdcabbbddacaccbcbc	FALSE
aaaaadcccbcdccabbaadaadbbbbacbccaaadc	FALSE
aaaaaddaadaabbbadbadbdbddbcbccaddbdda	FALSE
aaaaaddcacdcacbbcdcababdadbddbcdcdadc	FALSE
aaaaaacdccadccbdbdcbcbcbcabcdaaccdaba	TRUE
aacbbcdcbbbaabcaadbbbccaadcbabcdbbadc	TRUE
abadccacdadcddbbbcabcdcccccbacdccabac	TRUE
acaabbcdcacaaddcaacbbbbacdabaddbbbdcc	TRUE
accbbcacbbdcddaacbaaacacbadccbaaaaaca	TRUE
adbaabdccbddbaacdbaadcdaabacabcacaaab	TRUE
adddadcaadcdddbbbdabadabcccbbbcbdadda	TRUE
bacbbcbdbaaaacadbdcadacdcdbcbdcadabdc	TRUE
bbadcabdcbaadbcaabdccbcbdcdabcdaddcba	TRUE
bbdccabadddbacdddddccbbcacddbdbaacbcb	TRUE
bccaacaaaaadbbbbadaabddbcdadaadcbccbc	TRUE
bdadababaccdbbadccaabcdcbcaccaadaccca	TRUE
bddccacdcaabddbbabcdccddcadabdadcbcdc	TRUE
cabdcbcbbbaaabccacdadcabaabbacbaaaccc	TRUE
cbabdabdbadbdadcbcbbcbddbaabaaccdbcbc	TRUE
cbccddcbdbababcacbdbbdaacbadcbddddcbb	TRUE
ccbbcdcdbacadbdadadaddcadadaacbdcaaba	TRUE
ccdcddbaddbcaacbbbaabacbccbcdacaabddd	TRUE
cdcadaaabaacdbccdddabacdcdbddaccbbadc	TRUE
daadaccdbbbcacdbbdbcadacacdadaabbbcbb	TRUE
dadcaaaccabdbadccccdaacabaaaddbbdddda	TRUE
dbbdccbbaacdbadcdabdbdbacdcabddbcabaa	TRUE
dcabbaddaabbacbcdcaddcdabdbaccacacbca	TRUE
dccdcadacabcdacbacdccaadaddabacdadaaa	TRUE
ddbbdccbacbddddbccdbdddcdacaabdacacbd	TRUE
aaaaabaaaabccccbcbabababdbabcabcdaaacb	FALSE
aaaaababddbcaabbaddbdacdbaaabbccbbcaba	FALSE
aaaaabadddccbdbbcbdbbccbcccdddacadccbc	FALSE
aaaaabbbcccbabbddcadabbcbcadcbaadaadcd	FALSE
aaaaabbdbdaacccacbdaddbbddaadabbbabcbb	FALSE
aaaaabcbcdbaadbbcddbbbadddbcddacadbbcd	FALSE
aaaaabcdcccbddbcdcccbcabcdadcddcaabbdc	FALSE
aaaaabdbcdcbcbdbbcbbacbbcccbcdcdcaaada	FALSE
aaaaabddbcddcbaacdacbdcbdbcccdaaacddab	FALSE
aaaaacababbdddddbadcadaabbacdcaabddcdc	FALSE
aaaaacadacccbadadbbacaabcccabddacabbbd	FALSE
aaaaacbadcbadbbbdccdadadadaadbcbcaabdb	FALSE
aaaaacbdaabdbcbaddacbcadccbdacdbcdbbda	FALSE
aaaaaccbaadccabdddcbbddccaddbdddcccdab	FALSE
aaaaaccdacadaabbacbbdcdcdbdccbdcaacbcd	FALSE
aaaaacdaddddcbbacadbbbadbdcdabddddbabb	FALSE
aaaaacdcccdbccadacdcbcccacacdabbacdcdc	FALSE
aaaaadaacabababcbadacacdbdcccccadbbbba	FALSE
aaaaadacbddddacadcdbacabbcbdddbcdadcdb	FALSE
aaaaadbacacdbdadccbcdbddadadadbddabbac	FALSE
aaaaadbccaddbddccccdbabbddaddacbcbabaa	FALSE
aaaaadcabbcbaacbbaabccdadbbaacaaabddbd	FALSE
aaaaadccbccbaaacaabdcaadcddddcbabccddc	FALSE
aaaaadcdddcdcccbdaadcdddcccdcbcaadabcb	FALSE
aaaaaddbddaaddbccbbdddadccdcadacdbaabb	FALSE
aaaaccabbdabbddbbabaabdadacabdadbaccbd	TRUE
aacdaaababadbabacbcdcaadcabbdcbdaacccc	TRUE
abbbcadbbbbaacbdcabbaccbdcabbdabcabbbd	TRUE
acacbbdbabccacccdbdbaadddbddcacaaabdbd	TRUE
acdacbdbbcbddddabadcddbddacbbdbbbccdcc	TRUE
adbdacdddbbdaabbddaaacbbbdabccabcdcbdd	TRUE
baabcadcabbaaaccddaacbbcdbbadbaabdaadc	TRUE
baccdacaaacdabadcbdbaccccbaccdcdbbacdd	TRUE
bbbaaaccabcaabdadcadabddaaccddaadacddd	TRUE
bbdacbdcdabccdcabdbadabcabbacaaaaaacbc	TRUE
bcbcdabbaacddabcaabdddccdbcdaadcdcabcd	TRUE
bdababbdaaadadadbdcbabdadcdcaccccacdbc	TRUE
bdccdccbacbbcbddddadccaadbbdadbbdcaada	TRUE
cabbaccbcddadbbcccdcdcdadcdcbcbbbaadcb	TRUE
cbaabdbcaccbadacbaabadbcbabbaacabdadac	TRUE
cbdadadbbbddbbaaadabbacadcbbbdacabccca	TRUE
ccbdbcaacccbdadacccdcdbdcdcdccdbbccccd	TRUE
cdabdcacdaaadcbddcddcacbcdabdcccdabadd	TRUE
cdccccabdcbcccbaabaaaaccbcacbbaabdbbbc	TRUE
dabbbbbaabcbcdaaacabadaabdcdbcbbadbaba	TRUE
daddccaddbbdcaddbcccabdacbbdbaccbbcbaa	TRUE
dbccccacaaacabbccacdbcccbccaaccacbdcdc	TRUE
dcadcccbacacddbaadaadcdcdbdbdddbacabbc	TRUE
dcdbddadbabdbcadadcabdcabccccaddbaccbb	TRUE
ddbdadabbccdccddacbababbbcbdacacbcaaca	TRUE
aaaaabaaaaacacbbacacbbadbbaccbbddcaddbb	FALSE
aaaaabacadacbcaacbabbccdddbacadcbbcbcdb	FALSE
aaaaabbaadabcdcccdbcacacbcbcaaaaadbaacd	FALSE
aaaaabbcabbbbcdbabcbbddcbbcaabbbdcaacad	FALSE
aaaaabbddbdddccdbcadacbaabacdcdcbbabbbd	FALSE
aaaaabcbdccbbbbadcaccddadadbbdbbcdaabdc	FALSE
aaaaabdaabdbbbabddabcacdaccbdacdcaadabc	FALSE
aaaaabdbcdcbaddbddacacadabadabcdcaabacb	FALSE
aaaaabddcccbbcdaadcacbaaadadbdadaabcabb	FALSE
aaaaacabadaddcdbbbdabbbaadcadabadbddada	FALSE
aaaaacadacacbbbbdcbdddcdbdadbbcbcadcbcb	FALSE
aaaaacbbbaaaadddcdbddadcacddacaaadadaac	FALSE
aaaaacbdadbabbababbdbbccdcacdcacaccaaab	FALSE
aaaaaccbaccaaaccbaaabbbabaccbbabbacbdaa	FALSE
aaaaacccdbdabcdddadaddcdabacddaddaaccbc	FALSE
aaaaacdaddcdbbdadddbaccbcaccbcdddddccac	FALSE
aaaaacddadaadcaadccbddabcbdbbdddddcdbad	FALSE
aaaaadaaddbdadbbbaaadacbdcdadbaabcbcddb	FALSE
aaaaadacdccabddccccbbaaccaadcbcbcbbabcb	FALSE
aaaaadbacbdccdcddaacdcdcacaccdacbcabadb	FALSE
aaaaadbccacbbddccdcddcbddddccabdbcccaac	FALSE
aaaaadcaadddbaddabdbbbacabbbbcacdcaddda	FALSE
aaaaadccacccabdadcbdcbcbbdcbcbacabdcacd	FALSE
aaaaaddabaadabbbcccccabbbbbbbbbddcbacab	FALSE
aaaaaddbdcbbcbbbbadaaadddaadaaabdacadda	FALSE
aaaabaadbaaadcdacccddddacacddcccccdbddd	TRUE
aadacdacdbcaddbadcbadbdbbbbccadabcbaccb	TRUE
abbcadbddbdaadbbadbccdcdabbdccbcdbdbaaa	TRUE
abdddbcaddcaabdbcdccddbddacaddbbababbaa	TRUE
accaccbcacdbaabacdbbabcdddcdadacbdabcda	TRUE
adbbbcdaadcacbbccddcbcbdaabbaccddbcacab	TRUE
adddaaabbddcadadbcacccaccadbdadbbadcdaa	TRUE
bacccaccdcadcccbbbaddcbddaacdcddddadcaa	TRUE
bbbbddcbaaddacbccdcbbdbdadacbbbadccdbcb	TRUE
bcabcbcdacbcaaccaacacbcbbdbbbbbadbabbdb	TRUE
bcccdbbccbbcacabcccddbcddbcaacaaaaadabd	TRUE
bdbabdcdcbcdaacbdbbcbcbcdddbbdbabaccbca	TRUE
bddbaadabcdaadbbdabbcbcabdcdbabacbdbadc	TRUE
cabcbddadddccbbdccaaccbcccccccdaabdacab	TRUE
cbaabcacdccbdaadcccddabbbdcdadbccdabbad	TRUE
cbdaaddcdddacadacddadddadcaccdbdacbbcbb	TRUE
ccbadcaccbaacdbabbdadddabccadabaaccbdbb	TRUE
ccddbacacbdbcaaaadabdacdacabbbdacbaccbc	TRUE
cdccbbacbdccbbcbbbcbbcaddabcbaddbdcadda	TRUE
dabdcabdbaaaaccbbabaaabddbdccdbcdaabbac	TRUE
daddabbbdabdbacdaddccccdccdadccdcccbdaa	TRUE
dbcaaadddbaabdbbdabaacddcabdbdddacbbbdb	TRUE
dcacabcbbcbcbbdccbcdddaadaacadbdcaccccd	TRUE
dcdbacadccadadcadbacbbcdbbbcccbdbadcdbb	TRUE
ddbccacaccbcadacbaadadaacdbadcabaababcc	TRUE
aaaaabaaaacbccadbabdaabbacabddabcbddaaab	FALSE
aaaaababdcdadccbabcbccaccdbbaadbdddcbbad	FALSE
aaaaabadddbbbcabcbdbabdaacbcbaaddacccccb	FALSE
aaaaabbbddbdbcbaadcdbbddcdbcbdaabcbdcbab	FALSE
aaaaabbdcddbcdbabdcaddcbccaaacbdcbdacbcc	FALSE
aaaaabcbdacaaddcbdbaddddaaddbabddacbacad	FALSE
aaaaabcdbcbdacdcacaaabaadacddcacaacbadcb	FALSE
aaaaabdbbbabbacbdbccaddbddadabaadabcbbcb	FALSE
aaaaabdcddaddbabbcdbcccdaacdbbddaabaadcb	FALSE
aaaaacaadcaabadadcbdadbcacadbbbadcbbdacb	FALSE
aaaaacacdccdcadcbacbabadabdbbaacabcbbdad	FALSE
aaaaacbaddadaacaacaccbdcbaadcdccccdcbccb	FALSE
aaaaacbcdbbbdbcaadccdbdbdbdbdbbdcbdcccba	FALSE
aaaaaccaccdbdabcbadbdabccddcddbbddbadbdb	FALSE
aaaaacccdabbadabcddddbacbddbbdcdccddacca	FALSE
aaaaacdacaacdcabcbacdcbccdbaaaccbdbaadba	FALSE
aaaaacdccccababcddccbcbbccbdbdadacddddaa	FALSE
aaaaadaadbddcbbabdcbabacbacbcadddcbccdba	FALSE
aaaaadacdcacdbdbdddcaabdbbdbbcaababadbdb	FALSE
aaaaadbadcbaaddcbbcbdcdcdbadbccdbbaaccdd	FALSE
aaaaadbccddbbaadbbbaccacadbcbcbbcdacabdb	FALSE
aaaaadcabcbcdaadbbdcddddbbccbccbbababbdc	FALSE
aaaaadccaacbcbaaddabacadcccabadbabadacab	FALSE
aaaaaddaaccababbddcaccaabbcddacdacccbaad	FALSE
aaaaaddcbadabacdbbbbcababddabdacbddcbcbd	FALSE
aaaabdddbccdaacbcabdbbdccbcdccaaaabaabcd	TRUE
aacdaadaacccdabcdacddacbbcbabbadbadbbcdb	TRUE
abbbcadccbabadcbbdacaaadcdcaacdabbadbabc	TRUE
acabbabdaaaaacbbabcaaaabbcdbbaadabdccbaa	TRUE
acdaabdabaabccaadddaababcdbbcaaadcdbbddc	TRUE
adbbcadaadcbbccdbabaaabbcaccccbdbabccdca	TRUE
baaabcbdcbbbdddadbccabcadbdaaddcddcbcbcb	TRUE
bacbcdcaabdcccaddbdbcddacaaaddcbdaddaabd	TRUE
bbadccbbdcaabdaaadbdaccadcddaccccbcdbaba	TRUE
bbdcaccdcdccaabdcdbacbbbcabdcadcbbacbcab	TRUE
bccacdccdbacadaaacbadaaabbdbbbddcddaadcd	TRUE
bdaddbddbabacbdddababccbccdcbbbdadccbdcd	TRUE
bddccdababacabbabaacdcaaacccbdadbbacaaaa	TRUE
cacabdaccbbdddcaabadbdaabbccccabbacbdadb	TRUE
cbbabdcccadbdbbddbdccabbbacdaaccaddbacab	TRUE
cbdcadccbbcaabdcabbcaccacbbaadcdcdacadbc	TRUE
cccadbcadadbdabcdddbaddbccdabbababaaabcd	TRUE
cdacbccaaabccbdccbcbacadbbaccbdbbbadcbac	TRUE
cdcccbcdcdcdaabcdcbddaddcdcaaddabcccbdbb	TRUE
daadddbddaabddabbbaaccaaaadbdadaddcbccdd	TRUE
dadbbcbbdadbbbbdcbcbcabdbddbabbbaddddbca	TRUE
dbcacccbdddccaacdadadbaacdacadcddbaacdcc	TRUE
dcabbddbddccdaabcbdbdcacdbbdbadbbccaddcc	TRUE
dccdbcdcabdcadaaacacbabccaacbbcdcababadc	TRUE
ddbbadcdcbdccabaaddbbbcdddaccddbdaacacda	TRUE
aaaaabaaaaccdbacacdddccacdbacaaabbcddacca	FALSE
aaaaababcdaabbccacacbccbaaadacaddbbaadaac	FALSE
aaaaabbaaacbabcbacddcacbdbdddabdabbcbaaac	FALSE
aaaaabbcaaabcdabcaadcaadabdccbadcdadcacdc	FALSE
aaaaabcaaccdacccdcbdddcdbababcbdcdbaccccb	FALSE
aaaaabcbdddcaabacbcacccddcaacdcddbcccadca	FALSE
aaaaabcdcdcdbabccaacccbabcdbbbabddbcacbba	FALSE
aaaaabdbbacdacabdabaaaaabbcaaabddbcaabdaa	FALSE
aaaaabdcdcdacdbacaadddacaaabdbcbaacabcccb	FALSE
aaaaacaaccccddacacdacdccadddbdabaccdbdadd	FALSE
aaaaacacccabdacccaacccbabadacddabdbcbdcad	FALSE
aaaaacbacacaacccaadccbbddccbcbdbcdbdbbadd	FALSE
aaaaacbcdabdacabacddcaccccbdcccabbdadaddd	FALSE
aaaaaccacbaadbcaacdddbddaadbbcbcbdcbcccac	FALSE
aaaaacccaacbcdcadccbdacaccaadbcbbbabaaccb	FALSE
aaaaacdaaaaacababacdbbbcbcdabcccdbbdabdcb	FALSE
aaaaacdcabbbabbaaaabbbdaccbbcdacddabaccdd	FALSE
aaaaadaaaddcdbcdcbdaccaacbcccbcbcbdaadbab	FALSE
aaaaadacbbbdddaaddddbdacaccbdbbbccccdbbca	FALSE
aaaaadbabdcabbcddcddbacdcbadcacdabdcbcbaa	FALSE
aaaaadbcacaadababccbdbddbbcdccadcbcacbbbb	FALSE
aaaaadbddbdcbabbdbbddcddbdcadbacddddcbdaa	FALSE
aaaaadccabadcccabbaadaabdbdbabdbdabdddabd	FALSE
aaaaaddaaaacdadbbccbaccccbabddcbabacdcacb	FALSE
aaaaaddcabcaddcdbcdcddcdbbabdaabdbaaccdab	FALSE
aaaaaaddbbaaccdaabadabcccadbabcbaabccacad	TRUE
aacbccacacccabcdaaaabcdacaaaadadaadcadadc	TRUE
abbcdbcbabbdcbdbbdcacddddbbbaaabcccbabacb	TRUE
acabddadabadcbababbbcdccbbcbcbdabbdbdcddc	TRUE
acdabdddddcdbdadabbcabcccbdaddabbbabcabdd	TRUE
adbcbccdcdaaabdcabcbacdccdbbacaadcaaddbaa	TRUE
baaabdaccaddbddccbdcdccdacaabdaadcabbacaa	TRUE
baccccbacddadcbcbbcabdacbdabccdbdcdcbcbab	TRUE
bbbadcbadaccdabacaabbddcaaacabacaaaaaacbd	TRUE
bbddccdadbddbcadcbbddccbaddbabaadbdaaaabd	TRUE
bccbabcdbadaaabdddaccaddaddbdcdbdcdaabcda	TRUE
bdbbabddcabddccaabbdcabbccacdcbabbdccbcca	TRUE
bddddabbcaccabababadacddcabcdabcdcccbaaad	TRUE
cacacccbbdcaccdabdbadbcabbadbdddddcbbcada	TRUE
cbacababaacdbacccdbbbcbcbbddacdcacbcbddac	TRUE
cbdacdccbddbdaadbbddbbcdcadcadcbdcadddcac	TRUE
ccbdcbbbdcabcaadadadcbdadddabcbbcacdaddcc	TRUE
cdaccbbcbccbabcbbacbcdbbcdddccbcaaaacbcca	TRUE
cdccdaccddbcbacaabbcbabdababadaaacbbbcccb	TRUE
dabaabcbadbddbaadadccbdbdddaabdbdbccdcbba	TRUE
dadcddabdbccaadaabddbadbdcbabddbddddbdabd	TRUE
dbcaddacdbabcbbcaabcddabbdcaccccdbcbacdac	TRUE
dcacabdacaddbacbcacabbdaadcaabbaacabcaccb	TRUE
dccdabbdbacdccbdadcababdadcaddbcbddcbcdba	TRUE
ddbcaaadcbdccccbcddcabcacbadccdcbdcadadca	TRUE
aaaaabaaaabdaddccdabbbadcdbcbdbbcacccccdbb	FALSE
aaaaababdccbbbcbaadaddbcdbbccddacaadbaabbd	FALSE
aaaaabaddddabaaaddbbbcabbcbbaacdcdacadbada	FALSE
aaaaabbbdcbccaadadadcadadaacbacbabbdbddcda	FALSE
aaaaabbddcdcddbccabaaaaacdadadcbbcbacbcacd	FALSE
aaaaabcbcabbdacabcaaaabbabcdaccddbadababdc	FALSE
aaaaabcdcbcdadbcadbdccadaccaccbdccbdbdbaca	FALSE
aaaaabdbbdabcacbccddaaacddbadabbbababacccb	FALSE
aaaaabddbcabacdbbbadcabaabcabcbcbcbbbdcacd	FALSE
aaaaacabbacbdbbcbabbaacadccacdadccccaddacc	FALSE
aaaaacadacbaadbbcdacddbddbdcddcaadacdcdbad	FALSE
aaaaacbbaacbdccadbcbbadbdcdadcabbcbdcaaabc	FALSE
aaaaacbdaadbaaccaccbabacdbaddacdabbbabddac	FALSE
aaaaaccaddccbcdabadaabbdcdbdaccdcbddbbaada	FALSE
aaaaacccdbbbbbdcdadadccaabbbcbadaabbbddacd	FALSE
aaaaacdbacaccbadbaacdbcaabcadbabcaaddddddb	FALSE
aaaaacddacdacabddbdabaccbdbbabcbdaaddbbadd	FALSE
aaaaadabacadadddddcbcdaccdcdabdbacccbccdbb	FALSE
aaaaadadacdcbaccbdbbabbabcbcaccdbcccacbbbc	FALSE
aaaaadbadaddcbbdcaabdbbababcbbcddcddcaaabb	FALSE
aaaaadbcbddcaaddcabbdbaaddccadcdabcddadcbc	FALSE
aaaaadcabdaaddcbddaaaccbbcdccbddbaccaaaadd	FALSE
aaaaadcccacacbcccbaacbbbbccdcadbdcdacdbccc	FALSE
aaaaaddabbcbbbccbcdbaabccddcdbcddcccdadacb	FALSE
aaaaaddcadacccccbcaacddacdbbaacbdbcddbabdb	FALSE
aaaabcdbdcacdcddcdcdacadbadbdbcdccdcdcbcbc	TRUE
aacdcccadccdaadabbacadbbccabbcabcdbccabcdb	TRUE
abbdabccdbdabdaacabbaabbbcadaddcdcabccacbb	TRUE
abddddadaccccacaabadbaddbaaccccacddaabcbab	TRUE
accdaadcbdccbcbbbaddcdbbdcabdbbcaadbccdbcd	TRUE
adbbbacbbbddcbacadddcadaabcdcabddcacbddadc	TRUE
baacabbdbccdbacdaabdcabcdabdbdabccbdabdcbb	TRUE
badaccbbdbbccdabbadcbdddbbaacdacaabcabdcca	TRUE
bbcabbadbbbcbbdcddcbccbbcbcbabbbccbbabdcdb	TRUE
bcaaabbcabaabbbbdddabdaddbdbadadbcabbaadac	TRUE
bccbbccccdcabbcdbddababadbcccbdbddbbdbcdbc	TRUE
bdabdcdcbbadacacbdccadddbbbdbccdcbdcaadadd	TRUE
bdccbcdbccabbcaaaaadacdbcaddddbcccbbcbadac	TRUE
cabbabdddccadadcddadcbacbcadcacaaadccdbdad	TRUE
cadccbcaadcabcbcbcccddadcdddaaadaccdbcaadb	TRUE
cbbdcaabaacbdcacabbddcabbbcdccababcbcbbccc	TRUE
ccabcccbabbddbbdacdabcdbcdabbdcdaccbacdcbb	TRUE
ccdbacdababccdadcadccdcdccbdcaacabcbcbbdda	TRUE
cdcabbccdbabdbbcdaacbbaaadaaadabdababdacba	TRUE
daadcadbcdaaccdadccacabdabddabbbaaacadcbcc	TRUE
dadbaadddcacbcbcdbabaaddbbacdbcdbbadddacbc	TRUE
dbbccdcbacccadaaacacabccdbdabdabddbccacaaa	TRUE
dcacadbabdabcddbccaadadabcbccbbbcddbcccbac	TRUE
dcdbbcbdddddacdaaacccabbccababbdcdbbabdbbd	TRUE
ddbdbcbdddbbabcbccacdaadcdadccbccdaabddbad	TRUE
aaaaabaaaabcbdbcaadacddcbcbbbbbcdcbaccabcda	FALSE
aaaaabacaabcbabcdbbbadcabddcddbccddaaddbcda	FALSE
aaaaabbaaabbcbadcbccdccbababccadbabacbbcdcd	FALSE
aaaaabbbcdabaaabcbcbadabbbbbbbdddaaddddabba	FALSE
aaaaabbdddbcbccaabddcadaddadbbbdcbabbbbdcdd	FALSE
aaaaabcbdcdbbdddccdadddcbcabaabcdbaaabccada	FALSE
aaaaabcddbdcacdcdadccdacdaccbbaaaddaabdabbc	FALSE
aaaaabdbdccbddabdddbbadadadcddbbdddbdcbdacd	FALSE
aaaaabdddadbadacacadcccdcacbbcbdbcdcbdddbab	FALSE
aaaaacabdcccadcccacadcccaccadabdbbcaadbcddc	FALSE
aaaaacadddcabccadddaabdaccbcbbbdabbbccdbdcb	FALSE
aaaaacbcaaaddacbcbbbbabdccbddbddcbbdcdcbaba	FALSE
aaaaacbdcbbdcccdbaabcacddacadcdabdcaaaaabaa	FALSE
aaaaaccbccbcabdbcbbcddccdccbacbbbadccadcddc	FALSE
aaaaaccdbbadaabcddcacccaddaacdbabcadbccdacb	FALSE
aaaaacdbbdcadaccccdcbbcbdcccddccbabccbdbddb	FALSE
aaaaacddaaadbdbaccdddacdbdddcbbacccccdcacda	FALSE
aaaaadaadbadbaaabccabcdcccbccdbaccbaccadada	FALSE
aaaaadacccccaccaddbbbaadabdbadaacdbccdbbdab	FALSE
aaaaadbacdbaabdabbcadcbcbacacdadddbbcadcaca	FALSE
aaaaadbccdcaadabbddcdbcacadcccbccdadccccdbc	FALSE
aaaaadcabdadbbdaaaccacdcccbbcddccdaadcdbdba	FALSE
aaaaadccbcaadcccddbbdcbbbbbdbdadaabbcbccdac	FALSE
aaaaaddaadbcbdcdcbacbbcbdbacbbcbbadddcccaca	FALSE
aaaaaddcaaacabbccadacaacddcbccbbacadcaabdcd	FALSE
aaaaaacadcbbababdbddbaabbaaaddcaccbdbbdddbc	TRUE
aacdcdcbbaadbdbbbaaccbcaaabdbcbacdbbbabacda	TRUE
abbcbccddbbacabddccabcbdbcdddcbccbdcdbabdaa	TRUE
abddbddcdadbccadbdbcdabbcdcdabaaababcdadcaa	TRUE
accccacaaaddacabccbadaadbaabcadbadbbcdcabba	TRUE
adbabbacddacaaababddadabdaabaddddccbcdacbdd	TRUE
baaaaccdbbddcccabadabbcdcbbcabbccbcabddaccd	TRUE
baccdccaadabdbadaacdcabadaabdbaaddcdbcadbbd	TRUE
bbbccabadabcccddcdcaacabcaacdcadcbadbdabcba	TRUE
bcabcccdadcbbdbbdbcccbccabcbadbaabbbacadddc	TRUE
bccddcbdbaaadcddabdbbaabbbcbdadbcbdbcdbaacc	TRUE
bdbbccbacbacbdcddacacbababbccddcbcdbadbabba	TRUE
bdddbbcabacaddadbbadbacdababcdaccbccdadbbac	TRUE
cadacbcddacdaaccbddcbbbcacdadcbccddbacbaabc	TRUE
cbbdcccabbdadcacdadbbdbcdaabababcbabadcbcad	TRUE
ccaaabacddbddcacbbddadbacabccadacbbbbcdbcaa	TRUE
cccdcacdbadaacbacbcdacabdcdcadaababbdbdccdc	TRUE
cdadddacdbcbcbdabbaaabcccbcbbcadbbbdaadbaaa	TRUE
cddacbdcabbdcdbdddbaddbbccddccbbdadbddbabac	TRUE
dabbbddacccddcdaabccdabcbccdbdcbadcddcbaabb	TRUE
dbaaabacbbddddcbabacaccadcaccccbabcaacabdda	TRUE
dbcbacbdcbaabddcbdacacadcbdbcbddaaababdabac	TRUE
dcabdcccdbdacbdccdbbaadbbdbaabaaaddbccdddaa	TRUE
dccccbdcbbcdbdbbadbcbdaddbbbcadcaadadbadbaa	TRUE
ddbbabccbcdadbaabacaccaaaabacadadccdaabcbad	TRUE
aaaaabaaaaadabaaacbbbaabadaccccbbbdbdcaadacb	FALSE
aaaaababdcdbcabdabcadaddcbccdccddcbcacadacaa	FALSE
aaaaabaddaaccabbbadbbacbacccdabdbbccadbcbabd	FALSE
aaaaabbbcdbdcbbcdddbacadaaddccbcbadadaccdcaa	FALSE
aaaaabbddadaabcdcbacdaabcbacacdddaadaabcbacc	FALSE
aaaaabcbcdbcccdbadabcabcadcdddbcbacbbdcaaccb	FALSE
aaaaabcdcadbdbbaadcabcabaddabcddabdadbdaaddc	FALSE
aaaaabdbbcbadbcccaccccdaacbdcdadabcccbbdcddc	FALSE
aaaaabddbdaacadcbadccdcdbdcccbcbcabdbaddddcc	FALSE
aaaaacabbdaabacbdddddacadddabcacdbaacdacddbc	FALSE
aaaaacadbcdbdddcbdbcdbdaaaabcdcdcacbddbccaab	FALSE
aaaaacbbcadccccadccaaccabbadbabccabcbddccabd	FALSE
aaaaacbddbacacaaccaccbcdcdddbbbbabbdabcabcbb	FALSE
aaaaaccbdbbcabbccdcdcaadbacbdcdcacbcaacaaddb	FALSE
aaaaaccddcaacddbdacbdcabbbcaaccccdbaabdaaddc	FALSE
aaaaacdbccaaaacbabadcbabcdaaadabdbdaaaabaaba	FALSE
aaaaacddbacbabacbbddcdaabaddbacbbadadddcbdbb	FALSE
aaaaadabaabcccadaabbdbdacdbabbbacdaaaababcaa	FALSE
aaaaadadabcadcdccbbdcddcdbcbdbadbbdcbdcbbcbb	FALSE
aaaaadbadbbabdcabaddacbacaccbbadbcddbcaacdbc	FALSE
aaaaadbccadcdabdcbdbccccabbbaccacdcadbbccbda	FALSE
aaaaadcacbccacbbaabddbaacdbaccacddabcdbcacab	FALSE
aaaaadccbdacacdbcdcadabadbdbcbcbcbcaacaddcdb	FALSE
aaaaaddabaddbdaddcbcdcbaadccabddddcacdabaaca	FALSE
aaaaaddcaaacadaaabdaacddaddacbbbcacddccbddda	FALSE
aaaabcbcbdcbaadabccacacbddabacacadacbcaadcad	TRUE
aadabaabcaabadbccdadbacacdbcbbdabaacbbabadda	TRUE
abbcdbbcadcbcdcbabbddcaacaccdbbcccdaaddbaccc	TRUE
acabaadbddadaaccdbddbddadcdddaaccacdbdacdadd	TRUE
accbbccdbddacdabcbbccbaacbcacaccadcaababacbb	TRUE
adaddccccdcbbdccdbbaadcaadbddccccbdcadabbbdc	TRUE
addcaacdcaaccdddbadbdbbdbdacaaadacddadacdccc	TRUE
bacabadacaddbcdbcadacdcbbddacdbcddbdbbbbabaa	TRUE
bbaadcbbaabcdacbaaccbaadaccbcacbcaadbabdddca	TRUE
bbccdddacdbaabcccadbbaabccbaddcacbbdabbcbcca	TRUE
bcbbbabcbcddbbaabbccdbbdadadadbabbacdcacdbad	TRUE
bdaaadcacadcbbcadabdbbbdaccdcadbcddcadbdddab	TRUE
bdcdbacddbcdacadbacadcbadaabdbbdbdccbdbdbbab	TRUE
cabcdababccdbcddcdcdcbcdabcacdacbaccdacdacad	TRUE
caddaddabadccadbcdacaadcbdbbbacdcdbadbadccaa	TRUE
cbcacbabdacdadbbccabbaadabdbaaadddababbacbad	TRUE
ccacbaaabbaabcdbdcacaaacbccdbacdcbcabaacbbda	TRUE
ccdccadcbddbdbacdaccdbaacbdabcaccccdaccabadc	TRUE
cdcaaabdacacadabacdbdbcccabdddcabdddbcbbcdab	TRUE
daddbababcdddbdbbcadabdddcdacabdcdcdbbabcbcd	TRUE
dacaccdcbccdcdbddadbbabdbddbcdadbadcdbabccbd	TRUE
dbbccbbcdbdbacabdccbbcbcdbdaddcdbabdccddacbd	TRUE
dcadbaabadbadabdbdbaadbcabcaacdaacddbabcdaca	TRUE
dcdbcdadbaabdaacabbabcdcdcbcccaabaadbcbbccbc	TRUE
ddbccacaacbbaacbcbcaccdabdcbcddcdabbdbcabcbb	TRUE
aaaaabaaaadbbdabbabcabbaaacccaabcdcddbcccabda	FALSE
aaaaabacabcbdabbbbababdaccbbddbbaddbabaacadac	FALSE
aaaaabbaaaaacbabbddaadabdaaccccbdddadabdccddd	FALSE
aaaaabbcaaaccaaddbadbddaadbbbdbacddcdcdbaddaa	FALSE
aaaaabcabaabdcabaaacaaccacaabacaccbddadbadcbb	FALSE
aaaaabccbdbacaccdbadccacabbcacddbbbacdbabccdb	FALSE
aaaaabdabcabdddaaacaabdcadbadcdacbdacbcbadbbb	FALSE
aaaaabdcbdbacccbddacdadaabaaccbbbbbaccccbadac	FALSE
aaaaacaabacbbcccbdcbbdadabddcdcbaabdbbaabaada	FALSE
aaaaacacabbbacbbaabadbacbaddbacacbaadddcbbabc	FALSE
aaaaacadddadacaccababdbcdabcccbcaddadbcdadaac	FALSE
aaaaacbbddaddbcdabcabbadaccddcbbcaddacadccdbb	FALSE
aaaaacbdccccbaaccbddbaabadcadcdbbbacddaacacca	FALSE
aaaaaccbccdaabbbdbbcbdcdcdabaaabbbcbddbddcbac	FALSE
aaaaaccdbdadaccdbbbdadaacabdbccacdabacaddcadb	FALSE
aaaaacdbcdadddacbddbcabaadbcdbaacbddbbadcddac	FALSE
aaaaacddbcaacbbcababdacdddcacdcaacaaabcaadddc	FALSE
aaaaadababdcaadbacbdacbcbabccccadbbdacaccaabd	FALSE
aaaaadacdbcacbdbdbcdbaaacadcdccddaddcbacadcbd	FALSE
aaaaadbadcbbbddbadccadabcdcddaddcdcacbdcdabcd	FALSE
aaaaadbcdcddadddcdcacaadaacdcbadccabbdabacaaa	FALSE
aaaaadcaccccbadadabddcaccabdacbbaabaaccaadbab	FALSE
aaaaadccbdbdcabccbaadcaabdddddaadaddabddabcca	FALSE
aaaaaddacdcbccacbdbcddaabcccdcaababdbbdabccdc	FALSE
aaaaaddcadacabdacbaabccdaacabccccccdbddbdccbd	FALSE
aaaabadcabddbaabcdabcddbcbcbccbbbacabdccdaaba	TRUE
aadaabddaadddbabbaaabcaccbbbdbabbacbbbbababca	TRUE
abbcadaadadbaadcdccbaacadbcbcabcbbacdadccdbba	TRUE
acacdbabdcaacaddabcddbbdadbdbdbbcdaaadbdadbdb	TRUE
acdadacabdabccdbcdbbcaaadcdbccacadbcbdcaacdac	TRUE
adbbcbccbbdabadbbaacbbaaacabddddbbcbbacdbbabd	TRUE
addddacbcbbdbbadbbcdacdbcaacdbacdcbddabbbdabd	TRUE
bacdbababacbdabccadddbaccdbcabacacacaabbadabc	TRUE
bbbbbcdbcbaacabaadcccdddadccdcccdaaadcabaaaba	TRUE
bbdbbddbaddbbbccbacdcccbdcabddaadccddccbcadca	TRUE
bccaabbcbaaadbabadcdabcadabcbccbbcacccccbbbba	TRUE
bdabcacdcdaaaadddadcddccabbdacbdabccaddddaabc	TRUE
bdccddabbcbdbbbbcddaccacbbddcdddbbcccaadcadac	TRUE
cababdabaddcbcbacdcdbaddcccddacddbcaaacbdaaca	TRUE
cadcaccccaaacaccadbccbabcddadadccbbacccbdaabd	TRUE
cbcababacddacabddabbcbbbaccbbdaaaacadbadbdbdb	TRUE
ccaccddabcaabdadccbcbbcdcaddcbbcbcdbbdbdcadbb	TRUE
ccdaadcacccabbcdabaacbccbbaacbcbcbccdddcbacbd	TRUE
cdcaaacddcdcabdacaccabbdbaccbdaadbbbbcbcdcaad	TRUE
daaccbaccacbdbcaabaaadbcdbaccabdbacbdbdddbcdc	TRUE
dadbccaadbbdcddcadcbdacdcdabbdcaaabaacddbbccc	TRUE
dbcabcdbaadcccadbaaddabaaabadddcdabbaddcaaccb	TRUE
dcacbdbabcadcacbdddcccbbddacaadcaacadaadaddcc	TRUE
dccdcdbcaddccabbbcaacacccdbbbadcaaaabbdddabcb	TRUE
ddbbcdcccbddbcaabaaacccbbdacadbaabbaadbbacddc	TRUE
aaaaabaaaaadbcbabbcabbbdbaacbbbbccabdbbaabadab	FALSE
aaaaababdbdaacdbccdbcacbadccaccadccaddbcadabca	FALSE
aaaaabadbdccdddddaacacdabdcbaabacbdbcbdcacbcab	FALSE
aaaaabbbbccaabaacbccadbacadaddacbbdddbccabdcdc	FALSE
aaaaabbdbbabcbbababbdcccdcdcacadbdbaabbaddacba	FALSE
aaaaabcbbbddbabbbcbdcabaaaaabdbbdbabdadbdaaaac	FALSE
aaaaabcdbdcbcdcadbacdabdabcbcdddacabccabacbadb	FALSE
aaaaabdbbcdaacbabaacbbabddddccddcdcbabccabbccb	FALSE
aaaaabddbcadadaadcbcacadcddcabaaadbdccdbcabcbc	FALSE
aaaaacabcacbcbdcdcdaaadcadbbbdcadbccabbaacddaa	FALSE
aaaaacadbaaccacabcadcabcddbabdacdacdcbbdccddaa	FALSE
aaaaacbadcdccbbdcbbcccbdbdddadbcabdadbdbcbbbdc	FALSE
aaaaacbcdccbdbaacadaddbccdcacdbbccbbbdcacdcdcc	FALSE
aaaaaccacbaadababddbbbabcdddaabbaabadcacadacbd	FALSE
aaaaacccddaccbcddbabccacdaabcacadcdcdcbdcacdcc	FALSE
aaaaacdadaabcccbaddadabcdcaccdccdbcaadaaccbdad	FALSE
aaaaacdcdadccaccccaabbdbbabcdbbaabbcdddabccbaa	FALSE
aaaaadaadbacbacdadbdbbbccdcdacabacaddbabcbdccd	FALSE
aaaaadacccadcbdcbdabcbacbaacdbaabcdddccabcbccd	FALSE
aaaaadbabbdbcdddcaddbbbaacbddababbbddadbaaabad	FALSE
aaaaadbcbcaaabcdbcddcadaddbaacddcaaacbbabbccbb	FALSE
aaaaadcacbdcbabcdbcccaccadbbcdcaddbcbaadcbabcb	FALSE
aaaaadcccadccccbddcabdaababcbdcadbaadccbacbccb	FALSE
aaaaaddaccaadcbaacadaddddbdcccdaabcbacbcaaaabc	FALSE
aaaaaddccaacccbcccadbcddcbbdbdabaccbacaddddacc	FALSE
aaaaaaaddbdbcdbdddbddabddddccacdcbbdacabdcdbbb	TRUE
aaccabddcdbdcabacadabcbbcabbacdddbbbabcddabcdd	TRUE
abbaccbadbdbbdbcabbbcdddcbdbdbbcdbcbdaadacbbcd	TRUE
abdccdddcbccbcdccaddcdbbbaacabcdddabacbbacadbc	TRUE
acccbbbbddccbbdddccddababadcdddbcbacdacbdddcdd	TRUE
adbbdabacaabcadabddabbcabdbabccccbaabddbadcdac	TRUE
addcbcdcbcacbddbcddaabacdbddabaacacadadaacbacb	TRUE
bacbbadbaabacaddcbadaccdbbbbbdaddaadcddbddcdab	TRUE
bbacbccdccabbdacccdabcabdcaddabdacaadcabdcccdb	TRUE
bbcdbcddaadacbcbbbadbaacaaabbbdcadccdaccdcdbca	TRUE
bcbabccddaaaabbbdabcbaacdacbbaccacabdaabdccbbd	TRUE
bcddcbdbdbcbdcdcbdabcbbccbdcdababccadbcabdcbac	TRUE
bdcdccacabaaaccbbdaacdbcbcdcdacdcdcaabcaabccba	TRUE
cabcadbaadbddbaadcaabdcbbbdcbddbdcddabbcaccbbc	TRUE
cbaacdbcbcabcbbbcbdcabbadacdaddcadbbccdaacacca	TRUE
cbccbacbcdbaccaaabacccaccccddacccbcccbadddcdab	TRUE
ccbabcddacabbdcdabbacbabbadddadbacbadbaaddbdba	TRUE
ccddbdddddddbbdbaaaabbcdacdbdabcbccddcbacababa	TRUE
cdcbdddcdbcdbdabbbaacddcbaaabbbdcbdacbaabaadda	TRUE
dabaaaccdbbcdccbcbbddbadbbbadaddcdabdadaadacdd	TRUE
daddbdaaaaddccccbdbbdccbbdbcbbadbbcadaabaaaddc	TRUE
dbccbababacababcddcaabcccdbdccdacdddbcbcadcbcc	TRUE
dcbabbddcbbccdddabddacbaaabbabcdacdcbbabddbdbc	TRUE
dcdbdddddaadddccdccbdabacaacddadaddddcccbdbdac	TRUE
ddbcadbccbbbddabababccbcacdbbacaabcbcdacbacaba	TRUE
aaaaabaaaabdbbdacdaaaabdadbddababbbcbbbaaaddddc	FALSE
aaaaababccbcabcbdbcaddccdaccbcdcaaaacaddddaacbb	FALSE
aaaaabadbcdbbbbdbbbbcaccdbabaddbcadcabacddccccb	FALSE
aaaaabbbadaccdcccdbcadbccdbcadaadacdddbabdaadda	FALSE
aaaaabbdababdcbddccaddabbdcccbaababcbdccdcccaab	FALSE
aaaaabcaddbbdcaacaabdadcbcdbbacaadcbcdcacdddbcb	FALSE
aaaaabcdbbcdbbccbdcdabbbcaaacbdcadcbbdaadcbaccd	FALSE
aaaaabdbbdaddacbbabcabbbcbcabdccdbbbcbacabbacdd	FALSE
aaaaabddbaacacbbcccbcaddabccababcccccadcbaadddc	FALSE
aaaaacabbadadcddbbbbdddbdbbbdbcacccdbdddadbacdd	FALSE
aaaaacadbcaaddcadbdbbadadbcdaddccabbabdbbbbbaba	FALSE
aaaaacbbacccdbabccabcacbbbbcccbcbcdbcdcdaddddba	FALSE
aaaaacbdbacccccddcbdcaaabdaaacabdddbacdbcaccaaa	FALSE
aaaaaccbacccdbdccccddbbbbdcdddacaabdcaadcaaddaa	FALSE
aaaaaccdadbcbbaddcabbcbbccdcdcdbabcbdcaddaababa	FALSE
aaaaacdbaabdbcbdabcaccdaddbdbacccbabcdadcddcbcb	FALSE
aaaaacddaacbbcbadaacbabdadddcbccbadddabdbbbabba	FALSE
aaaaadabacddcdabdaddcdddacbbaddcaaaadacbcccbbbd	FALSE
aaaaadadbcadbdcaccdbabcaacbbacabddaabbdcdddbbab	FALSE
aaaaadbbaccabdbbacaabcbbbccacddacacaacddcadaabd	FALSE
aaaaadbcdaabcccdbbaadaabdccadbbdcccccaaaabaddbb	FALSE
aaaaadcaccdaabbbacbadbbdaaaddddbbbacbbbcbbddbcc	FALSE
aaaaadccbacadcdbbbccbbbbbbdadaccacaaaccbaccaccb	FALSE
aaaaadcddcccadaaadbbacababbbaaacccdadbdbddabcba	FALSE
aaaaaddcaacdacbabbaacabddadaccbcccacaccbcdbabab	FALSE
aaaacabdadcbdcbaacccdbdcacaabbbcddcacaadcbbcdca	TRUE
aaccadacdcaddddbccbaccbbacdabdcbbcdddbcccdcbbda	TRUE
abacdcdbdcdacaacaabaaaabdadbdccbabdcacdabcdaacd	TRUE
abdbddabbcbbbbadbcaddbbcabdcbabbbacddaccbbaaada	TRUE
accacddbdcbdcdbbaddbaccacbadcadbdbbdabddcadddad	TRUE
adacabdcdaacdbaadadabdbdcadaadcdbccbdbdaabdcbac	TRUE
adcdadcacadbadcbadddbbbcbcdcddbaadaaccdadbbcdbb	TRUE
babbbbbbcbddacddddcbdbcbcbbabbbabbcabbddccacaac	TRUE
baddccdbbabbcaaaaadadcddbdccadcbcacadbbabadaaab	TRUE
bbccccccbdabccbdcabdcaaaddbdadcbddbadbccaddacdb	TRUE
bcbabcabccabcbcddbadabadcdacccababddacbcdaabccd	TRUE
bcdcdcbabacbddccdacbbadbbaacdbdcbbdbbcdaacaccdc	TRUE
bdbddadcddaccbdaabcccccbdacadcdaddddbbadddbabab	TRUE
caaacadbbccababdacdadcbadcadcdbacbadcbaaaaabcab	TRUE
caccbbddccabccabcddcababcbccbcabbcbdcabdaddbcdd	TRUE
cbbbbabbdacbdbaabbaabccbcddacaadbacddaaddcdcdcc	TRUE
ccaaaaadcdcbdbbcdbacbbccddcabcabdcdadccdddcddbb	TRUE
cccdbddaddccbcddbabaaccaaabcbadadcdddadbcaccacc	TRUE
cdbbdbabaddcaaabbabdcbabdabacbdccbbcdabdaabcada	TRUE
cddcbbcabadabaacabadbddbbbadddcbadcaadaccaddcba	TRUE
dacbacccaddbdaaaccdcddbaadbcaddcadbcabcabddaacb	TRUE
dbbacacadcadcdbadaddadbcbcdbdcacbaabbdbbcaccdac	TRUE
dcabbdcadddbdadbaabcbcbbcbccbbdcbccbdcadbaadcdc	TRUE
dccccccbacbcbaccadabaddbbbacdadddbdbabaadbdcbcc	TRUE
ddbbbcdbcabbabbdabcabdacdbbabdadbdaaacadbdaaddc	TRUE
aaaaabaaabbcdcacbbdacddadbaccbbccdbacbdbdabbacdb	FALSE
aaaaabacaddabbbacabadbdbcabdcadabccddccdbaaddaba	FALSE
aaaaabaddaabdbbbdcdbcdccccdccdbdcacbaaddbacccabc	FALSE
aaaaabbbddabdadacdaaabdaccccddbcbdbacbbdcabbcbbb	FALSE
aaaaabbddaccacdcdddbbbdbbbbbaddddacdcdddbbcbadad	FALSE
aaaaabcbcdcbcbcaaabddaadbaabbbabbdabbdadabbbcbaa	FALSE
aaaaabcdccaabdbbadcbbddadabdacacccbacddadaadadba	FALSE
aaaaabdbdbbacdccadccadcabacdacaddbbcaadcbdadacda	FALSE
aaaaabddcccabbdaacbabbccdcdcadddaadacacccbdabbdb	FALSE
aaaaacabdbabdbacaddbdbcadbbcdbbacbccbbcbcbdabcaa	FALSE
aaaaacaddbaadddaacdadbdbcaddabacaddabdaccaaddabd	FALSE
aaaaacbbcabcadacccddddbbbbbadadcbabdbbadddddacad	FALSE
aaaaacbdbbcbccadccacbbaccaacdacbaaaabdbddaabcabc	FALSE
aaaaaccbacaaacaadcbadabcabadbcccdcaacacacaadccdc	FALSE
aaaaaccdabcbdbaabcbabcaccaddbdbbdaaddbbadcdcbbbc	FALSE
aaaaacdbaadbbdcddddcccdbdacccccdbbcbbcbacddcabbb	FALSE
aaaaacdcdaadbdaaabbcbbcccdbbbacbdcdddcbdadaddacb	FALSE
aaaaadaacacbdddbacdadcaadbbaabbababddbcadacdbbac	FALSE
aaaaadacbbccbcbabdbcbccdcdacbbbdbabdbddbbacbcbdd	FALSE
aaaaadbabbabcccbcccacbcacdbaababdddcdaacaadbbacc	FALSE
aaaaadbbdddacabcbcccbdbddadabaccdadccdccacdaabbd	FALSE
aaaaadbddabbbadcdbdcdacbdacbbcadaabdbaaaaabaacbc	FALSE
aaaaadcbdbdcbdcbacdacbaaadcbadcadabbababadcdcdda	FALSE
aaaaadcdcabbdddccacacdcbddddbdbabacaabaacdacbdba	FALSE
aaaaaddbccdabaaabddbcbcbbabbcbcccdaadbcbacbbacdd	FALSE
aaaacdaccbcbabbdcbbcacbdcabdccccdddbbddacdcabbab	TRUE
aaccbcdacdbdddbdccddbbdacbdaaaddddbcbaaacccccdbd	TRUE
abbbbccabacbbcbdbdcddacddcbacbddabcccbcdcbbbaaad	TRUE
acabbbdadcddaacdaaddbcddddccccbcddccbdbdcbcaacac	TRUE
acccbcbcbdaabadbbbbabacadbcccaaabdddcccccaadacdb	TRUE
adbaddddaaacbadabcaadcdbacabacaadcabaabcdbbccadb	TRUE
addddcbbadcdbabbdcdcbdbbddcaabbcacacdbbbdccabcba	TRUE
bacbccbdbdcdcdbbcccdbabbaabbccbaaccddadbccbdbcab	TRUE
bbabdcccaaddbdbacadaaacadcbbcdcddccbbaabbbcbdbaa	TRUE
bbdbbccabcddccaaccccdcddbddddbabadaacccdcdcacaaa	TRUE
bcbcabbdccaccddbbcbdbbbddccccbcabcdbaccaacccddac	TRUE
bdaabacdacdabadaaadaaaccaadabbbadcccacaaccdcabbc	TRUE
bdcdbbcccdbcbccabcaccaaacabccddcdcddaacddbadbadd	TRUE
cabbdccacbdbddcaaccacbbadcbbbbcddbacbcadacdbbdbb	TRUE
caddcaaabcdcddbddddacbcadaaabbdbabddcaadaddddbad	TRUE
cbcbcccbdbcabddcdabbcbaccbbbbcdbcbcacccaaacbdbcd	TRUE
ccacbcaddbadbcaabaddccccbbacaabdcaccacdcacbabdca	TRUE
ccdbddbbbddcdbbbcdbdadcdabbddaccacccabdcbaccbbcb	TRUE
cdcacccbadbdbacabddcddddabcbacdaaaaabcddcbbcdaab	TRUE
daacdcbbacdbbadaadadcccaaaadabdaadadaccdbaabcdaa	TRUE
dadaddbdbbcdbcccacbcbabacbdacadadbcbbbcbddbbcbab	TRUE
dbbcabadcbabdacdcbddbbcbaaababbbbbbacbcdabbcccda	TRUE
dcaabcdaddccdcababdabadcdbcabbdbadbacbccabccaddd	TRUE
dccdcccddacabdcaacacdccacbdcbbabbbbdccbccdbabbad	TRUE
ddbbdcdbbdacaadbbabcacabadcbaccbaadabbbddcacabbd	TRUE
aaaaabaaaacabadbbdabccbdcdccdbcddcadaaddcbbdcbddd	FALSE
aaaaababccddabdcaccbbdabaacbadcbbbddbdacbaaabbdaa	FALSE
aaaaabadcddccadbcadaabbdccdaabbcdaaddaadabbadddcd	FALSE
aaaaabbbbcaadadadbacaaddacbdabbcbacddbdcabdbddaba	FALSE
aaaaabbdbdababdaccdadbcbdaccbbbcdabdcbbdbbcdcbbda	FALSE
aaaaabcbacbbddbcbadcbcabbabcbcddadabaaccdcccbabbd	FALSE
aaaaabcdaaddbabbcadccddacaccacddcdbdacbdacbbacada	FALSE
aaaaabdadbdcbbcdcadbccaddcbbccccdcdcabbdbcbdadccb	FALSE
aaaaabdccbcccdcbccdcdabcdcddccccdaccccdbccddbdaac	FALSE
aaaaacaaccbbdcaddbbddaaddbdabccbdabbbccabdccccada	FALSE
aaaaacaccadddaabcbababadadbbdbbcaccbadcaacdaabdcb	FALSE
aaaaacbabcbcdbbdbabcdadacabbdbbdddbbaddccbccbadbb	FALSE
aaaaacbcaaabdcdcbdddddaacdcdaccbdbccaacacaacddbdb	FALSE
aaaaacbdcdcabdbacaccbbbadcdcabbabbdbcdcdbaadbcdda	FALSE
aaaaaccbddcddddccbdabdcacaacbbccdcbaccbbbbcbaabba	FALSE
aaaaacdaaaaddbadaddadaadcdccaaccacacdcdddcbbacccd	FALSE
aaaaacdcacdaaabaabcbbdcacddcbccadabacdcdababcbacc	FALSE
aaaaadaaabbdaacbcddbdabdbbabbcddacabdccddccdccaba	FALSE
aaaaadabddadbdaddddaaabccaddbbdabddddcdcaddaadbac	FALSE
aaaaadbaacdcddabddbcddaaadcadbabaabaddbddaacdcbab	FALSE
aaaaadbcaadbabccbcdcdbcbadbbacabcddbdccdbcaaccaaa	FALSE
aaaaadcababbddbbcbbcccccdabcdbaddcccacadacccdadbc	FALSE
aaaaadccbabcaaddacddddcdaaadcddccbbbcddbbdacbcadb	FALSE
aaaaaddaaddaadbdcbaaaacabdbbbbcabcdbbaddaddddbdbc	FALSE
aaaaaddcbadcddcbbabddacbadcabbadccadbcddbbddacbbd	FALSE
aaaaaabddcaababbdcbaadaacbcddcadbbcdcddaadaacabbb	TRUE
aacdbbbdbaadabbbaddbabdbddaacbadccaddddbadaabbbcb	TRUE
abbcccaccdbddcdadcaadacaccabcacaaaaabdbacaacbbdab	TRUE
acaadbddabdbadacdadaddcacbdddbdbcbabbbcbcbccdbbca	TRUE
acdaacacbdbacdaacccdacabdbacabadabcbdaddcddbddddb	TRUE
adbcddaadaacbadadcaacdbbbdadbadccbccbddababaacbcc	TRUE
baabdabbcabadaadacdadabcbabbbbdccdcdbadcbdddacbbc	TRUE
bacdadabdbddddaaddcbdcaaadbcbdaccccdbcbbccbaddcbc	TRUE
bbaddbadbabccbbdcbddabbabdbcbbcdbbccdcbddcabbbbab	TRUE
bbdcccdbcadbcaabdbcddbddbaacabbacdcccbcdcccbdcacb	TRUE
bcccacaabdcbadbabdbdadcddcdbcbbdbadccbbaabbcaaccc	TRUE
bdbbaaaabbdbcbbbbddaccacdacadaccbcdabccbadbbaaddc	TRUE
bdddaabbadcdaddbdbdddaabacbbdcccccbcdcddabdbdacbc	TRUE
cacbcaaabbdaaaaccdbadaaccacbbdcdccabccabdbbccabdb	TRUE
cbadcbccbcbaacbabaadaacbbdacabcbbadddcaaccababacb	TRUE
cbdbbddbdcaababcabbbdaabdabbdcdacbcdacacacbbccabb	TRUE
ccbdbdbaddbababcdddcdbbabadbbbacabbdacbcbbadcddba	TRUE
cdadbcbabccdcccbcaaaacdcabbcdbdcacbcbccdadabbaccc	TRUE
cddaccdbbdbccaadcdbbcdbccbcdbadcccacdaddadaddcdca	TRUE
dabbbcaaddcdacbaadcaabbdcdacdbcbbdbbcdcbcccdabbcd	TRUE
dadbdcaaccbcaccbcbbdbdbaacdcccbdbcdbddccddccadacc	TRUE
dbbdcdaaabdbdacacacbbcabacaadcaacacccaaabbdadbaba	TRUE
dcacbacdcccadabbbdcaabccaadbcaddddacbadadacdbaadb	TRUE
dccdcbdcbdcbccaabdacbddccdccdcacccdaddadbaabcdcac	TRUE
ddbcbdbddddddccabaabdcccdccbbcbaacacadacccdcdbdca	TRUE
aaaaabaaaabccbaaddcacabdbcacaccccdbcadcaccbacacaaa	FALSE
aaaaababdacddadadcccdbddcbdbccdbccadbdbcddaddccadd	FALSE
aaaaabadddddddbdcbacdaacbbdcdbbddcadabaddbbddddcac	FALSE
aaaaabbcaacccbacdbccabbcccbacbbdbabadcbadacbbaaacd	FALSE
aaaaabbddcdcdcbadddabbadbddaabcdabcddaabadababdada	FALSE
aaaaabcbcdbcdcdacbcaacbadccbdacaababbcdadcdcdadaab	FALSE
aaaaabcddabbabbdacabacdacacadbddadababccdbacddaaca	FALSE
aaaaabdbcdcdddbbcbbddbbddbccdadaccbdcdcbadaccacbda	FALSE
aaaaabddbcaabaacccdccbcdadcacdbdbaaaacddbdbbddddca	FALSE
aaaaacabbaadababcbaaddcbbaadcbaddbaaaddacbcddacdbd	FALSE
aaaaacadadbdcbdbbbbbccbccabdbdaddddcadddbacaddaccc	FALSE
aaaaacbbaacabbbbbbcbbacacbdaabbcbaadadbbcdbbbaabcb	FALSE
aaaaacbcbdddcccccbcbdcdbdcccbacbabbcbdddcaabaadcaa	FALSE
aaaaaccabddcdcaaccabaadbaddabaacbcdabaaccbcadbdacb	FALSE
aaaaaccccbaaaddcbcdbbbdccdabaaabccbbcbcccbbbddbadd	FALSE
aaaaacdabdbcaaadccbdaccbaccdccdbadcabaacaaaddcbbda	FALSE
aaaaacdcbadbaddbddaaabcccaaaacbabccacadcbdcbcaccbc	FALSE
aaaaadaabcdbdbabdbcbbccbabddbccbbcdcaacdaacbbabdbc	FALSE
aaaaadaccaabcadacdcbacbaccddabddcbadddcabaccadccbb	FALSE
aaaaadbababdbbbcabdaaddcadacabdcbdddcbcbbdabdbccdc	FALSE
aaaaadbcaacbacbcaadcddaabaadddaabcccdababccbdbbdda	FALSE
aaaaadbdddacbbdabbacdddcbbcbcbccabdbbcdcaccdddacbb	FALSE
aaaaadccadabdcddbdbaaabcadbccbbadddcbbcdbbdddadabb	FALSE
aaaaaddaabbaaccddcdbdabcdcdccaaddcccdaadbbdadcbcbc	FALSE
aaaaaddcadbcaccdaabcaccbdabbcacbbbaccbbbadbaadbdab	FALSE
aaaabadaacbabbbcbbcdbacbdcabaadaaadabccadccdddaaaa	TRUE
aadabbaaabacbadababaccbadadbbbdbcbbbbdbdacaabdaadb	TRUE
abbccbcbadcbbacadbabccdaabbddabddbcbdcdbaaaadbccbc	TRUE
acaaddaddadaabcdbbdddbcdcbadacacaadaaddbcbbbdabdbc	TRUE
acccbdbdcccdcdacadcccaccbbaddbabccddcdbbbbdadadbac	TRUE
adadbbbcbdcddccbcbaaabccdaacccdcbbbbcdcddacddabbac	TRUE
addadbacdaccacbadbbcddcddadbddabaacabcadaddacbcdac	TRUE
bacabbcbacabdbbbaacabcdcbcacbbaaabcdabcddbbdcabdbc	TRUE
bbadcabacbaaccacdddaccbbcccadcbbdcabbddbabdbdddaac	TRUE
bbdbbaaaabacabcdccdbdbddbdbbcacbbcaaacddcadcccdcca	TRUE
bcbdcabacbdacccaadcabbbddacacadbbbdcaaccdbcdadbccc	TRUE
bcddddcbdcdbbaddcaadbbcdcbddbaaddcacddbbaadbbcccdb	TRUE
bdccaaddbdaccbdaddccadccbcbdaadccbbcaadbcccbcdacdb	TRUE
caadcacadccabaaddaccdbabaadbaacbaaccccbcdaccbadcab	TRUE
caddbdadcdacdaaccccaacbaabbcbddbbbaacdabbcadadcdbc	TRUE
cbcbdbdddddcbabbbbaaaaddbbcccdadcadbcbcbaddaccdbda	TRUE
ccbadddcabacbdbcdacbbdccbadcbbdbcabcaddcbdbccaaaac	TRUE
ccddcdaddbadacababcdcdabcaabddbcaccaabcbddbcdababa	TRUE
cdccbcbabdcbcaadcbcdbabdaddddbbbbdcccacbdabcdcbadd	TRUE
dabadaddacdbcaddcdbbcadbdaaaabcdcacbaddadacaaaddbd	TRUE
dadbdbabaaaaadbcdbbcbbabcbabbdbbdabbdcbbcddbabbacd	TRUE
dbbdbcbbabcdcbcabaadbabcabadabcaabbcdbbddaadbdadbb	TRUE
dcabdadbbaaabbdaccbadbcabdbcdcdcbcbadbacdbbcdaaddd	TRUE
dcdabcbdbaccbcbccabcbbddddbccaccdcabdccadcacbcccdd	TRUE
ddbcdddddbacaabcaabcadadcdcdcdbccacbabaabacaaadbdc	TRUE
