aaaaabbdbdcdaddabcab	TRUE
aabbaddcbddcbdcccdcb	TRUE
aaccbdbbbddcccaacaaa	TRUE
aadddccbdaaacaaaabca	TRUE
abbadcbbddbcaacdbcbb	TRUE
abccaccadbcbcbcbbbad	TRUE
abddaccaccadcadbbccd	TRUE
acadcbbbcccacdaddadc	TRUE
acbdccdcdcbaadacdacd	TRUE
acdbadaddbcdcacbdaaa	TRUE
adadbcdadbbccdbdbadb	TRUE
adccadcdacdddbcabcba	TRUE
adddccaadbcabcababbd	TRUE
babadaacdddbcdcbadba	TRUE
bacbbdacdcbccdccddbd	TRUE
badccbbadbcdacbcacbd	TRUE
bbadbaabacbdcdbacadd	TRUE
bbcbbcccabbbdcacdcbc	TRUE
bbdcdccdccdddcccdcad	TRUE
bcbabcbddabdabaadbdd	TRUE
bccbbaabdcaccbccaddc	TRUE
bcdcabdbaaacdcdcdbdc	TRUE
bdadaddaababccabadac	TRUE
bdcacdddddddabbcbadc	TRUE
bddcabdaacdaccacacad	TRUE
caadcadbbacaaadccadd	TRUE
cacabcddadcbdbbbbaad	TRUE
cadacadbbcadadcacada	TRUE
cbaadbdcbccddccddccc	TRUE
cbbcbdccddcbbacccccc	TRUE
cbcdabccbbadcbbdcbdd	TRUE
cbdddadbbdcaadacadca	TRUE
ccbbaacddacdcdcaadaa	TRUE
cccbdccbcbcabccbdaad	TRUE
ccddbaadbbdcabdaabcc	TRUE
cdaddaccbbbadaaadaba	TRUE
cdcbbbbcabacbabaddab	TRUE
cddcacdaddbacbdcbaab	TRUE
daaddcddadbbbcdbbcbc	TRUE
dacacaabcdacabadabca	TRUE
dadbcdbcbdbbcbcadbbc	TRUE
dbadbbbbbbbcdaacdadc	TRUE
dbcaababbcbbbbdbbbcc	TRUE
dbdbbcaaadbaaababcdc	TRUE
dcabdadbbcdbcbaccbcb	TRUE
dcbccdbbacabcbbdbcbd	TRUE
dccdaddccddaaacbccdd	TRUE
ddaadaaccdccbacbacda	TRUE
ddbbcadbabadddbcddab	TRUE
ddccababbbccbcbcdbab	TRUE
aaaaaaaabcbccdbcadbb	FALSE
aaabbccdcbcadadaadda	FALSE
aababbbbbccdbbbdaabd	FALSE
aabdaababadacddabbab	FALSE
aacddccbadbbbbdabbdb	FALSE
aaddadddbbbbaccdbadd	FALSE
ababbababdabadadaacc	FALSE
abadddaadbbdacaaabbd	FALSE
abbbbcdbdbcddaaaaadb	FALSE
abcbdbdbccaadbbaaddd	FALSE
abdbccbdbbbaaaaddbda	FALSE
acbbaaaddbaaadadbbbd	FALSE
accbddbbdabdbbdaabaa	FALSE
adabaadbddabdaddaaaa	FALSE
adbbaaddbdddcaaacddb	FALSE
addaddbbadbccaddbaaa	FALSE
baaaaddadbadddddaadb	FALSE
baabcddbdadabcbbbbdb	FALSE
bababaadaabbaaaaaacb	FALSE
babcbabbbdbbbbbabbdb	FALSE
bacbdabddadbadbddddd	FALSE
badbbabaadbdaadbaccd	FALSE
bbaacbdbbddabdaadaba	FALSE
bbadaddbccbbbcbbcaab	FALSE
bbbbdaabddaabadbdcbd	FALSE
bbccaaaaddbbddddccbb	FALSE
bbdbddadbdabaabdbadc	FALSE
bcbbcbbcdcbccbadbaaa	FALSE
bcccdbdcbbadaababaaa	FALSE
bdaaddbbaabdadadcbcc	FALSE
bdbaaddcccbabbabbbad	FALSE
bdcbddaaabddadaaabdd	FALSE
bddddbbabbbbbbadbddb	FALSE
cbaabbbaababdcdbbbbd	FALSE
cbcaacdbbbdddbdbdddc	FALSE
ccaaaabacbdbdbcccddb	FALSE
ccbddadaaaabbadababa	FALSE
ccdbddbaaabddabcbccc	FALSE
cdcbcbbccbbcdbbddabd	FALSE
daabbaabcbbcabbabbba	FALSE
dabacbcbcabdabdbabab	FALSE
dadaaaddaacccaabbbdb	FALSE
daddbdadbcbaaaabcdbd	FALSE
dbadabbabadcbddbdadd	FALSE
dbbbdadbabacbcabbada	FALSE
dbdbabbbdcbccbbbbcac	FALSE
dcbccbbbadbddaabdadd	FALSE
ddabbdbbaccadabdddda	FALSE
ddbbccdabababaabaddd	FALSE
dddabbcccaaddabdabbd	FALSE
aaaaaacacadbdcdbcbcac	TRUE
aabbdbcabdccbddadbbcd	TRUE
aacdbabbaccdadcddcddd	TRUE
ababbcbdcbaddcbbbdcba	TRUE
abbcddbdabdbacbabdcbb	TRUE
abdabbababccccdcdddba	TRUE
acabdacbaabadcbbdadcd	TRUE
acbccbbddcadcdcabbdaa	TRUE
accdadacaacddddabdaaa	TRUE
acddcddabacdbbaadcbba	TRUE
adaddaacbadadbbbaddac	TRUE
adcbaacaddadaaacbddbd	TRUE
addcabdaabaaddccbdaaa	TRUE
baadbaaaaabcccddccccd	TRUE
bacaddbbbbbbcbadbbdda	TRUE
badbdccdaabadcccabdcd	TRUE
bbadbaacbbbcdaadcaddb	TRUE
bbcbacbcdddbbcdbcccbc	TRUE
bbdbaadbcaddccddcccca	TRUE
bcabcdacaddadaadbcaab	TRUE
bcbccabacbcdccacadbbb	TRUE
bccdabcbcdbdbdddcdaaa	TRUE
bdaacbaddbaaadccbbddb	TRUE
bdbbadddadcadbddaaacd	TRUE
bdccbccdabadccdcaabba	TRUE
bdddabcdbdacbbdbcabad	TRUE
caaddaaaaaabaccbcacab	TRUE
cacbbcdadcadaacbccccb	TRUE
cadcdacdbdabadadcadda	TRUE
cbadaddacbdcdbbbdcdba	TRUE
cbcaccdcbbcbdbcadbacc	TRUE
cbdbcdddbdcdccacdcbcb	TRUE
ccacbddcdaacdcaccabbb	TRUE
ccbdcbbccdaacdaabcdcd	TRUE
ccdaadccadccdcddcccdc	TRUE
cdabcdbcddaccddbdcdbb	TRUE
cdbcbaaaccbaddddcdbbd	TRUE
cdcdbbbcaababdbdbcdda	TRUE
daabcddbdbcaddbcbbaad	TRUE
dabccabbddbcbdbbbbcbc	TRUE
dacdcdbbcdbbacacaacad	TRUE
dbaacbbbdddadbacabdaa	TRUE
dbbbcbbaadbdbcacaabcb	TRUE
dbcdacbbcabccbdbabcbd	TRUE
dcaabdcaadddbaababcbc	TRUE
dcbbdbabcaadacaabacdc	TRUE
dccdbbcdcbdbcbbbcdadc	TRUE
ddaaabcbabdcdcaabddad	TRUE
ddbbaacdadaddddbdbdcd	TRUE
ddccddddddbcdcaddcacd	TRUE
aaaaaaabccccdabbbdbbb	FALSE
aaacbabbccccbbbbccbcc	FALSE
aabaddaabaabbabddacab	FALSE
aabdbdaddcbcbbcdddbdd	FALSE
aadaddcaaddaddaaddabb	FALSE
abaaaaddddcbbbcccaabb	FALSE
ababddbdbcbccccaaabcd	FALSE
abbacbcbcaddaaddabcbd	FALSE
abbdaaddcbcaaaccdddbb	FALSE
abcdbdbbddaaabddabada	FALSE
abddbaddbdcccbbbbbbcc	FALSE
acbccdcdbabadadbbabdd	FALSE
acdccbadadddbabdbbabb	FALSE
adacbdadabaabdbaaddad	FALSE
adbbdbabbdbabacadbbbd	FALSE
addbcbbabaababaaabbba	FALSE
baaaccbbaaabbdbbdacdd	FALSE
baadaaaabbaddbcbddaad	FALSE
babbaaabdabaccbddddbb	FALSE
babdadbbadacbdabddbbb	FALSE
badaabadbbdadddacdbad	FALSE
badddaadbddadaddbbbcc	FALSE
bbabbcbaddbadbbccdbdd	FALSE
bbaddbaadbcbcabddbbda	FALSE
bbbbcabdbaaddbbddacdb	FALSE
bbcaabdbdddaabadbcccd	FALSE
bbdbbaaaabaddcbcdaaad	FALSE
bcbbdbddcbdadbbbaadad	FALSE
bccdcbaaabbacbbcbcddd	FALSE
bdabdbbdbbddaacababdb	FALSE
bdbbbaaaabcbccaabdbdd	FALSE
bddbababdbccaabaacbcc	FALSE
cababbdbdabababcbdddd	FALSE
cbbbcadaaababbdabaddd	FALSE
cbcdbabadabbbbbabbbbc	FALSE
ccbbcaababbaabbaababd	FALSE
cccccbbbcdddcbbdbbdab	FALSE
cdadddbdadbaaddadbdad	FALSE
daaaaaaaaddbabccabbab	FALSE
daaddadaaaabbddcacddd	FALSE
dabdaabdbdadbaadddddb	FALSE
dadbbbbdaabcbbadadaab	FALSE
dbaadaabbacbddabadaab	FALSE
dbadddbbddabaaaadcaab	FALSE
dbbdbdabdaddcbccaacdd	FALSE
dbdbbcccdaaadaadbdbbd	FALSE
dccaaaaabbabdadaabbaa	FALSE
ddabbbddbbacccbcbccdd	FALSE
ddbbacccbaaadabdaaaab	FALSE
dddaaaadddbccbbabcbcd	FALSE
aaaaaaadcdbacabdaacadb	TRUE
aabadcbdccccccdadcbbbc	TRUE
aacbdaaadbcaddcddbadbb	TRUE
aadcccacdaabdcadbcdaba	TRUE
abadddabadccadbaddcbcd	TRUE
abcadacbdcaabaaadbddbb	TRUE
abdcbaabaabbdacabacbbb	TRUE
acaddcdbdcadaaacdbddba	TRUE
accabbbbbaaabbcacadaaa	TRUE
acdbccacacbddabaacabba	TRUE
adacbcbacacaaacddaccac	TRUE
adbdddbcbbbdccacadbbdb	TRUE
addaadbdccdcddcbaacaba	TRUE
baabbaadabdbcbbcdbcdcd	TRUE
babccccdbcbcbdacccbdbb	TRUE
bacddddddbbdcabccddacd	TRUE
bbabcbbabbacccddbbdcba	TRUE
bbbcccacacaaddbacbabda	TRUE
bbdaaadacccbaacbdbadba	TRUE
bcabadbcaaaabbcbccbbdd	TRUE
bcbcdbbadabddabacbabbc	TRUE
bcdaadddbacaddbdacdabb	TRUE
bdabcacdccacbadcdabccd	TRUE
bdbcbcccddaadbdacbddca	TRUE
bdcdcadccbaabadddcbdda	TRUE
caaabcbacbacccacbdcbdc	TRUE
cabbaaccddcabaacbababd	TRUE
cacbdbaccaacccdaaaacca	TRUE
cadcdbcccdacadddbbccdc	TRUE
cbbaaababdaddbcaaaccad	TRUE
cbcaaddaaacbbbabaaacdc	TRUE
cbdbbaaaddabadcddabccc	TRUE
ccacbcbabccbcdacbbaacb	TRUE
ccbddcccbcabbbaaacdcba	TRUE
ccdabcaddcabcbbbaadbba	TRUE
cdacbcbadaabbcadcbdaac	TRUE
cdbdabdbbbcdbdddccbbbc	TRUE
cddaccbddcdcaddbbbbbbd	TRUE
daabdadaccbaddcddabdcb	TRUE
dabdabcadcccabaadcdaad	TRUE
dadacbbabccbcadaccbdbd	TRUE
dbabaabacdaddcccabccbb	TRUE
dbbccbadcdbccdcbaabcad	TRUE
dbcddcdadcabddabdcbcdc	TRUE
dcabbdbdcdddbabdcbcdca	TRUE
dcbbdbcadbddbdbbaddcdc	TRUE
dccdabddcdcabbbcaabada	TRUE
dcddcaacbdccdbbbbacbcc	TRUE
ddbbaccdaaabdcacadbbbb	TRUE
ddccbcbbdbbbadaccdbacd	TRUE
aaaaaabbbcccdddbbbbcdb	FALSE
aaacccbaaadbadaaddbbac	FALSE
aabadabbdabbcadddddbba	FALSE
aabdbbaadadbdbbddabbcb	FALSE
aadaadddbdacdddabdadad	FALSE
aadddbbbbddbdbdccbcbcb	FALSE
ababbbadadaaaddbdcddbd	FALSE
abbaabbaabbbcdabdbbada	FALSE
abbcbcbbcdbadbaabddacb	FALSE
abcdbbdadbdbdbabdadddc	FALSE
abddaabdadcaddaabdabba	FALSE
acbbdadabbbababacbbbbb	FALSE
acccbdbbdddbdaabcbbccd	FALSE
adababdbbaaddaacbcbabc	FALSE
adbaabaddaadadbbbabdda	FALSE
adbdbbaadbdbdbbbdcabcb	FALSE
addcbbcbbcbccbcccbaccb	FALSE
baaadbdbaaddbdabddbcca	FALSE
baaddaccccbbbcccaadbba	FALSE
babbbddbdcdabbdbabbddb	FALSE
bacbbbdbadbabdbbcbbcbc	FALSE
badaddabadadbbdabaaaad	FALSE
bbaabdccbadbadaadbdddb	FALSE
bbbaaaaacbcbddcaccbbbb	FALSE
bbbbdddddccccadabdadda	FALSE
bbcbcbbbaabbabddaabdbc	FALSE
bbdbddddadadddbcbbbbca	FALSE
bcbcbbcdaadabadbbddbcc	FALSE
bcdbbbdadadbaaadaddabc	FALSE
bdadabcddbbabbdaadaabd	FALSE
bdbbdccccadddbdabddabd	FALSE
bddabbbddbccbcaddbbadd	FALSE
caaabdadabbabbbbddcdbd	FALSE
cbbadbddbbdabababbabcb	FALSE
cbccbcccddaabbaadddacb	FALSE
ccadbaabbaabbbabbadbab	FALSE
cccbcbcaadaadbbddbddbc	FALSE
cdabbdddbabdbbbabccbdd	FALSE
cdddabaabababdaadddabc	FALSE
daadaacbcbbcabadddbddd	FALSE
dabbbadaaddbababaabbcb	FALSE
dadabaabbdddbbadcddbdb	FALSE
dadddadbddbbddddbddcca	FALSE
dbaddaaabbaaccbbbcdbad	FALSE
dbbdabddbacbaabbabbaab	FALSE
dbdbabddadadcaaddbaddd	FALSE
dccbaadabdbaabbadaddba	FALSE
ddacadbbbbadddddbddabd	FALSE
ddbbbbabdbbaaddbabdcbb	FALSE
dddabddbbbaabdbbcbccbc	FALSE
aaaaabbbaadcaccddbdcbab	TRUE
aabbaddcdcbcdcdabbcdccd	TRUE
aacbcdcddcbaacaddcddddc	TRUE
aadcddbcdabdcdccbcabbad	TRUE
abaddcabbadcbaadacacacb	TRUE
abcbddaaaccaabdcbccbadc	TRUE
abdddbdbcacbaacddcdabbd	TRUE
acbadaabddaccddbbcbcdcd	TRUE
accbadcdbbddccbbcdddadc	TRUE
acddaacadadcbacaddbdcbd	TRUE
adbaaccadadcbdbdaadbcbd	TRUE
adcbacccadbbbbbdacabaab	TRUE
addcaadbabacbdadbbcbcdb	TRUE
baaccccbadbaaadbbdccbac	TRUE
babdccdbcdbaadadbddcabb	TRUE
badbbdbaacabaccbcaacbba	TRUE
bbaccabaccaccaaaaccccca	TRUE
bbbdbcdbcbdacaabacaaadd	TRUE
bbdacbdbdcaacccdacddbab	TRUE
bcaadbbdaccaadcddaaabcb	TRUE
bcbccdbadcbbbcaacbabdba	TRUE
bccddcacbaabbbdababdadc	TRUE
bdaabacbbdddaacbcacdadd	TRUE
bdbbbdbccddddabcaadcddd	TRUE
bdccbddccadbcaabdcabbaa	TRUE
caaabbdaccbbabacadbdcdc	TRUE
cabbcdacbdbbcccdadbacbc	TRUE
cacdacadbdddccdadbcdbad	TRUE
cadddcacbddcdcdbaadabbc	TRUE
cbbaadbddcdbddcbdddaccc	TRUE
cbcbdccbdadabbbcdadddad	TRUE
cbdccaacccdcacacdadcdbc	TRUE
ccaccccdbadadadbbcddcaa	TRUE
cccabcababadbabdabbacda	TRUE
ccdbddddbbbbcdbcbbaccbb	TRUE
cdacddbbacdaddbbbbcbcca	TRUE
cdcaacbddbbdbbbdbccabab	TRUE
cddbbcdcdccbdcbadcaadba	TRUE
daadaadcaacbcbbddccacdb	TRUE
dacabaadcbbadbdaacccdcd	TRUE
dadbabbbddcabdbacacdcaa	TRUE
dbaccccdbacadbaddadbddb	TRUE
dbcabccdacdbcabddcbbbdd	TRUE
dbdbabbbdaadcbcddcacadc	TRUE
dcabcdaaacbbababdaabdbd	TRUE
dcbcbdcbbbaaacbbcaaadca	TRUE
dccdbbbddcddcadaadcbdbd	TRUE
ddaabdbcccdccddddcbcbda	TRUE
ddbbdbbcadbacdbbabaaaca	TRUE
ddcbdcdcdddbaaccdccbcac	TRUE
aaaaaaabaddccdbbaadddbd	FALSE
aaabdababdbdbddddaaacca	FALSE
aabbaabbbabcdbdccaaaddd	FALSE
aabddaadadbadacdaddddab	FALSE
aadabbbabddabacccbcacbd	FALSE
abaabaaaddbadaaabbcaaac	FALSE
abacbbbbcabbabaaadabcbd	FALSE
abbacdbcbdbbbabdabdaada	FALSE
abbccddaadadbddabbdaaac	FALSE
abcdadbabdaadddbabbbacc	FALSE
abddabdbbdbaaabccbdadbd	FALSE
acbcccbbcbdcdbbbdbababd	FALSE
acddbaadddbddadbdabddcb	FALSE
adadbdadaccbadbabdaabba	FALSE
adbdbdadabdaabaaddbaccd	FALSE
addbbdddbaaddbbabbaacbb	FALSE
baaaddbaaadabcbbdadbaaa	FALSE
baadbababddabdbdaadbbba	FALSE
babbbbacbaaadaabaadbadc	FALSE
bacbcacbcbbdbbbbdbcbccd	FALSE
badbadbabdddabadccaadab	FALSE
bbaabdbdbbaaacaabddbadd	FALSE
bbacccaabbbddddbdddcbcd	FALSE
bbbbaadabdabbdccaccccbb	FALSE
bbbddaaadabababbcabdddd	FALSE
bbdabddccbbaaaabaabbdda	FALSE
bcaaabadabddaadddbcdbbb	FALSE
bccabdbbaabdaaddadbaabd	FALSE
bcdddadaddadaddccbbbccc	FALSE
bdadbadbadadbabaabbcacd	FALSE
bdbbdbadaadadbaadbaccbc	FALSE
bddabbaddcbcaabbabccbcd	FALSE
bddddddadbadaabdbbadaba	FALSE
cbadddbdbbbdddadabdbcbb	FALSE
cbccbaadabbdbdddbccbccd	FALSE
ccadabbdadddbbbabbcbcbc	FALSE
cccbccccadbbbaddcccbccb	FALSE
cdabbbbadabadababddaada	FALSE
cdddddadbdbdaaaabbabddb	FALSE
daadadaaabacbcccbadbadd	FALSE
dabbdbbbdddddabbaacbadd	FALSE
dadbbaccbccaaabbabbdbdd	FALSE
dbababddbdbabbdddbbccad	FALSE
dbbabacbdbddaddbadaddbd	FALSE
dbbdbaadbdaaaaabaddabdc	FALSE
dbdbbbaddabbbabbadbbbab	FALSE
dcbdbaadbdababdbaabdaba	FALSE
ddabdabaddcbddabbddbaab	FALSE
ddbbabaddbbddddcabaacbb	FALSE
dddabbaaabaabaacbbbaada	FALSE
aaaaabccadcacbacbccccdbc	TRUE
aabbacbddbdbcdadbddabbbc	TRUE
aacdaaacddaacbcdbcaaccbd	TRUE
aaddcaddadaaacabadadddcd	TRUE
abbbaaacaababbdcacbccddc	TRUE
abcbbbbcbabacccbbbdbdbaa	TRUE
abdcddbabbdccddaddcacbda	TRUE
acbabaddcbbccccbcabcddbc	TRUE
accacccbbbacabccccdcadcd	TRUE
acdccbadbccdccdacacdccdc	TRUE
adadcacadcbdddbbaacbcaaa	TRUE
adcbacbbacccbcbbddcccacc	TRUE
addcdaadbaaaadbbaaabbccb	TRUE
babaabaadacbbcdcababdbcc	TRUE
bacadcaaaccaabddccbcddbd	TRUE
badbccbaadcdaddcabcbadbd	TRUE
bbacdaabddadbbcccaddabda	TRUE
bbbddabdcadcaabcbccdadac	TRUE
bbdcabbcccdcdadcaadaadda	TRUE
bcadcabdcacadcbcdcbdabab	TRUE
bccaacadbbbcaccaadddbccc	TRUE
bcdbccadbccdbabaddcaddbd	TRUE
bdacdcabcbabaccbaabaccdc	TRUE
bdbdbaddbbccbaadccbaaaaa	TRUE
bddbbaabcabacbabbccacaaa	TRUE
caabcbdcaaddadccabaaaabd	TRUE
cabdbabdddaacacbbdaacaca	TRUE
cadaacababccacbcdbbdaccd	TRUE
cbaabacdbbacabdbcddabaad	TRUE
cbbbabdddbbcbdaccbcacacd	TRUE
cbcbaddaddcadccadbaddccb	TRUE
cbdcabaaacddbdbdcbbaacda	TRUE
ccadabbdcbccdacbcbadbada	TRUE
ccbdcccdbabbcbcdbabdbccb	TRUE
ccdaaadacaccdcbbbddadbab	TRUE
cdababaadbdababcacdaadaa	TRUE
cdbccaadcadccdbdddcddaad	TRUE
cdcdcadacaccbddaabccbaad	TRUE
daaabdcdcacdbdbcdababcbc	TRUE
dabbbccbacbcbcbcdabcdbab	TRUE
daccbadcdacbbdadcdaaccaa	TRUE
dbaabacaadbaadbdcccbbacb	TRUE
dbbccaacababaccbcaacdada	TRUE
dbcdcabbbdbbbdabdadbdaca	TRUE
dcaacccacadaacacccbbcbbb	TRUE
dcbbbccbddcbdbacddbcdbdb	TRUE
dccbddddacaddbccdbadbabb	TRUE
dcddcbaaadcccccadcaccdbc	TRUE
ddbacaadbacadcaccbcabaad	TRUE
ddcdaadbdbbabdbdabddacdc	TRUE
aaaaaaaabbccadabbaadbdbd	FALSE
aaacabbdddbddaabbdacbcbd	FALSE
aabadddaaadabdadcbbaaaac	FALSE
aacabadaadbccccccccddddd	FALSE
aadbaddaacdbbdabdbaaaaaa	FALSE
abaaababdcbbcabbbdaaabda	FALSE
abacdaddaddadabdbacbccdb	FALSE
abbbbbaadadaddbdccbbcabb	FALSE
abcbbcdabbaadbdcccbcbcbb	FALSE
abdbbaaaabbbdcabbbdbdbad	FALSE
acbbaabbbdababdacbbcdbbb	FALSE
accccaadaadbabbabbbcbbbc	FALSE
adaadaaacccbabdabababbdd	FALSE
adadddaaadbdbabdaadabcbd	FALSE
adbdabdadbbabddadddddadd	FALSE
addbabbdcbdddbbdaabdabda	FALSE
baaabbbaacaadbdbbbbbdbcc	FALSE
baaccaadddaaaabaaabdcdbb	FALSE
babacbbbddcbcddbbbbbadba	FALSE
babdaddadbbaddbddaccccbd	FALSE
badaaaabcbcdbaddadadbddd	FALSE
baddadbdbccababbbaccbcbc	FALSE
bbabbcbbbbccddbbdcaddada	FALSE
bbbaabdabaaaabddaabdcbca	FALSE
bbbcaadbbdabdadadbcdbddb	FALSE
bbcccbddbbcbaaadbaaabadb	FALSE
bbdbdddaddddcaaaaaabaddb	FALSE
bcbbccdabbccbcccbbbccbbc	FALSE
bcdaabbdababdabbaabaadab	FALSE
bdababbddbbdcaabccccbbbb	FALSE
bdbadbadbbbddbdccdadaddd	FALSE
bddaadaadddadbbbcdadbdad	FALSE
bddddbdaadaddddabbadaddb	FALSE
cbbaaabbbaccbdddbddbbbdb	FALSE
cbcdbdbbbddabbbbdaccccdd	FALSE
ccbabdddbbadabdaaababdcc	FALSE
cccccaabadadbadbdabdbdbd	FALSE
cdbabbadaadbdddbddddbcdd	FALSE
daaaabbaaccbcdabadaaadbd	FALSE
daadabbadbddddbbcbdabdda	FALSE
dabbbdbabbdbddbacbbdaddb	FALSE
dadacbccbbbadbaddaaaadba	FALSE
dbaaacdaaadaaaabdabddaad	FALSE
dbaddadbbbccbbabdbbdbadd	FALSE
dbbdbadbabdddbadadcdabbb	FALSE
dbdbbaadadcbbbcdbbdadada	FALSE
dcccabdbbbaaabddddbbbddb	FALSE
ddacababbbaadbdddbdaaaaa	FALSE
ddbbbdbcdbbdaaababadbaaa	FALSE
dddaddadadbbbbadcddddabd	FALSE
aaaaaabdbcababdaddcbaabaa	TRUE
aabbcdbbbadbaacdddbdbabbc	TRUE
aaccccaabacaaddbdddaddbcd	TRUE
abaaacbdbbcacbdbacaadaccc	TRUE
abbaddcddcbcaabbdacdaddcd	TRUE
abcbcacacddccaaaadbdadaca	TRUE
abddbbbccdccbadcbccddbbcc	TRUE
acbadbcdcdcadcbcbcbacccaa	TRUE
acccabaadcbbadccbaddbbaca	TRUE
acddadacbdccbdaddcbbdacdb	TRUE
adbadbbabacdbbdcddcbadcaa	TRUE
adcbdacbccbdaabbcbaddabdd	TRUE
addcbcbddcbbbccaddccddbba	TRUE
babaadcbdbaacadaacaadacdd	TRUE
bacbddcadccbddbdaddabaccc	TRUE
badcbddcbacbbdcbbabababad	TRUE
bbadcabbdccbddcdabcadbdaa	TRUE
bbcabcdcdcbcdcabaaacbdbcd	TRUE
bbdbbaaaacadddaacdbadbcdc	TRUE
bcadaadbddabbacdadaddadac	TRUE
bccaaddcacbddadaccadabddd	TRUE
bcdbbadadbbcbadcbddadccaa	TRUE
bdabdddbcbbdbccacccacdccc	TRUE
bdbdaabacabcccbbdbccdddac	TRUE
bdcdddadbcbcabccdcccabaca	TRUE
caaadbdcbcbdcdcaabbccbbbb	TRUE
cabbddaaacddadcdabcaabdab	TRUE
cacdbdbcbbdbcbadcdbdbdcdc	TRUE
cadddccbacbddbabcaabbaaaa	TRUE
cbbacbdcddcdbadbbadaacbdd	TRUE
cbccaddbacaacddcbadaddbcb	TRUE
cbddccabcacdadcccdcbbccbc	TRUE
ccbadbacdcddbbddcbadabdcc	TRUE
cccbddcdbaabdaacacabdbdcb	TRUE
ccdcdbaabdcaababddabaaaac	TRUE
cdbababccdcbdadcbabcccadd	TRUE
cdcaddcdabdcccbccbadbddaa	TRUE
cddcbcbabdccddaaabdcdccad	TRUE
daaddbbbccabddccdaabcaabc	TRUE
dacaddcbdcbbacaabbaacccbb	TRUE
dadbcbdcddbadbdcdbdbbcbac	TRUE
dbadbadbcdcdcbaadddcdbccb	TRUE
dbcaaadcbacaaabbaadcbdcda	TRUE
dbdacadcaaabddbacdcddcdba	TRUE
dcaadcbbdabaccddcddaaacdb	TRUE
dcbcbbcdbdbadacdbbbacdbca	TRUE
dccdcaccdbadcbcdbccbddbab	TRUE
ddaadaaaabdadcaadcddcacda	TRUE
ddbbdddbadbbaccdddadadccc	TRUE
ddcdababdcdbbacabbacbacac	TRUE
aaaaaaacbbccbcddbadbddabd	FALSE
aaabddaddabaaadcbbcdbdbba	FALSE
aababbadbbbdbdddaadacacbc	FALSE
aabdadbccbadddbbaadbddddb	FALSE
aadaadadaabdbaabbbdaaadbc	FALSE
aaddbbdddbbbbdcaaabbabdab	FALSE
ababbadcadabbdaaaadbbdbda	FALSE
abbaaadbabaaddadadacbdbba	FALSE
abbccbbbddbbaddaddccbbbcb	FALSE
abccdcadbdddbdadabdbbbbbb	FALSE
abdcadddbddbbbbddbdaabddd	FALSE
acbdcbdabbaaaaaddbadbadda	FALSE
acdabbbdabddbaaaaabdaabbb	FALSE
adabbdaddbbadcbcdadbabdbd	FALSE
adbbabdbbbbbbaadddccddabb	FALSE
adccaadaaaaddbbabdbddbdaa	FALSE
adddbabdbbdbabbbaabacabdd	FALSE
baabbcbdaddddaddbdbbdadda	FALSE
babaabadbdacbdadbbadddbdd	FALSE
babbdddbddccccaaacbcbbcdb	FALSE
bacccdbccdabbdabdadbdbddd	FALSE
badbddbabdddabbcbaccccdbb	FALSE
bbaaddacabddbadbdaaadaada	FALSE
bbadaadbabddabdabcbcbbbdb	FALSE
bbbbaadbdddbbdaddccdabaab	FALSE
bbbddbdbabbbbbabadabadcbc	FALSE
bbdadddadbcbbdddabbdadddd	FALSE
bcaabaabbddaaccdddbdbddbb	FALSE
bccaadaaadaadaaddbaddbcdb	FALSE
bdaaaababddbbbbcbcbabcddb	FALSE
bdadbbdbbacddadddaabbabad	FALSE
bdbdaaabdaabddccaaacbcbcc	FALSE
bddbbddddadbdaaddbaddaccb	FALSE
cadabbbaadadaaddbaadbdbbd	FALSE
cbbdbbadaaabddbababbadaac	FALSE
cbdddbcadaadaaddabbabdaaa	FALSE
cccadabdaaddaddbaadbabccc	FALSE
cdabbdbdaaadddabbadddbcdb	FALSE
daaaaadabbaaabbaabbdcbadb	FALSE
daadbadabcdddadbaddaddbba	FALSE
dabbdadacbaadbbbbdbbadbba	FALSE
dadbabdbbdbbdaddadbcccaab	FALSE
dbaabbadbdbddaddbbabdbdaa	FALSE
dbaddbbaacbbaadbadddddaba	FALSE
dbbdbbbdbabdbbbcbcbabaaab	FALSE
dbdbbbddcbcbbcdddbbaddabd	FALSE
dcccbbcaabbaaadbbbdaabdaa	FALSE
ddacaababdbbadbbddababadd	FALSE
ddbbadbbddbddabdccbcbbbba	FALSE
dddabbadabbaddabdabccabdd	FALSE
aaaaabacccaccdddbcbcdcaadc	TRUE
aabbadcaccdacdbabbacaddcab	TRUE
aacbcaadcaacdacbcaacccdaca	TRUE
aaddbbadcbbbbbadbbaaacbbbd	TRUE
abbadadbcaacabaaaddddcadac	TRUE
abccdaaacbcbbcaddabacbbdba	TRUE
abddacbddbdadbbabdcaabccbd	TRUE
acbaadcacabcdcccbddaaccaac	TRUE
acccbacdadbddababaaadccabd	TRUE
adaaabcbdbcbdbabdacddcbbad	TRUE
adbaadbdddaacdabcacaadacbb	TRUE
adcbbababcddabbdbdcbdcbbdc	TRUE
addbbccadaaddbaccdbbddbccb	TRUE
baacbaccdcbacdabcdcdcbbada	TRUE
babdabbbaadaacbabcccaddbbc	TRUE
badaabbddcdbaadcccbacbccbb	TRUE
bbaacbcbdcdbaccbdbbcbdcbdd	TRUE
bbbbbdcdacadaccbabdaadcbdd	TRUE
bbccdadbcaadaddcbdabbaadbc	TRUE
bcaacaaabcbcaadcadbcdbadac	TRUE
bcbbbcdbbcdcdcaabbbaadaccd	TRUE
bcccddbbdadaaaddbcbabcbbba	TRUE
bdaabcdddadaddaccadbcddddc	TRUE
bdbcaacabadabcbadbddbdbcca	TRUE
bdcdbacaacaccadacdbbdabcbd	TRUE
caaabccabbbcdabbaccabcbbca	TRUE
cabadbbbdddbdaccbcbbbdacbb	TRUE
caccaabbbccaddadcaacccddbb	TRUE
caddabdcbbcbccabbdcabdacbc	TRUE
cbbaacbacacdbadaadadbccddd	TRUE
cbcbcdacabadbcacccaaaaccad	TRUE
cbdbcdbadccdaddaddcabccccb	TRUE
ccaccbabcabdadbadadbdbccbc	TRUE
cccaacbaaacabccabcbcddabba	TRUE
ccdbadcddcdaabacccbcdddcca	TRUE
cdacbadcdadbaddbcbccbcddbd	TRUE
cdbdcaccbdbcbaccddbdacdccd	TRUE
cddacccbabddcdadbdbcaacdbc	TRUE
daabbccadabbccaaaadbbdccdd	TRUE
dabcdcabadbcccacbaabbcbbdc	TRUE
dadababdcabaaacbbbddddccab	TRUE
dbabbdcbaaaaacaadccddabcad	TRUE
dbbcacaababbbbcbbbcdbcdbdb	TRUE
dbcdcbdbacbddadcaabdbdccac	TRUE
dcaabcabccdbcacaddcccaacca	TRUE
dcbbcabbccccadbcdcaaabaccd	TRUE
dcccbbcabbbcaabaabccccccda	TRUE
dcdddacaadacbdaadcbbbdcdbd	TRUE
ddbbacdbddacabddaadcabaddd	TRUE
ddccccbdbadbacabcbdbbdccbd	TRUE
aaaaaaaaadbddacbbbcdddabda	FALSE
aaabcdddddbbdddddaaadbbacc	FALSE
aababaacaabbdadaaadcdbbbbb	FALSE
aabcddbbdddbaabadadcbcbbbc	FALSE
aadaaaabbbcbcbcaabbbdaadab	FALSE
aadddabdcabdbbaaabbbabddad	FALSE
ababcbcbcaabbbdddaaadcdddd	FALSE
abbabccbdddbcccbccbddaabdb	FALSE
abbdaabddbdabdbbcabacbcbcd	FALSE
abdaaaadaddadabdccabadbddd	FALSE
abdddabadbadbaccccbbabaabc	FALSE
accbaaaabdadadddbbdaacbdbb	FALSE
adaaabbddadddbcbccacbbbdbb	FALSE
adbaaaadbdabacbabbbbbddbdb	FALSE
adbdababdabbbbbdbbbddacdaa	FALSE
addaddbcbdddbaabdddbdadbab	FALSE
baaaabbadaddaabbddcbcabcdd	FALSE
baacbcbbcbcdcbadbbbaaadadd	FALSE
babacccdbdabbbddabaaaadacc	FALSE
babcccadabbbbdaadadbadbdaa	FALSE
badaababdbbcdadabadbdabadd	FALSE
baddabdbdbdbabbddbddbbcccd	FALSE
bbabaadbbdbbdabdbabccccbda	FALSE
bbadcaabbbddadabddaadbdada	FALSE
bbbbbbdaaaddaccbcbbbccccdb	FALSE
bbcbcbadbaaaabbbbdddbbdbbb	FALSE
bbdbbcccccccbaaaabbbcbbcdd	FALSE
bcbbaabbadaadadaadaaaabbbd	FALSE
bccbcdbcbddaaaddadbbddbbab	FALSE
bdaabaadbabcbccbbddbdaddab	FALSE
bdadcdddbaababddbaddaaabba	FALSE
bdbdaaadbdabbabbdbdddcaacd	FALSE
bddadadadbabbadbaabbabbcaa	FALSE
cabadaabaadbbdadbdaabcdbbd	FALSE
cbbcbabddbaaddaddbddadacbb	FALSE
cbdcbcaaddaaaaaadadbbadbdd	FALSE
ccbdbbdcadbddbbabdddbababa	FALSE
cdabbdbbdabdbbbbdbbddbbbbd	FALSE
daaaaabdbabacadbdabdabdbbb	FALSE
daadadaaadbbddbdbbdabdbcbc	FALSE
dabbcbcdaddbddbdbdadaddbbb	FALSE
dadadaaaadbdbaacbaabbbdbad	FALSE
dbaabbddbadbbbabdddddcaabc	FALSE
dbadddababddbdddddcbdadaab	FALSE
dbbdadbaabddbadadbabbdbacd	FALSE
dbdbbabdabadadbbbcbbabbccd	FALSE
ddaaaabbadbbabaadddadadbda	FALSE
ddadbabbdadbdaaabbabaccdbb	FALSE
ddbbbbddababadababaabaaabd	FALSE
dddabbdddaaabadddbccabdaaa	FALSE
aaaaaabcdbaacccbdbbbcddbdab	TRUE
aabbcbbddabcdccabacbbcccdac	TRUE
aaccbabaaddadcbadbadadbcdab	TRUE
aadcdaaccaacbdddddacabdbaaa	TRUE
abbacbaaabcababaacabcbacbca	TRUE
abccacabaadcdbdcbdcdcddddbc	TRUE
abdcddcddcabbabdbaadddacccc	TRUE
acbadcabbbbaccbccabdccdaaab	TRUE
accbddbdcacdcbcdbdcccdbadba	TRUE
acdcbddcbcacddcdacddbcbbcbb	TRUE
adadaccabddccddbdadcabadabc	TRUE
adbddcacdcdabbbbdacacbbbcaa	TRUE
addcaaaabcbababaddabdaddcbb	TRUE
baacbaadbaacbaccbacadbabcdb	TRUE
babdbbbcddbadacbbbabaabbada	TRUE
badaacbadaadbacacccadbdaabb	TRUE
bbabbcccdaddbaadcbcadabbcbc	TRUE
bbbcadbbcdbddcdaabdcbbbbdac	TRUE
bbcdbbbbdaadaddaabdabaacdcd	TRUE
bcaabdabcdcabcbaccdbbbaaacb	TRUE
bcbcadcdddaccbaabaadacddcad	TRUE
bcccddcbaacabbccbdccdabbddc	TRUE
bcddbdbddaaddddddacabacbdbb	TRUE
bdbadcbdbadabbbcadbbacbaaab	TRUE
bdcbdbadbbddaabaadadadbdcbb	TRUE
bdddcbcabbbaabcbadbabdbbddb	TRUE
cabbcbbdaccdbdaaaccaabacadc	TRUE
cacdabdcaccddcbcbddadcaccab	TRUE
cbaabadaccdaaddccdccccddbcd	TRUE
cbbbbaddaddabbdadacabdbddcd	TRUE
cbccbcbbdddcbcdacdadcadbbab	TRUE
cbddcbbdbbddbbdddacbbddddbc	TRUE
ccbbbcabdddddabdcdabacddbad	TRUE
cccccdcbadcbbcacdbabaddbbca	TRUE
ccddacacdadcdddaadaddddcaad	TRUE
cdadddccdacadcbcadbdadaaada	TRUE
cdcbbdbdaabcadccabcaaaccdcd	TRUE
cddcabccababcbdaaacadaacbba	TRUE
daadabbbbdcbccadcadbabdcdca	TRUE
dacaaddddabcbcaaabbcdcdcaab	TRUE
dadbbacdbbadabaadaccadccccc	TRUE
dbabcbddbdcbaadbabdbddaddad	TRUE
dbbdaabbbdbdccdabccdcbaadcc	TRUE
dbcdcddddcabdabbccadccbdaba	TRUE
dcaacdbbbadcbddbddccbddcbaa	TRUE
dcbbccababdabdbdbbaddbcdcab	TRUE
dcccccdabdcabcdaddddcaccadb	TRUE
ddaabacbcbcbdcccdcdbbdddacc	TRUE
ddbbdadaadabdbdabddacdaaaca	TRUE
ddccdcabddacbabbccddbddddba	TRUE
aaaaaabbaadbbabddcbdabbbbad	FALSE
aaacbbddadddbdadddaadaaadcb	FALSE
aabacccadbabdbdaaabdbbdacbd	FALSE
aabcccddcaddbbaddadddbbbddb	FALSE
aacdaddbabaaaaababaabbabddd	FALSE
aaddabaddaadbbdcdabdddabdda	FALSE
ababcbddddbbccaddabdbbaadba	FALSE
abbabdaaabbbbbacaabadbadadb	FALSE
abbcdbabaaaadaaabaabbbdaccc	FALSE
abcddbddbbddbbddbdabbaaabba	FALSE
abddbadbbbdbaabbadabcbccdbd	FALSE
acbdadbadaadbbdaababaaaddab	FALSE
acdddbaadddadddbdbbadaddbbb	FALSE
adaccbbcbbbcdabdbaddbbaabba	FALSE
adbbbcccbaabdddadabbabdbaad	FALSE
addaababddbadddbaaccbdbbada	FALSE
adddabbaaadbbbbabdccbcbbaba	FALSE
baaadadbdcbcababdabbbbbddab	FALSE
baadaacccdabbbdddababbadbaa	FALSE
babadbbacbbbbcbcaadaaaabbaa	FALSE
babdaddddbbbddadddadacbcbda	FALSE
badaadbaacbadbabadadbbbaaad	FALSE
baddbbdadabdaadbaddbcbcbcaa	FALSE
bbabaddbaadbababddbbadbdaca	FALSE
bbaddbdadaddbcbccccddbbbbbd	FALSE
bbbbbdbbcddbbbbbbbbadaaaabb	FALSE
bbcbccbcbbbccbcccbdbcaabdaa	FALSE
bbdbddaadbbddbccddbaadadddd	FALSE
bcbcdbabddaaadaddbbbaadadab	FALSE
bcdbddabdaaddbaaadaabcdbbdd	FALSE
bdadaadaaabdbadadabaabdbbcd	FALSE
bdbbdbddabaaabadaaadcbcddbb	FALSE
bddadcddbbbbdabddbadadaddbd	FALSE
cabdabaabbadbbdbdaadbbbdbcc	FALSE
cbbdcadaababbbbabddabdbbdaa	FALSE
cbdcbcbbaddaabbaabdbdaaddab	FALSE
ccbddddbdbbddbcddadbadaaddb	FALSE
cdaabdaaadbdbaadbaacccdddbd	FALSE
cdddbbdbbbddccccccbbabdadbd	FALSE
daadbbbddaddbaaabbbbcbbbccd	FALSE
dabbddadaaccbbdaadadbbadbad	FALSE
dadaccbbadbbabdbbabdadbbbda	FALSE
daddddcdabbaadadddddbbddabb	FALSE
dbadbaddbaaccadaadbbaaababd	FALSE
dbbbdbbaabaaabddbdddbaddbbd	FALSE
dbdadabbbddbbddddddaacbcdda	FALSE
dcbcbbbbbadadbabadadaabddda	FALSE
ddadabdcbccbdbabbbdddbbadbd	FALSE
ddbbbdabcbbbbcccbdabdaaaada	FALSE
dddadddabdabdbdbdcdadadbbab	FALSE
aaaaaabccadddcccbaacacaaaadd	TRUE
aabacddcccbdbabaabccdbcbadcc	TRUE
aaccbddadcabbccdbabdaccadabd	TRUE
aaddddccbcdcdaccdcacbbbcadac	TRUE
abbbbbccccadccbddcdcbcddcada	TRUE
abcbdbcbdadcbbbabbcbadaadbcc	TRUE
abdcbadababddaaacbdcdbcaddba	TRUE
acacdacabcbaababbdccbbdaccda	TRUE
acbddbabcdbcacadaabdadddcddc	TRUE
acdbcacbdbaddadcdaaaddacdbcd	TRUE
adacdaccddddcbbcbacbcabcbcad	TRUE
adbdabbadcbcccaabccbddbcdaac	TRUE
addbaabcbbcdbdcabccdabacdddc	TRUE
baadabbcccbaabbaadcadcdbaddb	TRUE
bacacdddcaadcdbabdcaadbbacda	TRUE
badbbddccbcbcacbbdbcddaadcbc	TRUE
bbacccccdcccccdacbcccccabcab	TRUE
bbcaaddbbbcacaddcaadcdbadaac	TRUE
bbdbadbadbbcbabcacabccadbadd	TRUE
bcacbddaaccdaddbaabcbbbbbaba	TRUE
bcbdaddbdabbdcacbbbccdddbcbd	TRUE
bcdabcbabbacdccadabdbdbbcaba	TRUE
bdabcddbbaacabcacccacddcdaad	TRUE
bdbcccdbcaabcdcbbcdbdaabbaab	TRUE
bdcdbcdcbccdbdabcccbbcbccacd	TRUE
caaaccaccddccadaaacacdbaabdb	TRUE
cabccdcdadcadbddaccdddcbadbd	TRUE
cadaaccbcadbbdaadbbaccddcbbc	TRUE
cbabbcabdcbcccdcbbcadaadadba	TRUE
cbbcaadccbcccccddcadcddbcddc	TRUE
cbccddcbacbbddbbdddaddadaabb	TRUE
cbdddccadaccdbdbbadadaccacba	TRUE
ccbabaddacbdbbcaadbbcdbbdbcd	TRUE
ccccbdbccadaaabccadcccdcdbca	TRUE
ccdccbabdbbdddcbacaddbbbddba	TRUE
cdbacaadbacccacccacabadbcacb	TRUE
cdccbdbcdcbcdcdbbdacaacaadba	TRUE
cddddabbdacacabaacdadddcdaca	TRUE
dabacccaabdcabddacbbbacccddb	TRUE
dacbabbbdbcdcabbaacbcaadbacb	TRUE
dadcacccbbbbcbcbaaaacdbcbacc	TRUE
dbacbbcbbbbbadbccaaadcbacaac	TRUE
dbbdcacbacdbdcbbdadcacaccdcb	TRUE
dbdacdbddadcdbbccaddbbdbdacb	TRUE
dcabbaacdadbacdbcacacccbcdcb	TRUE
dcbcccbddadcabcbcdadcaddbcdb	TRUE
dccdadddcaddccddcbbacbdbdbba	TRUE
ddaaadacbcdbddddcbddbbdccccc	TRUE
ddbbdacaabcddbaaccccbbdcabab	TRUE
ddcdacaacccccaadacbaccbdadca	TRUE
aaaaaaabadddabbdadaaaacaddbb	FALSE
aaabdaabadbdbbaabddbbddaadab	FALSE
aababdabdabaaadbcbbcbccccbaa	FALSE
aabcdbdddcbcbaadbdddadaadada	FALSE
aadaaddadaabdabadbddbdabbbab	FALSE
aaddbbdbaaaabdddadbbcadbbaad	FALSE
ababbacdbbbbbbbdadbaadbbacdd	FALSE
abbaabddbaaadadccddadbbdaaaa	FALSE
abbccbbbdbbbbaddbbabbaaadbba	FALSE
abccbcbdcdddbbadaddababbaada	FALSE
abdbbddaaadaddaabbaaacddaaaa	FALSE
acbbcbdccdbaadbaadaddadabbaa	FALSE
acdbcbcabaaddaddaadddbdddada	FALSE
adabdbbadddbddcddadddaadbddd	FALSE
adbaddcabbbbdabaababaadaddaa	FALSE
adccdaadbbdadadbadadaabdadaa	FALSE
adddabbabbbadcaddabdbdbdbdbd	FALSE
baababcbaabbbdbddacbdbdddddd	FALSE
babaadadaabaddccdabbbbbaddbb	FALSE
babbdabdbdaaddaadbbacccdabdd	FALSE
baccbbcdbdbcccacbccbcbccbbcc	FALSE
badbbdddbaaccccbbdbbbabaabbd	FALSE
bbaacccbaadbbbdaabcbcbbcbbbd	FALSE
bbadbaabbaabdababbadcabbcccd	FALSE
bbbbbabbbbdbadadaabddabdddcd	FALSE
bbbddddbbbbdcaabbbbababdaadb	FALSE
bbdbababbaabaadbccccddbaabdd	FALSE
bcabaabbbadbbbddddaabddbaaac	FALSE
bcccbbdbbdbbaabdaaaacbbbbbdb	FALSE
bdaadbbdbbadbabbbdbcaaabadad	FALSE
bdbadabaaabbbdababcbbccbcada	FALSE
bdbddaadaddddadbacccaaccdbbb	FALSE
bddbbdadabbbbadbdbabdaaddcbc	FALSE
cabbbadddbbbddbdbadadddccbdb	FALSE
cbbcdbabbdaabddbbababbdcdbdd	FALSE
ccbababbbddadddbdbadabadddac	FALSE
ccccddbababababddbaadbbdccbb	FALSE
cdbdaaabbddddbbdbdbbaabdbbad	FALSE
daaadabdcddbdaaabadbdbbdaddb	FALSE
daaddbaddaadadcbadadadbbdadb	FALSE
dabdbdabdbaaddadababacaddaad	FALSE
dadcaddbadabdddddaaaadbaabdd	FALSE
dbabaadbbabdbadabadaaadabddd	FALSE
dbbabacbbaddaaadaadddbaaadad	FALSE
dbbddaaccbbcbcabbdbaadbabbda	FALSE
dbddaaadcbaabdabdbbadbaddbba	FALSE
ddaadddabbbaddababaabdbbbcda	FALSE
ddbaaadbdbcbcccaaadbbbaddada	FALSE
ddbccccbaabbabababaabacccccd	FALSE
dddaddadadddddabdabddcbbbbbb	FALSE
aaaaaacadddabcdbbbaacbaabbbda	TRUE
aabbdbdabdaacdbbdabccacbccbba	TRUE
aacbddadcaacbbcccdbbcbababacb	TRUE
aaddabcbadcdacccddccddadabdcb	TRUE
abadcbaabcddbdacbaacadbdddcdd	TRUE
abcbccaadddcbacbcbcddbababbdd	TRUE
abdcccdabaaddcbcbbbbccdccabca	TRUE
acbaaadabaddadbcaddcdbaaabadc	TRUE
accabcdaacdacacaaadbdcbcabaca	TRUE
acdbbbdbdaaaacbbcaadcdadadbbd	TRUE
adacaddccaacdbabaadccacacabbc	TRUE
adbdabbdabadddabbabbdcacddcbc	TRUE
addabcdaaddadaabbcddbbdddacca	TRUE
baabdcbdbbaccdcdadbbadbdadadb	TRUE
babccdabbcdcbcdcaacbddadbddcb	TRUE
bacdbbcdabababddcdacadabdbacc	TRUE
bbaacdaddbdcadcadadbdcaabcbca	TRUE
bbbccbcdadbadcdcaadccadddadac	TRUE
bbcdcbdcbccdaacdaacdbbaaadccc	TRUE
bcabbcdcbcaacaacccabcbacbabdb	TRUE
bcbbcbcdddbdddbaddaccbcacbddd	TRUE
bccbcdadccbdaabcbcbccbadabada	TRUE
bcdcaaabacdadbcbaabcbcbbdacbb	TRUE
bdbaabbacdabccaacaacabacbcabc	TRUE
bdcacddadcbccbabcbddcbbcccbcb	TRUE
bddacaacdcbcccadaabaaadbcbbdc	TRUE
caabcdbbdabbdacbabaabacbcbbdd	TRUE
cabcccccabbbaaababbddbabaddac	TRUE
cacdbacabdbbbcbdbccabbdabdbcc	TRUE
caddccadbbdddddcdadcdbbcccaad	TRUE
cbbabdcbadddddccadbaaadbacdab	TRUE
cbcbdcdcccdbacadbcacbccccbbbb	TRUE
cbddddabddacacaadbabbadaadbba	TRUE
ccbbbcaddaccbddccbdddcbabcbaa	TRUE
cccdaaddadbccbcadabcccbdabcbb	TRUE
ccddcacbdacdddcbadaddadbcdacd	TRUE
cdbbcbdadaacbdbbcabdaaccbccbc	TRUE
cdccbdccbacbdcdbdaaacddabdcab	TRUE
cdddcbaddacacbacdbbbabaddccda	TRUE
dababcbbbbbadcabaaadacabddacb	TRUE
daccaabbbacbcccdbcacdbcaaaccd	TRUE
daddcacaacbbccccaabaddcdcddab	TRUE
dbbaddbcabacacdbdcbccdaaabcdc	TRUE
dbcdababadbdadacbbdccadaccccd	TRUE
dcaaadbaabcdaddcddaaacbadccdd	TRUE
dcbbbcaaccdcdcabbcdababacadbd	TRUE
dcccbcababdadacacaadbcaabcbcd	TRUE
dcddacdaabcadcdcdccddcaddadcb	TRUE
ddbaabbbabdcbdbaabddacdabdbdc	TRUE
ddcbcdaaadcdbadbacccbbbacaddd	TRUE
aaaaabcbaaddadaabddbaaabdadac	FALSE
aaacaababdabbadbaaadbddbaacdd	FALSE
aababdddbadbddbdababbddabacaa	FALSE
aabccabbdadabddabdbbadcbbddbd	FALSE
aacdbcdbdbbadadabbababdabbdaa	FALSE
aadddbbaaadaddadacccccaaddbab	FALSE
ababbaaddccccbaabbbbadbddbbda	FALSE
abadddaaaddbbababaddabbaadbad	FALSE
abbbdaabbddaaabaaddabccdabbdd	FALSE
abcbbcadbbdabdaddaadbdddadada	FALSE
abdbabddbdababaabadbdbdaaacda	FALSE
acadbbdabdababdbdadddaccdddbd	FALSE
accccbcbcbbdddcccbaaabdaadadb	FALSE
adaaccbabddaaddddbbaabaabdada	FALSE
adbaaaddccababadbdbaaabaabdad	FALSE
adbdbbdddaaaaadbbadabcbccbdab	FALSE
addbbaddbdbadaabbbddacadaddda	FALSE
baaabbabbddbdadbabacdbaabdbbb	FALSE
baacccbbcadddbbdbbaddaabbdacb	FALSE
babadbddaaaaadabababacddbaabb	FALSE
bacaabadbaaadaadbdbabaaaacccb	FALSE
badaddaddbdbabdbbbdacdadabbba	FALSE
badddaddbbdddbbadaaddaaacccdb	FALSE
bbabdadaaddaaadddaabbcccbbada	FALSE
bbbacbbdcbbadaaaabddddddbddbb	FALSE
bbbcdaddaabbbddbaabbadbddbadc	FALSE
bbdaabaadabddaadadccabcbcbcbb	FALSE
bbddadbbdababcdbabbadbabdadbb	FALSE
bcbdcbccddbadbaddbdbadbabaddb	FALSE
bcdddddabddabdbddaadadbbdcbbd	FALSE
bdadabdbaddabadbdddbddabbaaca	FALSE
bdbbdadddadbadbbdababdaacdddb	FALSE
bddadbbbddaaabadabccddbbddbbb	FALSE
cabaabbaddabbdadbddbbbbcbccbb	FALSE
cbbddbdcbabbbbdadbabbddaabdba	FALSE
ccadbddadbbdbdddabbbaccddbbdd	FALSE
ccccdbdaabbabddddbdababaacccb	FALSE
cdcbbdadbdabdababddbdadbbdabd	FALSE
daabbadcbcdadaddaadabadbdabbd	FALSE
dabbaabbdbaabadddddabbdbbaccc	FALSE
dabdddbdadabdabbbddddddcabbaa	FALSE
dadbdcdbbbaaaadbbadbdbdbadbda	FALSE
dbabaddbadbbaaddbdabbcdaabdab	FALSE
dbbabdbbbbddadabaddbabbdbddac	FALSE
dbdaaadabddccccbbaadbddbbbaab	FALSE
dbddbbdbaddbcbbdbdaaababbbdab	FALSE
ddaaddabbabadbbbbabbdaaaaadad	FALSE
ddbaadbabaddabdbaaacacbddbbdd	FALSE
ddbdadbdbdabdbadbbdabaaabdbda	FALSE
dddaddaddbadacbccaabbaadadadd	FALSE
