aaaaaaadcbccaccbcdabadddadcbdab	TRUE
aaaaabcaacdabdccddcddbdcbdabbab	TRUE
aaaaaccbbabacabdccccdbcbacbdaad	TRUE
aaaaaadddccdddaadcaaabccbcdcdca	TRUE
aaaaacaddcacdbdbdbacbabdaaacabc	TRUE
aaaaadcbbdbdbbbaaddcccbcaacbacc	TRUE
aaaaabbbbbcccdadcdcdadabacadcbc	TRUE
aaaaaccabaabbcaddcbddccbbdaacdc	TRUE
aaaaadcdabadadadbbdccabaabccbca	TRUE
aaaaabacaaaadbbdcaacdbdbddccbba	TRUE
aaaaacbdbbcdccbacdcaaabdccddbdd	TRUE
aaaaabadcbdcbccddbaabdddadabaca	TRUE
aaaaaccdacdcbddcaabddabcdbbdbbd	TRUE
aaaaaaccacadddbbaccddbaaddddcba	TRUE
aaaaadbdbdcdcccdabbabcdcddbcdbb	TRUE
aaaaaabddcaadbcadddbddbcdaadbad	TRUE
aaaaabcbcadbbaadcadccdcaacaddac	TRUE
aaaaadbdcacbbdbcacbaaaabbcabacd	TRUE
aaaaabaacdbbbadaabaaabbbadaacad	TRUE
aaaaaccccbccdadbddabddbddcbcbbc	TRUE
aaaaaaadaccbcadababbabbccdacacd	TRUE
aaaaabbcbaacccbddaabcbbbcbdabda	TRUE
aaaaaccaacbdbdbbbddbaaabcbbdcda	TRUE
aaaaaadbcbaacadacddaadaaadcdbbb	TRUE
aaaaaccaabbabcdccdbbabaabbbabaa	TRUE
baaaaaaadcbccaccbcdabadddadcbdab	FALSE
caaaaabcaacdabdccddcddbdcbdabbab	FALSE
daaaaaccbbabacabdccccdbcbacbdaad	FALSE
abaaaaadddccdddaadcaaabccbcdcdca	FALSE
acaaaacaddcacdbdbdbacbabdaaacabc	FALSE
adaaaadcbbdbdbbbaaddcccbcaacbacc	FALSE
aabaaabbbbbcccdadcdcdadabacadcbc	FALSE
aacaaaccabaabbcaddcbddccbbdaacdc	FALSE
aadaaadcdabadadadbbdccabaabccbca	FALSE
aaabaabacaaaadbbdcaacdbdbddccbba	FALSE
aaacaacbdbbcdccbacdcaaabdccddbdd	FALSE
aaaabadcbdcbccddbaabdddadabaca	FALSE
aaaabaccdacdcbddcaabddabcdbbdbbd	FALSE
aaaadaaccacadddbbaccddbaaddddcba	FALSE
aaaadbdbdcdcccdabbabcdcddbcdbb	FALSE
aaaacabddcaadbcadddbddbcdaadbad	FALSE
aaaadbcbcadbbaadcadccdcaacaddac	FALSE
aaabadbdcacbbdbcacbaaaabbcabacd	FALSE
aaadabaacdbbbadaabaaabbbadaacad	FALSE
aabaaccccbccdadbddabddbddcbcbbc	FALSE
aadaaaadaccbcadababbabbccdacacd	FALSE
abaaabbcbaacccbddaabcbbbcbdabda	FALSE
acaaaccaacbdbdbbbddbaaabcbbdcda	FALSE
baaaaadbcbaacadacddaadaaadcdbbb	FALSE
caaaaccaabbabcdccdbbabaabbbabaa	FALSE
aaaaaaacdaccadbcbaabcbdaddadcdba	TRUE
aaaaabacadbaccaabadcdbbbbdbbbabb	TRUE
aaaaadcddbbaabddcdaaacdcdbabdccc	TRUE
aaaaacabdccddcddbdcadbaaaacdcbac	TRUE
aaaaadddddbadabcaddbbdaccabdbbdc	TRUE
aaaaacadbacdbbcdddadababcdadadbc	TRUE
aaaaadbbdacbbccdddacdcccaddaaacb	TRUE
aaaaaaddababbdddabcbbcddbdbbaddb	TRUE
aaaaadadcdbcdacbaadcadbcbbcaadad	TRUE
aaaaaababcdddbaabccbbdccdaaacabb	TRUE
aaaaabdccacbbaacdabcdbcdcacadbcc	TRUE
aaaaaacddccdddababbaaddacbbdbcda	TRUE
aaaaacbbbabcaabdcdcadddcabdcdcbb	TRUE
aaaaabbaddbddbcccaacadddaaccccbb	TRUE
aaaaacaaaddbabdccdaccbcabbaddadd	TRUE
aaaaadcacbbabacaacdbcdccbdcaccaa	TRUE
aaaaaadbbaabbcbcbbabbbdaabbcdacc	TRUE
aaaaabdbaaabcbabcddbcdaccabbbbba	TRUE
aaaaacbbbabcbcdcdaabbbbdbbbddcba	TRUE
aaaaadbdbcaccadacdbcdcacbaccaaaa	TRUE
aaaaabcdabcaaaaaaadbcbbdddababcc	TRUE
aaaaadbcbadbddaacaaaaddacccaaaca	TRUE
aaaaabbabbaddddababcdddcccacdaad	TRUE
aaaaacddccaadbbbaddcdcbdcbcabccd	TRUE
aaaaaddbcacaccddbbacadadcccbacaa	TRUE
baaaaaaacdaccadbcbaabcbdaddadcdba	FALSE
caaaaabacadbaccaabadcdbbbbdbbbabb	FALSE
daaaaadcddbbaabddcdaaacdcdbabdccc	FALSE
abaaaacabdccddcddbdcadbaaaacdcbac	FALSE
acaaaadddddbadabcaddbbdaccabdbbdc	FALSE
aaaacadbacdbbcdddadababcdadadbc	FALSE
aabaaadbbdacbbccdddacdcccaddaaacb	FALSE
aadaaaaddababbdddabcbbcddbdbbaddb	FALSE
aaaadadcdbcdacbaadcadbcbbcaadad	FALSE
aaacaaababcdddbaabccbbdccdaaacabb	FALSE
aaadaabdccacbbaacdabcdbcdcacadbcc	FALSE
aaaabaacddccdddababbaaddacbbdbcda	FALSE
aaaacacbbbabcaabdcdcadddcabdcdcbb	FALSE
aaaabbaddbddbcccaacadddaaccccbb	FALSE
aaaabcaaaddbabdccdaccbcabbaddadd	FALSE
aaaacdcacbbabacaacdbcdccbdcaccaa	FALSE
aaabaadbbaabbcbcbbabbbdaabbcdacc	FALSE
aaacabdbaaabcbabcddbcdaccabbbbba	FALSE
aaadacbbbabcbcdcdaabbbbdbbbddcba	FALSE
aabaadbdbcaccadacdbcdcacbaccaaaa	FALSE
aadaabcdabcaaaaaaadbcbbdddababcc	FALSE
abaaadbcbadbddaacaaaaddacccaaaca	FALSE
adaaabbabbaddddababcdddcccacdaad	FALSE
baaaacddccaadbbbaddcdcbdcbcabccd	FALSE
caaaaddbcacaccddbbacadadcccbacaa	FALSE
aaaaaaaccbbbacddbabcdccdbddccddaa	TRUE
aaaaacbcdadcccbddddcbdbbacccdbbdd	TRUE
aaaaabdaaddccdaaaddcbcdbacdcdcbbd	TRUE
aaaaacbadbbbccbbcabcaabbabdcbabbc	TRUE
aaaaadbbcabdbadcbdbcddaacddbbddcb	TRUE
aaaaababbdccaaabdcaabadddaaabbcca	TRUE
aaaaaaabcacadbcabadabaaaabaddbccc	TRUE
aaaaacddbabbadcaccbbcccccddaccaaa	TRUE
aaaaaaadcdabdccbcbabddabdabbcbaca	TRUE
aaaaaabdcbbdcccccdcccccdbdccbabdb	TRUE
aaaaabccdbdaaddaabbabbadbbdacddab	TRUE
aaaaaccadcabbcdbdabcbddbcaabcccca	TRUE
aaaaacdabcacbadbdbdadacaccbcadbbb	TRUE
aaaaaddabacddadbbcccaccbacadbabcb	TRUE
aaaaacbdddcddcccbdbdccbbadbaccbbc	TRUE
aaaaabcababdbadddddadddcbdccaddcd	TRUE
aaaaaabddddcccaabacacaccbdaccddac	TRUE
aaaaabccbdaadadccabcdcdddabcbdcbb	TRUE
aaaaadcacccadbcaabbccacabdcaabbac	TRUE
aaaaaacaadcbddccadcadbdaacdacdcbd	TRUE
aaaaacdbcbdbaaacbcadbddbbccbdccbc	TRUE
aaaaadacaaabbbabadbadbbaaacbdcbcd	TRUE
aaaaaacbbaaddabbccbadbcbdcaabbacd	TRUE
aaaaaccdcabdbcdcdbcdcbadbcaccdbcd	TRUE
aaaaabdcdcacccddbccadddbcacdaaddc	TRUE
baaaaaaaccbbbacddbabcdccdbddccddaa	FALSE
caaaaacbcdadcccbddddcbdbbacccdbbdd	FALSE
daaaaabdaaddccdaaaddcbcdbacdcdcbbd	FALSE
abaaaacbadbbbccbbcabcaabbabdcbabbc	FALSE
acaaaadbbcabdbadcbdbcddaacddbbddcb	FALSE
aaaababbdccaaabdcaabadddaaabbcca	FALSE
aacaaaaabcacadbcabadabaaaabaddbccc	FALSE
aadaaacddbabbadcaccbbcccccddaccaaa	FALSE
aaabaaaadcdabdccbcbabddabdabbcbaca	FALSE
aaacaaabdcbbdcccccdcccccdbdccbabdb	FALSE
aaadaabccdbdaaddaabbabbadbbdacddab	FALSE
aaaabaccadcabbcdbdabcbddbcaabcccca	FALSE
aaaacacdabcacbadbdbdadacaccbcadbbb	FALSE
aaaadaddabacddadbbcccaccbacadbabcb	FALSE
aaaabcbdddcddcccbdbdccbbadbaccbbc	FALSE
aaaacbcababdbadddddadddcbdccaddcd	FALSE
aaabaabddddcccaabacacaccbdaccddac	FALSE
aaacabccbdaadadccabcdcdddabcbdcbb	FALSE
aaadadcacccadbcaabbccacabdcaabbac	FALSE
aacaaacaadcbddccadcadbdaacdacdcbd	FALSE
aadaacdbcbdbaaacbcadbddbbccbdccbc	FALSE
abaaadacaaabbbabadbadbbaaacbdcbcd	FALSE
adaaaacbbaaddabbccbadbcbdcaabbacd	FALSE
baaaaccdcabdbcdcdbcdcbadbcaccdbcd	FALSE
caaaabdcdcacccddbccadddbcacdaaddc	FALSE
aaaaaaaaddddbbbdacbcdcbaabaccdbaac	TRUE
aaaaaddacaddcabacdadadcadcddcdbcab	TRUE
aaaaababdddddacabadcabbcbcdcdbbdcb	TRUE
aaaaaddcdcacdbdaaadbbcbdcaadccdaac	TRUE
aaaaabbacdaacaabacabddacdaadccdcda	TRUE
aaaaacaddbcbdacbadcbadadabaacdcbdb	TRUE
aaaaabdaddbbdddcbcaaaabcdaaabbccca	TRUE
aaaaaacdabddacacaacbdcdadcbabdccbc	TRUE
aaaaabdcddbcbdbbcdbbdaaacbbabaabac	TRUE
aaaaaaddaaddbcabbcbdcaabbbcbbaaaba	TRUE
aaaaacdcacdadaddabbdcdccaaccdbdaaa	TRUE
aaaaabbabbacbbcbbbdbcbbbdcdbbbbcda	TRUE
aaaaaddbbadcadbdddbdcbdddabcddacab	TRUE
aaaaacabccaccdbdccdabaacccacdbbaba	TRUE
aaaaaaacbadadccdacbaddcadbbcccbabb	TRUE
aaaaacaddcdbbbadbdacdcbaabadababdb	TRUE
aaaaacbcacdaaacdababaaabbbcabdcbdd	TRUE
aaaaaadcbbaacdbcadcabccdcaacacbaca	TRUE
aaaaaabaaaaaccdddaadbddbdcbddcaacd	TRUE
aaaaacdccbaadaaaaadddbabdacccabbca	TRUE
aaaaaacbbdbddacdcacddbbacddabbddad	TRUE
aaaaadbccababccdddcabbcdadcadddadb	TRUE
aaaaabddcabccdcabcddbdbbadbbbcabdc	TRUE
aaaaaacbbbbdccccadcdbaccaaaacbcbba	TRUE
aaaaacdbcabdcbdbcbaadddabbaacbccad	TRUE
baaaaaaaaddddbbbdacbcdcbaabaccdbaac	FALSE
caaaaaddacaddcabacdadadcadcddcdbcab	FALSE
daaaaababdddddacabadcabbcbcdcdbbdcb	FALSE
abaaaaddcdcacdbdaaadbbcbdcaadccdaac	FALSE
acaaaabbacdaacaabacabddacdaadccdcda	FALSE
aaaacaddbcbdacbadcbadadabaacdcbdb	FALSE
aabaaabdaddbbdddcbcaaaabcdaaabbccca	FALSE
aadaaaacdabddacacaacbdcdadcbabdccbc	FALSE
aaaabdcddbcbdbbcdbbdaaacbbabaabac	FALSE
aaacaaaddaaddbcabbcbdcaabbbcbbaaaba	FALSE
aaadaacdcacdadaddabbdcdccaaccdbdaaa	FALSE
aaaabbabbacbbcbbbdbcbbbdcdbbbbcda	FALSE
aaaacaddbbadcadbdddbdcbdddabcddacab	FALSE
aaaadacabccaccdbdccdabaacccacdbbaba	FALSE
aaaabaacbadadccdacbaddcadbbcccbabb	FALSE
aaaaccaddcdbbbadbdacdcbaabadababdb	FALSE
aaaadcbcacdaaacdababaaabbbcabdcbdd	FALSE
aaacaadcbbaacdbcadcabccdcaacacbaca	FALSE
aaadaabaaaaaccdddaadbddbdcbddcaacd	FALSE
aabaacdccbaadaaaaadddbabdacccabbca	FALSE
aadaaacbbdbddacdcacddbbacddabbddad	FALSE
abaaadbccababccdddcabbcdadcadddadb	FALSE
acaaabddcabccdcabcddbdbbadbbbcabdc	FALSE
baaaaacbbbbdccccadcdbaccaaaacbcbba	FALSE
caaaacdbcabdcbdbcbaadddabbaacbccad	FALSE
aaaaaaabadbccaaadcddadadccdccbdadad	TRUE
aaaaadbaadbcbccddaaccbdbdbbbcbdbbac	TRUE
aaaaabaaadbdcddadbcabacbaabacbcbaad	TRUE
aaaaadccdddbbbbbaacdcaaacdacbacacdd	TRUE
aaaaaacbddcabcdabaaadbbabbdacadadbb	TRUE
aaaaadcdbbadaacbcdaccbcabacaddabadb	TRUE
aaaaaabdddddabdcbcdccbbdbcbbdaacdbc	TRUE
aaaaabcdaccdaddbaaddbaacddcbccbdbca	TRUE
aaaaaacdcdbaccdbcabcccbdacdbaaaabbd	TRUE
aaaaadbbddccccdaacbadbbbacdcbadabac	TRUE
aaaaabacbbcdcabccabccdddbdcdbacbcdc	TRUE
aaaaadcbdbcbcbdbdbdddbbdaddbcbbdaab	TRUE
aaaaacbabbbbadcbbacbaacacdadbdcbadb	TRUE
aaaaadaccbadccbadacbdadaadbcbababdd	TRUE
aaaaacdddaabddbcbacdbaacdbcbaaddabd	TRUE
aaaaaacdadacdcccbcaaddbcbabadccdbba	TRUE
aaaaabbddbaacbbcccbcdbcbaddbbaaadbd	TRUE
aaaaacadadcbbbccbdcacaccadabddbbaaa	TRUE
aaaaaccacaddbcacdaddabddabdcdaadccd	TRUE
aaaaabbbbcacacabacaadbbdddcbbbdccba	TRUE
aaaaaddcbdccccbaaccddddaccdbaccbdad	TRUE
aaaaadbcdbbbbbacbbabcdacabccadabbaa	TRUE
aaaaacacdbabaabcdcbcbccccbaabbdcddb	TRUE
aaaaaabbdacabbbbbaadbacadabdadcdccd	TRUE
aaaaabdbdbdadcdcadddcbcbddcdbcbccdc	TRUE
baaaaaaabadbccaaadcddadadccdccbdadad	FALSE
caaaaadbaadbcbccddaaccbdbdbbbcbdbbac	FALSE
aaaabaaadbdcddadbcabacbaabacbcbaad	FALSE
abaaaadccdddbbbbbaacdcaaacdacbacacdd	FALSE
adaaaaacbddcabcdabaaadbbabbdacadadbb	FALSE
aaaadcdbbadaacbcdaccbcabacaddabadb	FALSE
aacaaaabdddddabdcbcdccbbdbcbbdaacdbc	FALSE
aadaaabcdaccdaddbaaddbaacddcbccbdbca	FALSE
aaabaaacdcdbaccdbcabcccbdacdbaaaabbd	FALSE
aaacaadbbddccccdaacbadbbbacdcbadabac	FALSE
aaaabacbbcdcabccabccdddbdcdbacbcdc	FALSE
aaaabadcbdbcbcbdbdbdddbbdaddbcbbdaab	FALSE
aaaacacbabbbbadcbbacbaacacdadbdcbadb	FALSE
aaaadaccbadccbadacbdadaadbcbababdd	FALSE
aaaabcdddaabddbcbacdbaacdbcbaaddabd	FALSE
aaaadacdadacdcccbcaaddbcbabadccdbba	FALSE
aaababbddbaacbbcccbcdbcbaddbbaaadbd	FALSE
aaacacadadcbbbccbdcacaccadabddbbaaa	FALSE
aaadaccacaddbcacdaddabddabdcdaadccd	FALSE
aacaabbbbcacacabacaadbbdddcbbbdccba	FALSE
aadaaddcbdccccbaaccddddaccdbaccbdad	FALSE
abaaadbcdbbbbbacbbabcdacabccadabbaa	FALSE
acaaacacdbabaabcdcbcbccccbaabbdcddb	FALSE
baaaaabbdacabbbbbaadbacadabdadcdccd	FALSE
caaaabdbdbdadcdcadddcbcbddcdbcbccdc	FALSE
aaaaaaabbcdccabbcbcccadccccbbbbdacbd	TRUE
aaaaacbaadaddbcadbdabdbcbbddabbcccba	TRUE
aaaaadbcddbabcccbcbabbcdbdccccabadcc	TRUE
aaaaabccdaacaacccccaccbdcadbbbbddbbc	TRUE
aaaaadaddaddbbbbddcbadcccbdbdabcabbc	TRUE
aaaaaccbdbccbbcdcbbccabcdbcbddbcddbb	TRUE
aaaaaaacbccacdcbcaaabdcdbbbcbababbda	TRUE
aaaaabadccbcbcacbbcacdaadacddaddacbd	TRUE
aaaaaaabccadbbdccbbdbacbccbdbdabbcdc	TRUE
aaaaaaccccddccaacddadaaddbcccddabddc	TRUE
aaaaabadacaacbdcdacbdadddabbaabacaac	TRUE
aaaaaaaadacabccbbbbbbbbdbddacadcbbac	TRUE
aaaaabacababddbbbdacddabbbccdcddaaca	TRUE
aaaaacccbccbabccbdaabcddabadadcaaacb	TRUE
aaaaabacdbdcacdcddbbaccadaaddabcdaba	TRUE
aaaaabdbcadcaadcdcbbbcadbadcdccddabd	TRUE
aaaaacdbddddbacadcabdcdddcccdccaddbb	TRUE
aaaaaaaaadabddacacbbdabddbdcdbcbdcbd	TRUE
aaaaaaddccbaabcdbbabcbcbddcddcbdbcab	TRUE
aaaaacdaaabddcaadbabacbcbbcadddccbdd	TRUE
aaaaaadbcdddbbadabadcabadcbcaccaabbd	TRUE
aaaaadbabdccbbdbdabdaddaabbdcdbcacac	TRUE
aaaaadcdccddbabadbaddcaabcbacccccccd	TRUE
aaaaaadbaccbcbcacbcbaabcbdaadbccdada	TRUE
aaaaacbaabacbaaabaadccacccccacbdaada	TRUE
baaaaaaabbcdccabbcbcccadccccbbbbdacbd	FALSE
caaaaacbaadaddbcadbdabdbcbbddabbcccba	FALSE
daaaaadbcddbabcccbcbabbcdbdccccabadcc	FALSE
abaaaabccdaacaacccccaccbdcadbbbbddbbc	FALSE
acaaaadaddaddbbbbddcbadcccbdbdabcabbc	FALSE
aaaaccbdbccbbcdcbbccabcdbcbddbcddbb	FALSE
aacaaaaacbccacdcbcaaabdcdbbbcbababbda	FALSE
aadaaabadccbcbcacbbcacdaadacddaddacbd	FALSE
aaabaaaabccadbbdccbbdbacbccbdbdabbcdc	FALSE
aaacaaaccccddccaacddadaaddbcccddabddc	FALSE
aaadaabadacaacbdcdacbdadddabbaabacaac	FALSE
aaaabaaaadacabccbbbbbbbbdbddacadcbbac	FALSE
aaaacabacababddbbbdacddabbbccdcddaaca	FALSE
aaaadacccbccbabccbdaabcddabadadcaaacb	FALSE
aaaabbacdbdcacdcddbbaccadaaddabcdaba	FALSE
aaaacbdbcadcaadcdcbbbcadbadcdccddabd	FALSE
aaaadcdbddddbacadcabdcdddcccdccaddbb	FALSE
aaacaaaaadabddacacbbdabddbdcdbcbdcbd	FALSE
aaadaaddccbaabcdbbabcbcbddcddcbdbcab	FALSE
aabaacdaaabddcaadbabacbcbbcadddccbdd	FALSE
aadaaadbcdddbbadabadcabadcbcaccaabbd	FALSE
abaaadbabdccbbdbdabdaddaabbdcdbcacac	FALSE
acaaadcdccddbabadbaddcaabcbacccccccd	FALSE
baaaaadbaccbcbcacbcbaabcbdaadbccdada	FALSE
caaaacbaabacbaaabaadccacccccacbdaada	FALSE
aaaaaaaadbdaaacdcbccaaddcccacccdbbabc	TRUE
aaaaacaaddbdacabcdbdcdbdacbdacbcdabba	TRUE
aaaaabdabaabcdbaccacbcdabacbddbacabcd	TRUE
aaaaaccacadbdadadcbdababcccacaccdacda	TRUE
aaaaabdabaadadadccdddcccdcababadabcda	TRUE
aaaaabcdaadaddbcbdabacabaababcbbdbbdb	TRUE
aaaaadbcbdbdcbcdcaaadbbdacaddcdbadbba	TRUE
aaaaaabdbababccdadbdccdbcaddbcabccdac	TRUE
aaaaabaddbddbacddabcbdaabcddabdbccdbc	TRUE
aaaaaacabaabdddbdbcadcdcdddcdabdcabcb	TRUE
aaaaacaaaabccbdabaddccddaddbdcbcbdbab	TRUE
aaaaabdbbbbcccdabcdbdaaddaabaadabaadc	TRUE
aaaaaabcccabaddccaacddbbdcdbdaddbcadc	TRUE
aaaaacdcbccccccabcaabcbbcabadddaabccc	TRUE
aaaaaacbbbdcaacdabdcacabcdbbbdbdabaac	TRUE
aaaaaccdcbbdabccbcbaaddbccdbaddabbcaa	TRUE
aaaaabbccbbbcccddcdaccadacacdcccacacb	TRUE
aaaaaadcccaadcdbcccabcbbcdaddbbabddda	TRUE
aaaaababaddcbbbbdadabbdabbbaabcacbbac	TRUE
aaaaadcacdacadadbbabccbccdbbdccbcabcb	TRUE
aaaaacaababacbddcbdabbabdddccabbcdcbc	TRUE
aaaaabcccdbdbbbbddbdaabcbccccaaddadbd	TRUE
aaaaadcbacddacbbbdbdcddaddbaacdabcabc	TRUE
aaaaaadbdcddbbbaadccbddabddbdcaadbdac	TRUE
aaaaabcbbdacbbadabaadaaadabaccbbbcddb	TRUE
baaaaaaaadbdaaacdcbccaaddcccacccdbbabc	FALSE
caaaaacaaddbdacabcdbdcdbdacbdacbcdabba	FALSE
daaaaabdabaabcdbaccacbcdabacbddbacabcd	FALSE
abaaaaccacadbdadadcbdababcccacaccdacda	FALSE
acaaaabdabaadadadccdddcccdcababadabcda	FALSE
aaaabcdaadaddbcbdabacabaababcbbdbbdb	FALSE
aabaaadbcbdbdcbcdcaaadbbdacaddcdbadbba	FALSE
aadaaaabdbababccdadbdccdbcaddbcabccdac	FALSE
aaaabaddbddbacddabcbdaabcddabdbccdbc	FALSE
aaacaaacabaabdddbdbcadcdcdddcdabdcabcb	FALSE
aaadaacaaaabccbdabaddccddaddbdcbcbdbab	FALSE
aaaabdbbbbcccdabcdbdaaddaabaadabaadc	FALSE
aaaacaabcccabaddccaacddbbdcdbdaddbcadc	FALSE
aaaadacdcbccccccabcaabcbbcabadddaabccc	FALSE
aaaabacbbbdcaacdabdcacabcdbbbdbdabaac	FALSE
aaaacccdcbbdabccbcbaaddbccdbaddabbcaa	FALSE
aaaadbbccbbbcccddcdaccadacacdcccacacb	FALSE
aaacaadcccaadcdbcccabcbbcdaddbbabddda	FALSE
aaadababaddcbbbbdadabbdabbbaabcacbbac	FALSE
aabaadcacdacadadbbabccbccdbbdccbcabcb	FALSE
aadaacaababacbddcbdabbabdddccabbcdcbc	FALSE
abaaabcccdbdbbbbddbdaabcbccccaaddadbd	FALSE
acaaadcbacddacbbbdbdcddaddbaacdabcabc	FALSE
baaaaadbdcddbbbaadccbddabddbdcaadbdac	FALSE
caaaabcbbdacbbadabaadaaadabaccbbbcddb	FALSE
aaaaaaacaabbdbbabbacbcacacaacacbabdbdb	TRUE
aaaaadcadcaddcbbdcdabdbacacbcddccdbbdb	TRUE
aaaaabddaddcdabbdaabcbdbcbddddcaadbaca	TRUE
aaaaacccbdabaaacdcccdddabaddbbdccadccc	TRUE
aaaaabdaccabbccbcccacbcdbdbbccbadaaaba	TRUE
aaaaadcddbbbaaacbacbbaaaadaadaddbbbbbb	TRUE
aaaaabbdaaaccbbccdabdcddccaaabcbaadcac	TRUE
aaaaabbbbbbddccdacbcadbdcddabcacdcdadb	TRUE
aaaaadadcacbdabbcbdcbdbddbbaddadaabbcc	TRUE
aaaaababaddbddaadccaabbdaaacaacbdddccd	TRUE
aaaaaabbcabbaddccacbaacacdcaacdcddddbb	TRUE
aaaaabddbddacdcaacbdccbcaacdcadbbccabc	TRUE
aaaaaaddaacacdadadacbcddcdbccabcadcadd	TRUE
aaaaacdacdbcddccccddcccccccccbaddcaabb	TRUE
aaaaaaacaadbbadccacabcbaccacabbcddbdcd	TRUE
aaaaacaaaaaabbaabcbdaadcadacdcbbcacaca	TRUE
aaaaabcdbbacbcabbdcaabcadbbdddacadbaab	TRUE
aaaaacaddcdcdcccbdcdbcdaaaacbcadcbabdb	TRUE
aaaaacbbdddddbcabddbdabddaddcdaacbabcb	TRUE
aaaaabcdaacddbcdcabdbdcdcacdcbdcbaaddc	TRUE
aaaaacadabcbaaaccabaaccbbbdbcbadbaddbc	TRUE
aaaaabaacccddbbbbadadcabdacbbbcddaaacd	TRUE
aaaaaadacbccccbddbcababdbddcdbcdcabdcb	TRUE
aaaaacbabcadbbbcddcdadbccdbdbadbcbaabd	TRUE
aaaaadcaccdbdadacaaaadadadcdddacdbcada	TRUE
baaaaaaacaabbdbbabbacbcacacaacacbabdbdb	FALSE
caaaaadcadcaddcbbdcdabdbacacbcddccdbbdb	FALSE
daaaaabddaddcdabbdaabcbdbcbddddcaadbaca	FALSE
abaaaacccbdabaaacdcccdddabaddbbdccadccc	FALSE
acaaaabdaccabbccbcccacbcdbdbbccbadaaaba	FALSE
aaaadcddbbbaaacbacbbaaaadaadaddbbbbbb	FALSE
aabaaabbdaaaccbbccdabdcddccaaabcbaadcac	FALSE
aacaaabbbbbbddccdacbcadbdcddabcacdcdadb	FALSE
aaaadadcacbdabbcbdcbdbddbbaddadaabbcc	FALSE
aaabaababaddbddaadccaabbdaaacaacbdddccd	FALSE
aaadaaabbcabbaddccacbaacacdcaacdcddddbb	FALSE
aaaabddbddacdcaacbdccbcaacdcadbbccabc	FALSE
aaaacaaddaacacdadadacbcddcdbccabcadcadd	FALSE
aaaadacdacdbcddccccddcccccccccbaddcaabb	FALSE
aaaabaacaadbbadccacabcbaccacabbcddbdcd	FALSE
aaaaccaaaaaabbaabcbdaadcadacdcbbcacaca	FALSE
aaaadbcdbbacbcabbdcaabcadbbdddacadbaab	FALSE
aaacacaddcdcdcccbdcdbcdaaaacbcadcbabdb	FALSE
aaadacbbdddddbcabddbdabddaddcdaacbabcb	FALSE
aabaabcdaacddbcdcabdbdcdcacdcbdcbaaddc	FALSE
aadaacadabcbaaaccabaaccbbbdbcbadbaddbc	FALSE
abaaabaacccddbbbbadadcabdacbbbcddaaacd	FALSE
adaaaadacbccccbddbcababdbddcdbcdcabdcb	FALSE
baaaacbabcadbbbcddcdadbccdbdbadbcbaabd	FALSE
caaaadcaccdbdadacaaaadadadcdddacdbcada	FALSE
aaaaaaaaadcbbdbadbaadcdabcaddabbcbdadcc	TRUE
aaaaacdadaccddbddcccababdadbcadaabcbdcb	TRUE
aaaaababbbbcdcbaddbcdcdcbddbadbacbbdcab	TRUE
aaaaacabbbadcabaadcdbdcbbbdaadadbaccaac	TRUE
aaaaabaabcadbacbddbbbcddddcabdcdccccccc	TRUE
aaaaabbaabacdbdacdaadaadbacbcbbddddccdc	TRUE
aaaaadabcdabcdbbbbabaccadcdadaabbcdbcdb	TRUE
aaaaacadabbcbdcaddcabacdadaacbdcbbaacab	TRUE
aaaaaddabcdddacacabdddaacdbbdcdabdcacac	TRUE
aaaaacdddddbadcbaaaabcddcaabbacbacaaacd	TRUE
aaaaaacddbbaaddbbbbccbbbcabcbddbbccccda	TRUE
aaaaaaaadcabcbbcdcbacbbccbcccbdaacbddcb	TRUE
aaaaadadbcabcdcbaaaadcdcbaabcdccdddccad	TRUE
aaaaacabcaaacacccadbcdccccdacbadcdccbcb	TRUE
aaaaaacddadaacdbcdaabbaadcaacaaaabbadda	TRUE
aaaaaccaadcacdddaaaaccdcbadbadbaadbacca	TRUE
aaaaabbcadabbbcabdbacadadbcccdababcbbca	TRUE
aaaaadbdbbbddaaccddbcdbabaacdccdabaadda	TRUE
aaaaabdcbcabcdcdddaabdadbccacbdaddbcddc	TRUE
aaaaaacadcabdabdacabdbaddbbbddacbadcdba	TRUE
aaaaadabcdccaabccadaacacbbdbbaabbbbbbda	TRUE
aaaaacbbbadcdabdadcaaccadaadddaabbbbacb	TRUE
aaaaaaacdabaadbdbaccacacbaddacbcdcbaaad	TRUE
aaaaaabcdbdaccdcddddbacabbbbcbbabbaabcc	TRUE
aaaaacdcadcdbdbccbcdcddbbbabddccaabbcaa	TRUE
baaaaaaaaadcbbdbadbaadcdabcaddabbcbdadcc	FALSE
caaaaacdadaccddbddcccababdadbcadaabcbdcb	FALSE
daaaaababbbbcdcbaddbcdcdcbddbadbacbbdcab	FALSE
abaaaacabbbadcabaadcdbdcbbbdaadadbaccaac	FALSE
acaaaabaabcadbacbddbbbcddddcabdcdccccccc	FALSE
adaaaabbaabacdbdacdaadaadbacbcbbddddccdc	FALSE
aabaaadabcdabcdbbbbabaccadcdadaabbcdbcdb	FALSE
aacaaacadabbcbdcaddcabacdadaacbdcbbaacab	FALSE
aaaaddabcdddacacabdddaacdbbdcdabdcacac	FALSE
aaabaacdddddbadcbaaaabcddcaabbacbacaaacd	FALSE
aaadaaacddbbaaddbbbbccbbbcabcbddbbccccda	FALSE
aaaabaaaadcabcbbcdcbacbbccbcccbdaacbddcb	FALSE
aaaacadadbcabcdcbaaaadcdcbaabcdccdddccad	FALSE
aaaadacabcaaacacccadbcdccccdacbadcdccbcb	FALSE
aaaabacddadaacdbcdaabbaadcaacaaaabbadda	FALSE
aaaacccaadcacdddaaaaccdcbadbadbaadbacca	FALSE
aaaadbbcadabbbcabdbacadadbcccdababcbbca	FALSE
aaacadbdbbbddaaccddbcdbabaacdccdabaadda	FALSE
aaadabdcbcabcdcdddaabdadbccacbdaddbcddc	FALSE
aacaaacadcabdabdacabdbaddbbbddacbadcdba	FALSE
aadaadabcdccaabccadaacacbbdbbaabbbbbbda	FALSE
abaaacbbbadcdabdadcaaccadaadddaabbbbacb	FALSE
adaaaaacdabaadbdbaccacacbaddacbcdcbaaad	FALSE
baaaaabcdbdaccdcddddbacabbbbcbbabbaabcc	FALSE
caaaacdcadcdbdbccbcdcddbbbabddccaabbcaa	FALSE
aaaaaaaabdcccacabcdccdacbdadcbccacbaadbc	TRUE
aaaaabcaabccacaaaddbcbaabcbdbbdacdddcbdd	TRUE
aaaaacdbacdbbbadcdbdaaadcddddccaddcddbcb	TRUE
aaaaadcccccabcbccdcddabbadacbdccaadddcaa	TRUE
aaaaacdcdaaaddaadabbddadbcdbdbabaabbdbaa	TRUE
aaaaaddbdcacadcabbababdccbdacccddaaaabbb	TRUE
aaaaaabcaaaadbddaabbccddbbababbbccbabadc	TRUE
aaaaabbcdcacdbbdabaabadcdbddbdcddddddddc	TRUE
aaaaaccdbcbbdbabbaaaababcadcccdddbcdabcc	TRUE
aaaaaadbbcacdacadaccddbbcaddbcdbaacdacda	TRUE
aaaaabddcdccbacbdbccbbabdcabadbaaadbbdbc	TRUE
aaaaaaabcbcaaadcadbcaccadcdbcdcdcdacdcdc	TRUE
aaaaaaabccdbbdacabbbbcacdbbbcabdcdbdcccd	TRUE
aaaaabcbbccbadcdcdadacbcddbdccbbbaabccda	TRUE
aaaaaaabaacaaaabcdadbcbaccbccdabdbacdaba	TRUE
aaaaabbbddbbdbcbabdabbaacbddabaccddbaaaa	TRUE
aaaaadccbcccdbdcaacdcabaaaabcbaaddcaaacb	TRUE
aaaaaabdacaabbabddbdcbdaccddbcbbdbaccccc	TRUE
aaaaaddcddcccdcbcabdaaaabdbdababdbddcaba	TRUE
aaaaaabbbddcbdaaaaaacdcdcbabadbaccdbcdbb	TRUE
aaaaabcaddbbcbacbdcbdcbdccdcacbbcdccacab	TRUE
aaaaacaabcaadbababcdbbbcadbabbaaaacbbdda	TRUE
aaaaaabadcadbaaddadbaaadbbcbcadcabbcadca	TRUE
aaaaadbabcdabddbbadbddbdbabaabadcccbccaa	TRUE
aaaaadcbdadacaadabbdddcccbdddaaccbdbaddb	TRUE
baaaaaaaabdcccacabcdccdacbdadcbccacbaadbc	FALSE
caaaaabcaabccacaaaddbcbaabcbdbbdacdddcbdd	FALSE
daaaaacdbacdbbbadcdbdaaadcddddccaddcddbcb	FALSE
abaaaadcccccabcbccdcddabbadacbdccaadddcaa	FALSE
acaaaacdcdaaaddaadabbddadbcdbdbabaabbdbaa	FALSE
aaaaddbdcacadcabbababdccbdacccddaaaabbb	FALSE
aacaaaabcaaaadbddaabbccddbbababbbccbabadc	FALSE
aadaaabbcdcacdbbdabaabadcdbddbdcddddddddc	FALSE
aaaaccdbcbbdbabbaaaababcadcccdddbcdabcc	FALSE
aaacaaadbbcacdacadaccddbbcaddbcdbaacdacda	FALSE
aaadaabddcdccbacbdbccbbabdcabadbaaadbbdbc	FALSE
aaaabaaabcbcaaadcadbcaccadcdbcdcdcdacdcdc	FALSE
aaaacaaabccdbbdacabbbbcacdbbbcabdcdbdcccd	FALSE
aaaadabcbbccbadcdcdadacbcddbdccbbbaabccda	FALSE
aaaabaabaacaaaabcdadbcbaccbccdabdbacdaba	FALSE
aaaacbbbddbbdbcbabdabbaacbddabaccddbaaaa	FALSE
aaaaddccbcccdbdcaacdcabaaaabcbaaddcaaacb	FALSE
aaacaabdacaabbabddbdcbdaccddbcbbdbaccccc	FALSE
aaadaddcddcccdcbcabdaaaabdbdababdbddcaba	FALSE
aacaaabbbddcbdaaaaaacdcdcbabadbaccdbcdbb	FALSE
aadaabcaddbbcbacbdcbdcbdccdcacbbcdccacab	FALSE
abaaacaabcaadbababcdbbbcadbabbaaaacbbdda	FALSE
adaaaabadcadbaaddadbaaadbbcbcadcabbcadca	FALSE
baaaadbabcdabddbbadbddbdbabaabadcccbccaa	FALSE
caaaadcbdadacaadabbdddcccbdddaaccbdbaddb	FALSE
aaaaaaaabdbddbabbadbadbacbbccdbdbaadcbdad	TRUE
aaaaadadbccabccbcabcdadabcdcdcdbdbdaaacab	TRUE
aaaaacacbdccadcaaadbabdbdcbcbabbdcdbdcbda	TRUE
aaaaabddcaadcbaaccdcbadccdccbbaccbaaabccb	TRUE
aaaaacaaccdbcacddcabcabccabaaddbbbdaacdcb	TRUE
aaaaaccbbcbacddddaadcccdabdbdcccdaddcbbdd	TRUE
aaaaadddddbbbdacdcdabcdbbaabcbaabbbcdbadc	TRUE
aaaaacbdbcddacabdabbcdbaaccdadddacdacbbdc	TRUE
aaaaadddccdbdcdababbaacbdbadcbaadaadcadbb	TRUE
aaaaabadcabbbbadbcbbabcbbdbbadcacddbdbbbd	TRUE
aaaaadddacabcbacccabbaddbcadcdbaddcdbbddd	TRUE
aaaaababaadcaacaccccacbcbcddacbbbccabaacd	TRUE
aaaaababcdbdbcadbcdcbcbbcbdcdbdbcabdbacdc	TRUE
aaaaadcadddabbcbbcddcdcbcddaddcbdcacbbbcc	TRUE
aaaaabdcaacdbbdbcdbdacbdccbaadbbabdcddcdb	TRUE
aaaaaddcbdcbadccaaddbbddcabaacbaabaaadadb	TRUE
aaaaacccdcdaccaaacdcccacbdbcadbdccbccacda	TRUE
aaaaadabcbaaadbbbadddddddabbbddddadbaadcb	TRUE
aaaaacabababdcdcbbcdbdaccbdbddbaddccdcdbd	TRUE
aaaaaaadacaaacdacbadabddddaaadcaabadadbcb	TRUE
aaaaabdaabbbadbcddbcdabaddbabbddddcadcaba	TRUE
aaaaacdccbbaabacbcbabcdddddbcacababbcdacc	TRUE
aaaaaaaddabadbcdaaadcaabaccabcaababbdadbb	TRUE
aaaaabdcddcaaaccccbaabcabdaddbaabdabdbccc	TRUE
aaaaadcadbacabaccbaabacbcbdccbbdaaccccbdd	TRUE
baaaaaaaabdbddbabbadbadbacbbccdbdbaadcbdad	FALSE
caaaaadadbccabccbcabcdadabcdcdcdbdbdaaacab	FALSE
daaaaacacbdccadcaaadbabdbdcbcbabbdcdbdcbda	FALSE
abaaaabddcaadcbaaccdcbadccdccbbaccbaaabccb	FALSE
acaaaacaaccdbcacddcabcabccabaaddbbbdaacdcb	FALSE
adaaaaccbbcbacddddaadcccdabdbdcccdaddcbbdd	FALSE
aabaaadddddbbbdacdcdabcdbbaabcbaabbbcdbadc	FALSE
aacaaacbdbcddacabdabbcdbaaccdadddacdacbbdc	FALSE
aaaadddccdbdcdababbaacbdbadcbaadaadcadbb	FALSE
aaacaabadcabbbbadbcbbabcbbdbbadcacddbdbbbd	FALSE
aaadaadddacabcbacccabbaddbcadcdbaddcdbbddd	FALSE
aaaabababaadcaacaccccacbcbcddacbbbccabaacd	FALSE
aaaacababcdbdbcadbcdcbcbbcbdcdbdbcabdbacdc	FALSE
aaaadadcadddabbcbbcddcdcbcddaddcbdcacbbbcc	FALSE
aaaabbdcaacdbbdbcdbdacbdccbaadbbabdcddcdb	FALSE
aaaacddcbdcbadccaaddbbddcabaacbaabaaadadb	FALSE
aaaadcccdcdaccaaacdcccacbdbcadbdccbccacda	FALSE
aaacadabcbaaadbbbadddddddabbbddddadbaadcb	FALSE
aaadacabababdcdcbbcdbdaccbdbddbaddccdcdbd	FALSE
aacaaaadacaaacdacbadabddddaaadcaabadadbcb	FALSE
aadaabdaabbbadbcddbcdabaddbabbddddcadcaba	FALSE
abaaacdccbbaabacbcbabcdddddbcacababbcdacc	FALSE
adaaaaaddabadbcdaaadcaabaccabcaababbdadbb	FALSE
baaaabdcddcaaaccccbaabcabdaddbaabdabdbccc	FALSE
caaaadcadbacabaccbaabacbcbdccbbdaaccccbdd	FALSE
aaaaaaaaababacbcccbbdacddccbccdcabbbcbcbab	TRUE
aaaaaadbddbdccacaabadddcaddabbbabdaabbbaca	TRUE
aaaaaccbbdddcbcbdbaacdbbdddbbccaacbcabbddd	TRUE
aaaaaabcdcdcdcbdaadadcacbcaaddcadacdadbddb	TRUE
aaaaaccaaacbabbdcdaaddddddbcbcbaddcbacabdb	TRUE
aaaaacbcbdacdadabdbcbddcbdaddaadccabbaacad	TRUE
aaaaadcddaadacccbaabccaabaaddabcccbbbbbabc	TRUE
aaaaaadcbbaabcbaabdabdcdcdbcdcacacdaacddbb	TRUE
aaaaacbccbacbbbcacbaaaacacabbbccccbaddcccb	TRUE
aaaaaddabacaccbddbccdbaabcaccbcdbabbdadddd	TRUE
aaaaaabadbbdddbabbacddccaabdbdabdadcddbdba	TRUE
aaaaaaabcbcccbbdabacbddcbbcbdbcdaddccddcbc	TRUE
aaaaacacccdbdbcadcacaabbadacbbbccdcbadabac	TRUE
aaaaadddbcbadbaaaabadaccaccadcabbcdaaaddaa	TRUE
aaaaacabbdbacdcbbbbcdcbaaacdddbcdcabacdcbc	TRUE
aaaaaccaabbbddcccdbbbccbcabaadbbdcbdaccdad	TRUE
aaaaaaabcbacabdabdabaadbbcccdcacabbbacdbaa	TRUE
aaaaacaacbadbabbcdcdbbadccabcadbbcdddccbdc	TRUE
aaaaaaacbbbcbbddaccdacccbaaabacddadccbbbcc	TRUE
aaaaacadcccacabddcbbacdacadcbbbccddaaccabb	TRUE
aaaaadacbcccbdcabadaddaaaadcbbcddcacabddad	TRUE
aaaaaabaaadbadaabcdddcbadaabbddcaddbcadbbd	TRUE
aaaaababdcccabddbaaabdccbcaccccaddcdcabcdd	TRUE
aaaaabdbabbbddadbacccbacddbcdbdccadcdaabaa	TRUE
aaaaadaabddbdaacaacabdccadbcabdaabbadabdab	TRUE
baaaaaaaaababacbcccbbdacddccbccdcabbbcbcbab	FALSE
caaaaaadbddbdccacaabadddcaddabbbabdaabbbaca	FALSE
daaaaaccbbdddcbcbdbaacdbbdddbbccaacbcabbddd	FALSE
abaaaaabcdcdcdcbdaadadcacbcaaddcadacdadbddb	FALSE
acaaaaccaaacbabbdcdaaddddddbcbcbaddcbacabdb	FALSE
aaaacbcbdacdadabdbcbddcbdaddaadccabbaacad	FALSE
aabaaadcddaadacccbaabccaabaaddabcccbbbbbabc	FALSE
aadaaaadcbbaabcbaabdabdcdcdbcdcacacdaacddbb	FALSE
aaaacbccbacbbbcacbaaaacacabbbccccbaddcccb	FALSE
aaabaaddabacaccbddbccdbaabcaccbcdbabbdadddd	FALSE
aaadaaabadbbdddbabbacddccaabdbdabdadcddbdba	FALSE
aaaabaaabcbcccbbdabacbddcbbcbdbcdaddccddcbc	FALSE
aaaacacacccdbdbcadcacaabbadacbbbccdcbadabac	FALSE
aaaadadddbcbadbaaaabadaccaccadcabbcdaaaddaa	FALSE
aaaabcabbdbacdcbbbbcdcbaaacdddbcdcabacdcbc	FALSE
aaaacccaabbbddcccdbbbccbcabaadbbdcbdaccdad	FALSE
aaabaaabcbacabdabdabaadbbcccdcacabbbacdbaa	FALSE
aaacacaacbadbabbcdcdbbadccabcadbbcdddccbdc	FALSE
aabaaaacbbbcbbddaccdacccbaaabacddadccbbbcc	FALSE
aacaacadcccacabddcbbacdacadcbbbccddaaccabb	FALSE
aadaadacbcccbdcabadaddaaaadcbbcddcacabddad	FALSE
acaaaabaaadbadaabcdddcbadaabbddcaddbcadbbd	FALSE
adaaababdcccabddbaaabdccbcaccccaddcdcabcdd	FALSE
baaaabdbabbbddadbacccbacddbcdbdccadcdaabaa	FALSE
caaaadaabddbdaacaacabdccadbcabdaabbadabdab	FALSE
aaaaaaacccadbdccdabcccaabcacabadadbabbbdbba	TRUE
aaaaabbdccbbccdbccdadcabdbdaabbaccdcccaabbd	TRUE
aaaaabcbdbdbdcbabcdabadbbbadcccddddadaaddbc	TRUE
aaaaaaabbdbdcaddadaaaccaddbddcbbccadddccdcd	TRUE
aaaaabdbdbcdcbdddcbaaacddaabaacadbbcaabbcab	TRUE
aaaaacbcccdaccbcdaddcadabcdcbdbabcdbbdcbddc	TRUE
aaaaabcdbbaaababcdcccadcbcacdcabadbcdaabbab	TRUE
aaaaaddcdcaabbdabaadcdaadcdaadacacbdccabcdc	TRUE
aaaaacccccddcaacbdabcaaccacdbcccabbcaaaadcc	TRUE
aaaaabbaababaaabadbccdacadbaccbbadcbccaaaad	TRUE
aaaaadcccaacccbcbbbdaaabcbbbbadbddcacdbdbdb	TRUE
aaaaaddbbddbabdabcbaddbcacbbcdababaacdabddc	TRUE
aaaaaaadaddcbbccddcdcbbbdcdaacabbaacaadadcc	TRUE
aaaaabcaddbcaadbcbadbdcbdddaabbddcbcbabdcab	TRUE
aaaaacadabbaaabcdbacbccabdbdcbaccddddbaabbb	TRUE
aaaaaaddaacdbddbbbcbcccbaadcadcdcdbddabdcda	TRUE
aaaaabdabdddcabacacbbdddacdcdbdbcbdbcadadbc	TRUE
aaaaadcddcacadccbcadcadadbaabacabaadcabadcc	TRUE
aaaaacccddbbadacbbadbdbcaccbbabadbcbcccdddc	TRUE
aaaaabcdcdbccadbbddccabcccdddbcbdbbcacbdabb	TRUE
aaaaacbdaabacdaacacdaabbadcbbbdcdbcdadbbaad	TRUE
aaaaaabdccbdadabbcaddbddccbacabaaacbadcabcc	TRUE
aaaaadbdbcdddcdabccddccbaddbaacbbddacbbdcab	TRUE
aaaaaaaacdbadaccdbadcdddaacbaadbbbcacdaadad	TRUE
aaaaabdccbacadbdbcbdbdddcaababcbdbbdbdcaacd	TRUE
baaaaaaacccadbdccdabcccaabcacabadadbabbbdbba	FALSE
caaaaabbdccbbccdbccdadcabdbdaabbaccdcccaabbd	FALSE
daaaaabcbdbdbdcbabcdabadbbbadcccddddadaaddbc	FALSE
abaaaaaabbdbdcaddadaaaccaddbddcbbccadddccdcd	FALSE
acaaaabdbdbcdcbdddcbaaacddaabaacadbbcaabbcab	FALSE
adaaaacbcccdaccbcdaddcadabcdcbdbabcdbbdcbddc	FALSE
aabaaabcdbbaaababcdcccadcbcacdcabadbcdaabbab	FALSE
aacaaaddcdcaabbdabaadcdaadcdaadacacbdccabcdc	FALSE
aadaaacccccddcaacbdabcaaccacdbcccabbcaaaadcc	FALSE
aaabaabbaababaaabadbccdacadbaccbbadcbccaaaad	FALSE
aaacaadcccaacccbcbbbdaaabcbbbbadbddcacdbdbdb	FALSE
aaaaddbbddbabdabcbaddbcacbbcdababaacdabddc	FALSE
aaaacaaadaddcbbccddcdcbbbdcdaacabbaacaadadcc	FALSE
aaaadabcaddbcaadbcbadbdcbdddaabbddcbcbabdcab	FALSE
aaaacadabbaaabcdbacbccabdbdcbaccddddbaabbb	FALSE
aaaacaddaacdbddbbbcbcccbaadcadcdcdbddabdcda	FALSE
aaaadbdabdddcabacacbbdddacdcdbdbcbdbcadadbc	FALSE
aaabadcddcacadccbcadcadadbaabacabaadcabadcc	FALSE
aaacacccddbbadacbbadbdbcaccbbabadbcbcccdddc	FALSE
aabaabcdcdbccadbbddccabcccdddbcbdbbcacbdabb	FALSE
aacaacbdaabacdaacacdaabbadcbbbdcdbcdadbbaad	FALSE
abaaaabdccbdadabbcaddbddccbacabaaacbadcabcc	FALSE
acaaadbdbcdddcdabccddccbaddbaacbbddacbbdcab	FALSE
baaaaaaacdbadaccdbadcdddaacbaadbbbcacdaadad	FALSE
caaaabdccbacadbdbcbdbdddcaababcbdbbdbdcaacd	FALSE
aaaaaaabcdbcabcbadacbdcccdbccdadddcbbdbabaab	TRUE
aaaaadbcdcbcacbdabcdbcdcadaccdddadbbaaaaabaa	TRUE
aaaaacacacddaacdbdbdacddbbcbbbbadddbdbaacabb	TRUE
aaaaabbaccbaddddccbbbdddadbbadaabcadcbdaabdc	TRUE
aaaaacaaaaabdccbccdaadadbaacdacacccbabdbcabd	TRUE
aaaaabaaadcadcccdbcbddbccbbdbddccaadaabaddcb	TRUE
aaaaacaacdcbcacdbccbdccdcddbcdbcbccaddbacdbd	TRUE
aaaaaabccbcbbaccbdbbcbdcdddbbdbcddabbcabbbba	TRUE
aaaaadcbababdddbddcabdaddbcbacbdccddcbbdcaac	TRUE
aaaaaccabbdddcccadbcdadcbbbacaaabdbacdbdbbbb	TRUE
aaaaabdbbcbddcacdcaccadabcccacccbccabdcdabad	TRUE
aaaaaabaacbcdaddcdaaacabcddcbbbacccadddddbbd	TRUE
aaaaadaddabcbaaccccadddcccbcccbadddccdcdaccc	TRUE
aaaaaccadbccbcbcddcbbcbddbdbcbcbcbaccbdabdbc	TRUE
aaaaadbadacccddbdbccbbbbdbcdbccbaadcacabcbdc	TRUE
aaaaacdcdbcdcabaaabbddbddaaadadbdaacadabaccd	TRUE
aaaaaabccaadacdbaabcdacabbacdbaaadbdbbcdcaac	TRUE
aaaaabcbdbacaadcaacbabcdcacaabddcddcadabcdad	TRUE
aaaaadbadbcabbaacadaccbbdddadaccaaabbbdcdccb	TRUE
aaaaaadaacdcbaabbaacccbdcbccddbbcabccaddabbd	TRUE
aaaaabcadadbccdbcdaaacdcbbbdcdddbabdaccccbcd	TRUE
aaaaadbbddacddabbbccdcccbddbadbcccaadbbcddcd	TRUE
aaaaaacabaddddabcacadbbcddcdcbbbdcddbdbabaaa	TRUE
aaaaadacbcbdaadaacddcbccddbcbbbcbdbcabcccddb	TRUE
aaaaadacabaaadadabbcadbcaadabcbdcbcadbddaabc	TRUE
baaaaaaabcdbcabcbadacbdcccdbccdadddcbbdbabaab	FALSE
caaaaadbcdcbcacbdabcdbcdcadaccdddadbbaaaaabaa	FALSE
daaaaacacacddaacdbdbdacddbbcbbbbadddbdbaacabb	FALSE
abaaaabbaccbaddddccbbbdddadbbadaabcadcbdaabdc	FALSE
acaaaacaaaaabdccbccdaadadbaacdacacccbabdbcabd	FALSE
aaaabaaadcadcccdbcbddbccbbdbddccaadaabaddcb	FALSE
aabaaacaacdcbcacdbccbdccdcddbcdbcbccaddbacdbd	FALSE
aadaaaabccbcbbaccbdbbcbdcdddbbdbcddabbcabbbba	FALSE
aaaadcbababdddbddcabdaddbcbacbdccddcbbdcaac	FALSE
aaabaaccabbdddcccadbcdadcbbbacaaabdbacdbdbbbb	FALSE
aaadaabdbbcbddcacdcaccadabcccacccbccabdcdabad	FALSE
aaaabaabaacbcdaddcdaaacabcddcbbbacccadddddbbd	FALSE
aaaacadaddabcbaaccccadddcccbcccbadddccdcdaccc	FALSE
aaaadaccadbccbcbcddcbbcbddbdbcbcbcbaccbdabdbc	FALSE
aaaabdbadacccddbdbccbbbbdbcdbccbaadcacabcbdc	FALSE
aaaaccdcdbcdcabaaabbddbddaaadadbdaacadabaccd	FALSE
aaabaabccaadacdbaabcdacabbacdbaaadbdbbcdcaac	FALSE
aaacabcbdbacaadcaacbabcdcacaabddcddcadabcdad	FALSE
aaadadbadbcabbaacadaccbbdddadaccaaabbbdcdccb	FALSE
aacaaadaacdcbaabbaacccbdcbccddbbcabccaddabbd	FALSE
aadaabcadadbccdbcdaaacdcbbbdcdddbabdaccccbcd	FALSE
abaaadbbddacddabbbccdcccbddbadbcccaadbbcddcd	FALSE
adaaaacabaddddabcacadbbcddcdcbbbdcddbdbabaaa	FALSE
baaaadacbcbdaadaacddcbccddbcbbbcbdbcabcccddb	FALSE
caaaadacabaaadadabbcadbcaadabcbdcbcadbddaabc	FALSE
aaaaaaacccddabacacabadbbcaacacbccacccbaddcdca	TRUE
aaaaadaadccbccbccdadcdcbccabadddbabadddccabac	TRUE
aaaaacbdccdcbbaacddbccbcacbbdcbaaadccdbaccbab	TRUE
aaaaadcaaabccdacbaddccbcacdabdababdacbaaaadda	TRUE
aaaaabddccdbbcadabaaaaabccbcbdaccdcaddadabbaa	TRUE
aaaaabaacbdbabbabcdccdadbccccdbadcdbdcccddaba	TRUE
aaaaaaadbbdcabdadbabacdcbdcbccdcbdbaccbababad	TRUE
aaaaaadacbadaccabbacdbdddbabbbddaaacabdbdaddd	TRUE
aaaaacdbcaacdabaccaacdaaacacdcabacdccbdcbdadd	TRUE
aaaaaaaabcbaacccbadbacbbcccbcacbdbbabcdbbdbac	TRUE
aaaaaacdcbddcaadaddcdddcddcdaabaaabaaddacccbd	TRUE
aaaaababbdddbdcbdccabbbbcabdddccdacccaabcaacc	TRUE
aaaaaacdcdccbacdccdccbddcccbacdbccaadcaabcccb	TRUE
aaaaacbbcbcbddabdabacbadcdaccbbdabbcacaadbddc	TRUE
aaaaaabbabbdaccacacabbddbbccdbacbbacacdbbadac	TRUE
aaaaacadcaccdbbacdaacaacbbddaccacddbcacbdbabc	TRUE
aaaaaaaddbcabccbcbcbababbdccbdcbaaabacbccdccd	TRUE
aaaaadcddbadbabccabcddaccdadaaadabbcaabaaaaac	TRUE
aaaaacbbdbbbbabaccadbcbacdabbccbdbbacbcbdbbcb	TRUE
aaaaabbccadcaddddddaabddbdcadbddbaacabdbbddbb	TRUE
aaaaaabcccaddacdcbacdcddcadddddcdaaadddbbacab	TRUE
aaaaacdcbddccbbbadaabacbcababaccdcaacccbdddac	TRUE
aaaaabcadcccbdaddcbacbabadbbabbcbbaddaacacaab	TRUE
aaaaadadcbcacdbbddcccbbcdbdaddcdcdbcdbaccdddc	TRUE
aaaaacdbcbbcbcdccacbcdbbdbbcdddcbaaacbadbdbbd	TRUE
baaaaaaacccddabacacabadbbcaacacbccacccbaddcdca	FALSE
caaaaadaadccbccbccdadcdcbccabadddbabadddccabac	FALSE
daaaaacbdccdcbbaacddbccbcacbbdcbaaadccdbaccbab	FALSE
abaaaadcaaabccdacbaddccbcacdabdababdacbaaaadda	FALSE
acaaaabddccdbbcadabaaaaabccbcbdaccdcaddadabbaa	FALSE
aaaabaacbdbabbabcdccdadbccccdbadcdbdcccddaba	FALSE
aacaaaaadbbdcabdadbabacdcbdcbccdcbdbaccbababad	FALSE
aadaaaadacbadaccabbacdbdddbabbbddaaacabdbdaddd	FALSE
aaaacdbcaacdabaccaacdaaacacdcabacdccbdcbdadd	FALSE
aaacaaaaabcbaacccbadbacbbcccbcacbdbbabcdbbdbac	FALSE
aaadaaacdcbddcaadaddcdddcddcdaabaaabaaddacccbd	FALSE
aaaababbdddbdcbdccabbbbcabdddccdacccaabcaacc	FALSE
aaaacaacdcdccbacdccdccbddcccbacdbccaadcaabcccb	FALSE
aaaadacbbcbcbddabdabacbadcdaccbbdabbcacaadbddc	FALSE
aaaababbabbdaccacacabbddbbccdbacbbacacdbbadac	FALSE
aaaaccadcaccdbbacdaacaacbbddaccacddbcacbdbabc	FALSE
aaabaaaddbcabccbcbcbababbdccbdcbaaabacbccdccd	FALSE
aaacadcddbadbabccabcddaccdadaaadabbcaabaaaaac	FALSE
aaadacbbdbbbbabaccadbcbacdabbccbdbbacbcbdbbcb	FALSE
aabaabbccadcaddddddaabddbdcadbddbaacabdbbddbb	FALSE
aadaaabcccaddacdcbacdcddcadddddcdaaadddbbacab	FALSE
abaaacdcbddccbbbadaabacbcababaccdcaacccbdddac	FALSE
acaaabcadcccbdaddcbacbabadbbabbcbbaddaacacaab	FALSE
baaaadadcbcacdbbddcccbbcdbdaddcdcdbcdbaccdddc	FALSE
caaaacdbcbbcbcdccacbcdbbdbbcdddcbaaacbadbdbbd	FALSE
aaaaaaaddadbddbcacdddbdcccbcbdbccabadacbcdcada	TRUE
aaaaadcbcacdcbccaacacaadcbdaadddcddbcbddccbcab	TRUE
aaaaaccbbbcbacbdacdcccaabacaacbbbdaddabbbcdbdc	TRUE
aaaaadabdacbbbaddaadadbcddadcadcbcadcdacddcacc	TRUE
aaaaaccabdccadcbabbccbaababccdcbbccacdbdaaccaa	TRUE
aaaaabcccaaacbddbdaaccdcadccabdccbacbadddcbcda	TRUE
aaaaacdbdbbcaaacbcdababdcdcadddbdaccbbdbbbcbcc	TRUE
aaaaabcccdabccdacdbabdcbccacccbbdacccaccdbbbab	TRUE
aaaaadbbaabadccaaadbbbcdbdacaabbacddcbcdabaacc	TRUE
aaaaabdcbcddadbcadddacbdbcadbaaaaabadbddddcbdc	TRUE
aaaaaaabbdbdccdaabbcbdcaaddbdddcbcabdcabacddda	TRUE
aaaaacacddaabccbccdbcabbcdabccabcbdabbbaccdadb	TRUE
aaaaacbbcbdbddccbdcbcdbbbdbaaccccddaddcdddcbab	TRUE
aaaaabbdccdcbbdddbbbbdbbbbadacdcacdcbaddccbcbc	TRUE
aaaaacdcbccddbcddcbccaddbbdcdbbddbbcbbacdcbddb	TRUE
aaaaabdabacbadacabdbcbbcbdddabdacabbaadacbdbac	TRUE
aaaaaddbadcdcadcdabdbabbaabbbccccaabbadcddcbdd	TRUE
aaaaabbadccaccdbabcaabcbdcbaccadcbaabccdadcbdd	TRUE
aaaaadbcbcddddaccdcabcddabdaacacaadababdddcdba	TRUE
aaaaabdadcbacdcabdbaabbaadacdcaacdddbbcbbcadbc	TRUE
aaaaaddaaabdcbdadbbbcdcbcdddbdbddcbbcdaccbbccd	TRUE
aaaaaccbcaadabdacddcdcccbddbadaccdddabbbaccabb	TRUE
aaaaaadacbbcbcddaadbdbabdadbccbdaabacdcccadbbd	TRUE
aaaaacdccccacbdbccbcadabbabdbcadaaddadaacbbcbd	TRUE
aaaaaccbcaaabdcacdbabbbdbaaababadbbcdacdacddba	TRUE
baaaaaaaddadbddbcacdddbdcccbcbdbccabadacbcdcada	FALSE
caaaaadcbcacdcbccaacacaadcbdaadddcddbcbddccbcab	FALSE
daaaaaccbbbcbacbdacdcccaabacaacbbbdaddabbbcdbdc	FALSE
abaaaadabdacbbbaddaadadbcddadcadcbcadcdacddcacc	FALSE
acaaaaccabdccadcbabbccbaababccdcbbccacdbdaaccaa	FALSE
adaaaabcccaaacbddbdaaccdcadccabdccbacbadddcbcda	FALSE
aabaaacdbdbbcaaacbcdababdcdcadddbdaccbbdbbbcbcc	FALSE
aacaaabcccdabccdacdbabdcbccacccbbdacccaccdbbbab	FALSE
aaaadbbaabadccaaadbbbcdbdacaabbacddcbcdabaacc	FALSE
aaabaabdcbcddadbcadddacbdbcadbaaaaabadbddddcbdc	FALSE
aaadaaaabbdbdccdaabbcbdcaaddbdddcbcabdcabacddda	FALSE
aaaacacddaabccbccdbcabbcdabccabcbdabbbaccdadb	FALSE
aaaabacbbcbdbddccbdcbcdbbbdbaaccccddaddcdddcbab	FALSE
aaaacabbdccdcbbdddbbbbdbbbbadacdcacdcbaddccbcbc	FALSE
aaaacdcbccddbcddcbccaddbbdcdbbddbbcbbacdcbddb	FALSE
aaaabbdabacbadacabdbcbbcbdddabdacabbaadacbdbac	FALSE
aaaadddbadcdcadcdabdbabbaabbbccccaabbadcddcbdd	FALSE
aaababbadccaccdbabcaabcbdcbaccadcbaabccdadcbdd	FALSE
aaadadbcbcddddaccdcabcddabdaacacaadababdddcdba	FALSE
aabaabdadcbacdcabdbaabbaadacdcaacdddbbcbbcadbc	FALSE
aadaaddaaabdcbdadbbbcdcbcdddbdbddcbbcdaccbbccd	FALSE
abaaaccbcaadabdacddcdcccbddbadaccdddabbbaccabb	FALSE
adaaaadacbbcbcddaadbdbabdadbccbdaabacdcccadbbd	FALSE
baaaacdccccacbdbccbcadabbabdbcadaaddadaacbbcbd	FALSE
caaaaccbcaaabdcacdbabbbdbaaababadbbcdacdacddba	FALSE
aaaaaaaabdbccbdbbccaaaabccdcadcdbccdaaaacacabad	TRUE
aaaaabaaaddbbcdadaacacbacabdbbbdacaacadcaacacdb	TRUE
aaaaabcaacbbbcbbcddbbbbcbdcbbbababdcaacddbbdbdd	TRUE
aaaaaccbdabcbdcaacadbacdddbadbdbbbcdddcdbbcdbdb	TRUE
aaaaaaacddcaacbbdccabccdaddcaccdbaaabcbcdbaacbb	TRUE
aaaaabbacabacddcbcddcccabadadbabdaccbdbcaadacab	TRUE
aaaaaaacaaadcbabbdbccddadcdbbcdababbdaaccbaabcd	TRUE
aaaaadaaacccdcdbdcadbaadbbdccacbcacdaddcbdddbca	TRUE
aaaaacddbadddaacdcdcbdbcccadcabacadbabccdadabaa	TRUE
aaaaadabdbcaddcaccdadccadbadddcbabdbdaabdccbdcb	TRUE
aaaaaabbaddaddbcbabbadddcaccaaaaccbbbcaacababda	TRUE
aaaaaddcdadddbadbaaadbcbadbdabbcbbbcbddacccdddc	TRUE
aaaaaccbdabbdcdbdbdbccacddcdbacbdbbaadacbdbcdbd	TRUE
aaaaaacaabdadccaaddbbcbbcaddcabdcdbcaaccdcbbbbb	TRUE
aaaaacabadccaacadabbbbadbaccbddacdbadcbcbaaccca	TRUE
aaaaaabdcadbbabaaabcccdbcdbacdbcaddbbaddabbdbda	TRUE
aaaaabdabcccbccaddaacdcbaacdbbcdcdccbaaaaadccda	TRUE
aaaaaadabbbcbcacdbdbdbacbdaacbbacacabcbabacdaac	TRUE
aaaaababdddadbcbbbbacbbcbadddadcabcbbcbbaaabcad	TRUE
aaaaabbcadcbaaadccbcabdbbcbdbabcabaadabdcdbbacb	TRUE
aaaaacdadabccbccdadbccabcaccadaadddadaccddbbbab	TRUE
aaaaabbddbbcdbaccddabbdbbacbdbdcdbbdbadbcbdadbb	TRUE
aaaaadbdcddcdacabaddacaddcbaabcdcbadbdbcdacacdd	TRUE
aaaaaaacbbaccacbdcdacdcdddbabcbacadbcbdcacacbcb	TRUE
aaaaadabcadadbcadadadcccadaaccdcbddabacdcadbbbd	TRUE
baaaaaaaabdbccbdbbccaaaabccdcadcdbccdaaaacacabad	FALSE
caaaaabaaaddbbcdadaacacbacabdbbbdacaacadcaacacdb	FALSE
daaaaabcaacbbbcbbcddbbbbcbdcbbbababdcaacddbbdbdd	FALSE
aaaaccbdabcbdcaacadbacdddbadbdbbbcdddcdbbcdbdb	FALSE
acaaaaaacddcaacbbdccabccdaddcaccdbaaabcbcdbaacbb	FALSE
adaaaabbacabacddcbcddcccabadadbabdaccbdbcaadacab	FALSE
aabaaaaacaaadcbabbdbccddadcdbbcdababbdaaccbaabcd	FALSE
aacaaadaaacccdcdbdcadbaadbbdccacbcacdaddcbdddbca	FALSE
aadaaacddbadddaacdcdcbdbcccadcabacadbabccdadabaa	FALSE
aaabaadabdbcaddcaccdadccadbadddcbabdbdaabdccbdcb	FALSE
aaadaaabbaddaddbcbabbadddcaccaaaaccbbbcaacababda	FALSE
aaaaddcdadddbadbaaadbcbadbdabbcbbbcbddacccdddc	FALSE
aaaabaccbdabbdcdbdbdbccacddcdbacbdbbaadacbdbcdbd	FALSE
aaaadaacaabdadccaaddbbcbbcaddcabdcdbcaaccdcbbbbb	FALSE
aaaacabadccaacadabbbbadbaccbddacdbadcbcbaaccca	FALSE
aaaacabdcadbbabaaabcccdbcdbacdbcaddbbaddabbdbda	FALSE
aaaadbdabcccbccaddaacdcbaacdbbcdcdccbaaaaadccda	FALSE
aaacaadabbbcbcacdbdbdbacbdaacbbacacabcbabacdaac	FALSE
aaadababdddadbcbbbbacbbcbadddadcabcbbcbbaaabcad	FALSE
aabaabbcadcbaaadccbcabdbbcbdbabcabaadabdcdbbacb	FALSE
aacaacdadabccbccdadbccabcaccadaadddadaccddbbbab	FALSE
abaaabbddbbcdbaccddabbdbbacbdbdcdbbdbadbcbdadbb	FALSE
acaaadbdcddcdacabaddacaddcbaabcdcbadbdbcdacacdd	FALSE
baaaaaacbbaccacbdcdacdcdddbabcbacadbcbdcacacbcb	FALSE
caaaadabcadadbcadadadcccadaaccdcbddabacdcadbbbd	FALSE
aaaaaaaccdbddbbacadbcacdcaadbdadbbcbcbddbdaababd	TRUE
aaaaacbcdbcdbacabcbdaddaaaaabcdaccdaacdbcaccdcaa	TRUE
aaaaadabbdcbccdccccaccdadaadcbbcacaaaadcdacbbcac	TRUE
aaaaabbccaacdbdacdcbddcbcbbacbddbaabcbaddbbbbccc	TRUE
aaaaacbcccddbcacadcdcddcadabbabadcbdadddaacdadba	TRUE
aaaaabbcddadcdadcacbcbbcabbacbdbaddaccacdacbbccc	TRUE
aaaaacbdbbacacbabcdabbaccabacabdccabdbadabcdaada	TRUE
aaaaadbdbccadbdcbcdbcdbcaaaabccdaaadbddbddcabcab	TRUE
aaaaacadbbcaacdbccddadaacabadbaaddabdcacddddacdb	TRUE
aaaaadcbcdabcdadbacddbccadbdcdacacddcdbcbabbccbd	TRUE
aaaaabbacacdbdadccabadcbcdcaabcbacaaddaaabcbdddd	TRUE
aaaaaddaccdddacdbdcdcbcdcddaadcacdddbacbacbbaadc	TRUE
aaaaaaaabdaaaddbdbdbbccadcabbacadbdaddbacdddbdac	TRUE
aaaaaccdcdcaabdccdcadbccccaaacbbabdbcbcddcabdddc	TRUE
aaaaabbaaddacddddabaabdcabcbbbbbddcbcdbccdbcbcaa	TRUE
aaaaaabbdabdbccbdadaccdabddcdaaddbaadcdcccbcbdca	TRUE
aaaaadcdbbcbaadbddabcddabcdadcadaabbdbadddbaadca	TRUE
aaaaabddcdaadcbcaddadabaadcbbdcdbacbaddcccdbacaa	TRUE
aaaaacccddbbadbbddcdbccadcdaacdaaadcbcacdacaddcc	TRUE
aaaaaddcbcacbcbaaccdcaabbccdacbbdcdaaabcbbcdbbdc	TRUE
aaaaabcddaccaadbabbdccbcdcdbbabdadbcbcccdbdaccdc	TRUE
aaaaacdcababcacbbcdabdcccdcbacadcbbcdccbbadddcca	TRUE
aaaaadbdacdcdbbdadacdaaacabdddbbbcbccabddbddaabd	TRUE
aaaaaaacacdbadccacccddabcdabcacbaaccbabcadccdabd	TRUE
aaaaaddbccbbdddacadbddccdbbccacaadcbabddabcadacb	TRUE
baaaaaaaccdbddbbacadbcacdcaadbdadbbcbcbddbdaababd	FALSE
caaaaacbcdbcdbacabcbdaddaaaaabcdaccdaacdbcaccdcaa	FALSE
daaaaadabbdcbccdccccaccdadaadcbbcacaaaadcdacbbcac	FALSE
aaaabbccaacdbdacdcbddcbcbbacbddbaabcbaddbbbbccc	FALSE
acaaaacbcccddbcacadcdcddcadabbabadcbdadddaacdadba	FALSE
adaaaabbcddadcdadcacbcbbcabbacbdbaddaccacdacbbccc	FALSE
aabaaacbdbbacacbabcdabbaccabacabdccabdbadabcdaada	FALSE
aacaaadbdbccadbdcbcdbcdbcaaaabccdaaadbddbddcabcab	FALSE
aaaacadbbcaacdbccddadaacabadbaaddabdcacddddacdb	FALSE
aaabaadcbcdabcdadbacddbccadbdcdacacddcdbcbabbccbd	FALSE
aaacaabbacacdbdadccabadcbcdcaabcbacaaddaaabcbdddd	FALSE
aaaaddaccdddacdbdcdcbcdcddaadcacdddbacbacbbaadc	FALSE
aaaacaaaabdaaaddbdbdbbccadcabbacadbdaddbacdddbdac	FALSE
aaaadaccdcdcaabdccdcadbccccaaacbbabdbcbcddcabdddc	FALSE
aaaabbaaddacddddabaabdcabcbbbbbddcbcdbccdbcbcaa	FALSE
aaaacabbdabdbccbdadaccdabddcdaaddbaadcdcccbcbdca	FALSE
aaaaddcdbbcbaadbddabcddabcdadcadaabbdbadddbaadca	FALSE
aaababddcdaadcbcaddadabaadcbbdcdbacbaddcccdbacaa	FALSE
aaadacccddbbadbbddcdbccadcdaacdaaadcbcacdacaddcc	FALSE
aabaaddcbcacbcbaaccdcaabbccdacbbdcdaaabcbbcdbbdc	FALSE
aacaabcddaccaadbabbdccbcdcdbbabdadbcbcccdbdaccdc	FALSE
abaaacdcababcacbbcdabdcccdcbacadcbbcdccbbadddcca	FALSE
acaaadbdacdcdbbdadacdaaacabdddbbbcbccabddbddaabd	FALSE
baaaaaacacdbadccacccddabcdabcacbaaccbabcadccdabd	FALSE
caaaaddbccbbdddacadbddccdbbccacaadcbabddabcadacb	FALSE
aaaaaaaacddddbaacbcbddbddbbcdabbcdcbabdabcdbaabbc	TRUE
aaaaacddcaaadcdbbddbbcdabaccbddbacbdcdaaccdbdacad	TRUE
aaaaabbcadcdcaddacbdaddbbddbbabbadbdacacdddbddcdc	TRUE
aaaaaddbacbbcababbbcadbcadaacbccddddaccadabbcacac	TRUE
aaaaabdddabcbccbbaabacbbadadcbcbcbccbadbbbdbdcdcc	TRUE
aaaaacaabcccdbabdbcccdbbddcbdcbcbacbabddaaacadbda	TRUE
aaaaababcdbdcadcbabcddccababcbdbddbdaaddccaddabab	TRUE
aaaaaabaaddaacbbbddacdbabdabbddbbddbabdcddaaabcbb	TRUE
aaaaabccbddaccaacbcaabdbaadcadadaddddbcacdadcddac	TRUE
aaaaacacbcaabbdbdaabacbcbbdcdaacbdaccbdcdbdcabcdd	TRUE
aaaaadbadbdcadababcbbbbcdcdadccccbaabaddbcbcdcbbb	TRUE
aaaaaabdcadadaccadbabcbdbdacdababcabbaabbacdcaabd	TRUE
aaaaaddcbbddcbdadaaacddcaaccdbabbdcddcdcbddcadbaa	TRUE
aaaaabdcbcbdbbdaddcbadccbabcbadaadadbcbbddaaccdda	TRUE
aaaaadabbddacddbdcdaadaabcbcddccadbccdcadabaabacc	TRUE
aaaaabdbbcaabcadcbddabcaabacaddccccabcdabbadacccd	TRUE
aaaaaacadcccabbddaadacbbbaddcabacccdcccabaacdbdab	TRUE
aaaaadcdacdcadabdbdccaccccdacccbccdccacdcacdadbbb	TRUE
aaaaaacdaabcaadddbbbbcbdbccbdbcbaccdcccdbbcddbaac	TRUE
aaaaacabccbdbcabcdcbacadbccabcabacbcdcbcdbaacbadc	TRUE
aaaaacbddaacdabaaccccacbcabdcabcccdacdddbbbcbdacc	TRUE
aaaaabbadabbccaaacaaddabbacadcadaaabadbaaaacdcddb	TRUE
aaaaaabbdbbcbcbaabdccbbbdcacdbbaabccbdcbcdabaacab	TRUE
aaaaacabaabdabcdabcccbbbbaabcccbaccbdbdbbddcaadcd	TRUE
aaaaaddbaddbabdbcccbadaabdcbdabdabcadbddacaadaacd	TRUE
baaaaaaaacddddbaacbcbddbddbbcdabbcdcbabdabcdbaabbc	FALSE
caaaaacddcaaadcdbbddbbcdabaccbddbacbdcdaaccdbdacad	FALSE
daaaaabbcadcdcaddacbdaddbbddbbabbadbdacacdddbddcdc	FALSE
abaaaaddbacbbcababbbcadbcadaacbccddddaccadabbcacac	FALSE
acaaaabdddabcbccbbaabacbbadadcbcbcbccbadbbbdbdcdcc	FALSE
aaaacaabcccdbabdbcccdbbddcbdcbcbacbabddaaacadbda	FALSE
aabaaababcdbdcadcbabcddccababcbdbddbdaaddccaddabab	FALSE
aadaaaabaaddaacbbbddacdbabdabbddbbddbabdcddaaabcbb	FALSE
aaaabccbddaccaacbcaabdbaadcadadaddddbcacdadcddac	FALSE
aaacaacacbcaabbdbdaabacbcbbdcdaacbdaccbdcdbdcabcdd	FALSE
aaadaadbadbdcadababcbbbbcdcdadccccbaabaddbcbcdcbbb	FALSE
aaaabaabdcadadaccadbabcbdbdacdababcabbaabbacdcaabd	FALSE
aaaacaddcbbddcbdadaaacddcaaccdbabbdcddcdcbddcadbaa	FALSE
aaaadabdcbcbdbbdaddcbadccbabcbadaadadbcbbddaaccdda	FALSE
aaaabdabbddacddbdcdaadaabcbcddccadbccdcadabaabacc	FALSE
aaaacbdbbcaabcadcbddabcaabacaddccccabcdabbadacccd	FALSE
aaabaacadcccabbddaadacbbbaddcabacccdcccabaacdbdab	FALSE
aaacadcdacdcadabdbdccaccccdacccbccdccacdcacdadbbb	FALSE
aabaaacdaabcaadddbbbbcbdbccbdbcbaccdcccdbbcddbaac	FALSE
aacaacabccbdbcabcdcbacadbccabcabacbcdcbcdbaacbadc	FALSE
aadaacbddaacdabaaccccacbcabdcabcccdacdddbbbcbdacc	FALSE
abaaabbadabbccaaacaaddabbacadcadaaabadbaaaacdcddb	FALSE
adaaaabbdbbcbcbaabdccbbbdcacdbbaabccbdcbcdabaacab	FALSE
baaaacabaabdabcdabcccbbbbaabcccbaccbdbdbbddcaadcd	FALSE
caaaaddbaddbabdbcccbadaabdcbdabdabcadbddacaadaacd	FALSE
aaaaaaaaacccdacbaaabaccabbadacabddddbbcdccaabcdada	TRUE
aaaaaccbcdaadcbbaaacadcbabadccccbbddbaccbaaabbaaaa	TRUE
aaaaadaabcbdccaabbcccabcacddcccdcaabdaddbcaddadbda	TRUE
aaaaabcbddaaccadcdcdbdabababaccacaccaccaacadbabacc	TRUE
aaaaaabcddbddacdbcbbbdadadcaddacbaaababbccbddbaaab	TRUE
aaaaabdbadcdabdadcbcaadaaaaaddbdaccddccbcccdcbacbb	TRUE
aaaaadaabcaaabddadacdaaadcdbcabbcabdadccbbaabbcacd	TRUE
aaaaabddcaacdbcdbaccadaaacdbbddaacbddcbaddcabdaaca	TRUE
aaaaadccadabcbdacabdddaadacaabcbbaadbadadddcaabcca	TRUE
aaaaaaadccacdcbcbccdaccdddabcbabacdcaaacbabcadabbb	TRUE
aaaaacdabaabaabbdaddbadabdbadbaadbaccacacdddccbadb	TRUE
aaaaaaadaabdadccadbdcdcdddbaaccadacdadcbcddcadabac	TRUE
aaaaacddadbbbccacdddccbcadaacdddacbdadccbdbcdbaabc	TRUE
aaaaadbcaddaacddadbdaccddcabbdcbcbbbcadbddaabbccca	TRUE
aaaaaadccaacddcbaadbdaaacdadcccbddcacbadbcdddacbbd	TRUE
aaaaadccbbbdbdcbcbbcbdddadcadddccdcdabcacacdbbcacb	TRUE
aaaaabadbdbaccdacccbbdaaaddcbccdbcbbdcadcccdcdacaa	TRUE
aaaaacccdbbccbabcbdacdcdaabbcccdddcabdbbaadacdadab	TRUE
aaaaadcdbcadbdaadadacbcdbdbcdacaaaaacbadacbabaacab	TRUE
aaaaadddcdbbdcbdaacbdbcdcbddccbcdbbaaadcdcbcbbdbcd	TRUE
aaaaaabbacbbcdcbbbabcadcdbaacbcbdddaddaabbccdcddbc	TRUE
aaaaadcbbadbbbdacdcdbddbbbcbdcbbdcaddddcdbacadaaac	TRUE
aaaaadbbadadcbbcadacbbddccaabaacddddcababddadbbbac	TRUE
aaaaaadabdccacbaaacbabccbdbaadbbbcccaddaddbabacbdc	TRUE
aaaaaddddbdbccbbabbdbdabcacbdbdaabaddcdbbdaaabdabb	TRUE
baaaaaaaaacccdacbaaabaccabbadacabddddbbcdccaabcdada	FALSE
caaaaaccbcdaadcbbaaacadcbabadccccbbddbaccbaaabbaaaa	FALSE
daaaaadaabcbdccaabbcccabcacddcccdcaabdaddbcaddadbda	FALSE
aaaabcbddaaccadcdcdbdabababaccacaccaccaacadbabacc	FALSE
acaaaaabcddbddacdbcbbbdadadcaddacbaaababbccbddbaaab	FALSE
adaaaabdbadcdabdadcbcaadaaaaaddbdaccddccbcccdcbacbb	FALSE
aabaaadaabcaaabddadacdaaadcdbcabbcabdadccbbaabbcacd	FALSE
aacaaabddcaacdbcdbaccadaaacdbbddaacbddcbaddcabdaaca	FALSE
aaaadccadabcbdacabdddaadacaabcbbaadbadadddcaabcca	FALSE
aaacaaaadccacdcbcbccdaccdddabcbabacdcaaacbabcadabbb	FALSE
aaadaacdabaabaabbdaddbadabdbadbaadbaccacacdddccbadb	FALSE
aaaabaaadaabdadccadbdcdcdddbaaccadacdadcbcddcadabac	FALSE
aaaacacddadbbbccacdddccbcadaacdddacbdadccbdbcdbaabc	FALSE
aaaadadbcaddaacddadbdaccddcabbdcbcbbbcadbddaabbccca	FALSE
aaaabadccaacddcbaadbdaaacdadcccbddcacbadbcdddacbbd	FALSE
aaaacdccbbbdbdcbcbbcbdddadcadddccdcdabcacacdbbcacb	FALSE
aaaadbadbdbaccdacccbbdaaaddcbccdbcbbdcadcccdcdacaa	FALSE
aaacacccdbbccbabcbdacdcdaabbcccdddcabdbbaadacdadab	FALSE
aaadadcdbcadbdaadadacbcdbdbcdacaaaaacbadacbabaacab	FALSE
aabaadddcdbbdcbdaacbdbcdcbddccbcdbbaaadcdcbcbbdbcd	FALSE
aadaaabbacbbcdcbbbabcadcdbaacbcbdddaddaabbccdcddbc	FALSE
abaaadcbbadbbbdacdcdbddbbbcbdcbbdcaddddcdbacadaaac	FALSE
acaaadbbadadcbbcadacbbddccaabaacddddcababddadbbbac	FALSE
baaaaadabdccacbaaacbabccbdbaadbbbcccaddaddbabacbdc	FALSE
caaaaddddbdbccbbabbdbdabcacbdbdaabaddcdbbdaaabdabb	FALSE
