aaaaabaaacdabcccabdc	TRUE
aabbcbcbcddcbbdbbbac	TRUE
aaccbddaaabaacaaacbc	TRUE
aadddbdbabbcaccccbac	TRUE
abbbcdabbacdbbbdddbb	TRUE
abcdcbcbdcabdbdbdbdd	TRUE
acabaaacbbadcbdadacd	TRUE
acbcaddbbddcaadaabbb	TRUE
accccdaccbccabccccda	TRUE
adaaabddabdcbccaabbb	TRUE
adbcaaaaaabbdcdaabbd	TRUE
adcdbabccbddcaaabddd	TRUE
baabbabcccddabcabdaa	TRUE
babdadddcdaabcaccbba	TRUE
badaabccdbdbbabbcabd	TRUE
bbacbacbbabcdddbcabd	TRUE
bbbccddddcabbaabaabc	TRUE
bbcdbabbcabaadcaaacd	TRUE
bbddcbdacdaacbdccbac	TRUE
bcbaaadcdcbbadbdacba	TRUE
bccadcbbabbbacbcabbd	TRUE
bcdcbacaacddacacbbab	TRUE
bdacdcdaabcdbcbbbdab	TRUE
bdbdcacaadaaaacdbabd	TRUE
bddaacdbdbaabdcbacdc	TRUE
caaacabcddccbdabccbb	TRUE
cabbdcacadabcbcbabca	TRUE
caccccbbcddcbbdabacb	TRUE
cadddccdcbbbaabdbabb	TRUE
cbbbbccdbcdcabcabaab	TRUE
cbccccbbbbcaadbadddc	TRUE
ccaaaaadcdababcbcdbd	TRUE
ccbadbcbbdacbdbccddc	TRUE
ccccbcbaaccacbdbacab	TRUE
ccdcccbaadabbdadbddc	TRUE
cdadbbabbbcbdbaaddbd	TRUE
cdbdcbcdbabbbcbadbca	TRUE
cdcddcdadcadcbdcdcdb	TRUE
daabcaabcbbccbbbcbda	TRUE
dabcddaacdabcbbaabdb	TRUE
dadabdcddaacdbbcddbb	TRUE
dbacadbabdadacaacbad	TRUE
dbbdcccbcdcabcabdaba	TRUE
dbdaccdbcbbdbdaacddd	TRUE
dcabacddcabbcbcccbca	TRUE
dcbcdabaccacccadbbab	TRUE
dcdaabbddcbacabdbacb	TRUE
ddababbcdddbcacbdcbb	TRUE
ddbccbbcbbaaaacabdca	TRUE
ddcdbdbdbdbcdbadcabd	TRUE
aaaaaaadacacadabccca	FALSE
aaaccacddbdaabddbaac	FALSE
aabbbdabcaaaaaddaaac	FALSE
aaccaaddbddaabbbaadd	FALSE
aadbbaadbcdacbaabbbb	FALSE
aadddddccaaaaaaccaac	FALSE
abaddadbbacaccdbbaab	FALSE
abbdabddbbabadbbdbdd	FALSE
abdbadddbdddadbabbcb	FALSE
acacacaabbacaababbaa	FALSE
accabbabbaaabbacbdba	FALSE
adaabcacbbbbabbaddba	FALSE
adadbbddbbabdadccabd	FALSE
adbdaaaaadddddaaaddc	FALSE
adcddadadaaabbbabadb	FALSE
addccbccaacadaaddcab	FALSE
baaadaaadabddcdddadb	FALSE
babaababaaaadaddccda	FALSE
babddabddbdbbbddcddb	FALSE
badcdabdaaaddbbbaaab	FALSE
bbabdcacbbaaadadbdbd	FALSE
bbbbcacdddbabdbbadab	FALSE
bbdaabddbbdbbbacaacc	FALSE
bcaacaaacccccccadbaa	FALSE
bdabadaabdcaabdbbdbb	FALSE
bdadddddbdbbaaacbaad	FALSE
bdbdbabadbdcdbdbabba	FALSE
bddbbbbaaadaddcaddaa	FALSE
caacababababbaddbdad	FALSE
cacacacdbaddbbdaabab	FALSE
cbaaddbaabbbbaaaadba	FALSE
cbdadaaababbaabbdadd	FALSE
ccadadbdbabaabbcabbb	FALSE
cccccbbdbbdbbabdbadd	FALSE
cddadbdbdbdbaddabdbc	FALSE
daabdbbbcdaadabbabda	FALSE
dabadacdaddbbabbbbba	FALSE
dacaccddaccbbbbbaaab	FALSE
dadaddccbcddbbddbdda	FALSE
daddcbcbbdbabadabdad	FALSE
dbadadaddadcaacddaca	FALSE
dbbbdadbbccbabbadada	FALSE
dbdaddddddabdbddbbdd	FALSE
dcaaccccaabddabdddda	FALSE
dccacbbcccdbddabbbbb	FALSE
ddaaaadbaddaaadbcccc	FALSE
ddacdaabaadaaadbdccc	FALSE
ddbbccdabadabaadbaaa	FALSE
ddcbccbbbbdadadabbaa	FALSE
dddbaddddaadcdddaccc	FALSE
aaaaaacaadcdaccabdcac	TRUE
aabbaccbcdcccbbccaaaa	TRUE
aaccadddbacdabbaabbaa	TRUE
aadcdacdbbcbbcddadada	TRUE
abbadcadcacdbcccddadb	TRUE
abcbcbcbcddccbddccccd	TRUE
abdcdbdddbccbacdaabcd	TRUE
acbaacbacdbccabdabbbd	TRUE
accacacaacdbabbcacdac	TRUE
acdbdaadcdbbdbaacadba	TRUE
adaccdcccacbdccddaaad	TRUE
adbdccabdddaaaadcaabd	TRUE
addbaaaaddaddcabcaadb	TRUE
baaccababcbdccddcabdb	TRUE
bacabadbbcbbabcacbdad	TRUE
badbbbbbbcbdaddcaaaca	TRUE
bbacacbbccbbbcccccbcd	TRUE
bbbcddcbcadcabcdcddbd	TRUE
bbdabbbbaadcdbddcbaca	TRUE
bcabcbcdbcacdabcbbcac	TRUE
bcbcaadacadddcacbbbda	TRUE
bcccccccdadcccdaccadd	TRUE
bcdcddddcdbacadbddcdb	TRUE
bdbaaababdbabacbacaba	TRUE
bdcadacdbcabdccaadbab	TRUE
bddcadbdacbccaabcbbaa	TRUE
caaddaccacdacddbdcbdc	TRUE
cacbacbccaaaaaccdbbab	TRUE
cadcbcdbaababdaacddcb	TRUE
cbadaaccbbddcbacccdcc	TRUE
cbbdcacbdcddacddcbcbd	TRUE
cbdacabacdbdcbdcaacbc	TRUE
ccacbbdccbcbbbacbbdac	TRUE
ccbdcbdaaaaaccdabdbda	TRUE
ccdaabbdaddbbbbdbacdc	TRUE
cdabaabcdccdddabbabac	TRUE
cdbccbcadbabacccdcddb	TRUE
cddaabbadaacdadacbcca	TRUE
daabdadcaacaadadccbca	TRUE
dabdcbdaaacdbbbaaaada	TRUE
dacddbbdbacbaaadbcdcd	TRUE
dbaacbbdcdcadcdabbdaa	TRUE
dbbcbaaccbbddacaddcba	TRUE
dbccccbbbbabbabdcaaab	TRUE
dbdddddcdbdacbabcbbcd	TRUE
dcbcaababbdacbbccdbdb	TRUE
dccddbddacaaacadccadd	TRUE
ddaaccddcbcacddbdbabb	TRUE
ddbbdabbdbacbddbdbcac	TRUE
ddcccbcbbbddccababbab	TRUE
aaaaaaaabbaacdbbbddab	FALSE
aaabdadbbdbbdddacabba	FALSE
aababaabbaaaaababddbd	FALSE
aabdbbdccabdbabdbaaad	FALSE
aadaadcaccdababcaaccc	FALSE
aaddaaabbdbcabdbdabad	FALSE
abaadddcadaaaadbadaad	FALSE
abbabbddbdbaddbdcabdd	FALSE
abcbbbbadbbaddabbddad	FALSE
abddbadaddddadbbbdcdb	FALSE
acbadadbaadbadababbba	FALSE
acdaadabbdbbbddbaadbb	FALSE
adabbdaadaaddaaacadcc	FALSE
adbaabddbdcbadaabbdab	FALSE
adbdddcabadbbbdbbbdba	FALSE
addbabaaabddbbabdcbdd	FALSE
addddccaaacaccddcaaca	FALSE
baaddbaabbbdabcbbaada	FALSE
babccbbdbbdbaadadabad	FALSE
badadadbbdbbabcccbbad	FALSE
bbaabddbdbbcbbbbabbdd	FALSE
bbbabbdbaddaddbdcdddb	FALSE
bbcadbbdadadabddddbab	FALSE
bbddacabbbbddbbbddbab	FALSE
bdaacbbdabdddabbdaaaa	FALSE
bdbaadbaabbbbbaacaada	FALSE
bdcaccdaadaaddddacbba	FALSE
bdddabccacabdbaaddaad	FALSE
caaccccacccaabbbbbddd	FALSE
cacbdbdbdaddaaaabbbab	FALSE
cbbaadaaaddadaabbddca	FALSE
ccaabbdbbbbadabbaadab	FALSE
ccbdbadaadbaadbbaddda	FALSE
ccddbbdbabadadbbcacca	FALSE
daaaabbacaaaccdbbabdd	FALSE
daacdddcaacccbbaaacba	FALSE
dabbabbacbdbdddbbbaaa	FALSE
dacacaccbbbaabbdbadbc	FALSE
dadbccaadabbdddbbbaad	FALSE
dbaabbdbbbdbaabdabcdc	FALSE
dbbabbdacdbdadadbabdb	FALSE
dbbdddaddddbacaaddbab	FALSE
dbdbdaadcdbdaddadabbb	FALSE
dcacdaaaddabbaddaadbb	FALSE
dccbabaaccccadbbdddda	FALSE
ddaabddababdabbccdcbb	FALSE
ddacbdbaabdadaadbddbd	FALSE
ddbbadcccccadaaadddda	FALSE
ddccaadbdbbaabadcbaab	FALSE
dddbabdaddbaccacccabd	FALSE
aaaaaacbcbacbcaacbcacd	TRUE
aabbbcdcbabaabaddbbcac	TRUE
aacccdbadaccbccacadbdb	TRUE
abaaabddbcbabbdcccbbab	TRUE
abbbbbcdcadbdbccbaacaa	TRUE
abccccbcdbcadcadadaccb	TRUE
abddccdabcccddcddaddbc	TRUE
acbbbdaaaadbbcdaddcdcc	TRUE
accdabcabdabdcdacbabdd	TRUE
adaadcbbcdbbbbdbccdbba	TRUE
adbbdddccdddcbdcbdcbad	TRUE
adcdaaadabcbacccbcdada	TRUE
adddcddbcdbbabdbacdcac	TRUE
babbbcadcdcbaadbcbbcda	TRUE
baccbcababbbbcabccbbdc	TRUE
baddbcbdabbbacacabbcaa	TRUE
bbbabdbacdaabbcbadbabc	TRUE
bbccadcdddcccadcddabac	TRUE
bbddbcdbdccddcccabadda	TRUE
bcadcccbdcbabbbcdcabab	TRUE
bccacdabbbdabcabdcaaab	TRUE
bcdcaaacacbccdaabdcadd	TRUE
bdacdddcabbbdcabcdcaad	TRUE
bdbddbdccdccbddddcdccd	TRUE
bddbcabcccbbdcaddcaabd	TRUE
caaccdcbccabbdbabcdbac	TRUE
cabdcabdddabdadcaacbaa	TRUE
cadaacbcbccaacddcababc	TRUE
cbaacccdadccddabdbbaad	TRUE
cbbcbbdbaabbcdccadaacd	TRUE
cbcccddcdaabbaabccaaca	TRUE
cbddbdaacaddacccabdbdd	TRUE
ccbadbdcdcbccdcdcddcad	TRUE
cccccaacaaaacddcccdcdb	TRUE
cdaababaccdbabccdccbbb	TRUE
cdbadadbbdcbdcbdcbabcd	TRUE
cdcbccbadadbcbdbbdaadb	TRUE
cddcbccdcbaabbdababaac	TRUE
dababacddbdcccdbdbbdcb	TRUE
dacbabcddbcddbcdacbcac	TRUE
dadcabcabbdabddadadcda	TRUE
dbaccddcbbbcdacaaaacba	TRUE
dbbdddcdaadcbcddbcddbb	TRUE
dbdaddbdbbcddbacbcddaa	TRUE
dcaccacbdcdbbbbacdabcd	TRUE
dcbdbcccaabccdadadaacc	TRUE
dccddaddcccbddbcabcdbc	TRUE
ddaaccbccbdabdbbdbcaca	TRUE
ddbbbadabdcdaabdddccaa	TRUE
ddccbadaacaadbabbdccdc	TRUE
aaaaaaaadbabbdddbcdbda	FALSE
aaabddbbababcbbddadddb	FALSE
aabbaaadbddbbdbbdbdcdd	FALSE
aacacabaacaaacacaacacc	FALSE
aadadabdbaddaccadaadca	FALSE
aaddbbbddadabbdaabaaba	FALSE
ababddacccaadaaaadabaa	FALSE
abbbabaaaadbbcadbbbbbd	FALSE
abdaaddbdaccaacbdadddd	FALSE
abddcaababdaaddabbddab	FALSE
acbbcabdbbaddbaaaddddd	FALSE
acddaaddbdddbbaabddacb	FALSE
adabdddbadbbabccdddcaa	FALSE
adbabbccaacbddbdaabadd	FALSE
adcaacdadddadaaccaabaa	FALSE
addacbdabadadababadbdd	FALSE
adddccabbaabdadadbdbab	FALSE
baadabbdaadaccacaababb	FALSE
babdbbadbdbcbabdadabad	FALSE
badcabbbbbaadabbdaaaad	FALSE
bbabdababddaddaaabccab	FALSE
bbbbbbabbbbccdbdaabdda	FALSE
bbdababddabbadddddabcd	FALSE
bbddbbdbddbdabddcbbddd	FALSE
bdabadaddbbbbabcccccbd	FALSE
bdbadbddabdbbaccdbadbd	FALSE
bdcccadbbdbadbadadbddd	FALSE
bdddaddbadabadbdcacaaa	FALSE
caadbddbadadbdadbdaaba	FALSE
cacdbaaaabddbabbaacaac	FALSE
cbbbdbabaadaaadabdbbdc	FALSE
ccacccccadbbbbdbbaaadd	FALSE
ccccbcacdbdbddbdddabba	FALSE
cddabdbaadadabbbbdaadd	FALSE
daabddbbdccacccdcbaabb	FALSE
dabaacaabddabddaabbdad	FALSE
dabdbddbaddbabcaabdbbb	FALSE
dadaaaadbbdadbbbdbabdc	FALSE
dadbdddbdbdbabacccbdad	FALSE
dbaabaddbdaababacdbabd	FALSE
dbaddddaddadbcaccaaacb	FALSE
dbbdbddbcddadbaaabdbba	FALSE
dbdbdbbdabccddaaabaddb	FALSE
dcacdaaabbbaaddddbabbb	FALSE
dccccddabaabadccaacacc	FALSE
ddabaabadbbacddddaabbb	FALSE
ddadcacacaaabbaaaccddc	FALSE
ddbbdbbbabadddbdcccaac	FALSE
ddccababaabaacddadcabb	FALSE
dddbabaaddadaaacddcccb	FALSE
aaaaaabadcadbccccddbaaa	TRUE
aabadabcbdddaacaaacddca	TRUE
aacbaddbcdbacabccaabbdc	TRUE
aadcadaababdabbbbccbdac	TRUE
abbaacbcabdbabacabdaada	TRUE
abcbabadccccbccbdccddbb	TRUE
abdcbaccaadbabdbcdabdba	TRUE
acaccbcbcbcdbacdaccbdcb	TRUE
acbddcddababadacccabbdd	TRUE
acdbabbccbbcadcdacbbaaa	TRUE
adabcaccabdabcabccadadb	TRUE
adbdababccbdcdcaadbadaa	TRUE
adcddccccacdbcdadbaabdd	TRUE
baaacbddcbaabddcccdacdb	TRUE
babcbaacdabdabdddcabdac	TRUE
bacdbcbadbdacdaabbbbabb	TRUE
bbaabacdaabdccbcbaccdaa	TRUE
bbbbaccbbdaadaaabadbbac	TRUE
bbccadbacababddbdadbcad	TRUE
bbdcdcccaacbcdcbbcdbbaa	TRUE
bcbaacdbaaddcccbbdddbbc	TRUE
bccadccdbdadaaccadabddb	TRUE
bcdbddddbbacbadacabccda	TRUE
bdadbadddbbccbdbdbcccdd	TRUE
bdcbabdcaacdabdbadbabbc	TRUE
bdddbbadbcacacacbccddbb	TRUE
cabaadcbddbbddbdcdaddbc	TRUE
cacbbcdbcbcddadddabbcab	TRUE
cadccaccdaacbbdcdcdbdda	TRUE
cbadcdadbdbbabcabdcbdda	TRUE
cbcaaccbdbbaccbbcbbacda	TRUE
cbdadbaabadccdadcaccbbc	TRUE
ccaccacbcdbdcccbcdacbaa	TRUE
ccbdcdadacddcccaacbbdcc	TRUE
ccdbcdbdbcabbcddcaacdab	TRUE
cdaccdaddbbcbdadcbdaaba	TRUE
cdbddbdbbacbadcbdbbdddd	TRUE
cddadbcabcbaadbccccbabc	TRUE
daacccbdaabdccddbddaadc	TRUE
dabcddcbadaaabbadcccbdb	TRUE
dadacadccdacdbaacbdbada	TRUE
dbabdacbcbccadbcbaacadc	TRUE
dbbccdddabacdcaadcbdcca	TRUE
dbcdcccdacadcbccddccdaa	TRUE
dcabbacaadcdbbcaccababc	TRUE
dcbcabcbdcbbcabbccbbada	TRUE
dccdbcccdadddbddbababad	TRUE
ddaadaaccdccbccdadddbda	TRUE
ddbbdcccaadbbcddcbdcbac	TRUE
ddcdbacbddcdadaddbcbbad	TRUE
aaaaaaaacabdabdbaaacbaa	FALSE
aaacacbaabbbdaadaababba	FALSE
aabadadbddbadcdddaddcbb	FALSE
aaccacaaaaccccaadababdb	FALSE
aadbbadadddbcccccdddaab	FALSE
aaddddbbbbdddbbccdddddb	FALSE
abadbbbabbadbbdbdbddcaa	FALSE
abbbdadbabdadddcbdbbbda	FALSE
abdbadbdbddaababddccdda	FALSE
acabbaddadbbdaddbdcabba	FALSE
accbcdbbdabaabbbbbadbaa	FALSE
adaadacaaabaccdadadaaab	FALSE
adadacddbaddabdbdbabddd	FALSE
adbbdbbabbaddadbdacbdba	FALSE
adccbdddadabadbbbdbbcab	FALSE
addbbbdbdabadbbccaadbdb	FALSE
adddddbdbadbaabbacaacad	FALSE
baadbbbabccbbdaddadddad	FALSE
babbdadacdbadadadbaaada	FALSE
badabbaadabadaabddbbabb	FALSE
baddddddadbddbcababdbaa	FALSE
bbadbaaddadadbadadcaaac	FALSE
bbbdababaabacdaadbdddab	FALSE
bbdadbddbddaaddabaabcac	FALSE
bcaccdbbbaababbbaabaaba	FALSE
bdabcddbadbabbaddbbbaab	FALSE
bdbbabbdbadcdddadbddbbb	FALSE
bddaadbbdddddaacadabbab	FALSE
caaaaacbababbbcbbdbdddb	FALSE
cabbdddaaadbaabddbcbaab	FALSE
cbaabcacccaacaadadadadc	FALSE
cbdbbdadaabbbbbbdbcaabb	FALSE
ccbbcadabbdbaaaddaaaaba	FALSE
ccccddadaddcaccabaababb	FALSE
daaaabaadbaaddbadcadccb	FALSE
daadabbbbcadaadaaaaaacb	FALSE
dabbbbaadbbabadbabbddbc	FALSE
dacacaccdaaaddddadadcca	FALSE
dadacccaaacbbbbdaccccaa	FALSE
daddbdcbadadbadbabaaaaa	FALSE
dbaccadadddbbbbdddaadab	FALSE
dbbbdaaaaaadbdbbbcadbbd	FALSE
dbdadaadaabdabaacaabbaa	FALSE
dcaaaaaadbabbdadabacaac	FALSE
dccacacddabbbbdadacccaa	FALSE
ddaaacaccbacadaadbbabad	FALSE
ddacdaaabdbbadabbbbabbd	FALSE
ddbbbbbbbdbbcaccbdabdbb	FALSE
ddccaccbaaddabddddbaaaa	FALSE
dddbbababcbabdabbbabbba	FALSE
aaaaaabdcdbabcabdddcdacc	TRUE
aabbacdcbcdbcdddacaacdaa	TRUE
aacccabcdaabaccdcbabdbab	TRUE
aadddabadbdbdacbbadbcabd	TRUE
abbadbdacacadcbdbadbabba	TRUE
abcbddcdaacdccaaabbaddba	TRUE
abdcbcbaccbbcbdcbcdacbdb	TRUE
acadcdccaacbabbbdadcaddc	TRUE
accaadadbaaaabcbbdcabbdd	TRUE
acdadbddadbdbcacacbcaada	TRUE
adaccdbaabdcbcccaaabbcdc	TRUE
adcaddbaacbbaddacaddccbc	TRUE
addcbcaccaabdccaddacbbdd	TRUE
baacdaddcdbabdaabdbbddda	TRUE
bacaaaddccbabaddbabccbbb	TRUE
badbacdbcabaacdbbbcdabbc	TRUE
bbadabcddaadbddbcbddddbd	TRUE
bbcaabadadaccacbcbcddaab	TRUE
bbdcbbcdabdddccacddddbcc	TRUE
bcadbcdbbbbdbcadbbbabbca	TRUE
bcbdcabcdabbcdddcbcabcbd	TRUE
bcdaaccddabcbcabcadbdacc	TRUE
bdaabdbcbcaadaadcddcccca	TRUE
bdbbcdbbabadbdbddbdccaab	TRUE
bdccbddcbdccbaadbabbaabd	TRUE
caaadcabdbdcaaaaccacabcc	TRUE
cabcabddaabcabdaddcbacdc	TRUE
caccbbdcbddccbbcddbccdca	TRUE
cbaaaacddabbaadbaadbdcac	TRUE
cbbacadbabdadbcbdabaadcc	TRUE
cbcbbdcbcccdccdccdccadda	TRUE
cbdbcddbdadcdcdaadddaaba	TRUE
ccacbcadbadcdcbcddddbbcb	TRUE
cccaaaaccbccbdaddbcbbcdd	TRUE
ccdbcacaaaaaadacdbccaaad	TRUE
cdacadddcbdabdcabdcbcdda	TRUE
cdbdacdccbccbaabaabcabca	TRUE
cddacbcbcbbdbdccacacdcbb	TRUE
daabadcddaadbddcabaaddca	TRUE
dabdcbbcadcdcadcbdcabcab	TRUE
dadabcbdcdadbdbadbaacadd	TRUE
dbabcbbdddcabdbbbbcdaddb	TRUE
dbbcbcbbabdccacabcbdcbcd	TRUE
dbcdaacdacaaacdaababcbba	TRUE
dcaadcacbdcbaccbdbcbbacc	TRUE
dcbcdadaadbbbbbcadcbbdbc	TRUE
dcdaabdddcacabbaddabddda	TRUE
ddabccdccdbabbdddbcbacaa	TRUE
ddbbdbcbadadbcbdabddbcaa	TRUE
ddccbccdacaacadddbdabbdc	TRUE
aaaaaabdbbaadcaabdbaaaad	FALSE
aaaccacdbbabbbdadabaaada	FALSE
aabbbdaabbdddddaabcdaddd	FALSE
aaccadabddaaddbdabbbdaba	FALSE
aadbbdadadabbbbdaabbbbdc	FALSE
aaddddaddabbdbbaadddaadc	FALSE
abacbabadabdaddbaaaadbdb	FALSE
abbbbaababaabaaacccbdadb	FALSE
abdaabdadaaadabbaccadcab	FALSE
abdddabdadaddadaadabcaba	FALSE
acbabbaabbbbabadbbdabbac	FALSE
acdabdabdabaaadabdaaaacb	FALSE
adabdbdaaaddbddbdaabbada	FALSE
adbabdbadbadbadddbdacadc	FALSE
adcacbabdaadaaabddaadbbb	FALSE
addaddcbaabaabddbbadbdbd	FALSE
addddadcdbabbbdbdaacccca	FALSE
baadabadadaaabdcdadaabaa	FALSE
babbdaddadadbadbdbbbcaab	FALSE
badadbdaaadabdcaddaadccb	FALSE
badddbdddaaabddacaabdadb	FALSE
bbadaddbbbadabdaaddadcab	FALSE
bbbbdddaccbdbbdbbdaabadd	FALSE
bbdacacbbaadbbbadaddabda	FALSE
bcdaabbbaaddddbddddbbaad	FALSE
bdadbdbbbabdddbdddcbdbda	FALSE
bdbccaaadabbbabdabdabadd	FALSE
bddbbbddbadbdcbbbdddbdbb	FALSE
caadabdddaaabbabdbabdadd	FALSE
cacdddbddddddddadbadbbda	FALSE
cbbcdabbababdbbabababdad	FALSE
ccacccacabbccaddcccccaab	FALSE
ccdabaadddddbdddaacacbba	FALSE
cddddbdddababbdabbaaabdc	FALSE
daabdbbdadddbdcacdadbaba	FALSE
daadddcaaacadbabbbdccabb	FALSE
dabddaadabbaaabcbddbdbdb	FALSE
dadaabadabaaaabbaddbdbac	FALSE
dadcccacaaccacdaadbbadca	FALSE
dbaadadabdbbddabbbdaaddb	FALSE
dbadddddbadbdabdcdcacccc	FALSE
dbbdababaaaaadbdccaccdaa	FALSE
dbdbadbdbbbbdddaadcbaaad	FALSE
dcabddbbabdbdadaadbbdacc	FALSE
dccbbaacacdacaaabbaaabaa	FALSE
ddaadbaadadbdacaabddbdba	FALSE
ddadbbadbcaccdaadbdddaba	FALSE
ddbbdaaddabddbdbdcadadaa	FALSE
ddcbbddabdabdabbbbaaabdd	FALSE
dddbbabbabbabddadbdccbbd	FALSE
aaaaaaccadcddaabdaacadbca	TRUE
aabbcdcdaabddababcdaaadda	TRUE
aaccbccddbabdbdacdbbadadb	TRUE
aaddddadaddabbcdcccbacccc	TRUE
abbbbdbbaddaacbdabdacaabc	TRUE
abccaddbacbbdcabadbbaabcc	TRUE
abddcbcacbdcdaabcdabdaaab	TRUE
acbbcbdbdddcaacbaaccccccc	TRUE
accdaddbbdccdabcaddabbbad	TRUE
acdddadacddccbbddaacabcdc	TRUE
adbacddcabbdbcbddbadccbdc	TRUE
adccbddcdcbbbdbacabdbcdab	TRUE
addcdbdaccdddbdcadccdaada	TRUE
babacbaddbdaaadbbdcdbdbac	TRUE
bacbbdbccdbdbcaccaacababb	TRUE
badccdabdabddbbdbdbcaacca	TRUE
bbadbdbadbbabbabaccdcdaab	TRUE
bbcadbccddccbabddbdbcdbdb	TRUE
bbdbcbcacaaadacbddabbbbad	TRUE
bcadbbcdcbbdabbadcbccbdcd	TRUE
bccacdadaaacccdcbdbbacbbd	TRUE
bcdbccdcabbcabcacdcbadcaa	TRUE
bdacbbbbadacdcaadbbcabcbc	TRUE
bdbdccbaddbccbabdaacabdac	TRUE
bddabdabbbbccbbbdccdbdddb	TRUE
caaadddcdacdbcabbbcadadbb	TRUE
cabbdaaaadcacaacaabbdbbbb	TRUE
caccbbbbcadaccaadcbbcdddd	TRUE
caddbdddccabcadbadcddabda	TRUE
cbbabaccdababddcabbdbcadc	TRUE
cbcbcaababdabcdddbcbcbdab	TRUE
cbdcbdbbdadbcdadadddcabbd	TRUE
ccadbdcaacbaacadcaadcaadd	TRUE
cccaabbadbaadcdaddcbdcbab	TRUE
ccdbdcbbabdaadccdbddadacd	TRUE
cdacadcaaacbcadcbddabbbab	TRUE
cdbddbbdaacdadbbaddadccdd	TRUE
cddadacacddcdcaacaccabcac	TRUE
daabdbddcbcdabadbcbbcccab	TRUE
dabdadbacadbcabbcdbabddcd	TRUE
dacddbadcbdbbccbcbbbdacab	TRUE
dbabbdbbbdbdcdbbdcaaaabbc	TRUE
dbbcbbddbddbdcccadadaadad	TRUE
dbcdcadbbdbaacddaaaabbdba	TRUE
dcabaaccdaababadaaacdaadd	TRUE
dcbbccabdcddbbcbacdabacbc	TRUE
dccccbbcbabbccacabacbcbca	TRUE
dcddddbdbbdbbcbadcadcaddd	TRUE
ddbbdbbccbacccabdbabbddbc	TRUE
ddcdaccbdbadcdaccbbabacca	TRUE
aaaaaaadcabcbabababaddabd	FALSE
aaacabaaacdabdddbddbabddb	FALSE
aabaddabbababdbbabacadacb	FALSE
aacacabbcdadaabbdaaabadbd	FALSE
aadacccacccddaddbbbdbdccc	FALSE
aaddbadcaabadadbbddbbdbad	FALSE
ababdbdbadbacdadaddadbbda	FALSE
abbbbbbaaadbccdaaaaaacacb	FALSE
abdaaccaccaaccddbddadbadb	FALSE
abddabddaaaabdcacddadabbb	FALSE
acaddbdabdaabbdbbbdbdbdba	FALSE
accdbadbbbdcaaabbbbaaabbb	FALSE
adababbbcaacccddbbbaaaadb	FALSE
adaddddadaadddccccbcdcaac	FALSE
adbdbddababdaadabadadbccb	FALSE
addababcccdddadaacbbbbaab	FALSE
adddaaddacbbddbdacaacaaaa	FALSE
baaadbbaabacbddaaabbbbbdb	FALSE
babaadadddddbddcbabdbddba	FALSE
babddaddbdaaaccbbbaddbdbb	FALSE
baddabdbacccddaababaadaba	FALSE
bbabadbaddaabbbcaaccaaaaa	FALSE
bbbbaadbbababaddbdbbcacaa	FALSE
bbdaabcbbdaaabbbdaaaadaab	FALSE
bbddbddddbaddcaabbbdbadbd	FALSE
bdaabbbbaddabadadbcdbdaaa	FALSE
bdbabbaadaaddcaaaaaaacaac	FALSE
bdbddbaabaddadbbadcddcccb	FALSE
bddbdadbbbaadadbabdacdddc	FALSE
caacabbdddaaaabadadcccaab	FALSE
cacccbabbbadbbadadccbbabb	FALSE
cbbbaabccaabdadbbabbbabdd	FALSE
ccabbccaccaaacccdadaaacba	FALSE
cccbaaccbabbdddabdbdbdaad	FALSE
cddadabdbbbdddbbdbddbabbb	FALSE
daacaadaabadbabddaabacacb	FALSE
dababbddaddadbdaddbdcccdc	FALSE
dabddbbaaddadadbaddacdccb	FALSE
dadacacadbdabdadbdbacbbab	FALSE
daddbaadaabbbbdacdbbdaaaa	FALSE
dbabdabdababadcdddcccaacc	FALSE
dbbadabcaacaaccabaddadbbd	FALSE
dbcbababbbdbddadbababaddb	FALSE
dbddaddbaabadddbddcdaaacc	FALSE
dcbbbabbbbabbadddccccabba	FALSE
dcdbbddbadaababdbddabcaca	FALSE
ddabdbabbbaadadddbcadaaaa	FALSE
ddbadbdbbdadaadbbdbadaccb	FALSE
ddcacbccaaabdaadbdabddbda	FALSE
dddbbbadbbadbadbaadddbbac	FALSE
aaaaaabaddcbadcdbbdbdcddcd	TRUE
aabaccaabaccacbccdcbdddadb	TRUE
aacccdaaaadcddcdbcadabdaaa	TRUE
abaaabacaddcbacacbbbcbadcb	TRUE
abbbcdabcbccdccbdadccbcada	TRUE
abcdbdbdcbcadddbbdbbdcbccd	TRUE
acaaccbcaccbabbaaabccdaadc	TRUE
acbbbbbaddbbdacddbccddbbcb	TRUE
accbdbcdaaddbbcbbbcdacccdc	TRUE
acddbcbddcbddcaaabcbcdccdc	TRUE
adbabcabbddddbbaabacbccbbb	TRUE
adccbabdacbdadadcddddddddb	TRUE
adddcaddacbdcbcacdbbbbadda	TRUE
babbaaaddddbbcdbabbcabbcdc	TRUE
bacbddbdabbbbcdaccccdaaabb	TRUE
baddccbaaddbbdccbacaccdaac	TRUE
bbbaadcababdddcddcabacccbb	TRUE
bbcbdccacaaaddcdadcdadccdd	TRUE
bbdcddbbdcbdccdaccddcdabda	TRUE
bcadbbcdbbcdabbdbbacabbaac	TRUE
bcbddddcbbcaddcdbddabddcab	TRUE
bcdbcadcdcaadacdcabaddadcd	TRUE
bdacabdcbccabaaabbccdccbbc	TRUE
bdbdbaaadaadcbdcbbdaccacdc	TRUE
bddabbacbadcccaaacccdbccbd	TRUE
caabbbcddbddcdcdabddcddbbd	TRUE
cabccdcbacdcaabbbbbbcddcac	TRUE
cadaabddadabcbbcadbaaabcaa	TRUE
cbaadabbaacbcdaddacadadbcc	TRUE
cbbcbdaaccbdacbbadacdcaabc	TRUE
cbcdbcacacabdcaabbadcbcaad	TRUE
cbdddcdcdabbdadcbacbbbbabb	TRUE
ccbadcdabbaddcdbdaccdcdaab	TRUE
ccccaacdacaccccdcccbcabcac	TRUE
ccddbaadcccbbabaadcbaacacd	TRUE
cdbadccabacdbddddabbdadacd	TRUE
cdcbbdbdbaaddacbccadddcdaa	TRUE
cddbdcccadcdcadaadabccbcaa	TRUE
daadbdbaaaaacabacbcdcadaba	TRUE
dacabdbbcdcaaacaccdaacaabb	TRUE
dadbcadaacdcbcbdcadabaacbd	TRUE
dbabdddababacabbbaaabacdcb	TRUE
dbbdadacabbbabccccdacabbca	TRUE
dbcdddabbbdbddbabbbcbcdbdb	TRUE
dcaacdddabbdcaaaaccdabaadb	TRUE
dcbcbccbdcdcdabbcacbbbddaa	TRUE
dccdaacacaabbccdcddccbaaab	TRUE
ddaaabddbcaddbacadcabcdcda	TRUE
ddbbbbdcbbccbdabccacbdbdaa	TRUE
ddcdabbcbccaddddcbbbdccaaa	TRUE
aaaaaaaacbddadaadbbaacccac	FALSE
aaacacaabdbdadddbadabbaddd	FALSE
aabadddabbadbabdbacddadadc	FALSE
aacbbabaabbdbbabdddadbdcca	FALSE
aadbabddddbbaadbdbaddbbbcc	FALSE
aadddcccdaaabbbddbddbaabac	FALSE
abadbdaddbccdbbbababddbbba	FALSE
abbdaaddaacdddbbabaadbdbda	FALSE
abdbbbbddadccddbabdaddbbbb	FALSE
acaccbaadbaadacaaaaacccccc	FALSE
acccaabccbaaadaddbdbbbabbd	FALSE
adaabadbaadbdbabcacaabaddb	FALSE
adadaabbaabdddadbbddccadab	FALSE
adbbaadbbbbddbdbbabcacddac	FALSE
adcbabcbdbbbbaaaadbdddaadd	FALSE
addbaaccadaadddaadbdaabbba	FALSE
adddbdddbadabddadabbcdadad	FALSE
baabadddbdabaccbdabbbdbaaa	FALSE
babadaabdbdbbadaddccccccbb	FALSE
bacaacadbddbadddbabbadabaa	FALSE
baddaddaddbbdbddccaadabdda	FALSE
bbabbdbbaababadcccccdcccbb	FALSE
bbbbaabadbadabbabdcaaacdca	FALSE
bbdaabacbddbddddadaabaaaba	FALSE
bbddbaddbdbbbbabaabbdbccda	FALSE
bdababadabddccbddabbbbddba	FALSE
bdbaaadbdbcdbdaaddbaaababa	FALSE
bdbdbdabdadbdbbcbddaaaaaab	FALSE
bddbdbdadabdddbdbcbdbaaabd	FALSE
caacbbbabcaaabaddabbbddbaa	FALSE
cadaddbbbbdddabaaabadaacaa	FALSE
cbcdababaaaddbaaabbabdbbdb	FALSE
ccbbaacaccbddabbbdaabbbaba	FALSE
ccdbadadaabdadbdbdabddadac	FALSE
daaaabdcdddabadabdabdabadd	FALSE
daacddddbdadabdddbbbdbacab	FALSE
dabbadaaabbbbdaabadbcaabbb	FALSE
dacbabcaacbdaaddbdbbabddab	FALSE
dadadbdabddbabbabbadbbdbdc	FALSE
daddbbaddccbdadaddadbaddab	FALSE
dbabdddaadddabdabdbddddaaa	FALSE
dbbbadbddababddadaaadcaada	FALSE
dbcdbdbddadbbdddbbaabadbdb	FALSE
dbddbdcaaacaddddaabbbdabba	FALSE
dcbcaadbdbbdbdabdbddabddad	FALSE
ddaaadbdadadbabcdbaabaaabb	FALSE
ddacbaccacacaddaddbbdaabaa	FALSE
ddbacabbbbaababaaaabbbbada	FALSE
ddcaaaacbdaddaaaaccaaaabbb	FALSE
dddaddadaddcbddadbdbaaaabb	FALSE
aaaaaccbcccbccbadbacdabdcac	TRUE
aabbbacbacaddadcbacbbbaabbc	TRUE
aacbcdacabcabdabccdaadbacdb	TRUE
aadcbdcccbbbbcdacbdacacbdbd	TRUE
abaddbccadcaaddaccdddbbcadc	TRUE
abcbbdcdccbdacbcaadbbdcabcd	TRUE
abddadacaacccadcbbdbcdabbbc	TRUE
acadbbbcbbbadacacaacdbccddc	TRUE
accabbdccaaaddaaccdcbaabddc	TRUE
acdbaabdddaaaadddddbdcabcab	TRUE
adadabadbacadaaacdbbcddddbd	TRUE
adcacddaccbbdbcabcdbddbbbbc	TRUE
addcadbddbacaacbdadabcdbddc	TRUE
baadbdcccbdcdacabcbadcaabba	TRUE
bacacddadccdbbddbabbbcdcbaa	TRUE
badbacacdcbdadbbaccbdadabab	TRUE
bbacbcadddcdaadadbccacababb	TRUE
bbcaaccacdaaabcdaacaaccdaaa	TRUE
bbdacdaadccddaaddbbcbccdbbd	TRUE
bcabddbbbccccbaaadaacadbdac	TRUE
bcbcdbcadbcabcdcadbdbccaddb	TRUE
bcdbacdbcbcabcdacbdaaaabada	TRUE
bdacbcacbabddbbdccbacaddcca	TRUE
bdbdadbbcacabbddcacccdcbcdb	TRUE
bdcdcdacaadaddabcbdbaccbcca	TRUE
caaacccbbdbabcabaccccadcadb	TRUE
cabbdadcaaccadcbcbabcabdadb	TRUE
cacdadacbbcbabbabcdadcddcdd	TRUE
cbaaccccddcbcaccdbbacbbdbbb	TRUE
cbbcccbabcdbdbabaabbaadcbda	TRUE
cbcdacaaadcadababaccbadcbaa	TRUE
cbddcabbddcdbbaabcadcdadbac	TRUE
ccbadbbbbcacacccabbaadaccbb	TRUE
cccbdbabccdacadbcdbcdcdcbac	TRUE
ccdcbccddacbaaddbdacadccadc	TRUE
cdbaacadbccddbabcdcbbbdacdd	TRUE
cdcabbaacccdccdcadaabbaccab	TRUE
cddbcbdacacaadddbdddbbddcdb	TRUE
daaccabbbbaaadaddcbaabbdddc	TRUE
dabdccbaddacdccbaddbbabcdab	TRUE
dadacccdcadcbabcbaaacbadbca	TRUE
dbacccaaabaddcabccdcbaababa	TRUE
dbbdabddcdcbadaacdadbdbdbdc	TRUE
dbcdbabcbcccdaadabddbcaccdd	TRUE
dcaacbcddbddcdadbcbabbdddcc	TRUE
dcbbcadddcddbdbdbccddabadca	TRUE
dcccccabcaddabacabbbadabbab	TRUE
dcddccacbdddabcbdcdbadbcadb	TRUE
ddbbbbacdddccbabaadaccbaabb	TRUE
ddccbdddddcaacababddbccacdd	TRUE
aaaaaaabdaabbaccddabaadaddb	FALSE
aaabdcdbbabdbadabbbddbaddbb	FALSE
aababbdabdddbaccaaaaaaaddda	FALSE
aabdcbbdaaaadbdbdabdbaddddb	FALSE
aadadaabddbdbbbbadbdaaddcdc	FALSE
aaddbdabaaabaadadaaaacacccc	FALSE
ababddaadabaaaccddcaabbaaab	FALSE
abbbabadcbdabbdddbdbbdadbba	FALSE
abcbbadaaaadddaddbdabbaddaa	FALSE
abddabdbaabacaccdbbaabbaabd	FALSE
acbadadddbaaaaabbdbdaababca	FALSE
acdabdabaabdabbaadadbdbdddd	FALSE
adabbbadbbbabbbaddbaaabdbab	FALSE
adadddbddbcddadcaacacaccccc	FALSE
adbddaadbaadbaccabdbbaaddbb	FALSE
addababddddaaabadaddcdcaabb	FALSE
adddabbbaadcdaabbdbadbdaddd	FALSE
baabaddabbbabadadadaabbacab	FALSE
babacbbbbdadbabadaadddadddb	FALSE
bacbababbbbbbdabbaabddbaaaa	FALSE
baddabbdabbdddbdbdbaaaacdac	FALSE
bbabddbdbabbbddbdabdaadacab	FALSE
bbbbaaadbbbddcbaadbdbdddddb	FALSE
bbdaabdbdaddccccaccacaaccab	FALSE
bbdddabddbbbbdbcdababbbdbab	FALSE
bdaadddbdacbddbddaabddbbadb	FALSE
bdbaacdbbbadaababdabbabbaad	FALSE
bdbdbccaaccdcaacaccccacbbbb	FALSE
bddbbbdababaaaddbbcbadabbaa	FALSE
caaadababadabdbbdaaccccbbba	FALSE
cacbabccccbaadbabdbabaabdbd	FALSE
cbbaabbbbbbdbbaaddbdbccbaab	FALSE
ccaaddaaddbbabaddbabadbdddb	FALSE
cccbbbbbbbabaabdbddbaacacac	FALSE
cddaadadbbdddbdaddbddbdbbda	FALSE
daabdaddabddaaaadcbaaabddda	FALSE
dabaabbddabdddbadbbcdbddbdd	FALSE
dabdacaabbdaabadaadbaddbaaa	FALSE
dadaaabadadbdbddabbabacaada	FALSE
dadcaaacbddadaddbbdbaaaddcb	FALSE
dbaabcdadbbdbabbaaabbdabddd	FALSE
dbbaabaaabbdabbbdaddbdcadad	FALSE
dbbddcdadddbaabdddabbaabdab	FALSE
dbdbdaddadccccbaaaddabbadda	FALSE
dcacaccababadddbdaaadaaabca	FALSE
dccdddadadbdbadbadadddbdbdc	FALSE
ddabdabbbacabdadbdbdbdadbbb	FALSE
ddbadcaccaccdbbbdbadddaddbd	FALSE
ddcaccccccbbcacabbdadbbadbd	FALSE
dddbadaddabaaddbaaadaddaabd	FALSE
aaaaabcadddbcbbaaaadbbddddbb	TRUE
aabaadcadacbcbadbabdadbdbddd	TRUE
aacbdbaababadacdcdabaaacaddb	TRUE
aaddcccadcbcaacadcbaadcbadbb	TRUE
abbacbaaccdabcaaccdaaadadabc	TRUE
abcbabdaddaccddabccddbcdcddc	TRUE
abdbdcdbbccbddccdddabaabacdc	TRUE
acadababbdacdbacbbbcadcdbbda	TRUE
accabcccaacdbbcbcdbcddabbcda	TRUE
acdadcdbbacacddddadddcdaccac	TRUE
adabdbbdaaabbbcdccbbbaddbabd	TRUE
adbdbbbbbbaabdcadcabbddbbdba	TRUE
addadcadacdccbddddbadadacdbc	TRUE
baacadcbdbaabcdbdcdadcbbbddd	TRUE
babdaacdaadaabbbbddabababbcd	TRUE
badabbbbbbcdccdbdcddcadbbabc	TRUE
bbabbbddbbccddabddcabbcbcddc	TRUE
bbbcdcacabacbdcdbdacacdbbcdc	TRUE
bbcdbaacaadcdbabbcadabbddbbd	TRUE
bbdddabadbbbcaddbcabcabbabca	TRUE
bcbbabcbcbbdcdbdabdababcabca	TRUE
bccdadabcbdbddcdbdbbddcabddc	TRUE
bdabbbaabbcdbdadacdacdcbabdd	TRUE
bdbcdbaabdadbbcadccabdbddada	TRUE
bddadbbcddbbbcdddbcacbaacdab	TRUE
caaccacacccbcabaadabbadaaaca	TRUE
cabdcadcacaabaacddabbcdabdaa	TRUE
cadaadccddddbabcaaabbbddccac	TRUE
cbacabbdbbddbbcbacccabdabbdb	TRUE
cbcaabdcadcacbadaddcccbdcdbb	TRUE
cbdabbdddbadbcccbbdbcbcaddba	TRUE
ccabacdacbbcabdddaaacbcadbbc	TRUE
ccbcdabccbaccddddabddddbacca	TRUE
cccdaabccadcdbcdabdbbaabdbad	TRUE
ccddcabaadcacaacabdbcacccbdd	TRUE
cdbabbbbddccbcccdabdaccaaaad	TRUE
cdcacacdcabccddbcddcbdbbdccc	TRUE
cddbcbabaccbcdabadcbbbcdbaac	TRUE
daabaadcbaacdcdbbccdaaabddbc	TRUE
dabccdddbbcdcdaccbccccbbabdd	TRUE
dadaaaddcdabcbbcdbadccabaccc	TRUE
dbaadabadcadccbdcdacabddbadb	TRUE
dbbcbccdaacdcbdbaddccbbadcba	TRUE
dbcdbacdaaccdbddbbabbbcbacdb	TRUE
dcaadcdabbcabcbbacacdcbbdaba	TRUE
dcbcbababaddaacdbcacbbcaaadd	TRUE
dccdacddcacadaaccdddbddadacc	TRUE
ddaadbbaabacabaccbcdbadcabad	TRUE
ddbcbabccaccacaacbadbbdbcbcb	TRUE
ddccbdabbbacdaaaacabacccbddb	TRUE
aaaaaaaaaaababadaddcdabbbaba	FALSE
aaacabbdbbabddabbdadadaccbbb	FALSE
aababbbbbcacbdbdbdddbbdaddba	FALSE
aabdbdddaaddbdadbcddaddadcac	FALSE
aadabadbbcaaabddabdababdabbd	FALSE
aaddabaaaaaaabadddaaccdddadb	FALSE
abaaddabbddbabdaabbacabbbdbb	FALSE
abbaaababbdccbddaaababdbbada	FALSE
abbcdadbdadbabdddbaddbdbbaab	FALSE
abdaddbbaadaddbddbddbbabbcac	FALSE
acaaccccaacccbdabbbaddaddbdb	FALSE
accacccaddddbbaaccacacbaaaab	FALSE
adaaddadaadabbbddadbcdaadaad	FALSE
adaddabdaaaaaabcaaadbbadddda	FALSE
adbdaaddaaacbbbdbbbdaabdbddb	FALSE
addabaabbaadbaadbadadadbbcac	FALSE
adddaabbaddadccddddadaabbbbb	FALSE
baabacdccacaaccacaacaacacaca	FALSE
bababdddcaaabdbddddaddbdbdda	FALSE
babdbdbddadbabdaddddbddbcdcb	FALSE
badbbbbdbdbabaacccabadbbdbad	FALSE
bbaabddaaabbbdbaadadcaccbdba	FALSE
bbbaabbdbddbbcdddabbdbadaddd	FALSE
bbbdbddbdbacacddbbbabbddbbda	FALSE
bbdbbabdabbabcacaabbabbdadda	FALSE
bccacddaaadaabaddddadaaaaabd	FALSE
bdacaaacbabaddbbdbbabbbdbbbd	FALSE
bdbbadabdbdbaadddaabadbccddb	FALSE
bddabadddbbbddbbbbbdbddabcbb	FALSE
bddddaadabdaabbbababdbabcdaa	FALSE
cabdabdabadaadddabdbddaadccc	FALSE
cbabadaadbddbdaddabbbdbadbaa	FALSE
ccaabbbadabbccbbbaaabbbbabaa	FALSE
cccbddbaabdaaddbbbadaababddd	FALSE
cdddaadddbdaabadbbadddccabaa	FALSE
daacaabdddadddddaaadddbbbccc	FALSE
dabadbddaadabbbaaacbabddadbb	FALSE
dacabdbdaabddadababdaadbbbbc	FALSE
dadadcaaabbdbdaddbbabbdddcca	FALSE
dadddabbbabccabdabaddddbbdbd	FALSE
dbadadadbababbdabadcacdaabbb	FALSE
dbbbbabaaaadaadcbaabaabdbbda	FALSE
dbdaaaddabaabdbddbddbdbdadbd	FALSE
dbddbadbadaaddbbcdadabdbbbdd	FALSE
dcbbaddddaddaababaaabddaccca	FALSE
ddaabdddbbabdababbcccbaaaaaa	FALSE
ddadbabdabaababaaacaccaddcca	FALSE
ddbbbbdddbbbaababbabbcacdadb	FALSE
ddccaaabbcbadabaddbbdabadaad	FALSE
dddbaddabbaabdaaabdcbbbbdada	FALSE
aaaaaabcdbcbcbaadbbbdabaaaaca	TRUE
aababaddbbccaccdabadcccabaabb	TRUE
aacbddbcdcdaaddbdcdaacbacdcbd	TRUE
aaddacbbdacdbacaabbaaabdaadba	TRUE
abbaccdcacdaaaccdcbcccacaaabc	TRUE
abcbbbaabdadccabbcdabcbaaabbd	TRUE
abdbcccaddddcccdddbaacacabbdc	TRUE
acacbcdaaccaabaacdcbcbbccbacc	TRUE
acbdbdaadadbddaccadddabbbadca	TRUE
accddcdcaabdbbaccaaddaccbdaba	TRUE
adaaccabdbdbcdbbdadbbdbaabdaa	TRUE
adbccdcbdbbabbabaaacdbabdcadb	TRUE
addaaadadbbdcddbbccddbbcccdad	TRUE
baaabdcbbacdbcdbcaaabcbbcbbca	TRUE
babbcaddccdaaaaabcbdbcaacadbd	TRUE
bacdbaddadbbaaddcbabbdabbabda	TRUE
bbaaaaddcdbcdbadbaddcaccaabdc	TRUE
bbbadbcabbcbcbbadbacdcdcabccd	TRUE
bbcbcbcbbcbdabccdcacdcccadbbd	TRUE
bbdcdbcddbbdadcaccddaddddaabc	TRUE
bcbacbbcdcacbbdaddcbcaadabdbb	TRUE
bccbadaabbabdbacdcdabaccdbadd	TRUE
bcdcbdbcddbcdacdabdaccabaaadc	TRUE
bdacdabdbbbdbccadbdcadabbcbba	TRUE
bdcabbdddddbadabdcabccadcabbc	TRUE
bddbbbacaaacaacacabcddbdbcbcd	TRUE
caacaaacaaaadaaacddadccdbcabc	TRUE
cabdcbddadabaababcababbcdddda	TRUE
cadacacbcccdaabdcbbdcabcaabab	TRUE
cbacaabacdcdbaabbbabdacbcacdc	TRUE
cbbdbaccbbabcdbbbaabcdbddacab	TRUE
cbdacdcdddcccdbaaadbaddcbddba	TRUE
ccacbbdbcbaadddabcddadcbdcbbb	TRUE
ccbdbabaadddddcccaddcaadacbba	TRUE
ccdbabdabdcaaadbbcaaccacabcbb	TRUE
cdaccbcddbbcaccbbdaccdcdcccca	TRUE
cdbdcbbdcbabaaaaddbbadcacdddb	TRUE
cddacbbaacdcdadcbcddacbdaddbb	TRUE
daabdddbbabaaaadbbbabcdaadcbd	TRUE
dabccdaadadbacabdacbdccadddbd	TRUE
dacddddcbcdaabcbbcdbbaacdadaa	TRUE
dbaabaacaabbbcbdaadaccabcddca	TRUE
dbbbcdacdbcaaccadbaacbbcbdcdc	TRUE
dbcccabddaadbdadddbaaacccbbab	TRUE
dbddcbbcadccdddbacccacbdcbbab	TRUE
dcbcaaddbcbccdabbdcddbccbaadc	TRUE
dccdcdcdbabbdcddcbcadcbbcbbda	TRUE
ddaabbadbacccabddcdaccdddbcba	TRUE
ddbbbabbdcbdbdbaadaccbacabccd	TRUE
ddccaacdbddbdbdbababcbcbbcabb	TRUE
aaaaaaadaaddcdadaadbbdccccaba	FALSE
aaabdacaacccacddbdabaabbabbab	FALSE
aababbbbaaadbcaaaacdaadbddddb	FALSE
aacaaaaaccabbccccabbbbdaadbda	FALSE
aadadddaabadaaabbddcdadcaccba	FALSE
abaaaadbddbadbddaddaabdadbdcc	FALSE
abadbbbdbdcabbaadaaddbbbdbdad	FALSE
abbbdaaaabbaaadbadbaddcaabddd	FALSE
abdabbdbdddbddbbdbbbbbaadcaad	FALSE
abddbdadadaddbbbddcdaadabddab	FALSE
acbdbdbbddbbaaabcaccccaababbb	FALSE
adaaabbaddaddbbbaaadbddddaabc	FALSE
adacaaccbaaadaddbaddadbddddba	FALSE
adbadbbbaddabdbddaddbbaaabdcb	FALSE
adcaacdbaaabbabdbadbddadadaca	FALSE
addadbaabddbbacddabddaabbdaab	FALSE
adddadbaaddbdadabbdaccdbbdbab	FALSE
baabbbbdbabbbdbbdadbdcbaddabd	FALSE
babadcddaababdbadbddbdaabddbd	FALSE
baccbdaaababaabbabdaaaaadadba	FALSE
baddaaadbdadbbbddcccbaddbadda	FALSE
bbabaddabcccbbddadaaaddaaaaad	FALSE
bbbadbdbaaadbbbcbdbdddabdaaaa	FALSE
bbcbbddabdabadababbbdbdddabda	FALSE
bbdbddddaddbcccbbbbaaddddadad	FALSE
bdaaaaadbdaaabadabbdadbaaadac	FALSE
bdadaabddabbbdddbddabbbcabada	FALSE
bdbbbbdbdadbabadaadabadddbaad	FALSE
bddabdadcacaaadbdbdbbadbdbdab	FALSE
caaacdddbdabbaababaddabadadca	FALSE
caccacaaabaadaabadbabaabaadda	FALSE
cbbccbbababddbddbbbbbbaddbdda	FALSE
ccaccdddaaaddadddbbabbbabaabb	FALSE
ccdaaabdaabdbbbabbdbaadddbaad	FALSE
daaaadabbdbbaadaaaddbadbcbaab	FALSE
daaccaddabadbdaabdaaadddaddac	FALSE
dabadbddaadbdbbbdbacdbbaabbbb	FALSE
dabddddbbbddbcaccacaacadadddb	FALSE
dadadbbaaaadcdaaadbbdbbbbbadd	FALSE
daddcbaaabaabbcccddbddadbbabd	FALSE
dbacaddbdabaddaabddaadbaadadd	FALSE
dbbbbbaadaabddccdaddabaabbaab	FALSE
dbdabaadabadbbbabdddcdccbaaab	FALSE
dbddbdddabaddaacaaacccaadcaba	FALSE
dccaaccadabddbaabaadbdaabbaac	FALSE
ddaabddbdbbbbdddbddaaadbbddcb	FALSE
ddadaadabdadadaadaaadaadbbbdb	FALSE
ddbbadadbaabbbdbdaaddbbcadcab	FALSE
ddccacaaaabadbbababdbaacaaaac	FALSE
dddbaadbbdbbdadadaddababcabbb	FALSE
