aaaaaaaabdcacabbcbac	TRUE
aaabdabdadcabbcddcac	TRUE
aaadbcacaaaaabbaacba	TRUE
aabbbbdbbcdbdbccaacd	TRUE
aabcdabacbbdcbbabbbd	TRUE
aacacbccdcadabcdabcc	TRUE
aaccbabbbddcdbcbacaa	TRUE
aadaabbbaccddccddbcd	TRUE
aadbcdaaaadbacbbcbbd	TRUE
aaddadcbcbababbcbaab	TRUE
abaadaadbbaaadaaaadd	TRUE
abaccdadbdbadddcbdac	TRUE
abbabccdaacadbcadcbd	TRUE
abbcabaadddbddadddac	TRUE
abbdccabcacaabddadab	TRUE
abcbabdbabcccabcaabd	TRUE
abccdcacdaddbaaabddc	TRUE
abdabdbbcccaddcabbbd	TRUE
abdcacaaccdcaaddcbad	TRUE
abdddcbababddcbcacab	TRUE
acabdacadddabbdbcdac	TRUE
acadbbdbdbbcdacbadcd	TRUE
acbbabcbdbbdddcacadd	TRUE
acbcccababdcccaabdbb	TRUE
acbdddbbdddacaddcabd	TRUE
accbdcdcbbccbddbaacd	TRUE
accdcdadaaddbbcdbaab	TRUE
acdbbbbcaaabccabbacd	TRUE
acddbbcabaccbcdccbdd	TRUE
adabbcdabbccdacaccba	TRUE
adadbcbabdbbcbcccdbb	TRUE
adbaddbabdadaaabbccd	TRUE
adbcbdaadbdccdbaccda	TRUE
adcaacbbabdcbbaccbbd	TRUE
adcbcdadbcabcbbadadb	TRUE
adcdbcdcbbddaadaccdb	TRUE
addbadbcdcababbdbcca	TRUE
adddaccbacbbadadabdc	TRUE
daaaddaaabbdaababbab	TRUE
daaccbbcbcbdbbdbabdc	TRUE
dabababdcdcdbdbdddaa	TRUE
dabcaacddaabacabadbc	TRUE
dabdbcdddcaabcbcaccd	TRUE
dacbabbdcbbccdbcccdc	TRUE
daccccdbcababababccc	TRUE
dadabdcbdbccbbbbcccc	TRUE
dadcaddacabcbdbdaacd	TRUE
daddcdcccdbacbcdbbcd	TRUE
ddabcdaccddbbbbcaaab	TRUE
ddadbdcddadcdbbacaab	TRUE
aaaaaacabaaddcdddaad	FALSE
baaabcbcdcbcacbaadac	FALSE
baadccdaddddacbbbadd	FALSE
babdcdbcddbbbcdaaddb	FALSE
baccdcdddcdcddadddcd	FALSE
badcbbdbbbbdbadabbcd	FALSE
bbabdcbaabcaacccdbbd	FALSE
bbbbacbcdcaccbcbacad	FALSE
bbcadbadcacaacacbcdd	FALSE
bbdaabbdbaaadbddbaad	FALSE
bbddcdcaadcabbdbbada	FALSE
bcadbcadccbbcadacbcd	FALSE
bcbcdbbccacaabddcccd	FALSE
bcccaccacdabaccacacd	FALSE
bcdbcccdcbcabccccbda	FALSE
bdaadbbbadadccbacdaa	FALSE
bdbacbdbcbcaccdddbcc	FALSE
bdcaaddabdabbbbbdcca	FALSE
bddaacbbadbabcabcacd	FALSE
bdddcdbdaabddcdabdab	FALSE
caadbcbaddaaacadbadb	FALSE
cabcdbabdaacdcacabbb	FALSE
cacbdacbbcadccbccabd	FALSE
cadbccdaacaccaaabbbb	FALSE
cbabdccacbdbbddacadd	FALSE
cbbbbbdbccaabdaccbbd	FALSE
cbcacabdcddcdaadbbac	FALSE
cbcdcdbdcddcdabbabcb	FALSE
cbddbaaacabdddacdabc	FALSE
ccacdaadcccaacaadacb	FALSE
ccbccaadaabccaddcaba	FALSE
cccbdccdabcdbaaabbcc	FALSE
ccdbbddddbaacdaccacb	FALSE
cdaacacadaddbbccbbac	FALSE
cdbaccbcacabcadbbcab	FALSE
cdcabbbdaacaddaaadda	FALSE
cdcdccaaadccdcacbdbd	FALSE
cddcdcbbdbacabbccacc	FALSE
dbabbadaacccbbbcccaa	FALSE
dbbbbaabcabaaccacbca	FALSE
dbcacaabdacccacacaac	FALSE
dbcdbcdadccaaddcccdd	FALSE
dbddbcabaccbdbaabbba	FALSE
dcadaadaabdcdcabadab	FALSE
dcbcdabcbabdbbdcdaad	FALSE
dccbdccaadaddbaddcad	FALSE
dcdbbcdadcbacabbdbdd	FALSE
ddbabbdbdaabcabacacb	FALSE
ddbddaacbddcccdbdcad	FALSE
ddcdcabdcdbaadacadca	FALSE
aaaaaacbcdcdaadcacabb	TRUE
aaabdaadbccacabcacada	TRUE
aaadbbbcccdbaddaaadbb	TRUE
aabbadbdbcccaddcababa	TRUE
aabcdcbababdcaddbbbcb	TRUE
aacaccdaadbdbccadbdac	TRUE
aacccbcdbaccdadaadcdb	TRUE
aadabbbacacccbddbbcba	TRUE
aadcaadacccddccbcbcab	TRUE
aadddbbaadaadcadcbbcd	TRUE
ababbccdbdacadadaacbb	TRUE
abadadbcdbbaabdbbabad	TRUE
abbbabdbbcadcadccdccb	TRUE
abbcdadccbdbdbdccdbbd	TRUE
abcabcbaabbccabbdbccd	TRUE
abccacbbdaaadbabcdcbd	TRUE
abcdcccdddbbbcaabbbda	TRUE
abdbabdccdbccacbabcaa	TRUE
abdcccbccccabcbcacacc	TRUE
acaaabcdcbabacccdaddd	TRUE
acabdcaabadbacababdcc	TRUE
acadcdabbcaccadcdabbd	TRUE
acbbbddbbbdccccaabddc	TRUE
acbcdbddddddadddbbaac	TRUE
accabadbccdacbcabcdbc	TRUE
accbdbabaccbdcdcaddcb	TRUE
accdccdccddbddcdabdcc	TRUE
acdbcaadacdbcabaabcdd	TRUE
acddbcbbcadccccdcadbb	TRUE
adabbcadbddccbaadadbb	TRUE
adadaadbabbdbccdbbbdb	TRUE
adbacbaabbdccbdabbbbd	TRUE
adbcabdbbcdcaacdcacdb	TRUE
adbddcccbbccdcbabbcba	TRUE
adcbdcacdbaadcbdacccc	TRUE
adcdccacccacbdccbabcc	TRUE
addbbbdbddaabdbdcdadd	TRUE
adddabcdcbbdcddaabdaa	TRUE
daabababbdbabacdbdcbc	TRUE
daadabcacdcdadcbdbcbb	TRUE
dabacacadbcbdbbdcccba	TRUE
dabcacdcababddabdadad	TRUE
dabddbabaacdcabacbdcc	TRUE
dacbadbdaadcbcbaadbab	TRUE
daccdbccddbbaadccccdb	TRUE
dadacbacbccaddddbabcc	TRUE
dadcacdadcbccacbccdcb	TRUE
dadddccddacbadcacdbda	TRUE
ddabdcaaabcbdbcdbcdcd	TRUE
ddadbcccdddcddbdadbab	TRUE
aaabdaacccdbdacdacdca	FALSE
baabaddabddbdbaabcacb	FALSE
babbabbcdddabdcdadabb	FALSE
bacabaacbbdbdcbabcaca	FALSE
bacdcaadaadbbdbbccada	FALSE
baddbadadddbabcdacccb	FALSE
bbadbadabdabcadbabdac	FALSE
bbbcbdabacbdaabcbdbad	FALSE
bbccabaabdabbdcdbdbca	FALSE
bbdbbccdbabbbcdbbbbdb	FALSE
bcaadbbccdcaadbdaaabb	FALSE
bcbacabaacbdbbaaabbbd	FALSE
bccacaccaccaddcaaadad	FALSE
bcdaaadbbdabbabbacbbc	FALSE
bcddcaabddaaccadcdbba	FALSE
bdadadaddadbbbdbbbacc	FALSE
bdbccccdadaaddadcdccd	FALSE
bdccbdabbbdacbdccbadd	FALSE
bddcabdacdbcdaabcdaaa	FALSE
caabaacacdcbdaccbdabc	FALSE
cabacbbbcbddbbbcaddcb	FALSE
cabddcabccbccabcbbabb	FALSE
cacdaacabdbaadcaddcba	FALSE
cadcbbdbcddadaadadbbb	FALSE
cbabcddadbbbabdcaadda	FALSE
cbbbadbcaabcbbbdacacc	FALSE
cbcbabaabbddcddbddcda	FALSE
cbdadddcccaabcaacacad	FALSE
ccaaccbbccbccabaacbca	FALSE
ccaddcaadaadaacbaabcb	FALSE
ccbdbbaccbdbdadacbcbd	FALSE
cccdacdcabbbaddcbaaca	FALSE
ccdbcdbabddacdabcacdc	FALSE
cdabaddbcaaccabddbbda	FALSE
cdbacbbdcacaabdabaaaa	FALSE
cdcabcbdcaccacbbbcdda	FALSE
cdcdcadbbaddbbdbcacad	FALSE
cddccdcabdcbbbdcaccbb	FALSE
dbabbdddacddcaadabbaa	FALSE
dbbbaaddbacbbcdbddcad	FALSE
dbcabdcccdbdcccacbcbc	FALSE
dbcdadddcdcccacdcdaaa	FALSE
dbdccabaacdbacabaadcd	FALSE
dcacbaccacacbbbaabccb	FALSE
dcbbdcbaddbbdbddbadbc	FALSE
dccbbcddabaabadacadbc	FALSE
dcdbccaadbcdbddbbbdcc	FALSE
ddabdacdaaadbaccaddaa	FALSE
ddbdadcbccbbddaadcada	FALSE
ddcdabacacbdbddcddbda	FALSE
aaaaaaabbbbdcbbcdadada	TRUE
aaacacbbdddbbcbbbcbdcc	TRUE
aabaaacddabccbacddaacc	TRUE
aabbcaacdcdacaacccccdd	TRUE
aabdaddadabcbcaccabdab	TRUE
aacadcabcbdcbcbddacdba	TRUE
aaccbdccbbbbdaccbddaaa	TRUE
aadacbabbabdbadcabbbba	TRUE
aadcacdbacaadabcdbdbdc	TRUE
aadddbaabbaabdbababdcd	TRUE
ababbcdadaabddcddcddbc	TRUE
abadabaddbbaaddbddccbb	TRUE
abbacadacacbdcbcddcadc	TRUE
abbcaacddbcbcadccbdbab	TRUE
abbdcccddddabadcbcdcca	TRUE
abcbbdbadcbbadacdabcac	TRUE
abccddbaaadbadbdcdcbcb	TRUE
abdacbccdbddbcccadaabd	TRUE
abdcaccaaabbdccabacaba	TRUE
abddcdcdcaaadcdcabdcbb	TRUE
acabcadcacdddaccdbaaab	TRUE
acadadcdcddacbdbabbdab	TRUE
acbbacddacaabccbbbdccb	TRUE
acbccddddbdccbabbbadcb	TRUE
accabaddbddaabcbbbbcad	TRUE
acccacdddddaaaddbcbbdb	TRUE
accddccdadcbabcacbccdc	TRUE
acdbbdbddbacadcaaadcbc	TRUE
acddacdcddabacdaddddca	TRUE
adabaabaccdccbbdcaaadb	TRUE
adaccbcadccacdcbbdccbc	TRUE
adbabccddabbbbaacbcbda	TRUE
adbcbabbdbdbdddcccccdb	TRUE
adbdddbcbbbddaccbadbcb	TRUE
adcbdbadddcbcbaacadcdd	TRUE
adcdcaacccbcaadbccaaaa	TRUE
addbbcbbbaabcdbcdccccd	TRUE
addcdcdcadcdabccbabacb	TRUE
daaacdabbcaadddbbcaacb	TRUE
daacbabdcbbcdacdaabdac	TRUE
daaddddbabcadabbbdbaab	TRUE
dabbcbcaaaabdbcbdddaac	TRUE
dabdbbaddcaadbbcbbcacc	TRUE
dacbabbdadddbcdbcbaabd	TRUE
dacccdcdcbcbcacaacdccb	TRUE
dadabccacdcbdbdcccacca	TRUE
dadcaabddadbcdbcabdbcb	TRUE
dadddacdcaddbdabdaadbb	TRUE
ddabccbadadaabbbaaabad	TRUE
ddadbcdabddbaabdabadac	TRUE
aaaaacacacdacacdccacca	FALSE
baaacccadaacccdccddcbb	FALSE
baadddaaabbaabdcabaabd	FALSE
babdcaaacbaccdbdacdaca	FALSE
baccdcdbadadddaccdcdab	FALSE
baddacadbabcccdcbacbab	FALSE
bbacdabcbadbcaadaadaab	FALSE
bbbcaabdbdbacabbbccadc	FALSE
bbcbcdddaabbcbdbbdacad	FALSE
bbdbabbccdcbaaacbbcdbb	FALSE
bcaabddddaaacbdaccbccc	FALSE
bcaddcbdaddaabbbacccdc	FALSE
bcbdcdccdcdabdbdabddac	FALSE
bccdbbcbdabacbdbbcaacd	FALSE
bcdcbbdbabadcbbcbbaaad	FALSE
bdabdccbabbcdbdbcdbcbc	FALSE
bdbcabadbdddccddbaddbb	FALSE
bdcbbcbbadccadbadccbdd	FALSE
bddadbacaddacbcbcaddac	FALSE
caaaabbaaadabbccbbccdc	FALSE
caadadbbadcdddbacdccba	FALSE
cabcacccbcddcccccddbab	FALSE
cacbbcabddcdabdbaacbba	FALSE
cadaddabbcddcaadaadcdb	FALSE
cadddcddcbcbacbdccdaad	FALSE
cbadacadbcbcdaadcccdac	FALSE
cbbcbddcdcdbddacbaabdc	FALSE
cbcbdabaaacdccdbdaaddc	FALSE
cbdbbbabbccdcdbaacdcbc	FALSE
ccabbacbaccbdcdcabccac	FALSE
ccbacddabdaddabbacaddc	FALSE
cccabdaabadabcadaacaaa	FALSE
cccddadabdbacbcbdbbaba	FALSE
ccdcdcddbbdcabbcacbdba	FALSE
cdacbcccdddbadbaaccdcd	FALSE
cdbcacbadbacbcbcbdaccb	FALSE
cdccbadcadbdbbdcdcbddb	FALSE
cddbdbdacacacbbbbadcac	FALSE
dbaaccbcdcbcccaddcdcac	FALSE
dbbabadcaadccbbdcdcabd	FALSE
dbbdbddcbbabcdcccbbabc	FALSE
dbccdbdbadbdcddabaacdb	FALSE
dbdcbadbcaacdbaccddbdd	FALSE
dcacbccbdbcdbaadadabaa	FALSE
dcbcaabbbcbcbdccdbbdcc	FALSE
dccbcbcadcdadcbcddaccc	FALSE
dcdaccbcdcaacaacbbdacb	FALSE
ddbaabbcabdbcdcddcbdca	FALSE
ddcaabcbcdbaacababccba	FALSE
ddcdbbbdbdaddddbadddac	FALSE
aaaaaabaaadcacabbacdabc	TRUE
aaabbdcaacdacbbacbbddbc	TRUE
aaadabddaaaabdcbdacddca	TRUE
aabbabaaacbabdbccbcaacd	TRUE
aabccdcccaddaaccbbbbacb	TRUE
aacacadbcccdaccbddccdda	TRUE
aaccbccabbcaabbbddaadcb	TRUE
aadaabadcbcbcdbbacdcbcb	TRUE
aadbdcaabcdaacbbaadddcb	TRUE
aaddcdcbaabcdddbbdcaaca	TRUE
ababcadabacdcbccdacbbaa	TRUE
abadadccbbdadbccabdcbbb	TRUE
abbadacbddabadadbbcbcbd	TRUE
abbcbdaacabddcacadcbabc	TRUE
abcaaaccbbbcccdcdcaaadd	TRUE
abcbccbbdaaaabdbaaccdbd	TRUE
abcdbadddbcadbbddddaacb	TRUE
abdadcdccbaacbdbaadbbdb	TRUE
abdccddabbdbabdbaccddab	TRUE
acaabbaacbaaaabdadabbcb	TRUE
acabdbcbbcbcbacccccdabd	TRUE
acadccaacaddbcdbbbdaabb	TRUE
acbbcccbacbdcccbdcdaccd	TRUE
acbdabdadacabccddccabdc	TRUE
accacbcbaacdcadddbccaac	TRUE
acccadaaddcaadacabdabbb	TRUE
accdcdbbccddbdbaaacaaba	TRUE
acdbbcdbdacaccddaddabca	TRUE
acdcdcdddabbcaaddbacbbd	TRUE
adaadbaadabbcacbcabadda	TRUE
adacbddcabcdddbdbbbbdcd	TRUE
adaddddbadbaacddabbbdda	TRUE
adbbcdbadabcabbdcdaadab	TRUE
adbdcdbbbadbddadcddaabc	TRUE
adcbcbbdcdbbbcacacbcbab	TRUE
adcdbddabacccbdcccddbad	TRUE
addbadcbcbbaabaabacabba	TRUE
adddacadcdcacbcaaabadbb	TRUE
daaacdbaccbacbadcadbbab	TRUE
daacadcdcacccbccacccacb	TRUE
dabaabdabcbcacaccddbddd	TRUE
dabbcdbacbdcabcdbadcbbd	TRUE
dabdbdacbbbbaabadbbddbd	TRUE
dacbabbbdaacdbbdccbccbc	TRUE
daccdbaabccdbcaacbadbda	TRUE
dadadabdbbcdadbbbbdcaba	TRUE
dadccaaaccccccbaadbdabc	TRUE
ddaaacbccdcbbddaabddcca	TRUE
ddabdabdaadabbddacddbbb	TRUE
ddaddadabbdddcdbacbbdab	TRUE
aaaabdacacccdacdaccdaca	FALSE
baaaccbababaabdbdaaaacd	FALSE
babababcbdccdddaaaaadcd	FALSE
babdbddadabcccabadbacdc	FALSE
bacdaadccdadcaccccdacdc	FALSE
badcabaaadcdabcbabbadba	FALSE
bbabbddbcabadcadcbdddcc	FALSE
bbbbbbbbbcdbdabacbbbdaa	FALSE
bbcaddadcbbccaadbcccdac	FALSE
bbdacabbccdbbbdbadbbabc	FALSE
bcaaddabbaabcdbaaabadac	FALSE
bcbadccbdcaddcacdbabadd	FALSE
bccadbbabdbcacdbbcbabca	FALSE
bcdaacabdbddabbdcacccca	FALSE
bcdcdbdccbbdacbdbdadcdd	FALSE
bdacaddbbaaabcaacaabaca	FALSE
bdbbddccaadbccbacccbbcb	FALSE
bdcbcdcababbbbabcbbddba	FALSE
bddbbbbcaccaccacabdbdcb	FALSE
caaaccdabbaddbacaccddcc	FALSE
caaddcdbddacabdcbbcbccd	FALSE
cabdbddcddccdacdcabdbcc	FALSE
cacddcbbbcbadccbaadaacd	FALSE
caddadcbdcdddabccbdabad	FALSE
cbaccdaccbcaaddcdcabdba	FALSE
cbbcaaacbaaabadcbdcdbac	FALSE
cbcbcabdbbcbcacbaaacdbb	FALSE
cbdbaccaacadbbbccdadabd	FALSE
ccaaadaacdcdcdbdacbbcac	FALSE
ccadcaaddadbbabbbdbdcac	FALSE
ccbdaaaddcccbdbaacbcbcd	FALSE
cccccddcbababbadbcccacd	FALSE
ccdcbaaccabddbaadbdbddc	FALSE
cdabbbccdacbaacaabccbbb	FALSE
cdbacdabccaabcaaddaaabb	FALSE
cdbdcdaadacbdacbdacaddd	FALSE
cdcdbcbccdcabbbbaadccbd	FALSE
cddcdcdaaccbdbccbbcaccb	FALSE
dbabbdcabcadcaabbacdbcb	FALSE
dbbbccddacdaabddaddddca	FALSE
dbcbabcadcdcacbcadbdcbc	FALSE
dbdaababdaadbacccdcabda	FALSE
dbddccadcbdbdcabbdcddbd	FALSE
dcaddabccdbcdacbbcbdcdd	FALSE
dcbddbcadbbdcaaabdacdcd	FALSE
dcccdbacbaadabdcaadddbc	FALSE
dcdcbcabaaadbbbbbbdabcc	FALSE
ddbbabcdabddadcaadbbcba	FALSE
ddcaacccbdadaccbddbbbad	FALSE
ddcdadcddacbcdcacbdbbcc	FALSE
aaaaaaacdddabacddcbddcdd	TRUE
aaabcbaaadcbadacbcccaada	TRUE
aaadadbcadbadabdbcacbddd	TRUE
aabadbdacadbcadadcacacdc	TRUE
aabccadbbbadabdcdaddcbac	TRUE
aacacabacacbddcbbdcbcbba	TRUE
aacccbaaadacbaacbbabbcca	TRUE
aadacbcacccdcdcbbacbabca	TRUE
aadcbdabcccaabdbcdcdcaab	TRUE
abaaabbbcbadabcdbcaabaca	TRUE
ababdacdcccddababbaacaac	TRUE
abadcaadacadadaccbbaabaa	TRUE
abbbaaaadcbcddcadccdcdab	TRUE
abbcdccdbabcbbcddddaacad	TRUE
abcacaddbcaabadbcdaacaad	TRUE
abccbbbcbddccdccabdaccbd	TRUE
abdaabbacbcabddbabcabacb	TRUE
abdbccbbdbaabdbbadbabbac	TRUE
abddacbacbccadbdddbabccd	TRUE
acaacacaddacbbbbcaabddac	TRUE
acacababacabbbddccddabcd	TRUE
acadbdaadbcdabcdbaacabac	TRUE
acbbabdbbdcbbbabdbbbbbda	TRUE
acbccdbcccaddadabdbbbbda	TRUE
accaaddcabaacbccbdbdcbdc	TRUE
acccabbcdbbcddbcdabdaada	TRUE
accdccdbdbabbaaaadbbbcdc	TRUE
acdbbdadcacbaaabbadadbab	TRUE
acddaddbacbcdddbbbcbdacb	TRUE
adababdaccaaccdcbbbbdcad	TRUE
adaccddbcdbdcbccbccbddbc	TRUE
adbacadcdccdadcbdacbbcca	TRUE
adbbdcdddccccaccacdabbbd	TRUE
adbdbcaaddaaaacdabbadaaa	TRUE
adcadadccadaabbcabbdacdb	TRUE
adcccddcabddddbacbcbddbb	TRUE
addabcdbcaabbcbdcbabccac	TRUE
addcaababdcadcbbbbbaaddb	TRUE
adddcdcdadbbcdcbcaabacac	TRUE
daabbbaaddcbcaaccdcbbbca	TRUE
daadacdbbbdbbbdbdabcadac	TRUE
dabbaaacdcbacdaaacabdbbc	TRUE
dabccbdbbdccbadcadbabddc	TRUE
dacaaccaacaccdbdcbbcbdcd	TRUE
dacbdbcbdbcbbaabadbcaada	TRUE
dacddbccddbbdbbacaaabcbc	TRUE
dadbccdccbccabcbbacddcda	TRUE
daddbadcccddbbacdcabadcd	TRUE
ddabadcaaadcdacdbdcdbbdd	TRUE
ddadbabcccdbcbadbbcddbcb	TRUE
aaaaacdccdbdaacddccdbaaa	FALSE
baabbacbadcaaccadacdabcc	FALSE
babaddabccbacadaabcaadbc	FALSE
bacadbabbcdacbbdaacbcaaa	FALSE
badaacbbbaccaadaccdadaaa	FALSE
baddaaadabdcdaddcbacccca	FALSE
bbaccbadadbbacccbacbdaac	FALSE
bbbcadbacbcdcdddbdddbbca	FALSE
bbcbbabcddcaddcaaaddccbd	FALSE
bbdaaadbbacdbddaababcacc	FALSE
bbdcdbbbbccdabdcadbdbdad	FALSE
bcabdcaaccbbdbaabbbdddcb	FALSE
bcbadbccabaaadcadacdccdd	FALSE
bccaaccbabadcaadddacdacd	FALSE
bccdbccbbdcbbdabbacbbdcd	FALSE
bcdcacbccdbcaabadbcdaaca	FALSE
bdabbcbcadabdadddadccadc	FALSE
bdbabdbccacabbaaadaabcab	FALSE
bdcabbdbbccadadcaaadacab	FALSE
bdcdddacabddbcccddcadacb	FALSE
bdddaacabacbacabdddaadcd	FALSE
caabddcdaaaaaabdbbbcdcdd	FALSE
cabcacadcdcccbaabcabcbaa	FALSE
cacbbcbaccabdbdbddcbcaca	FALSE
cadadbacabccabacabdcdbbb	FALSE
cadddcccabcdabbdcbacbbdb	FALSE
cbadbbbbddbdbabadbcdddba	FALSE
cbbccdbdcbbcbbbbaccbadad	FALSE
cbcccdaadabccdddadcbbccc	FALSE
cbdcdbabdbabaaaadccdcaac	FALSE
ccaccbccccbdaddacdabbacb	FALSE
ccbccabadbbbcdbaacdccbbb	FALSE
ccccdddbddaabdaccdbdcada	FALSE
ccdcdcbdcaabbddaadccbdab	FALSE
cdacbabbcdadcccaaccbaccc	FALSE
cdbbcdbadaaadbbdbdcbdaba	FALSE
cdcacbccadaadadcccbbcbcb	FALSE
cddaababddaccccbbccbbdcc	FALSE
cdddccbaadcbcdcbadbacbdb	FALSE
dbaccbbabadadcdbcddcdbab	FALSE
dbbcbbcbbbcbcbbabbabacbb	FALSE
dbcccadabbccaacdcdcbddbb	FALSE
dbdbcbdcbdabbbcbcbbcdaaa	FALSE
dcabcabdcabdadddacbddaad	FALSE
dcbacdacadbbbbdbdcdbcbba	FALSE
dcbdddcbcdbbdbbacaaabcbc	FALSE
dcccdbadcacbcdbbbdcadadd	FALSE
dcdccdddaabbbdddbcbdaadd	FALSE
ddbcadaadacdaacdabcadbba	FALSE
ddccabccadddacbdddadadac	FALSE
aaaaaaadcbbdbbbcadbcaabaa	TRUE
aaabcbcbdbdadabbdddcaddca	TRUE
aaadcbaaddcbcacacbccdabcb	TRUE
aabbbacacdbacdccdbababdca	TRUE
aabcdcccddacdbdbccabdbdaa	TRUE
aacabadddadbdcaadbbdbdbac	TRUE
aaccbbaabcaacbacaadcbbdbc	TRUE
aacddbbccdacbbaacaabdccdd	TRUE
aadbbddbadcdadadcbabacabc	TRUE
aaddbadbcdddcbdbaaaacabba	TRUE
abaadbcaadabbcacadaabbcab	TRUE
abaccdaabacdadacbdcdcdaba	TRUE
abbabdbaacbccacdddabbabaa	TRUE
abbcacdbcddbbbddcbbaabcca	TRUE
abbdddcbddddbacdaadaaaabb	TRUE
abcbcccbbadcadacdabbbacba	TRUE
abcdbcbcdccaccdccaaaaddcb	TRUE
abdbadcdcaaabbccdcbdbaabc	TRUE
abdcdbdccbcbacdcdcdbdaadb	TRUE
acaadaabbddbcbcddbccddbbb	TRUE
acaccabadbcabbbcdcadabcab	TRUE
acbababddbbcdaddbcdbccbcb	TRUE
acbbdcaabdcabbbcaccdbdcac	TRUE
acbdbbdbcdbacccdddbbcddcb	TRUE
accbaaabadcbbbccbdbbadbba	TRUE
accdaadccabddcdbacadacdcc	TRUE
acdacccbdbcabbbbadabacbbb	TRUE
acdcbbccbcbccccaddabadddd	TRUE
adaaabcadaababcdbcbbcbbab	TRUE
adabdacdbababbabcbdaabbcc	TRUE
adadbadbdbcbdadcbaabadacb	TRUE
adbbabdabdbcbbadbacbdcddb	TRUE
adbcbcbdddaadbabadcdddccc	TRUE
adcaaccabbbcacbcacddbdcad	TRUE
adccaacdabbccbddcdddcdddb	TRUE
adcdcadddaaabcabbaaacabaa	TRUE
addbcadbdbcdaaacdddddbaab	TRUE
adddaabccabdaacadbbbacaad	TRUE
daaaccacadadcabcbcdbdbdbd	TRUE
daacadabbcadbbdddabaaddad	TRUE
dabaaabdddadadaadbcdccbba	TRUE
dabcabcaaccdddababbabbdcb	TRUE
dacaaabadacaaaddabbbcaacb	TRUE
dacbcbcabbddaddbabadadbba	TRUE
dacdbcaadcdbadaccabadaccb	TRUE
dadaddcdaacbcbdccadcabcdd	TRUE
dadccdadddcccbbddbcdadbcb	TRUE
ddaabbacbcaaddaddadaadcdc	TRUE
ddabdccdbdcccacddddcdaadc	TRUE
ddadcbdcbdaaaddcbcabaaddd	TRUE
aaaabaaacbacbacbabdaaaacc	FALSE
baaadddabbacbccdccbcdadca	FALSE
babacbdacaccdcbcadcbacdcb	FALSE
babdcccccbcdbdccdadcddaab	FALSE
bacdabacdbadabdcdcdbbbcda	FALSE
badcbaddacdcadddddadbbbab	FALSE
bbacabadcbdabaadbddabbbdd	FALSE
bbbadddadcdbbabdbbcbcbbdb	FALSE
bbcaabccacdaccbaabbbccbad	FALSE
bbcddabaabbcaacabaacbbada	FALSE
bbddbbddadcccbbcdcaccccbd	FALSE
bcacddcbdbbbaccdacababbcd	FALSE
bcbbddaabccbcabaacbbbdbab	FALSE
bccbccccacbabccbdcdabdccd	FALSE
bcdbbbadccccadbabbaacbdcb	FALSE
bdaacaddcbbabacdcacaacaca	FALSE
bdaddccbccaccacdbbadaaabc	FALSE
bdbdabbdaacbacababbcccada	FALSE
bdcdaadddcbddbdbccabbaccc	FALSE
bddccbaadbdcadabdbccdaacb	FALSE
caabdbccbabdcbcbbbcbbdadd	FALSE
cabbdbdacacdbdadabbdaddcd	FALSE
cacbbdaacbbabdabbcdbbdbda	FALSE
cadacbadbaadabacdadcbaccc	FALSE
cbaaadaccadbbdabbdabddacb	FALSE
cbadddbdcbbabdadbdcbccbbc	FALSE
cbcaaabcaccbbbbacaddaaabd	FALSE
cbcdcdcddddddacdadcddadda	FALSE
cbddaccacabbbcbddcdadbaca	FALSE
ccacbcbdadcacdddaadadaccc	FALSE
ccbbdcccdacdabbababcaacda	FALSE
cccbcdacbbacbacbabcbbadca	FALSE
ccdbadaccdbbbcadaacadcdab	FALSE
cdaaccdabdacacccdbccacccd	FALSE
cdbaaaaccabdccdbccbdabaad	FALSE
cdbdaabaaadccadccdacaaaac	FALSE
cdccbbdbdccdcadadbcaaabcd	FALSE
cddcbdacdbbddddaacdadcdab	FALSE
dbabbacbccddcbddcdaadbbaa	FALSE
dbbadadbdbcabdadaadccdbdb	FALSE
dbcacaaadbcdabdbcdcdccbbd	FALSE
dbcdddbcaacccadddddaababd	FALSE
dbddbabaabaadbaccabdcdddc	FALSE
dcacdddacabaaadcdaacbdbda	FALSE
dcbbdabddbdabcacaabaddcdd	FALSE
dccbcabaaccbaddaabbcaadac	FALSE
dcdadddcdddbdadcdadabadbd	FALSE
ddbaaacdbbbbcbdbcbbdcadad	FALSE
ddbddbcaacdcbabbababdaadd	FALSE
ddcdabbccadddcdbabdaccabc	FALSE
aaaaaaacdccdcadccdaadbcccb	TRUE
aaabccbcdbcaadbbdddbadbbdd	TRUE
aaadbbbdbbbaadbcabcdaaccdb	TRUE
aabbabcbbdcacbcadacabcbbcc	TRUE
aabcccdabbcabccabcabcdbcda	TRUE
aacaacdbaabcbdbcdbdcbbacda	TRUE
aaccacdacaaaaddaccbdbdabcb	TRUE
aacddcadbabbbadbcbbdacbcca	TRUE
aadbcaabaaababaacbacddcdcb	TRUE
aadcdbcdcaaddacaabbbbdcabb	TRUE
abaacdadcbcddbcccbbcadbcdb	TRUE
abacccdacccddccccdadcbcdac	TRUE
abbabaccdcacabccababbabdcd	TRUE
abbbdbabddbcccbbddbadbdcbb	TRUE
abbdbbbadccabdaaababbcabca	TRUE
abcaddcdcabdbcaaccdddadbcb	TRUE
abcccabbbacaccddbccabaabdd	TRUE
abdabcbabcadaadbcaddaabadc	TRUE
abdcacaddacadddcabcdadbbba	TRUE
abddcbbcccbcdcdbaaacbdabbc	TRUE
acabbbadcdcbdccaddccdaaabd	TRUE
acadaccaababbdacddadccbdbc	TRUE
acbacdccadbbcdacdbacdbbcda	TRUE
acbcbdcddcaaddbcdbbdcabcac	TRUE
accabcdacddbbdbddbcabcaccc	TRUE
acccbbacaccbaabdcbcabcddaa	TRUE
acdaabdcbbccaddacdbbcbacba	TRUE
acdbcccddadaadaddcbbdbdacc	TRUE
acddbaaaabcbdbbcaaacbacbac	TRUE
adaadcddbddbcbbbcbacbbadcc	TRUE
adacbddabaddcabaadabdcccac	TRUE
adbabdbccdadbcddcccdbacbcb	TRUE
adbcbdccbabbaccabadddcddda	TRUE
adcaabdaadadacaaaabccacdca	TRUE
adccaadcaadabddbcbbcbcbcdb	TRUE
adcdcbcbcadaaacdcddabcccdc	TRUE
addbbcacccacacaabaabdddbcc	TRUE
adddababdcdbbdbddddcccbddc	TRUE
daaacdacdadbabddcbdddbbccc	TRUE
daaccadcdcbbcabddaadccabcb	TRUE
dabaabaabacbcbccadbaaabcca	TRUE
dabbdaddcaddadacadacddbbac	TRUE
dabdbcbbbaacabacbdcdddadbd	TRUE
dacbaadacabdcccdbdcbcbbcba	TRUE
daccbdbdbbdcbaabdcccabddbb	TRUE
dadaaccdbdcdddbcadbcdccada	TRUE
dadbdbaaabacaccbcbdbcdbabd	TRUE
daddccbcabbbbaccabadbcaaaa	TRUE
ddabcadabbcccacbadbcadadab	TRUE
ddadbcaccddacbccbbccaabdad	TRUE
aaaadcaacdacdcbacbacaaccdd	FALSE
baabdababaabcdabdaccdbaddc	FALSE
babbadbababccaaccbbdadbacd	FALSE
bacabcbbbabbcbacadbcabddda	FALSE
bacddbcdcbacdbbadcdccdbbba	FALSE
baddaddcccddcddabdaabbbbcc	FALSE
bbaccbbcddcbaacadbcacddacd	FALSE
bbbbdadaadcdababcbbdcbcdac	FALSE
bbcbbadccdbccccccddbcdadcd	FALSE
bbdabdbcbbddaabcadbcabccad	FALSE
bbdddbaabcabbdbaddbdbccdab	FALSE
bcadbcdadddaadbacbbaccccdb	FALSE
bcbcdbaaddabdaccbdbbdddbbd	FALSE
bcccadcdcbbbdbaccbdacaaaad	FALSE
bcdbcbcdbacbabdacbcdbbcdab	FALSE
bdaadbbddddbacacabccacbbba	FALSE
bdadcddcbcddcdcdccdaacccdd	FALSE
bdbcdbaababbacabcccaddacda	FALSE
bdccaabdddaaaabdbdbdddbdac	FALSE
bddccaabbadacdaabcaddcdabd	FALSE
caacbaabbddbaddbdddabddcdd	FALSE
cabcbbabbccdddbbaabdcccadb	FALSE
caccadaacabbdcacadcbbbdcdc	FALSE
cadcaccdaddacdaddcdaadcccb	FALSE
cbaacbdccaddbbcbababdaaccb	FALSE
cbbabcbbcaaaabbacaddbacabd	FALSE
cbbdbbddadcccadadbdaaadbca	FALSE
cbcdbddbcbcbdcaccccaaaabdd	FALSE
cbddbcbcabbcdcbcaaaccaddbd	FALSE
ccacccbddacacdabcbcaccccac	FALSE
ccbcaccddacddabdadaaccddcc	FALSE
ccccbcbbddcbcabbcaaccdabcd	FALSE
ccdbacbabaccbdbdddcaabbcbc	FALSE
cdaadadcbbbdcaabaccaddddbd	FALSE
cdbacadccacbbaddacddcabacb	FALSE
cdbdcccdddbdccdabbdbdbcaac	FALSE
cdccddcaaaaabcccbbdbaabaac	FALSE
cddcaaacbcdccadaaabcbdcdbc	FALSE
dbabaaaabcdbadcbadabadaaaa	FALSE
dbaddbcbaaaadacbdadabcbddb	FALSE
dbbdcaccdcdbccaabdccdaacaa	FALSE
dbccddcbbbcccaaabdaacddbdd	FALSE
dbdcbacaaacdacaaadcdcdabdb	FALSE
dcacaaacbaadcdbaabbdccbada	FALSE
dcbbddbaaadcbcbabcdcbcdabb	FALSE
dccbaccdaaddabacbbddccdbda	FALSE
dcdadadcdddbbcdddbdadddabb	FALSE
ddbacaccbdbabbcbbacdccbaad	FALSE
ddbddacdbadbaacacabacdaadd	FALSE
ddccdcdbbdbcbadbadcdcbdcbc	FALSE
aaaaaadaabcaacdcadaadddbdbd	TRUE
aaabdbcdbddcbccbdbbdddcdbac	TRUE
aaadbdcdddaccddddaaacadaabd	TRUE
aabbbbcdaadadcacbadbadccbbc	TRUE
aabdaccdcddadbdcccadddbdbcc	TRUE
aacaccbbacddacddcadcbbcdacb	TRUE
aaccbcaaabbbbdadccbbcbabbdb	TRUE
aacddcdcadabbbcdcbddccdddcd	TRUE
aadbcdbadbdadacdcccbbacaabd	TRUE
aaddcbcbccbccaaacacaccbadbc	TRUE
ababacdbdbcccbbdbcbcdadaada	TRUE
abacdbdddccccacabdcddcdbbad	TRUE
abbacbcdddaacddddaadabdbccc	TRUE
abbcbaaaacaaabbddbcdcbbcbcb	TRUE
abbdcbadcbabdacbdacaaaccadb	TRUE
abcbbaaabaddccbcdbbbbabdabc	TRUE
abccdaddadcbdddcdccaadbdacc	TRUE
abdabaacdcadacdbcaaabbdaaad	TRUE
abdcacdccabccabdbabacacccab	TRUE
abdddabbabbdcddabdbbcbdcddd	TRUE
acabbccccccdabbbddaccbcaddd	TRUE
acadacdaacbbcdddbbbbcacccbb	TRUE
acbbadbabdbadbadacbdcbdbcac	TRUE
acbccccbdbadabdbadacbcaacdd	TRUE
accaadaaabababbaabdadacccdc	TRUE
acccacadddcadbcbcdcbcbbadbc	TRUE
accdddacdaccaabdbbabaaccacb	TRUE
acdbcdaddadbdbbacdddbdbcdcd	TRUE
acddbbadccdaaadcbaaabcbbccd	TRUE
adaadbdadbcaaaacadaadcccdcc	TRUE
adaccaaabbcbcaaccdcbcdacbba	TRUE
adbabbabdbbbbcabbdbadcccbaa	TRUE
adbbddaacdadbbadcbadbaddcad	TRUE
adbddaadbdaaddcadcbcaaccdab	TRUE
adcbadccbaccccbabbaddbbbcdb	TRUE
adccddccdbbcccdddacdcdcdada	TRUE
addbaaaccabdbcadadcbccbbcac	TRUE
addcdccabcdcbabccaaacaabcbc	TRUE
daaaccaddbcccbabbbbddbcdcab	TRUE
daacbcaccbcdbdcdabacdbbdcbb	TRUE
dabaacdacdbbddcadcdbbdbbbcb	TRUE
dabbccddabacddccdcaccccdcac	TRUE
dabdbacacdcbacacddbbcdbbabc	TRUE
dacbabcbcdabaabaabbbdcccabd	TRUE
daccdaccabcaaadddbaccacbddc	TRUE
dadacababdaaaaaaabbaabdccbd	TRUE
dadcaadddcadbcadcdaddabcccb	TRUE
dadddacddbabacaaabdaabdcacc	TRUE
ddabccdacddddcaccddbcbbbddc	TRUE
ddadcadcbbbccadccbaadddddda	TRUE
aaaacaaaddccddaaadadacaaacd	FALSE
baabddcbaadcddcbccabdbcabda	FALSE
babcacabaadbbbabdaadcacbdcd	FALSE
bacbacdbcdadddbcdbbadddaddb	FALSE
badadbbbacbcdadbcadbbdddcaa	FALSE
bbaabccdcbbaacdaacdaccacbbb	FALSE
bbadcdbcdbbbdabdcdbccbddddb	FALSE
bbbcdcccacddbabccaacacbcddd	FALSE
bbccaaadbdabacacdcdddbdcada	FALSE
bbdbcabcdbbdabcdcaaddcaadac	FALSE
bcaadddbacaadbcadadccacaacb	FALSE
bcbabdbbacbcbcccaabbacabbca	FALSE
bccaabcbdabccadaaaabbacaddb	FALSE
bccddbdcadcdcddbacdabbdcccc	FALSE
bcddbbaabbaacadacdbaddaddac	FALSE
bdacddadddaacdbccabbbdbbcab	FALSE
bdbcabaabbbacdccacbbdcaabdb	FALSE
bdcbbbaadbbcabacddbdcdccccb	FALSE
bddadcddbcadbbbdabcbdcdaadb	FALSE
caaabacbadbdacdcaddadcdbbbc	FALSE
caadbdbdcabadbdccbcabadcdba	FALSE
cabcccaadacbdbadcabbcdadaba	FALSE
cacbddbddbcddcdbdbabbdababb	FALSE
cadbbbccddbcdcaccbcdbadaddc	FALSE
cbaadcabccccadaadabddadbcbd	FALSE
cbaddbbdddabbabaaacdabacbbb	FALSE
cbbddabbbdaadcdbcbdddaddbdb	FALSE
cbcdaadcadcdcddcbbccdacccac	FALSE
cbdccbcdccaabdbabcddaaacacb	FALSE
ccabdaccacdcaccbbadcdbacbdb	FALSE
ccbcbccdabbaabbcaddacacdcaa	FALSE
cccbcabdcddcacbdcacbadcbdcc	FALSE
ccdabdadddcbcaacaccacccbabc	FALSE
cdabaadbbadbdabcabdbccddacc	FALSE
cdbabcdbacbdbaaabaccaaaadab	FALSE
cdbdcaaccdbcbaaddabbbadaddc	FALSE
cdcdabcbabcdbcababddaaabdaa	FALSE
cddcddccaacccbaadbacddbdcab	FALSE
dbabcccdccbadaacbdddbccccda	FALSE
dbbbbccbbabddbadcaadcbaccbb	FALSE
dbcbbaadaabcadccbcaaaabdccb	FALSE
dbdbabbddbbadcbdadaddaaccab	FALSE
dcaabbcacabcdbdcdadaacabcdb	FALSE
dcbabadddaccdbbcdcccaccdbcb	FALSE
dcbdbcbcacdabcbddbadcbabdac	FALSE
dccccdbcbbcbacdbdbdccbcbadb	FALSE
dcdbdaadaccacacaaccbbcdccda	FALSE
ddbacddabdadcdbaadbbbbaddab	FALSE
ddcaabdabcddbcdbccbbddaccca	FALSE
ddcddbbbacaccbaacbddbcabbcc	FALSE
aaaaaaababccbcbccbdbbabacbca	TRUE
aaabdaadadccaccadbbacbddccad	TRUE
aaadcaabaacbabbbdbbcaadcaaca	TRUE
aabbadbcbdbbbcdcdbdccdbbadad	TRUE
aabcddbcdcdddccabdcddadacdcd	TRUE
aacadbabdadcabbccbbdbbdcbbdc	TRUE
aaccbbacdaadccdacaadadbcbcba	TRUE
aadaabbaabbdcacdcbbbdacbbbad	TRUE
aadcaaabddcdbadadccbddcdcabd	TRUE
aaddddaccacbdbbcaacccacaacba	TRUE
ababcdcdbdaadcbadbcadadbbdbd	TRUE
abadcccbdcbbdbaacbdcdcdbdaba	TRUE
abbbbabacbabdddabbdadcabccdb	TRUE
abbcdadcadabbccccbbbbbbaccdd	TRUE
abcabcabaddbaacddaaccdcbdccc	TRUE
abcbdcbcbdbbcdbdbdadcdbbaddc	TRUE
abcdcadabbdccabdbcccdbdcbaad	TRUE
abdbaaacbdbbdababcddadaddadd	TRUE
abdccbadbcdaacbdccbadcbcdbcb	TRUE
acaabcbbcabcbacacdbddadbabad	TRUE
acabddbacbcaccdbbcaadabdccbc	TRUE
acadbcadcadcaccaddbdbcbdbddb	TRUE
acbbadcaacababcccdaccccabcdd	TRUE
acbcccddcdbbdadcbababaaadaad	TRUE
accabdbdcdaadddabdacccddbcbc	TRUE
acccabcbdcaccaddcccddacddbbc	TRUE
acdabcaadaaaadddcbabccddcadc	TRUE
acdcbabbdbcddbcbcdbabcdadbbc	TRUE
acddddcacadbaabcdbdbdbdbcabb	TRUE
adabcadacdadcabdbcbcbcbdbacc	TRUE
adadbccbaccaadabaaabdbaacbad	TRUE
adbbacaddbcaabdccccbbcaacadc	TRUE
adbdaaccdabcbccaabcdaaadbccc	TRUE
adcadbacddccdcbccbcbcbddcadb	TRUE
adccbdbaacabadacadcdcccaacac	TRUE
addaabbdaabdadaabdddaccbcbba	TRUE
addbdbcbbdaadbbacdbbcbababad	TRUE
adddacbadcdcdccacccdcbcaacdb	TRUE
daaadbaaabacccdcbcbbbbaaabca	TRUE
daaccbacaccaabaabdacaacabbbb	TRUE
dabaabcbcaabddabccaddabdccbb	TRUE
dabbcbcaaaadabcdadabcbadcdba	TRUE
dabdccbbdaabbcdbbadcaacccbac	TRUE
dacbbbbdadcadbadcaaabaddcbdd	TRUE
dacdabcdddaccbdcabaddbbacdbc	TRUE
dadadcdcbcbdddcacabccdbcbaac	TRUE
dadcdbbcaddacbcbcbabaaabcacb	TRUE
ddaabbbccbdbccbacbccadddaaba	TRUE
ddacaaaaddcbdaacbdbbcacbdadd	TRUE
ddadcabacbdcdadcadcbdaaccdaa	TRUE
aaadcddaaaaddaadcdccdcaadccb	FALSE
baabdadddbcbccadcbccdaaacbcb	FALSE
babbbddcacddccdaabacccdbbbdb	FALSE
bacbaabadbdabacabccaabbcacad	FALSE
badaadbdbbcbcdcddcbbddcbcdab	FALSE
baddccddcdddabadbdaabccbbacb	FALSE
bbacbbbcdbbabcddbdabdddcdabc	FALSE
bbbbdabbdadbbcadcbddaacbcbab	FALSE
bbcbbbdbbdcdbcbdcdadaddcdabd	FALSE
bbdbaabccacacbbcdacabcddbdda	FALSE
bcaacbbaccbacbcccbdbbdacaadc	FALSE
bcbaccbcbacbaddcbcbdaaccccca	FALSE
bcbdcbbbadbabbababacaadadada	FALSE
bcccddaccdbadbcdcdadadbbddcb	FALSE
bcdcbadaabccabdccbbaddacbcdc	FALSE
bdabcaddcadacbbbbadbcaacacbd	FALSE
bdbacddcbaccdbdbbbcabbcdccac	FALSE
bdbddbdbcddbabbbcbbdbabcadcd	FALSE
bdcdbacdbddbaccaddcdaadacbbc	FALSE
bddccaadadddaadcbccaccbabbda	FALSE
caabcdcbbbabdaaabddcadaaabaa	FALSE
cabbacadbbdadcbdbcbaaddcdaaa	FALSE
cacacababbaaaaabdadcdaaabbbc	FALSE
cadaadacddcdbdaccbdcbabbcadd	FALSE
cbaaaccacbaccbccaaacaacddddc	FALSE
cbadaddcccadddcbbabcbadddaba	FALSE
cbbdadcbacdccaacbbcddcaccddb	FALSE
cbcdbbcdabccccddcabaadacaabd	FALSE
cbdcbcdddadabcccdcaabdaddcdd	FALSE
ccacbaccaacbabdcbaadcbaacdcc	FALSE
ccbbddcaacabaababbabdcabdcdd	FALSE
cccbccadadadddbaddaabacdcacd	FALSE
ccdaccbbccaadbdaaaabbbdcccab	FALSE
ccdddbdbbdddcdbabbdbddcbdaaa	FALSE
cdacdccaacdacdbddcccabddacca	FALSE
cdbcaacdddababddbacaacdbacdc	FALSE
cdccabbacbaacabdadbcbccadcaa	FALSE
cddbbdaaabbccadcbcacacabddac	FALSE
dbaaaccababacdaccbdcddbbbcca	FALSE
dbadbadddcaccdaddbdcbbbddcbc	FALSE
dbbcdbdcabcaaadaabdbabdcaacd	FALSE
dbccbaccccdabcbacdcddababccd	FALSE
dbdbdbcadccacacdacccdbdaabad	FALSE
dcabcaddadcadaacddcbacdcdbda	FALSE
dcbbbcadddcdaadbcbacccbbadad	FALSE
dccbabcdbbaddcbddbddaddaccaa	FALSE
dcdacdacdcdaabcabbcdccabacbc	FALSE
ddbaccdbbdaaadaacdbccaacbcaa	FALSE
ddcaabddaabbdacabbcbaacadaaa	FALSE
ddcdbacbcbbcdadcbacbabbababa	FALSE
aaaaaaacadbbdbddbaadcbccaadca	TRUE
aaacaadcadbbbdcacdccbdcccabba	TRUE
aaaddbadbacbbddbababaccdcdaac	TRUE
aabbbadddbabbacddadadabdcbbba	TRUE
aabcdcababdaabadcbaddcbcbddba	TRUE
aacacdcbdbcbcbbdabbdabbbdcabd	TRUE
aaccadccabadccacdbbbaaadbbacc	TRUE
aacddabacabbdddabcdadacadcdac	TRUE
aadbcaddcaacabbdaaaabaabbcdbd	TRUE
aaddadabccabadbbbcdaacabcddad	TRUE
abaadabcaabcdcaabcadbdbbbccab	TRUE
abaccabbbaadccbdabacdccaddcdd	TRUE
abbaadaacacccbaacdbaabbcbbbcc	TRUE
abbbdbaaabcaabaadcabdbbbadcdc	TRUE
abbdbbabcbdbdaabcbaacbddbcbbc	TRUE
abcadbdbaadcaaaadbdcdacddabbb	TRUE
abcccbacdbddabcbdabacacbddcdd	TRUE
abdacabaddcbdcdbaaccdabadcbaa	TRUE
abdcbdaacbbccaccdbcbdcbcbcada	TRUE
acaaadbbabcbcaabadcbabbdbdcdc	TRUE
acabdbbdcaddcccbcdabbcaabbddc	TRUE
acadcdabcacbbcaadccabaacdbbbd	TRUE
acbbbacacacddacbaddbbababbaac	TRUE
acbcddadccbccbdaabadadadbdbac	TRUE
accaccddbcbadccdbabdcaabcbacd	TRUE
acccbadddcbaccadacacccddbbddc	TRUE
accdddcccdadaccacdbbadcbcaddd	TRUE
acdbccabcbacbbdbbcbdddbbdbadc	TRUE
acddcacdccdcdaaaaddcbacbcbcdb	TRUE
adabbbdddacacdcabbdbccaabcabc	TRUE
adacddbbcadbdccbbabdcdbbdccbd	TRUE
adbadbaabdbdddadaccaadabcacca	TRUE
adbcbdcaccdbcadddcaacabadbcbb	TRUE
adcaabaaabdbdbbbbcbacacacbaad	TRUE
adcbcbcdbbdadcbcbaccaacdbbdda	TRUE
adcdbbacddcdbaaccccacabccbaca	TRUE
addbabbaaabbadadddcbbcdaadabd	TRUE
addcdcacacccdbbadbccbcaccccbd	TRUE
daaacabcccdccbcbbacbddbbddabc	TRUE
daacacabcadadbabadbcddaabaadd	TRUE
daaddadaaabbdcaacaaaacbbddcda	TRUE
dabbadcbcdaddadadabcccbcdcbdd	TRUE
dabcdccaaddbccabdccaddddcbcda	TRUE
dacacbddcddadcdadbbcdddbdacbc	TRUE
daccacddbaccbccbddbcccaabcabd	TRUE
dadaacabdacbbdaadcdaacccccbdb	TRUE
dadbdcdcaacabdbcbbcbcdbadaddb	TRUE
daddbdabcbdddcbdabbcdadaacdca	TRUE
ddabcdacdbdacbbabcbbdcbddddbd	TRUE
ddadbdaabdbacdbccdcbadbcdbadb	TRUE
aabacbdadacddcdbaaaaaacdacdda	FALSE
baadaaabcaccacdcccbdbbbbdacda	FALSE
babccdccbbbcaabbadcdbcbdcaadc	FALSE
baccacdbcdbcbbdadcacbdbbbbddc	FALSE
badbacbaaaacdbbbbddacbdcbcdbb	FALSE
bbaadaabcadabbdadcabcdaccbbab	FALSE
bbbabdadacdadbdbbcbabdbacadad	FALSE
bbbdcbaaadbcddaabdabdcdddaabd	FALSE
bbcddbbcbaacbddcaabbaabaaaadb	FALSE
bbddcabaddbddbcadddccdabdacad	FALSE
bcadccbadcdcbbbbadacbcaabbaad	FALSE
bcbdaabdaabbabaddddadbadddbca	FALSE
bccccadcccdabdabdcdcbadbcbaab	FALSE
bcdbdcddbaccdaacdbcbcdcccbbdc	FALSE
bdabcacabccacbdccadbaccbbbdda	FALSE
bdbbbadacaddaadbddccbdcbcbcbd	FALSE
bdcabbbdcdbccabcddaaaaccbabaa	FALSE
bdcddddccdbbbababbbacbaaabcab	FALSE
bdddbbbbabcadbbbbcdcaabcbacab	FALSE
caaccbcabbdbcacdcacddcbacdcaa	FALSE
cabcdddadcccccbcbddddccabccdd	FALSE
cacccabdcaaddcabaaddbccdcbdac	FALSE
cadccabacabadcacdccbacdbbcdbd	FALSE
cbaadaacacbddbcdadcbcdbbcadcb	FALSE
cbbabccbbccbcccbddcbadddccdaa	FALSE
cbbdcbaabbdcdcaccbdabbbdcaaad	FALSE
cbccdccbdbcabdaaacabcadcadacc	FALSE
cbdbdbbdacbaddcbbbcbcadaabdaa	FALSE
ccabcdbcacdbcbaadcbcdbcdaccdd	FALSE
ccbaddddccadddaaaaababcdcaadc	FALSE
cccabcddabbbbadcbabbadbaddbcc	FALSE
cccdbcbdacbcdcdadabcbbdaccbbc	FALSE
ccdcddaddcaddcbbadcadbbbdccda	FALSE
cdabddcdabdbaabdaaccbdacccbdb	FALSE
cdbbaaabaacbdcbddcddabdadacdd	FALSE
cdcabbcdcabdbcccbbbcbaabccbbd	FALSE
cdcdcccbddbabbbdadaabcabadabb	FALSE
cddcccdccbbadacacdbbdadcddccb	FALSE
dbacadbbcabbdccbbbacdcadcdddb	FALSE
dbbbbbcbdbbacacddcadddbcdcbda	FALSE
dbcbabdccbbdcabccbcabdbcacacc	FALSE
dbdababdbccdbbacccdbbbbcccddd	FALSE
dcaabbdccdabacbadbabbdacdddab	FALSE
dcaddcbcbbbbddbbbdabdcbcdacbc	FALSE
dcbdbbcddddaaddbdcaaacbbdaddb	FALSE
dcccacbadbacbcbdaaddcaabaabad	FALSE
dcdbcacabbbabcdcddbaaddccaadd	FALSE
ddbadccbcbdbbcdaaaacabcdcbbcd	FALSE
ddcaabdcbcaccacaabcdaddcaabaa	FALSE
ddccdcaacdbcdbcbaccbcbaadbacd	FALSE
