aaaaaaaaabacbccbcddaaccbdddddda	TRUE
aaaaaaadaaddccdcacdddcaaadaddab	TRUE
aabdcadbdbbbbaaaaaaaadbaccabccb	TRUE
abbaaaaaaacdbdaaabadacdccddaacb	TRUE
abdddcbcbddadaaaaaaaaadcdccabad	TRUE
accbdaacbcaacacbdaabdcaaaaaaacd	TRUE
adbabbcaaaaaaacbdcccccdbaacbccd	TRUE
addddbacddacabdccbaaaaaaabbcdab	TRUE
bacadcbcbbdaabccbdbaaacaaaaaaad	TRUE
bbbbdcaaaaaaacbcaccbccaddbabcbb	TRUE
bcaacddbddddadbaaaaaaadbdcbacda	TRUE
bcdabaccbadbaaaaaaacababdcadacd	TRUE
bdbdbaaaaaaadadbbaaadcdccdadcdc	TRUE
caaaaaaacbcaacadabbaaccaddcdbbd	TRUE
caccbaadcddaaaaaaacddbaacadcaba	TRUE
cbbacdabdccaaaaaaaabbabcdbccaab	TRUE
ccaaaaaaaabccbbabdcbddacdbadcbc	TRUE
cccbdbcadcbcaacddbaddcaaaaaaaba	TRUE
cdadcdbbacddaacbbaaccdbcaaaaaaa	TRUE
daaaaaaabbcbcbbdddddcaccbddccca	TRUE
dacbbdbbbbdabdbdbcbacaaaaaaadab	TRUE
dbadaccbbdaaaaaaabcbacccbcddadd	TRUE
dbdcbaddcbacaacccdcaaaaaaadcdbc	TRUE
dcbcdcdaaaaaaacdcbadbbcbddaacdd	TRUE
ddadaaaaaaacbddddbcccbbcddcbdcc	TRUE
aaaaaadaaabacbccbcddaaccbdddddda	FALSE
abaaaaadaaddccdcacdddcaaadaddab	FALSE
aabdcadbdbbbbaaaaaabadbaccabccb	FALSE
abbaaaaabaacdbdaaabadacdccddaacb	FALSE
abdddcbcbddadaaaaaadaadcdccabad	FALSE
accbdaacbcaacacbdaabdcaaabaaacd	FALSE
adbabbcaaaaabacbdcccccdbaacbccd	FALSE
addddbacddacabdccbaaaaaadabbcdab	FALSE
bacadcbcbbdaabccbdbaaacaaaaabad	FALSE
bbbbdcdaaaaaacbcaccbccaddbabcbb	FALSE
bcaacddbddddadbaaadaaaadbdcbacda	FALSE
bcdabaccbadbaaaaacacababdcadacd	FALSE
bdbdbaaaaabaadadbbaaadcdccdadcdc	FALSE
caaaadaaacbcaacadabbaaccaddcdbbd	FALSE
caccbaadcddaabaaaacddbaacadcaba	FALSE
cbbacdabdccadaaaaaabbabcdbccaab	FALSE
ccaaacaaaaabccbbabdcbddacdbadcbc	FALSE
cccbdbcadcbcaacddbaddcaaaabaaba	FALSE
cdadcdbbacddaacbbaaccdbcaadaaaaa	FALSE
daaaaaabbbcbcbbdddddcaccbddccca	FALSE
dacbbdbbbbdabdbdbcbacbaaaaaadab	FALSE
dbadaccbbdaaaaadabcbacccbcddadd	FALSE
dbdcbaddcbacaacccdcaaaaadaadcdbc	FALSE
dcbcdcdaadaaaacdcbadbbcbddaacdd	FALSE
ddadaaadaaaacbddddbcccbbcddcbdcc	FALSE
aaaaaaaaabadabcbaabadbbcaadbbbbc	TRUE
aaaaaaadcdacabbbbbbdbdbdbbdbcbcb	TRUE
aacbbaaddddaddbaaaaaaadcadbdcbda	TRUE
abacdcccdccdababacbacddbcaaaaaaa	TRUE
abdddaacddccbdcdddacaaaaaaaabcdd	TRUE
accbdbddaaaaaaabcdbddbdcdabcdaad	TRUE
adadbaaadcdcabadbccadabbaaaaaaac	TRUE
baaaaaaabadbdbadacacaabaadaddacc	TRUE
baccabadabccbdccdaaaaaaaccdabcdb	TRUE
bbbaddddcddacdbdadccabbaaaaaaada	TRUE
bcaaaaaddcccacbbbbbcaaaaaaadcaab	TRUE
bcccdccaaaaaaadaabccabcaaaccbccd	TRUE
bdbaabaaaaaaabdbaacbdabcdbbdaabb	TRUE
bdddaaaaaaaccbcdcccdaaccacddddba	TRUE
cabddabdccccbccaadcdaaaaaaabbdda	TRUE
cbaccdacbaccbbadddaaaaaaabbcdccd	TRUE
cbdaaaaaaadbbdbcddbaacabbccbadda	TRUE
ccccbaabdabcdaaaaaaadcccbcadabbc	TRUE
cdbaaccabbdabdaaaaaaaaabdcdcccaa	TRUE
daaaaaaabcbdccdddbaacbbaadadddac	TRUE
dabdaddbadccdcaaabcaaaaaaabcacbb	TRUE
dbacaaaaaaacaccaccddadcacdbacccd	TRUE
dbdbcbdaabcacbddaccacaaaaaaacccb	TRUE
dcccaaaaaaaabbadbcadccadbdccbbaa	TRUE
ddadbdbdcaadbcccccabbcdbcaaaaaaa	TRUE
aaaaadaaaabadabcbaabadbbcaadbbbbc	FALSE
aacaaaaadcdacabbbbbbdbdbdbbdbcbcb	FALSE
aacbbaaddddaddbbaaaaaadcadbdcbda	FALSE
abacdcccdccdababacbacddbcacaaaaaa	FALSE
abdddaacddccbdcdddacaaadaaaaabcdd	FALSE
accbdbddaabaaaabcdbddbdcdabcdaad	FALSE
adadbaaadcdcabadbccadabbaadaaaac	FALSE
baaaaaabadbdbadacacaabaadaddacc	FALSE
baccabadabccbdccdaaaaaaccdabcdb	FALSE
bbbaddddcddacdbdadccabbacaaaaada	FALSE
bcaaaaaddcccacbbbbbcaaaaacaadcaab	FALSE
bcccdccaacaaaadaabccabcaaaccbccd	FALSE
bdbaabaaaaaadbdbaacbdabcdbbdaabb	FALSE
bdddaaaaaaccbcdcccdaaccacddddba	FALSE
cabddabdccccbccaadcdaabaaaabbdda	FALSE
cbaccdacbaccbbadddaaabaaaabbcdccd	FALSE
cbdaaaabaaadbbdbcddbaacabbccbadda	FALSE
ccccbaabdabcdaadaaaadcccbcadabbc	FALSE
cdbaaccabbdabdaaaacaaaaabdcdcccaa	FALSE
daaaaaacabcbdccdddbaacbbaadadddac	FALSE
dabdaddbadccdcaaabcaaaabaaabcacbb	FALSE
dbacaaaadaacaccaccddadcacdbacccd	FALSE
dbdbcbdaabcacbddaccacaaaaacacccb	FALSE
dcccaaacaaaabbadbcadccadbdccbbaa	FALSE
ddadbdbdcaadbcccccabbcdbcaaacaaa	FALSE
aaaaaaaaabbdbbbbadbbcdcbcaaaadccd	TRUE
aaabdcbdcacbcacdabbbbddddaaaaaaac	TRUE
aadcaccbaabcdabdacbaaaaaaadabdbac	TRUE
abcbadbcddaaaaaaabdaadaadcdbdcdac	TRUE
acbaaaaaaacabdbbbcacdaddbddbdaccc	TRUE
acdccdacdbddddaaaaaaacadbaadacaaa	TRUE
adcbadbaaaaaaadcccacbaabcdabaccdc	TRUE
baabaccadcbcbbacddcacabaaaaaaabaa	TRUE
badbbaaaaaaadbbdccccccaaabdbacccd	TRUE
bbbdbabadacccacacaaaaaaadbdbbaabd	TRUE
bcabacdbcdcabbacccbadaabacaaaaaaa	TRUE
bcccdadbbdbbcdcbcacbacbaaaaaaadda	TRUE
bdbaacbcaccaaaaaaabdacccadabdbccc	TRUE
caaaaaaaacadcbcbcadbababbdcdacacc	TRUE
cacaaaaaaadcbbccdccacbabacdcadbdc	TRUE
cbadbddddabcdbbddcaaaaaaaaabcadcc	TRUE
ccaaaaaaaadabcdbadacbdcbacbdabcdc	TRUE
cccdbbcdbbdbddcbbdcdbbdaaaaaaadcc	TRUE
cdbcaadcbbadaaaaaaacbbdbacdbbcbcb	TRUE
daaaaaaabcabdbddbcccccbcabcdcbacb	TRUE
dabdcacdcababcbbaaaaaaacbaacdcdcb	TRUE
dbadbaadccdddddbccddaabddaaaaaaac	TRUE
dbdbccdcdadbdcdbdcdaaaaaaaadbccac	TRUE
dccbbbadbacbbbdbbbbaaaaaaabcbcdbb	TRUE
ddbabcddcbdaaaaaaadacaacbcdbdddda	TRUE
aadaaaaaabbdbbbbadbbcdcbcaaaadccd	FALSE
aaabdcbdcacbcacdabbbbddddaaabaaaac	FALSE
aadcaccbaabcdabdacbaaaaaadabdbac	FALSE
abcbadbcddaaacaaaabdaadaadcdbdcdac	FALSE
acbadaaaaaacabdbbbcacdaddbddbdaccc	FALSE
acdccdacdbddddaaaadaaacadbaadacaaa	FALSE
adcbadbaaaabaadcccacbaabcdabaccdc	FALSE
baabaccadcbcbbacddcacabaaabaaaabaa	FALSE
badbbaaaaaadbbdccccccaaabdbacccd	FALSE
bbbdbabadacccacacbaaaaaadbdbbaabd	FALSE
bcabacdbcdcabbacccbadaabacaaaaaa	FALSE
bcccdadbbdbbcdcbcacbacbaaaaaacadda	FALSE
bdbaacbcaccaaadaaabdacccadabdbccc	FALSE
caaabaaaaacadcbcbcadbababbdcdacacc	FALSE
cacaaaaaadcbbccdccacbabacdcadbdc	FALSE
cbadbddddabcdbbddcaacaaaaaabcadcc	FALSE
ccaaaaaabadabcdbadacbdcbacbdabcdc	FALSE
cccdbbcdbbdbddcbbdcdbbdabaaaaaadcc	FALSE
cdbcaadcbbadaaabaaaacbbdbacdbbcbcb	FALSE
daaaabaabcabdbddbcccccbcabcdcbacb	FALSE
dabdcacdcababcbbaaaaaabacbaacdcdcb	FALSE
dbadbaadccdddddbccddaabddaaaaaac	FALSE
dbdbccdcdadbdcdbdcdaaaaaabaadbccac	FALSE
dccbbbadbacbbbdbbbbaaaaababcbcdbb	FALSE
ddbabcddcbdaaadaaaadacaacbcdbdddda	FALSE
aaaaaaaaacbaccbbdbbdcaabcbbbddaccc	TRUE
aaaaacdaaaaaaaccdbadddbacdacbabadd	TRUE
aadbbccddaaaaaaabbbdcdcdcaacacbbaa	TRUE
abbcadbbdaaabadddaaaaaaaabbbabccac	TRUE
acabbbbdabdcbddcadbcadabdcdaaaaaaa	TRUE
acdabddbdbcabcdcdddcadaaaaaaadbacb	TRUE
adbcadaddaddacaaaabaddbbaaaaaaacdc	TRUE
baaaaaaaabbbaacbdadccacaddacccdaab	TRUE
bacaacbccdaaaaaaacbbaacdacbbcadbcb	TRUE
bbacbbddbcddccdbddadcaaaaaaaddacbb	TRUE
bcaaaaaaaccdddbcabbbcabbbdbcdcbcbd	TRUE
bcdaadbbacaccaadabdddcadcaaaaaaacc	TRUE
bdbcbbadababbbdacbbcddcbacdaaaaaaa	TRUE
caaaaaaabbbcbcdbdddcbbacaacccdaacd	TRUE
cacdcacccbdadaacbbdcaaaaaaacaaccdd	TRUE
cbbbbdbccadacdcbbaaaaaaabadaccbcca	TRUE
ccabdcddaaaaaaabbbdbdaabccdcdbadab	TRUE
cccddaacbbdaaaaaaaddcdadacabaccdbd	TRUE
cdbadcbaddaaaaaabcaaaaaaddcabccacb	TRUE
cddddcabbaddbddcdcddddaaaaaaaabaab	TRUE
dacacaacbcbccbcdbdcadaaaaaaaaabaab	TRUE
dbacddacaaaaaaabcdccbabcbaccbbbaac	TRUE
dbdcacccaababdcaaaaaaabcbcdddadbbc	TRUE
dccacddbacaaaaaaabbdcabcbdcdddaaaa	TRUE
ddbaddcadbbbdddcaadcbbdaaaaaaacdab	TRUE
aaaaadaaacbaccbbdbbdcaabcbbbddaccc	FALSE
aaaaacdaaaaaaccdbadddbacdacbabadd	FALSE
aadbbccddaaacaaaabbbdcdcdcaacacbbaa	FALSE
abbcadbbdaaabadddaaaadaaaabbbabccac	FALSE
acabbbbdabdcbddcadbcadabdcdaaaaaa	FALSE
acdabddbdbcabcdcdddcadaaaaacadbacb	FALSE
adbcadaddaddacaaaabaddbbaaaaaaccdc	FALSE
babaaaaaabbbaacbdadccacaddacccdaab	FALSE
bacaacbccdaaaaaacbbaacdacbbcadbcb	FALSE
bbacbbddbcddccdbddadcaaadaaaaddacbb	FALSE
bcaabaaaaaccdddbcabbbcabbbdbcdcbcbd	FALSE
bcdaadbbacaccaadabdddcadcaabaaaaacc	FALSE
bdbcbbadababbbdacbbcddcbacdaaaacaaa	FALSE
caaaaaabbbcbcdbdddcbbacaacccdaacd	FALSE
cacdcacccbdadaacbbdcaaaaaacacaaccdd	FALSE
cbbbbdbccadacdcbbaaabaaabadaccbcca	FALSE
ccabdcddaaabaaabbbdbdaabccdcdbadab	FALSE
cccddaacbbdaaaadaaaddcdadacabaccdbd	FALSE
cdbadcbaddaaaaaabcaaaaadddcabccacb	FALSE
cddddcabbaddbddcdcddddaaaaacaaabaab	FALSE
dacacaacbcbccbcdbdcadaaaaaacaaabaab	FALSE
dbacddacaaaaaacabcdccbabcbaccbbbaac	FALSE
dbdcacccaababdcaadaaaaabcbcdddadbbc	FALSE
dccacddbacaaaaaabbdcabcbdcdddaaaa	FALSE
ddbaddcadbbbdddcaadcbbdadaaaaacdab	FALSE
aaaaaaaaacacadbaabbddddaccacdbdccdc	TRUE
aaaaaaadbadaadbccccddbdcccadcbdbadd	TRUE
aacbbdcbcaadbadbacacbbbbbddcaaaaaaa	TRUE
abadcadcccaaaaaaacaccccacbbddcdcbac	TRUE
abddaacbdabdadbccdaaaaaaadccbbddcdd	TRUE
accbccdcccdcacadbccdddadaaaaaaabccd	TRUE
adbabcbdaacdbddccccbcabcbbabaaaaaaa	TRUE
baaaaaaabaacaacabdadbcdbadccdbcddda	TRUE
bacacdccaaaaaaaaaabbdbcdbbacbbbbcda	TRUE
bbacccabbadacbaaaaaaaabccbadbbbdcbc	TRUE
bbdcbabcaddaaaaaaaabdabccdcbbbbcbcb	TRUE
bccabccbbacaaaaaaabddabadcbccbabcca	TRUE
bdbabbccabaaaaaaabdaacdcdadbbcbabaa	TRUE
caaaaaaaabdabccacbcdcbbcdaacbdacbba	TRUE
cacadaddbcbcbbdddbbbdadcaaaaaaabcdd	TRUE
cbadcabdacdcccaaaaaaacbacbbbbcaaddc	TRUE
cbdddaddbbccabdaaaaaaadddcdbbcaabdc	TRUE
cccbbbcacbcabbdcacadaadadaaaaaaabcd	TRUE
cdbadcdccdbbddadddbdbdaaaaaaacccddb	TRUE
cddcdcdabaadabacbcbcabdcdddcaaaaaaa	TRUE
dacbacadbddadccdbbddddaddbdcaaaaaaa	TRUE
dbbcabaaaabaacccbbdcbbacacaaaaaaadd	TRUE
dcabaaaaaaabdcdbcdbdcaacaadaadaccab	TRUE
dccdddccbdcdcdcbcdbdadaaaaaaacacbdc	TRUE
ddbadbbcacaccdbbabbaaaaaaabadddabac	TRUE
aaaaabaaacacadbaabbddddaccacdbdccdc	FALSE
baaaaaadbadaadbccccddbdcccadcbdbadd	FALSE
aacbbdcbcaadbadbacacbbbbbddcaaaaaa	FALSE
abadcadcccaadaaaaacaccccacbbddcdcbac	FALSE
abddaacbdabdadbccdaadaaaadccbbddcdd	FALSE
accbccdcccdcacadbccdddadcaaaaaabccd	FALSE
adbabcbdaacdbddccccbcabcbbabaaaaaa	FALSE
baaaaaabaacaacabdadbcdbadccdbcddda	FALSE
bacacdccaaaaaadaaabbdbcdbbacbbbbcda	FALSE
bbacccabbadacbaaaaadaabccbadbbbdcbc	FALSE
bbdcbabcaddaaaaaadaabdabccdcbbbbcbcb	FALSE
bccabccbbacaaaabaabddabadcbccbabcca	FALSE
bdbabbccabaaadaaabdaacdcdadbbcbabaa	FALSE
caaaaabaaabdabccacbcdcbbcdaacbdacbba	FALSE
cacadaddbcbcbbdddbbbdadcaaaaaacbcdd	FALSE
cbadcabdacdcccaaaaabacbacbbbbcaaddc	FALSE
cbdddaddbbccabdaaaaadaadddcdbbcaabdc	FALSE
cccbbbcacbcabbdcacadaadadaacaaaabcd	FALSE
cdbadcdccdbbddadddbdbdaaaacaaacccddb	FALSE
cddcdcdabaadabacbcbcabdcdddcaaaacaa	FALSE
dacbacadbddadccdbbddddaddbdcaaaaaba	FALSE
dbbcabaaaabaacccbbdcbbacacaacaaaaadd	FALSE
dcabaaaaababdcdbcdbdcaacaadaadaccab	FALSE
dccdddccbdcdcdcbcdbdadaaacaaaacacbdc	FALSE
ddbadbbcacaccdbbabbaaabaaaabadddabac	FALSE
aaaaaaaaabdddccdbcadbdacaccdcdcccbbc	TRUE
aaaaaaadcbdddbdcacdbacaaabbdcababdcb	TRUE
aacacccccccbabaaaaaaacacbaacdbcabacb	TRUE
abaccaaabcbdcbacaaaaaaaacbdbabccbaac	TRUE
abdbddccdbaccabbcadbdcaaaaaaacdadbbc	TRUE
accadcbbbddaadcdcbbcbdddadbacaaaaaaa	TRUE
adacadaaaaaaaaddcbbaddbddbbbdbababcc	TRUE
addaccaaaccddcaaaaaaacbbdcbcbbaaabbc	TRUE
babcdccbccabdcddaaaaaaabbcdcddcdddba	TRUE
bbacaaaaaaadbababcadbabcabacbaaaacba	TRUE
bbdbabcccbbdaccdaaaaaaabccbbabbaacdc	TRUE
bcbdcadcabbdcaacdbcdbbcbaaaaaaabbdcc	TRUE
bdabdbdbbaaaaaaadacdddaacadabdccbcdd	TRUE
bddcbbddcadaaaaaaacdadddaacbbdacbcbd	TRUE
cabdbaccccbdccbaddaaaaaaaadbbacdbdac	TRUE
cbabbaaabddadccaaaaaaaacaaadbbbdcddc	TRUE
cbdacbcaaaaaaaaadcdcadbcbabbabdbadaa	TRUE
cccaadbcddbabccdbacbaaaaaaacbbacdcbb	TRUE
cdbabbddacbabbbacabcacaaaaaaadcccdaa	TRUE
cddcdabcadaaaaaaacbdabbaacdacbabbcbb	TRUE
dacaaaaaaabdacbabaabcaddbcdddbbdccba	TRUE
dbadaddcadbbdcbacbccacaaaaaaaaccdcaa	TRUE
dcaaaaaaacbcbabdadacddcbabbdaabdbaba	TRUE
dccccbcaaaaaaabbdbababcabdcaaabdadca	TRUE
ddbbcbdccacadaaccadaaaaaaaabdcdcdcbd	TRUE
aaaabaaaaabdddccdbcadbdacaccdcdcccbbc	FALSE
aaaaaabdcbdddbdcacdbacaaabbdcababdcb	FALSE
aacacccccccbabaaaaaabacacbaacdbcabacb	FALSE
abaccaaabcbdcbacaaabaaaaacbdbabccbaac	FALSE
abdbddccdbaccabbcadbdcabaaaaacdadbbc	FALSE
accadcbbbddaadcdcbbcbdddadbacaaaaaba	FALSE
adacadaaaaaacaddcbbaddbddbbbdbababcc	FALSE
addaccaaaccddcaaaaaacbbdcbcbbaaabbc	FALSE
babcdccbccabdcddaacaaaaabbcdcddcdddba	FALSE
bbacaaacaaaadbababcadbabcabacbaaaacba	FALSE
bbdbabcccbbdaccdadaaaaabccbbabbaacdc	FALSE
bcbdcadcabbdcaacdbcdbbcbbaaaaaabbdcc	FALSE
bdabdbdbbaabaaaadacdddaacadabdccbcdd	FALSE
bddcbbddcadaaaaaacdadddaacbbdacbcbd	FALSE
cabdbaccccbdccbaddaadaaaaadbbacdbdac	FALSE
cbabbaaabddadccaaadaaaaacaaadbbbdcddc	FALSE
cbdacbcaaaabaaaaadcdcadbcbabbabdbadaa	FALSE
cccaadbcddbabccdbacbaaaaaacbbacdcbb	FALSE
cdbabbddacbabbbacabcacaaaacaadcccdaa	FALSE
cddcdabcadaaaaadaacbdabbaacdacbabbcbb	FALSE
dacaabaaaabdacbabaabcaddbcdddbbdccba	FALSE
dbadaddcadbbdcbacbccacaaaadaaaccdcaa	FALSE
dcaaaaaacbcbabdadacddcbabbdaabdbaba	FALSE
dccccbcaaaaaacabbdbababcabdcaaabdadca	FALSE
ddbbcbdccacadaaccadaaabaaaabdcdcdcbd	FALSE
aaaaaaaaacadabcdcdbbccabbdbbcdcbcbcbc	TRUE
aaaaaaadcddbbcbccdcccdabcbbddaababaac	TRUE
aacbbadbaaaaaaabbddaaddcbcbadbcabbdba	TRUE
abbbcbcdcbbabcababcdcbdaaaaaaadadccba	TRUE
acadabaccbaadbbcdaaaaaaaadbcabdcacbba	TRUE
acdaddbbcbccabadbcdbbbabaaaaaaabaacdc	TRUE
adbcbdbbddbdcdcbbabdaaacdcbaaaaaaabca	TRUE
baaaaaaadabddcadddcbcaadcbddabdddabbb	TRUE
bacccaaadbacbdadcbaaaaaaadbaaccabbddd	TRUE
bbbacbdcaaaaaaacadabbbcbbbaabbcbcddab	TRUE
bbdddcdadaadbbcdaaaaaaadccaaacdddddca	TRUE
bcdaaaaaaabdcabcbaddbcaaabdcaabdcbbbc	TRUE
bdbcddadbccaaaaaaabcbcbacccaabacacbdc	TRUE
caaaaaaadddabdddddcbddaaacabdacadbadb	TRUE
cacddacdccdcaaaaaaabbddddcbbaabcbadba	TRUE
cbbccbbaaaaaaabdcbcaccbbdbbdacdabddcb	TRUE
ccabababbbcaadcdcadbcbacaaaaaaacdcdbb	TRUE
ccdbcddccaaaaaaabcbcdaaadbdacaaddbdcb	TRUE
cdbdacbabcbdbaaaaaaabccccbbdccbbaaccd	TRUE
daaaaaaabcabcdcbaacadcbcaaaaaddadccba	TRUE
dacacdacaadcdbaaaaaaadcacdadddcdbbddc	TRUE
dbadadaaaadcdccabcbcaaaaaaabaabacbaba	TRUE
dbdbabddbabddcbaadcccaaaaaaabacabbcad	TRUE
dcbdddadcccbaaaaaaacccdcabaababbbadad	TRUE
ddacdddcbadadbbcaaacaaaaaaadcdbbadccb	TRUE
aaaaaadaacadabcdcdbbccabbdbbcdcbcbcbc	FALSE
aacaaaadcddbbcbccdcccdabcbbddaababaac	FALSE
aacbbadbaaaaaacabbddaaddcbcbadbcabbdba	FALSE
abbbcbcdcbbabcababcdcbdaaaadaaadadccba	FALSE
acadabaccbaadbbcdaaaacaaaadbcabdcacbba	FALSE
acdaddbbcbccabadbcdbbbabaaaabaaabaacdc	FALSE
adbcbdbbddbdcdcbbabdaaacdcbaaaaacaabca	FALSE
baaaaaadabddcadddcbcaadcbddabdddabbb	FALSE
bacccaaadbacbdadcbadaaaaadbaaccabbddd	FALSE
bbbacbdcaaaaaadacadabbbcbbbaabbcbcddab	FALSE
bbdddcdadaadbbcdaacaaaaadccaaacdddddca	FALSE
bcdbaaaaaabdcabcbaddbcaaabdcaabdcbbbc	FALSE
bdbcddadbccaaaaadaabcbcbacccaabacacbdc	FALSE
caaaaaabadddabdddddcbddaaacabdacadbadb	FALSE
cacddacdccdcaadaaaaabbddddcbbaabcbadba	FALSE
cbbccbbadaaaaabdcbcaccbbdbbdacdabddcb	FALSE
ccabababbbcaadcdcadbcbacaadaaaaacdcdbb	FALSE
ccdbcddccaaaadaaabcbcdaaadbdacaaddbdcb	FALSE
cdbdacbabcbdbaaaaaababccccbbdccbbaaccd	FALSE
daaadaaaabcabcdcbaacadcbcaaaaaddadccba	FALSE
dacacdacaadcdbaaaaacadcacdadddcdbbddc	FALSE
dbadadaaaadcdccabcbcaaaaadabaabacbaba	FALSE
dbdbabddbabddcbaadcccaacaaaabacabbcad	FALSE
dcbdddadcccbaacaaaacccdcabaababbbadad	FALSE
ddacdddcbadadbbcaaacaaaaaadcdbbadccb	FALSE
aaaaaaaaadbccdabaacacbabbcbabbccdbbabd	TRUE
aaabbcacacbaaaaaaacddadbdccddccddcbdca	TRUE
aadbaaaaaaaaacaabddadcaadaddcadadcbabb	TRUE
abbdccbaaaaaaadbbcbadbacdcbbaaaaacbacd	TRUE
acacdaabbbcbdaaaaaaadabadbabbaadcacaba	TRUE
acddabaaacbcaadaaadbbcddcdbaaaaaaadcbc	TRUE
adcaddabdbdddddcdcaacaaaaaaabbbdacacdd	TRUE
baacadbbdbaaaaaaaacccbdabaabbbcdacdbac	TRUE
baddaaaaaaacacccaddcbcaaddccbbbbbaacdd	TRUE
bbcbacaaaaaaacddcdbaccacbdbcbcaadbadbc	TRUE
bcacbcbabdaaaaaaaaaddddcadcbdcbbdaacbd	TRUE
bcdccaccbbaccbacccbcacbaaaaaaadbdcaacc	TRUE
bdcdaaaaaaabbccdacbabbccdabdadddbabaaa	TRUE
caacddbcacadcbaababcbdccaaaaaaabccdadb	TRUE
cadadddcccccbacddacacdbdaaabbccaaaaaaa	TRUE
cbbcaaaaaaaabbbcbdbcaaddabdabcbacdbbcb	TRUE
ccaaabcaccdcabdbabcaaaaaaacbcbbdbaddab	TRUE
ccdabdbbbadacdbdddcdcabaaaaaaacadaadcb	TRUE
cdbdaaaaaaaccbabaaddaadbcaabbbdcdbbacc	TRUE
daaaaaaaddbabdacbdbdbdbbaddbcdbadcdaba	TRUE
daccadcddddddbcaaaaaaaaaabdabcbadbdcdb	TRUE
dbbadccaaaaaaadaacadccbaadaadddadbbccc	TRUE
dcaaccbcbadbadbbbccacdcaddaddaaaaaaadb	TRUE
dccdaaaaaaacadbddadbdabccaaacabadbbddd	TRUE
ddadbcddccbdabdadadaaaaaaabccccdccdabd	TRUE
aaaaaacaadbccdabaacacbabbcbabbccdbbabd	FALSE
aaabbcacacbaaadaaaacddadbdccddccddcbdca	FALSE
aadbaaaaaadaaacaabddadcaadaddcadadcbabb	FALSE
abbdccbacaaaaaadbbcbadbacdcbbaaaaacbacd	FALSE
acacdaabbbcbdaaaaadaadabadbabbaadcacaba	FALSE
acddabaaacbcaadaaadbbcddcdbabaaaaaadcbc	FALSE
adcaddabdbdddddcdcaacdaaaaaabbbdacacdd	FALSE
baacadbbdbaadaaaaacccbdabaabbbcdacdbac	FALSE
baddaaaaaabcacccaddcbcaaddccbbbbbaacdd	FALSE
bbcbacaaaaaacddcdbaccacbdbcbcaadbadbc	FALSE
bcacbcbabdaadaaaaaaddddcadcbdcbbdaacbd	FALSE
bcdccaccbbaccbacccbcacbaaacaaadbdcaacc	FALSE
bdcdaaaaaababbccdacbabbccdabdadddbabaaa	FALSE
caacddbcacadcbaababcbdccabaaaaabccdadb	FALSE
cadadddcccccbacddacacdbdaaabbccaaacaaaa	FALSE
cbbcaaaaabaabbbcbdbcaaddabdabcbacdbbcb	FALSE
ccaaabcaccdcabdbabcaaaaaacbcbbdbaddab	FALSE
ccdabdbbbadacdbdddcdcabacaaaaacadaadcb	FALSE
cdbddaaaaaaccbabaaddaadbcaabbbdcdbbacc	FALSE
daaaaadaaddbabdacbdbdbdbbaddbcdbadcdaba	FALSE
daccadcddddddbcaaaaaacaaabdabcbadbdcdb	FALSE
dbbadccaaaaaacadaacadccbaadaadddadbbccc	FALSE
dcaaccbcbadbadbbbccacdcaddaddaaaaabaadb	FALSE
dccdaaaaaacadbddadbdabccaaacabadbbddd	FALSE
ddadbcddccbdabdadadbaaaaaabccccdccdabd	FALSE
aaaaaaaaadaadcddcacbcabcaacdcaabdacdbda	TRUE
aaaaaaadbccaacbdababddbccbbbcdaddbdccca	TRUE
aabdccdaccdbcdcabcbbbbddacaaaaaaaccbacc	TRUE
ababaaddddbadbcbcabddbaabaaaaaaadddcacc	TRUE
abdacaaaaaaabccacbbccacddcddaadddacaddc	TRUE
acbcbaaaaaaadcdabdcdadddabdabbadcdcdbad	TRUE
adabbcaccdcaddadbadcdaaaaaaaddccbaadbdc	TRUE
addbddaaaacabdbcaddaaaddbbcabaaaaaaabcd	TRUE
bacaaabdbaadcbacaaaaaaadbdbacdbbdabadab	TRUE
bbacbbdbcaaadbdabadbbacbaaaccaaaaaaabba	TRUE
bbdbcacaabbadadcdaaaaaaabacddcaabbbdbbb	TRUE
bccbccbacccdbaaaaaaabdccccacabdbbcdccda	TRUE
bdbabbccdaaaaaaabddaaccdccaccdccbdbbada	TRUE
bddcbcdabacdaaaaaaacaccdbdddccbccccdbbc	TRUE
cacaaccbdccabcdcaaaaaaacdbcabccddbccdcb	TRUE
cbacdabacbaaaaaaacdaccddddacaaadcdcccbb	TRUE
cbdbdacaaaccdccbbcaaaaaaabcccabdccacdbb	TRUE
ccbdbdcccbbdcdbadcbddbdbdaaaaaaabaacaad	TRUE
cdadabcacbcbbbadaddcdbddddcdbdaaaaaaaca	TRUE
cddbacadaacabacaaaaaaabbdbdbbbaacdcaccd	TRUE
dabccdcbdbdbcbcddbdabdbbadccaaaaaaabbbd	TRUE
dbaccbcadaaaaaaacaadbaacccbcadadaacbaca	TRUE
dbdbbdcacccdaaaccbadbcaaaaaaaddccdcccbc	TRUE
dccbadaadccbbcbdaddccdccabbbaaaaaaabdac	TRUE
ddbbbbcabbcbcbaaaaaaacbacdababaabdbbcad	TRUE
aaadaaaaadaadcddcacbcabcaacdcaabdacdbda	FALSE
aaaacaadbccaacbdababddbccbbbcdaddbdccca	FALSE
aabdccdaccdbcdcabcbbbbddacaaaaaacccbacc	FALSE
ababaaddddbadbcbcabddbaabaaaaaadddcacc	FALSE
abdacaaaaadabccacbbccacddcddaadddacaddc	FALSE
acbcbadaaaaadcdabdcdadddabdabbadcdcdbad	FALSE
adabbcaccdcaddadbadcdaaaaaaddccbaadbdc	FALSE
addbddaaaacabdbcaddaaaddbbcabaaaaacabcd	FALSE
bacaaabdbaadcbacaaaaaacadbdbacdbbdabadab	FALSE
bbacbbdbcaaadbdabadbbacbaaaccbaaaaaabba	FALSE
bbdbcacaabbadadcdaaaaaabacddcaabbbdbbb	FALSE
bccbccbacccdbaaaaabaabdccccacabdbbcdccda	FALSE
bdbabbccdaaaaaabddaaccdccaccdccbdbbada	FALSE
bddcbcdabacdaadaaaaacaccdbdddccbccccdbbc	FALSE
cacaaccbdccabcdcabaaaaaacdbcabccddbccdcb	FALSE
cbacdabacbaacaaaacdaccddddacaaadcdcccbb	FALSE
cbdbdacaaaccdccbbcaaaadaabcccabdccacdbb	FALSE
ccbdbdcccbbdcdbadcbddbdbdaaaaaabaacaad	FALSE
cdadabcacbcbbbadaddcdbddddcdbdaaaaacaaca	FALSE
cddbacadaacabacaaacaaaabbdbdbbbaacdcaccd	FALSE
dabccdcbdbdbcbcddbdabdbbadccaaadaaabbbd	FALSE
dbaccbcadaaaaabaacaadbaacccbcadadaacbaca	FALSE
dbdbbdcacccdaaaccbadbcaabaaaaaddccdcccbc	FALSE
dccbadaadccbbcbdaddccdccabbbcaaaaaabdac	FALSE
ddbbbbcabbcbcbaaaaadaacbacdababaabdbbcad	FALSE
aaaaaaaaacdaabcdbddcbcbadacbabcdbcabdbac	TRUE
aaaaaaadcdbdddaacbbdcbbaadacccadaadccabd	TRUE
aacadaaddabdadcdadcaaaaaaaaabdaddcdbbddc	TRUE
abbbdcdbccaabccaaaaaaadddcacabcacdaaddac	TRUE
acaaacddbbaaaaaaadcdabcdaccccddcdbdcaaac	TRUE
accbaacddbcacbadccbbcacabacbbdaaaaaaadad	TRUE
adbabddacdcacaddcaaaaaaadacaadadacbcabdb	TRUE
baaaaaaacddcdccdbdacadcdbbbaaddcadbbcdca	TRUE
badaccacdabaccbdadadcdbccacdacaaaaaaaada	TRUE
bbbdcaaaaaaabbcacdbacbdddccdadbacdbbdbcb	TRUE
bcaadcbdaaaaaaadcabccdcbaacbdbdcbbcadccb	TRUE
bcdbabcbbcdbbbdabccaaaaaaabdbaddcbbdabca	TRUE
bdccaaaaaaacdcaaccbacaabacadbcdddbadabdc	TRUE
caaabdaadccddaaaaaaaabcddaddbcbbddacbdaa	TRUE
cacdbdadccddadbdacbdaaaaaaacdabdbabccbbd	TRUE
cbcaaacccaacaabdacccdcaaaaaaacdcbbdbddda	TRUE
ccacbdacbdcabccacaacccaaaaaaabdcdcbcaabb	TRUE
ccdcaaaaaaacbddadcdcabdcabaacddacdcabddb	TRUE
cdcacdacdbbcacacadbcadccacbbddddbaaaaaaa	TRUE
daaacababcddddcaaaaaaabadbddddadadbbcbab	TRUE
dacdaadaadbbdadcbbaaaacaaaaaaababcbdacbc	TRUE
dbbbdaaaaaaadacadababacadaccdbdccbcdacba	TRUE
dcaaaaaaadbaccbccbadbacddcbdcaacccddcbcd	TRUE
dccbdadbcbaaadaaaaaaacddddcaaabbcaacddab	TRUE
ddbbbbaaccbbdccaaaaaaadaaccdbbcabacacbdd	TRUE
aaaacaaaaacdaabcdbddcbcbadacbabcdbcabdbac	FALSE
baaaaaadcdbdddaacbbdcbbaadacccadaadccabd	FALSE
aacadaaddabdadcdadcaaaaabaaabdaddcdbbddc	FALSE
abbbdcdbccaabccabaaaaaadddcacabcacdaaddac	FALSE
acaaacddbbadaaaaaadcdabcdaccccddcdbdcaaac	FALSE
accbaacddbcacbadccbbcacabacbbdaaaaadaadad	FALSE
adbabddacdcacaddcaaaaaadacaadadacbcabdb	FALSE
baacaaaacddcdccdbdacadcdbbbaaddcadbbcdca	FALSE
badaccacdabaccbdadadcdbccacdacaacaaaaaada	FALSE
bbbdcaaaaacaabbcacdbacbdddccdadbacdbbdbcb	FALSE
bcaadcbdadaaaaaadcabccdcbaacbdbdcbbcadccb	FALSE
bcdbabcbbcdbbbdabccaacaaaabdbaddcbbdabca	FALSE
bdccaaaaaacdcaaccbacaabacadbcdddbadabdc	FALSE
caaabdaadccddaaaaabaabcddaddbcbbddacbdaa	FALSE
cacdbdadccddadbdacbdaaaaabaacdabdbabccbbd	FALSE
cbcaaacccaacaabdacccdcaaaacaacdcbbdbddda	FALSE
ccacbdacbdcabccacaacccaaaaaacbdcdcbcaabb	FALSE
ccdcaaaaadaacbddadcdcabdcabaacddacdcabddb	FALSE
cdcacdacdbbcacacadbcadccacbbddddbadaaaaa	FALSE
daaacababcddddcaadaaaabadbddddadadbbcbab	FALSE
dacdaadaadbbdadcbbaaaacabaaaaababcbdacbc	FALSE
dbbbdaaaaabaadacadababacadaccdbdccbcdacba	FALSE
dcbaaaaaadbaccbccbadbacddcbdcaacccddcbcd	FALSE
dccbdadbcbaaadaaaacaaacddddcaaabbcaacddab	FALSE
ddbbbbaaccbbdccdaaaaaadaaccdbbcabacacbdd	FALSE
aaaaaaaaaaccbcbbbdbbbddcdbdabaaacadcbdaad	TRUE
aaaaadcbcbbbddbcdcacaaaabbaaaaaaaddbbbbcb	TRUE
aaccdccaaaaaaabaccbcbdcdbdcdaadbdddbaadcc	TRUE
abacdbcbcaadddbbaaddbaaaaaaabcdbbbbccadbb	TRUE
abdddadbdababbcbcadcccdabaaaaaaaaddacbdca	TRUE
acccddbaaaccccdabcdacabcbcadaaaaaaadaccdb	TRUE
adbadcaccaaaaaaabdbbacccbccdcabddcccddaab	TRUE
baaaaaaaadcddcbbdbdccbddaccdcdcdcdadcbbcb	TRUE
babddddbdacdcaaaaaaacbddddcadaacbdabaddbb	TRUE
bbaccdaaccacddddcadacaacbaaaaaaabaccccbbd	TRUE
bbdbbbaccbdaccccddaddbadcbccbaacaaaaaaabd	TRUE
bcbdcbbccdaaaaaaacaadcccbaadadacaabdbaadd	TRUE
bdaccdaacabcacbaaaaaaabbdbdbcdddbcdaadaaa	TRUE
bddbcbaadcadacbaaadaccbaccabddaaaaaaabcdb	TRUE
cabcaabaccddbcbbbbbdbcbdcddbbbaaaaaaaccab	TRUE
cbabaaabadcdacaaaaaaacbbcdbcdbaabcbbbcaab	TRUE
cbdcacbdcbaaaaaaacddbbbacadbbacbabacbadda	TRUE
cccbaacddabcdacbccdbdaaaaaaabdcbabbccbdac	TRUE
cdbaaaaaaacbbbcbababaccbdcdcabdadcdccdaab	TRUE
cddcdaddcdabcacdabbdbcbbaddbdcaccaaaaaaad	TRUE
dabdbbddbbaabacbbbacacadbdaddcacdcaaaaaaa	TRUE
dbacdbbdaabbdccdddbbaabaaaaaaacddacbbdbba	TRUE
dbddddbbddddddcccaaaaaaadcbdadadadcabaccd	TRUE
dccdbddcaacbacdcdddbdbabaadadbbbadaaaaaaa	TRUE
ddbcbaccaaaaaaabddaddbaaadccbcacdabcdaddc	TRUE
aaaaacaaaaaccbcbbbdbbbddcdbdabaaacadcbdaad	FALSE
aaaaadcbcbbbddbcdcacaaaabbaaaaabaaddbbbbcb	FALSE
aaccdccaaaabaabaccbcbdcdbdcdaadbdddbaadcc	FALSE
abacdbcbcaadddbbaaddbbaaaaaabcdbbbbccadbb	FALSE
abdddadbdababbcbcadcccdabaabaaaaaaddacbdca	FALSE
acccddbaaaccccdabcdacabcbcadaaaaabaadaccdb	FALSE
adbadcaccaadaaaaabdbbacccbccdcabddcccddaab	FALSE
baaaaaacadcddcbbdbdccbddaccdcdcdcdadcbbcb	FALSE
babddddbdacdcaaaacaaacbddddcadaacbdabaddbb	FALSE
bbaccdaaccacddddcadacaacbaaaaaabaccccbbd	FALSE
bbdbbbaccbdaccccddaddbadcbccbaacaaaabaabd	FALSE
bcbdcbbccdaaaaaacaadcccbaadadacaabdbaadd	FALSE
bdaccdaacabcacbaadaaaabbdbdbcdddbcdaadaaa	FALSE
bddbcbaadcadacbaaadaccbaccabddaaaaabaabcdb	FALSE
cabcaabaccddbcbbbbbdbcbdcddbbbaaaaacaccab	FALSE
cbabaaabadcdacaabaaaaacbbcdbcdbaabcbbbcaab	FALSE
cbdcacbdcbabaaaaacddbbbacadbbacbabacbadda	FALSE
cccbaacddabcdacbccdbdaaaaaacabdcbabbccbdac	FALSE
cdbaaaaaaccbbbcbababaccbdcdcabdadcdccdaab	FALSE
cddcdaddcdabcacdabbdbcbbaddbdcaccaaaaaad	FALSE
dabdbbddbbaabacbbbacacadbdaddcacdcaaaaaa	FALSE
dbacdbbdaabbdccdddbbaabaaabaaacddacbbdbba	FALSE
dbddddbbddddddccccaaaaaadcbdadadadcabaccd	FALSE
dccdbddcaacbacdcdddbdbabaadadbbbadaaabaaaa	FALSE
ddbcbaccaaaaadabddaddbaaadccbcacdabcdaddc	FALSE
aaaaaaaaabbcbddcaaadbbdbccbacaadcbabaccdda	TRUE
aaaabaaaaaaadcddabdcababddbbddddbdcbcabcab	TRUE
aacdbcbabacaacacadcdaaaaaaaabdadcdbaaaccbb	TRUE
abbacbccbbdabccdbdaaaaaaadbdbadaacdcdabcba	TRUE
abdcbddbcddddaaaaaaacbaacdbadaabcddcddcaaa	TRUE
accadcaaaaaaaacbacbcabaacaaddbcdacdaaabbbd	TRUE
adbcadbbbcdcabadbccbcdbbddaaaaaaabddadddbc	TRUE
baaaaaaaddcdbaddcbdddddadbaadcccdcbcccaaaa	TRUE
bacdbadaccbacbdbaaaaccadaacdaaadbdaaaaaaab	TRUE
bbbbbadbbabddcbdcabcadbaaaaaaadbdccdddcbbb	TRUE
bcaaaaaaabcbcabaddbacdcaaddbdccadcbdaaccdc	TRUE
bcccabddadaabbddbcdcaccbbadcbbdaaaaaaabdca	TRUE
bdbbdcadcdabbadbaaaaaaadccbdddccabdddabbab	TRUE
caaaaadaacdaaaaaaaabdcbaabbaadcaaabbdcabbb	TRUE
cadbaaaaaaadaccacaacacadcadbbabbccdaaddcaa	TRUE
cbbcacbddcadaaaaaaabcdbdbdbadbdbcbadccdadb	TRUE
ccaaaaaaaadbcaaaacbaaccdaccbcdbadcaacccdab	TRUE
cccdcdbbccccddabaddbcbbcddadcccaaaaaaacddd	TRUE
cdbaadbdaaaaaaacdcaadddcdcbdadabcbacbddcdd	TRUE
daaaaaaaabadbbccbbdbdcbdcdddbdabbdaabdabda	TRUE
dacbdddadaaaaaaadbacbdcbadcbccbdbadaddcccd	TRUE
dbaddbdbdcdbcacdccaaaaaaadbbbaaaaccacadcba	TRUE
dbdcccaaabbddbaaaadcbcbbaadaaaaaaabbacbdab	TRUE
dccaccdabadabccdcbbdddbcaabcbaacacaaaaaaab	TRUE
ddadaabaaaaaaaccadbdccbbdbbabbbccbdacdcaca	TRUE
aaaaaabaaabbcbddcaaadbbdbccbacaadcbabaccdda	FALSE
aaaabaaabaaadcddabdcababddbbddddbdcbcabcab	FALSE
aacdbcbabacaacacadcdaaadaaaaabdadcdbaaaccbb	FALSE
abbacbccbbdabccdbdacaaaaaadbdbadaacdcdabcba	FALSE
abdcbddbcddddaabaaaacbaacdbadaabcddcddcaaa	FALSE
accadcaaaaaadacbacbcabaacaaddbcdacdaaabbbd	FALSE
adbcadbbbcdcabadbccbcdbbddaabaaaaabddadddbc	FALSE
baaaacaaaddcdbaddcbdddddadbaadcccdcbcccaaaa	FALSE
bacdbadaccbacbdbaaaaccadaacdaaadbdaaaabaab	FALSE
bbbbbadbbabddcbdcabcadbacaaaaaadbdccdddcbbb	FALSE
bcaaaaaabbcbcabaddbacdcaaddbdccadcbdaaccdc	FALSE
bcccabddadaabbddbcdcaccbbadcbbdaaaabaaabdca	FALSE
bdbbdcadcdabbadbaaaabaadccbdddccabdddabbab	FALSE
caaaaadaacdaaaadaaaabdcbaabbaadcaaabbdcabbb	FALSE
cadbaaaaaadaccacaacacadcadbbabbccdaaddcaa	FALSE
cbbcacbddcadaaaaaabbcdbdbdbadbdbcbadccdadb	FALSE
ccaaaacaaaadbcaaaacbaaccdaccbcdbadcaacccdab	FALSE
cccdcdbbccccddabaddbcbbcddadcccaaaaaadacddd	FALSE
cdbaadbdabaaaaaacdcaadddcdcbdadabcbacbddcdd	FALSE
daaaaadaaabadbbccbbdbdcbdcdddbdabbdaabdabda	FALSE
dacbdddadaaadaaaadbacbdcbadcbccbdbadaddcccd	FALSE
dbaddbdbdcdbcacdccaaadaaaadbbbaaaaccacadcba	FALSE
dbdcccaaabbddbaaaadcbcbbaadaaaabaabbacbdab	FALSE
dccaccdabadabccdcbbdddbcaabcbaacacdaaaaaab	FALSE
ddadaabaaaaaabaccadbdccbbdbbabbbccbdacdcaca	FALSE
aaaaaaaaabdadbddbcdddddacacdddcbcbccddcccdd	TRUE
aaabbccbaaaaaaabacbdadbbdabadbadcdcccdcddca	TRUE
aadcababcccacaacbaaaaaaacabdababcdcbaddadbb	TRUE
abcabbbaccbdcadaddbcbddcacdcbabcbaaaaaaaadd	TRUE
acacdadccdcbbcaadbdbcabdbcaaaaaaaadbcdadaba	TRUE
acdbbcbcbccccbadcbaacdadcaaaaaaacaccccdcdda	TRUE
adcaabdaddccdbccdccbabbaaaaaaacbcacaddcbdac	TRUE
baaacddabdccdadacdaddacbdaaaaaaabadacddabdb	TRUE
bacdaaaaaaabcbdbaabdacacacddbccdccacadadcaa	TRUE
bbbbdadaabcddcbdabacaccbadcbccdbcaaaaaaacbb	TRUE
bcaabcacbcaddcabddabcabccdddcbaaaaaaaddbbac	TRUE
bccdaaaaaaaadccdddadddbdadcccbbcabdbbddcaac	TRUE
bdbbcabdaaccdcdbbdddccdcaccbddaacccdaaaaaaa	TRUE
caaaaaaacdcaaccdadcadcaddbbcddaaacdcdaaaadd	TRUE
cacbcccddddaddaacabdaaaaaaadabcdadbdcabcbba	TRUE
cbbaadbcdbadcacbadbdcbaaaaaaaabccabddcccadb	TRUE
ccaaaaaaaccdbddadcaccddacdacdbcacbcbcaacabd	TRUE
ccdadbdabcbbbacdbdbcaababcaaaaaaadcdddcdddb	TRUE
cdbdbbcddbcbbbacadabbabcaaaaaaaddbcddacadab	TRUE
daaaaaaacaaaccdcbbbadbcbcbacdacdbdbaccdcddb	TRUE
dacacbaaacbacbbdccccaaaaaaadbaaaccbdacccbca	TRUE
dbaddacccdbbcbcbcddadaaaaaaadbdbabaaabcbbbb	TRUE
dbdcbdbcdaabaaccaaaaaaabdcacbacacbadaaccbbd	TRUE
dccbcbddbbcaaaaaaaddabcabacdbaadaccaadbcaaa	TRUE
ddbbdcdcabbbbdcbacbaccdbbbdaccbddabdaaaaaaa	TRUE
aaaaaadaaabdadbddbcdddddacacdddcbcbccddcccdd	FALSE
aaabbccbaaaaaabacbdadbbdabadbadcdcccdcddca	FALSE
aadcababcccacaacbaaaaaadcabdababcdcbaddadbb	FALSE
abcabbbaccbdcadaddbcbddcacdcbabcbaaaadaaaadd	FALSE
acacdadccdcbbcaadbdbcabdbcaabaaaaadbcdadaba	FALSE
acdbbcbcbccccbadcbaacdadcbaaaaaacaccccdcdda	FALSE
adcaabdaddccdbccdccbabbaacaaaacbcacaddcbdac	FALSE
baaacddabdccdadacdaddacbddaaaaaabadacddabdb	FALSE
bacdaaacaaaabcbdbaabdacacacddbccdccacadadcaa	FALSE
bbbbdadaabcddcbdabacaccbadcbccdbcbaaaaaacbb	FALSE
bcaabcacbcaddcabddabcabccdddcbaaaaaaddbbac	FALSE
bccdaaacaaaadccdddadddbdadcccbbcabdbbddcaac	FALSE
bdbbcabdaaccdcdbbdddccdcaccbddaacccdaaaaadaa	FALSE
caaaaabaacdcaaccdadcadcaddbbcddaaacdcdaaaadd	FALSE
cacbcccddddaddaacabddaaaaaadabcdadbdcabcbba	FALSE
cbbaadbcdbadcacbadbdcbaaadaaaabccabddcccadb	FALSE
ccaaaaaacccdbddadcaccddacdacdbcacbcbcaacabd	FALSE
ccdadbdabcbbbacdbdbcaababcaaaaaadcdddcdddb	FALSE
cdbdbbcddbcbbbacadabbabcaaaaaacaddbcddacadab	FALSE
daaaaaabcaaaccdcbbbadbcbcbacdacdbdbaccdcddb	FALSE
dacacbaaacbacbbdccccaaaaacadbaaaccbdacccbca	FALSE
dbaddacccdbbcbcbcddadadaaaaadbdbabaaabcbbbb	FALSE
dbdcbdbcdaabaaccaaaaaacbdcacbacacbadaaccbbd	FALSE
dccbcbddbbcaaaacaaaddabcabacdbaadaccaadbcaaa	FALSE
ddbbdcdcabbbbdcbacbaccdbbbdaccbddabdaadaaaaa	FALSE
aaaaaaaaabbcddcabcbbdccaabacadaaadabcbdabdad	TRUE
aaabcbbcacadabaadbdaaaddabdaaaaaaaaaacdadacb	TRUE
aadaacaccdaacddabbdcbcdaaaaaaadaadcbabbabcca	TRUE
abbdccccaaabdaabcbabcccbdbdddcaaaaaaadccdcda	TRUE
acacaaaaaaabbcaadcacacadabbdabcbaadbaadbadbc	TRUE
accdcabcbbcdaaccbbdcdaaaaaaabcabbbdddaaacaca	TRUE
adbbdcaaaaaaabbbacbbacdbadaacababadcacbdbddd	TRUE
baaaaaaaabcbbbabccaaabaddaaaaaaccabdbdabadad	TRUE
bacacddcbcabdadacaacaaaaaaadccdcccbaddbcddab	TRUE
bbadddddbadccbbcbaaaaaaabcaadddbacacdadbacca	TRUE
bbdddccdddabbbbdcadbbbccaaaaaaabbdacabcbdbdc	TRUE
bccddaccdcaaaaaaadcbabbaddbbbbcadcabcbdbbbaa	TRUE
bdbbdbbabbcdcdaabbddadaccbcbaaaaaaaccdaadddb	TRUE
caaacaaddbadbdaaaaaaacbabcacacadacaacbddaabc	TRUE
cadbabaadcdbaacabddacbccabacaaaaaaaadcdbdcdd	TRUE
cbbdbbaddbbcdbacdadaacaaaaaaabbcbccaccdadbba	TRUE
ccacabcbcddbdabaddbaaddddcbaaaaaaaadbbbcdacc	TRUE
ccdbabdaacadbccddbcddaaaaaaaaaadbacdbcbdddda	TRUE
cdbddaaabdabbccddbabcbbbbbacdbcaaaaaaadabcbb	TRUE
daaaaddaaaaaaaadaabcaadadaddaabaacacccdbcaba	TRUE
dacccccababcaaacbccaabbcdaacbcaaaaaaaaddbbbd	TRUE
dbbbcaacaddbaddaadccdccccdabcabdcbcaaaaaaada	TRUE
dcaaaaaaaccbbbcabdcabcdbddbaddcbdbcaddbacbca	TRUE
dccbbabbadbabcbcaaaaaaabbbaacacdcbcaaabdacdb	TRUE
ddbaaabccbbdbcbbcddabaacdaaaaaaabacbabadcada	TRUE
aaaabaaaabbcddcabcbbdccaabacadaaadabcbdabdad	FALSE
aaabcbbcacadabaadbdaaaddabdaaaaaadaaacdadacb	FALSE
aadaacaccdaacddabbdcbcdaaaacaadaadcbabbabcca	FALSE
abbdccccaaabdaabcbabcccbdbdddcaabaaaadccdcda	FALSE
acacaaaacaaabbcaadcacacadabbdabcbaadbaadbadbc	FALSE
accdcabcbbcdaaccbbdcdaaaabaaabcabbbdddaaacaca	FALSE
adbbdcaaacaaabbbacbbacdbadaacababadcacbdbddd	FALSE
baaaabaaaabcbbbabccaaabaddaaaaaaccabdbdabadad	FALSE
bacacddcbcabdadacaaccaaaaaadccdcccbaddbcddab	FALSE
bbadddddbadccbbcbaaaabaabcaadddbacacdadbacca	FALSE
bbdddccdddabbbbdcadbbbccaaaaaabbbdacabcbdbdc	FALSE
bccddaccdcaadaaaadcbabbaddbbbbcadcabcbdbbbaa	FALSE
bdbbdbbabbcdcdaabbddadaccbcbaacaaaaccdaadddb	FALSE
caaacaaddbadbdaaaaabaacbabcacacadacaacbddaabc	FALSE
cadbabaadcdbaacabddacbccabacaacaaaaadcdbdcdd	FALSE
cbbdbbaddbbcdbacdadaacaaaaaabbcbccaccdadbba	FALSE
ccacabcbcddbdabaddbaaddddcbaaaaacaadbbbcdacc	FALSE
ccdbabdaacadbccddbcddaaaaacaaaaadbacdbcbdddda	FALSE
cdbddaaabdabbccddbabcbbbbbacdbcaaaaaabdabcbb	FALSE
daaaaddaaaaaabaadaabcaadadaddaabaacacccdbcaba	FALSE
dacccccababcaaacbccaabbcdaacbcaaaaacaaaddbbbd	FALSE
dbbbcaacaddbaddaadccdccccdabcabdcbcaadaaaada	FALSE
dcadaaaaaaccbbbcabdcabcdbddbaddcbdbcaddbacbca	FALSE
dccbbabbadbabcbcaaaaaacabbbaacacdcbcaaabdacdb	FALSE
ddbaaabccbbdbcbbcddabaacdaaaacaaabacbabadcada	FALSE
aaaaaaaaaacbbdbdaadcabacdacbbbcdccdbaaadddadd	TRUE
aaacaadadcacdddbaaaaaaadcbaccccdcdccaadccdaca	TRUE
aadbdbdbbaaaaaaacbccbdaabaaacdaddbcbaaadcdbdd	TRUE
abcbdaabdbcdaabaaaaaaacbdbddabaaddbdbdabbcdba	TRUE
acbbaacdcbcdddbbacabcaaaaaaabbadacbaddcabccbd	TRUE
acdddbddbadbdddbaaaaaaabcddccadacacbddabddcba	TRUE
adcbaaabdccabacabbaabcbccdadbddaadaaaaaaacdab	TRUE
baabddaabdabddbcbdddbdadbadaaccacbdadaaaaaaad	TRUE
badbbaaddccadcbabaaaacccbbadbcbadabdaaaaaaaad	TRUE
bbbddacacdbdcdabbcbaacaaabcbaaaaaaabbadccacac	TRUE
bcacbcacabcadaaaccdddaaaaaaacacbadbbabcaaacbc	TRUE
bcddcaccadddbbadbaaaaaaabcbbcbababbdddaaccaca	TRUE
bdccccbaaaaaaacabbcbdbcdaabbaadbcaadcacdbdbaa	TRUE
caabbcbaaddaddbdbadacbadbaaaaaaaadcabcacbacba	TRUE
caccccdbddbaddccaaadcaaaaaaabcacdcadbadcacdcb	TRUE
cbbaaaaaaacdadabbbddcddacdcdcdbcddbdaaaccdabc	TRUE
ccabbaadcdaddacbdbddccbaaaaaaabdabcddccdcdaac	TRUE
ccdacbcaddddacbbcaacdabccdadbdcbaaaaaaacbcabd	TRUE
cdcabbbaacccabadcacaacadcabbbaaaaaaacbbacdcda	TRUE
daaaadbaaabbaaaaaaaabbdbaaabaaadbadbabadcbadc	TRUE
daccabcaabbbdbbcbbbaaaaaaaadabcdbdbcdddadddcd	TRUE
dbbadbdbaccaaaaaaabcacdacbbbadbbbadbbdccdacab	TRUE
dcaaaaaaabaaadbccbaaabaadbbcbaddbcbacaddccaad	TRUE
dccdcccbaaaaaaaddddbbacddcacacdcdbababbdcdccb	TRUE
ddbcaadccababddbbdbbaadbdaaaaaaabcdbadbcdaaac	TRUE
aaadaaaaaacbbdbdaadcabacdacbbbcdccdbaaadddadd	FALSE
aaacaadadcacdddbaacaaaadcbaccccdcdccaadccdaca	FALSE
aadbdbdbbaaabaaacbccbdaabaaacdaddbcbaaadcdbdd	FALSE
abcbdaabdbcdaabaaaaaacbdbddabaaddbdbdabbcdba	FALSE
acbbaacdcbcdddbbacabcaaaabaaabbadacbaddcabccbd	FALSE
acdddbddbadbdddbaaaacaaabcddccadacacbddabddcba	FALSE
adcbaaabdccabacabbaabcbccdadbddaadaacaaaaacdab	FALSE
baabddaabdabddbcbdddbdadbadaaccacbdadaaaaaacad	FALSE
badbbaaddccadcbabaaaacccbbadbcbadabdaaaabaaaad	FALSE
bbbddacacdbdcdabbcbaacaaabcbaaabaaaabbadccacac	FALSE
bcacbcacabcadaaaccdddaaaaaacacbadbbabcaaacbc	FALSE
bcddcaccadddbbadbaaaaaabcbbcbababbdddaaccaca	FALSE
bdccccbaacaaaacabbcbdbcdaabbaadbcaadcacdbdbaa	FALSE
caabbcbaaddaddbdbadacbadbaaadaaaaadcabcacbacba	FALSE
caccccdbddbaddccaaadcaaabaaabcacdcadbadcacdcb	FALSE
cbbaaaaaabcdadabbbddcddacdcdcdbcddbdaaaccdabc	FALSE
ccabbaadcdaddacbdbddccbadaaaaaabdabcddccdcdaac	FALSE
ccdacbcaddddacbbcaacdabccdadbdcbaaaabaacbcabd	FALSE
cdcabbbaacccabadcacaacadcabbbaaaaaacbbacdcda	FALSE
daaaadbaaabbaadaaaaabbdbaaabaaadbadbabadcbadc	FALSE
daccabcaabbbdbbcbbbaaaaabaaadabcdbdbcdddadddcd	FALSE
dbbadbdbaccaabaaaaabcacdacbbbadbbbadbbdccdacab	FALSE
dcaaaaaabaaadbccbaaabaadbbcbaddbcbacaddccaad	FALSE
dccdcccbacaaaaaaddddbbacddcacacdcdbababbdcdccb	FALSE
ddbcaadccababddbbdbbaadbdaaabaaabcdbadbcdaaac	FALSE
aaaaaaaaabcabbaddbcbabcddabdaaccbccabbbdbbccbc	TRUE
aaabbdadbcbcadddaaaaaaaacacbcdaadbadbbcdcbcaad	TRUE
aadacbbbacbcdbcaaaaaaadacabcdaaacbcccbadbdcdcd	TRUE
abcacbdaacdcaadccbacbaaaaaaababccccddacccdcdaa	TRUE
acacdbdcdbacccddaccbdacbccaaabccbcccdbaaaaaaac	TRUE
acdabdbdcbdcdbbabacaaaaaaabbacaccaadcccbcccbac	TRUE
adbcddaaaaaaacdcaaabacdcdbbbaddcaaadbcdddddbca	TRUE
addddacbbbbccbddacbbdbcadcaccbbacdcdbdaaaaaaaa	TRUE
babdccadbccbbdbaadadcdbaaaaaaacbbcaaababaccbad	TRUE
bbabbdddbbbaadaadcbbbacaabcbbcaaaaaaacdbaccada	TRUE
bbdadcaacabaaaaaaabdaaadaaabacbcdabcbbdacdbaad	TRUE
bcbdbacacbcdadccacccacccdcddcdabcaaaaaaaaabdcc	TRUE
bdaddddccabacabaaaaaaadacdcccbabcaaabcccacdbdb	TRUE
bddcaabdddabcbbcaddbcbaaaadcdbcbdcaaaaaaaacdcb	TRUE
caccbadcadcaaaaaaabcccdaccddcccbcabcccbbdcdccc	TRUE
cbbccaadadacdababbbacaaadaabdaaaaaaadbadbccaca	TRUE
cbddddaccbcdcacdcdbbcaaaacbcdddadaaaaaaaccccca	TRUE
ccccdcdcdcaaaaaaaaddadabaacbdcacccbdcccadacbcc	TRUE
cdbbdaaabdddaabdaaaaaaacccaaccadcabbddcadbbaca	TRUE
daaabbcabbabacdcaaaaaaaabcdcaccacbccccbbddccda	TRUE
daccddcbdaacaaccccdbbacbcaaaaaaaaabacddabcbbcc	TRUE
dbbbdacdadacdbaccbdddaaaaaaacadaddcaabcbdabccd	TRUE
dcaaaaaaadbdccdcdbdadaabdaddddbcddbdcaddddcbbd	TRUE
dccddcdabcacabcccaaaaaaaacbddbbddbbadbcdbabbab	TRUE
ddbcdbbdaaaaaaacbdadabcbbcdbaabaaddddadbbbccab	TRUE
aaacaaaaabcabbaddbcbabcddabdaaccbccabbbdbbccbc	FALSE
aaabbdadbcbcadddaaadaaaacacbcdaadbadbbcdcbcaad	FALSE
aadacbbbacbcdbcaaaadaaadacabcdaaacbcccbadbdcdcd	FALSE
abcacbdaacdcaadccbacbaaaaaababccccddacccdcdaa	FALSE
acacdbdcdbacccddaccbdacbccaaabccbcccdbaabaaaaac	FALSE
acdabdbdcbdcdbbabacaaacaaaabbacaccaadcccbcccbac	FALSE
adbcddaaaaaacdcaaabacdcdbbbaddcaaadbcdddddbca	FALSE
addddacbbbbccbddacbbdbcadcaccbbacdcdbdaaaadaaa	FALSE
babdccadbccbbdbaadadcdbacaaaaacbbcaaababaccbad	FALSE
bbabbdddbbbaadaadcbbbacaabcbbcacaaaaaacdbaccada	FALSE
bbdadcaacabadaaaaabdaaadaaabacbcdabcbbdacdbaad	FALSE
bcbdbacacbcdadccacccacccdcddcdabcaadaaaaaabdcc	FALSE
bdaddddccabacabaacaaaaadacdcccbabcaaabcccacdbdb	FALSE
bddcaabdddabcbbcaddbcbaaaadcdbcbdcaadaaaaacdcb	FALSE
caccbadcadcaaadaaabcccdaccddcccbcabcccbbdcdccc	FALSE
cbbccaadadacdababbbacaaadaabdaaaaaadbadbccaca	FALSE
cbddddaccbcdcacdcdbbcaaaacbcdddadaaaaaacccccca	FALSE
ccccdcdcdcaaaaaadaddadabaacbdcacccbdcccadacbcc	FALSE
cdbbdaaabdddaabdaaaaaacccaaccadcabbddcadbbaca	FALSE
daaabbcabbabacdcaaaaaadaabcdcaccacbccccbbddccda	FALSE
daccddcbdaacaaccccdbbacbcaaaabaaaabacddabcbbcc	FALSE
dbbbdacdadacdbaccbdddaaaaaacadaddcaabcbdabccd	FALSE
dcaaaaaabadbdccdcdbdadaabdaddddbcddbdcaddddcbbd	FALSE
dccddcdabcacabcccaabaaaaacbddbbddbbadbcdbabbab	FALSE
ddbcdbbdaaabaaaacbdadabcbbcdbaabaaddddadbbbccab	FALSE
aaaaaaaaabbbdacccbbcccadaabaadbbcacbbccdcdccbcc	TRUE
aaacaaabdaaaaaaadcbbdddabddddadbaacbbcccddaabda	TRUE
aadcbdddcbddddbbcaaaaaaadcbddccadbdcccbcbaccdcc	TRUE
abcabbaadcbaadaacdcadbbdcdadbaaacabdabaaaaaaaab	TRUE
acadbcbcbbbaaaaaaadbabddaaacbbddbdddddacbddbaab	TRUE
acdbdbcbcbcddcacaaabbdccaadbcadaaaaaaaadcdbcbaa	TRUE
adcaaaaaabaaaaaacadacbbdaddccdcacbabdbbaabbaadd	TRUE
baacaaddabccacadabbaccbcbbadadcbcdcaaaaaaaccdbc	TRUE
badbbaadbcadbaaababdbaccddbbaccbadbaaddcaaaaaaa	TRUE
bbbcbaaccbdadcaaaaaaaabadcdbbbdaddcaabbcabababd	TRUE
bcaaaaaaadbdbcabacdbcccaccdddadbccbbddbcacddddd	TRUE
bcdaaccacdbcccdbbacaaaaaadcaaaaaacabccdbcdbdbbc	TRUE
bdbcbcbdddbbaaaaacaaccbdbabbacdaaaaaaabccddaaac	TRUE
caaaaaaadcdcddcacccaacaaccbcbbdbcddadcdcdcbdbdc	TRUE
caccccbbbdccaaaaaaadadcdacbbcdcabccaacaaaabccdd	TRUE
cbbbbaababbabcabcdaadbddccdddaaaccaaaaaaabcaacd	TRUE
ccaaaaaaaaaabdddccdaddadcdbccbaaabaabbddaadabcb	TRUE
cccdbaabcccbbbcacadabbbdaadabbbacdcbdbbbaaaaaaa	TRUE
cdbbdacdcdacdbaabcccdbabdaaaaaaabddbabaacbdbbbd	TRUE
daaaaaaabcddbdadbdacabadbbdcaadaddcadcbbbbbbbcc	TRUE
dacbddcacaddcbbdbdbbdadccabaaddaaaaaaaddabdbadc	TRUE
dbaccbbddccacbbccdddcccbbdaaaaaaaddddbacadaabbc	TRUE
dbdacbccaaaaaaaccbdccdbabddcbbaabbaabacccccaddd	TRUE
dcbccbaaddcbbbbcaabbabdadbbdbbddacddbdacaaaaaaa	TRUE
ddacdcccbdadcddddabdbbcadabaaaaaaaabcabcacddbac	TRUE
aaaadaaaaabbbdacccbbcccadaabaadbbcacbbccdcdccbcc	FALSE
aaacaaabdaaaaaadcbbdddabddddadbaacbbcccddaabda	FALSE
aadcbdddcbddddbbcacaaaaadcbddccadbdcccbcbaccdcc	FALSE
abcabbaadcbaadaacdcadbbdcdadbaaacabdabaaabaaaab	FALSE
acadbcbcbbbaaabaaaadbabddaaacbbddbdddddacbddbaab	FALSE
acdbdbcbcbcddcacaaabbdccaadbcadaaaaaacadcdbcbaa	FALSE
adcaaaaaabaaadaaacadacbbdaddccdcacbabdbbaabbaadd	FALSE
baacaaddabccacadabbaccbcbbadadcbcdcaaaaaabccdbc	FALSE
badbbaadbcadbaaababdbaccddbbaccbadbaaddcaaacaaaa	FALSE
bbbcbaaccbdadcaaaaaadabadcdbbbdaddcaabbcabababd	FALSE
bcaaaacaadbdbcabacdbcccaccdddadbccbbddbcacddddd	FALSE
bcdaaccacdbcccdbbacaaaaaadcabaaaacabccdbcdbdbbc	FALSE
bdbcbcbdddbbaaaaacaaccbdbabbacdaaaadaabccddaaac	FALSE
cabaaaaadcdcddcacccaacaaccbcbbdbcddadcdcdcbdbdc	FALSE
caccccbbbdccaaaaadadadcdacbbcdcabccaacaaaabccdd	FALSE
cbbbbaababbabcabcdaadbddccdddaaaccaadaaaabcaacd	FALSE
ccaaaaaadaaabdddccdaddadcdbccbaaabaabbddaadabcb	FALSE
cccdbaabcccbbbcacadabbbdaadabbbacdcbdbbbacaaaaa	FALSE
cdbbdacdcdacdbaabcccdbabdaaaabaaabddbabaacbdbbbd	FALSE
daaabaaaabcddbdadbdacabadbbdcaadaddcadcbbbbbbbcc	FALSE
dacbddcacaddcbbdbdbbdadccabaaddaaaaaaddabdbadc	FALSE
dbaccbbddccacbbccdddcccbbdaaaaaaddddbacadaabbc	FALSE
dbdacbccbaaaaaaccbdccdbabddcbbaabbaabacccccaddd	FALSE
dcbccbaaddcbbbbcaabbabdadbbdbbddacddbdacabaaaaaa	FALSE
ddacdcccbdadcddddabdbbcadabaabaaaaabcabcacddbac	FALSE
aaaaaaaaadddccbadddcacacbccdbabdabccdcbabbadddbd	TRUE
aabbabbbbbdbbcccdccbabaaaaaaabddcdabccabaaabbbca	TRUE
abaadbddcbcbaccdaaaaaaadbccbadbccaccbccdaaccaadb	TRUE
abdbaadadaabbcbcbaabdddbdadbcbacaddbbadaaaaaaaab	TRUE
acbcadabdaaaccdccdcbccdcdacdbacdadaaaaaaaaabbdbb	TRUE
adacaaacbadacbbabdbcabcaaaaaaabdadaacddcbddddbac	TRUE
addbdcadadddbccaaaaaaabccbcabadcbdacbbcdcccddaca	TRUE
babccdcdbacaacaddabaaaaaaacdabbbbdaaccadcadbbccd	TRUE
bbaadabbddcacaaaaaaacdcdbadbcdbcdabcaacaddbbabcd	TRUE
bbccdbdbbbaaabdaccdaaaaaaabdaababdcddabcbcaadbcd	TRUE
bcbbcadababcbcaadddbcdbccbcbddbcbbddcaaaaaaadbbb	TRUE
bcddacbabddbdddbdbacdcdaaaaaaabbdabdabcaacdadadc	TRUE
bdcabccddcdbbacaacadbdccdaaaaaaaabcabdaaacdabcca	TRUE
caabccdbcaaaabdbadbdabdbdcdabbbababdbaadaaaaaaaa	TRUE
cacddcbddccbddcddbbadcdaaaaaaaddabccacaaadccaddd	TRUE
cbbadbbddcccabbcadccdbcdddaaaaaaadccbaddabddbaac	TRUE
ccaacddaaaaaaacbcbacbdadddcbbadbacdcadaaacbadacc	TRUE
ccccddccabaacaaadcdcdcdaaaaaaabdaaacbcddbbacdbaa	TRUE
cdbbaaaaaaadddcacdacaadcacabaadbcbdcbcdaaaadabbb	TRUE
daaaaaaaabacbdbcbabdddbdcdbcabbbdaabbdcabcdbbcbd	TRUE
dacdaaaaaaadddcdcdacdbdddddddbabcddbbdcbcaadaccc	TRUE
dbbbbccaacccacaabaabbadacbbdadcaaaaaaabdccaccdbc	TRUE
dbdccdcbabbcacdcddaaaaaaabccdcdabbccbbddbabdbadb	TRUE
dccbdbdcdcadcbddaddcabdccddacaccdbaddcdadaaaaaaa	TRUE
ddbabccbcddcdbdddbdabdbaaabdaaaaaaaccbababcacdad	TRUE
aaaacaaaadddccbadddcacacbccdbabdabccdcbabbadddbd	FALSE
aabbabbbbbdbbcccdccbabaaacaaabddcdabccabaaabbbca	FALSE
abaadbddcbcbaccdacaaaaadbccbadbccaccbccdaaccaadb	FALSE
abdbaadadaabbcbcbaabdddbdadbcbacaddbbadaaaaaacaab	FALSE
acbcadabdaaaccdccdcbccdcdacdbacdadaadaaaaaabbdbb	FALSE
adacaaacbadacbbabdbcabcaaaabaaabdadaacddcbddddbac	FALSE
addbdcadadddbccaaaaacabccbcabadcbdacbbcdcccddaca	FALSE
babccdcdbacaacaddabaaaaacacdabbbbdaaccadcadbbccd	FALSE
bbaadabbddcaccaaaaaacdcdbadbcdbcdabcaacaddbbabcd	FALSE
bbccdbdbbbaaabdaccdaaaadaaabdaababdcddabcbcaadbcd	FALSE
bcbbcadababcbcaadddbcdbccbcbddbcbbddcaaabaaaadbbb	FALSE
bcddacbabddbdddbdbacdcdacaaaaabbdabdabcaacdadadc	FALSE
bdcabccddcdbbacaacadbdccdaaaabaaaabcabdaaacdabcca	FALSE
caabccdbcaaaabdbadbdabdbdcdabbbababdbaadaaaaaacaa	FALSE
cacddcbddccbddcddbbadcdaadaaaaaddabccacaaadccaddd	FALSE
cbbadbbddcccabbcadccdbcdddadaaaaadccbaddabddbaac	FALSE
ccaacddaaaaacacbcbacbdadddcbbadbacdcadaaacbadacc	FALSE
ccccddccabaacaaadcdcdcdaaaadaaabdaaacbcddbbacdbaa	FALSE
cdbbaaaaacadddcacdacaadcacabaadbcbdcbcdaaaadabbb	FALSE
daaaaaabaabacbdbcbabdddbdcdbcabbbdaabbdcabcdbbcbd	FALSE
dacdacaaaaadddcdcdacdbdddddddbabcddbbdcbcaadaccc	FALSE
dbbbbccaacccacaabaabbadacbbdadcaaaaaabdccaccdbc	FALSE
dbdccdcbabbcacdcddaaaaacaabccdcdabbccbbddbabdbadb	FALSE
dccbdbdcdcadcbddaddcabdccddacaccdbaddcdadaaacaaaa	FALSE
ddbabccbcddcdbdddbdabdbaaabdadaaaaaccbababcacdad	FALSE
aaaaaaaaaabdabcccbdcacacabcbbccdcdddcbbabadaadaba	TRUE
aaacbcbccbabccccddbcadaaaaaaaccbcbadbcdaacacbdcda	TRUE
aadcaaaaaabaabaaaaaadcadcddabcacdacaaadcadbdaaddc	TRUE
abbdacdbabcdabacadcdcaabccbbcbcccddaaaaaaadacddcd	TRUE
acacbabadbbcabcdacdbaadaaaaaaadbdcaacbdaadddadacd	TRUE
acdbbcaaaaaaacccbbdcaaddadcddbbccbdcacbccdccdadbb	TRUE
adcacbcbcddddabcaaaaaaaddadccbaabcdbdacddddaabdbd	TRUE
baacabdbacbaaaaaaaccccdcdcbacccdbbdadddcdabcdcada	TRUE
badbcdaccdbabaddaadcbcdcacdcbcaaaaaaabaacbbacbacb	TRUE
bbcbdcdacaccaaaaaaabaabccccdcbbaadddaaddbabdcdcda	TRUE
bcbbbadbcaaaaaaabccbbbcdbbdbcaaaaacaccbcacbdcbacd	TRUE
bdaaaaaaaddaaccaabcabaadbaaacbaabcdabaabddddbbddb	TRUE
bdcccbccbddcddcbacadddbcacbcdccdbcbcaaaaaaaddcdaa	TRUE
cabaaaaaaabdbdbabaabaabbcacdcdbbbadbbabacdabbacaa	TRUE
caddbbacadcddaccaccacaddcbcabaaaaaaadbdbdbcddbdad	TRUE
cbbdbcacdbdcdcadddddccdadbdbabbaaaaaaaabcdcaddabc	TRUE
ccabcaaaaadbaddbddaaaaaaaacdacbdcabaddcababbdcbba	TRUE
ccdcabbadbaaaaaaadcaaabdbcabbbcddddaadbacaabcbcbd	TRUE
cdcbbaaaaaaaccacaddbcdcdbcccaaadaaddcdbdbbdacbada	TRUE
daabaaccaaadcdcccaabcaadacbbdcbbbaccdbacaaaaaaadd	TRUE
dacdacaacbaddcbadcbdaccaaaaaaacadccdadddcbabdacba	TRUE
dbbadbaaaaaaadcdadccabadadcaccaabaccdcadddbcdcdcc	TRUE
dcaadccccccaabcbaaaaaaacccadbcccacdaadbdcdaaacbcb	TRUE
dccdabdbadbcbbbacadbcdacbaccbaadcbadbcdbbbaaaaaaa	TRUE
ddbadabcabdbdcdcccaabcbabcbdaaabaaaaaaadbdbaccadb	TRUE
aaaaabaaaaabdabcccbdcacacabcbbccdcdddcbbabadaadaba	FALSE
aaacbcbccbabccccddbcadaaaaaaccbcbadbcdaacacbdcda	FALSE
aadcaaaaaabaabaaacaaadcadcddabcacdacaaadcadbdaaddc	FALSE
abbdacdbabcdabacadcdcaabccbbcbcccddaaaaaadacddcd	FALSE
acacbabadbbcabcdacdbaadbaaaaaadbdcaacbdaadddadacd	FALSE
acdbbcabaaaaaacccbbdcaaddadcddbbccbdcacbccdccdadbb	FALSE
adcacbcbcddddabcaacaaaaddadccbaabcdbdacddddaabdbd	FALSE
baacabdbacbaaaaaaccccdcdcbacccdbbdadddcdabcdcada	FALSE
badbcdaccdbabaddaadcbcdcacdcbcaaabaaabaacbbacbacb	FALSE
bbcbdcdacaccaaabaaabaabccccdcbbaadddaaddbabdcdcda	FALSE
bcbbbadbcaaaabaabccbbbcdbbdbcaaaaacaccbcacbdcbacd	FALSE
bdaacaaaaddaaccaabcabaadbaaacbaabcdabaabddddbbddb	FALSE
bdcccbccbddcddcbacadddbcacbcdccdbcbcacaaaaaddcdaa	FALSE
cabaaaaaabdbdbabaabaabbcacdcdbbbadbbabacdabbacaa	FALSE
caddbbacadcddaccaccacaddcbcabadaaaaadbdbdbcddbdad	FALSE
cbbdbcacdbdcdcadddddccdadbdbabbaaacaaaaabcdcaddabc	FALSE
ccabcaaaaadbaddbddaaaabaaacdacbdcabaddcababbdcbba	FALSE
ccdcabbadbaaacaaadcaaabdbcabbbcddddaadbacaabcbcbd	FALSE
cdcbbaaadaaaccacaddbcdcdbcccaaadaaddcdbdbbdacbada	FALSE
daabaaccaaadcdcccaabcaadacbbdcbbbaccdbacaaaaadaadd	FALSE
dacdacaacbaddcbadcbdaccaaaaaacadccdadddcbabdacba	FALSE
dbbadbadaaaaaadcdadccabadadcaccaabaccdcadddbcdcdcc	FALSE
dcaadccccccaabcbaaaabaaacccadbcccacdaadbdcdaaacbcb	FALSE
dccdabdbadbcbbbacadbcdacbaccbaadcbadbcdbbbaacaaaa	FALSE
ddbadabcabdbdcdcccaabcbabcbdaaabaaaaaabadbdbaccadb	FALSE
aaaaaaaaaacddcdacbcadbaaccbaacbcbabbacadbacbadcbdb	TRUE
aaadadabbccdaccdddcbdadbbcbbbacbbabaadbdaaaaaaadaa	TRUE
aadbbaaaaaaaacadbaaaaadaadccddbaabadaadbbcadccdddd	TRUE
abcabaabbbacddcdbbdbdbbdcabacaadabddaddaaaaaaabbda	TRUE
acadbacddddbabdbaddcbcbacdadaddabbcaaaaaaabddccddc	TRUE
acddccbabaabbaaaadaaaaaaadbbacaddbcdbadaaaababddac	TRUE
adcdadbababacddcddacaddbbdccacaaaaaaadcbccdcadacba	TRUE
babaabaaaaaaabacdbbcbbcbaaadaabbdcaccbdacbdacdaaaa	TRUE
bbaaabcbdbccaccbddaadadcadcbdbbbddbbaabcabdaaaaaaa	TRUE
bbcdcbdbbddcddbacaaaacaabbccadccadabdaccaaaaaaabdd	TRUE
bcbbddbbababcadbdccdaaaaaaaddccabdaacdbddbddbbdccb	TRUE
bdaacbbaadabcaacdaaaaaaaddbcdddbddabaabaacddbbdcba	TRUE
bdcbddcdcdbbccdbaaaaaaabcadddcddccccbdddbcccabadac	TRUE
caadbaaaaaaabdcdabbbaddcaddcccacddbdbcccddbddcbcba	TRUE
cadddbccbddaaaaaaaddaaacadcaddcbddbdadacccddbdbada	TRUE
cbcbabaaaaaaadcbdbdcbdddabdbaccdbadbcabbadacdcdadc	TRUE
ccadadcbdaacaddbbdcadbaaaaaaadacacdcabababdaabcddd	TRUE
ccdbdabbcbddaadadbbccbbbdacbbddacccdcbaddcaaaaaaac	TRUE
cdccbacdccacbcccbbcbbcbacaaaaaaacbbcdacbddcabcaccb	TRUE
daabdbccdabaaaaaaaabdabacbbaacdbbdbcbcdcaaddabdddd	TRUE
dadbdddbbdaccbdcaaaaaaababadccbbaaaadddbadcacaddbb	TRUE
dbbdcaddbaaaaaaacaaaddbddbdddcbcbaacacbdaddcabdcba	TRUE
dcabcddcddbccaacdccbdbccaaaaaaabddbbdccbccbacacaad	TRUE
dcdaaddbddcaaaaaaabaddbbbbbaacbdadcadcacbbcdacbabd	TRUE
ddbbbabcbacdccdaadaabcdccbacabbdaacabdbbbbdaaaaaaa	TRUE
aaacaaaaaacddcdacbcadbaaccbaacbcbabbacadbacbadcbdb	FALSE
aaadadabbccdaccdddcbdadbbcbbbacbbabaadbdaaaaacadaa	FALSE
aadbbaaaaaadacadbaaaaadaadccddbaabadaadbbcadccdddd	FALSE
abcabaabbbacddcdbbdbdbbdcabacaadabddaddadaaaaaabbda	FALSE
acadbacddddbabdbaddcbcbacdadaddabbcaaaaaacabddccddc	FALSE
acddccbabaabbaaaadaaacaaaadbbacaddbcdbadaaaababddac	FALSE
adcdadbababacddcddacaddbbdccacaaaaaadcbccdcadacba	FALSE
babaabaaaaaabacdbbcbbcbaaadaabbdcaccbdacbdacdaaaa	FALSE
bbaaabcbdbccaccbddaadadcadcbdbbbddbbaabcabdaaaaaab	FALSE
bbcdcbdbbddcddbacaaaacaabbccadccadabdaccaacaaaabdd	FALSE
bcbbddbbababcadbdccdacaaaaaddccabdaacdbddbddbbdccb	FALSE
bdaacbbaadabcaacdaaaabaaddbcdddbddabaabaacddbbdcba	FALSE
bdcbddcdcdbbccdbabaaaaaabcadddcddccccbdddbcccabadac	FALSE
caadbaaabaaaabdcdabbbaddcaddcccacddbdbcccddbddcbcba	FALSE
cadddbccbddcaaaaaaddaaacadcaddcbddbdadacccddbdbada	FALSE
cbcbabaaaaaabdcbdbdcbdddabdbaccdbadbcabbadacdcdadc	FALSE
ccadadcbdaacaddbbdcadbaaaaaadacacdcabababdaabcddd	FALSE
ccdbdabbcbddaadadbbccbbbdacbbddacccdcbaddcaaaaaacc	FALSE
cdccbacdccacbcccbbcbbcbacaaaaaabcbbcdacbddcabcaccb	FALSE
daabdbccdabaaaacaaaabdabacbbaacdbbdbcbcdcaaddabdddd	FALSE
dadbdddbbdaccbdcaabaaaababadccbbaaaadddbadcacaddbb	FALSE
dbbdcaddbadaaaaacaaaddbddbdddcbcbaacacbdaddcabdcba	FALSE
dcabcddcddbccaacdccbdbccaaaaababddbbdccbccbacacaad	FALSE
dcdaaddbddcaabaaaaabaddbbbbbaacbdadcadcacbbcdacbabd	FALSE
ddbbbabcbacdccdaadaabcdccbacabbdaacabdbbbbdaaaaaac	FALSE
