aaaaaaaacbaaccccbcca	FALSE
aaacbcddacbabcdcbcdb	FALSE
aaadccdbacdbaccabbcd	FALSE
aaaaddacccaccadbccbb	FALSE
aaabbadddccadcbbacca	FALSE
aaaadcbdacabdbdbaacc	FALSE
aaabdccdcdacaddcdddb	FALSE
aaacdcaadabbdbdccaba	FALSE
aaadbdcccdbcabaaccdd	FALSE
aaacbcdadabbadabadbb	FALSE
aaadcdbdddbcacbddaba	FALSE
aaaadcabbbadbadcbbba	FALSE
aaabddddcccddaabacba	FALSE
aaaabadbbdcacccadddc	FALSE
aaabaccdaacaabcbbadc	FALSE
aaaddbdcacdccadaddbd	FALSE
aaabcdccdddcdabcddcd	FALSE
aaaaacdbbdabdccbacdb	FALSE
aaacdabdddbdbadddbda	FALSE
aaadcacdaccabdbbadbb	FALSE
aaaadddabacaadccccac	FALSE
aaabdccdddcacccbbbba	FALSE
aaaacddadadbccaabbcd	FALSE
aaacdabdbadbaabaaaaa	FALSE
aaadbbbdabcabaccbdbd	FALSE
aaabcdbbdbcccccccadc	FALSE
aaaabdbaabcdbcccbddb	FALSE
aaacaaccdaabacbaacab	FALSE
aaabcadabacbbccbdbbd	FALSE
aaadacabacabcabcaddb	FALSE
aaaacadaadddcbcdccad	FALSE
aaacdcdaddcaadcdaacd	FALSE
aaadbacdaaaccbbabdad	FALSE
aaaccdaabaccdbdcaadc	FALSE
aaadbaabdbdcacabbaab	FALSE
aaacbabcbaabaadcdaac	FALSE
aaadcaabaabbbdbadaac	FALSE
aaaadcdccbabdcddcdca	FALSE
aaabbdacadcbadcdbaab	FALSE
aaaabbbbbdabdaaccbbb	FALSE
aaabcacdbaabdadddacb	FALSE
aaaacabcbbdbacbbdbdc	FALSE
aaabacaaddacbabccdbd	FALSE
aaaaaabcdaccbdcabdcb	FALSE
aaacdaddbdcabcacadcb	FALSE
aaadcdaadaaacdcddbcc	FALSE
aaaaddddcbacbbaacddc	FALSE
aaadaacdcbbadccdacbc	FALSE
aaaabaadadaaaadcdcaa	FALSE
aaabccacbdcccdaddadb	FALSE
baaaaaaaacbaaccccbcca	TRUE
baaacbcddacbabcdcbcdb	TRUE
baaadccdbacdbaccabbcd	TRUE
caaaaddacccaccadbccbb	TRUE
caaabbadddccadcbbacca	TRUE
daaaadcbdacabdbdbaacc	TRUE
daaabdccdcdacaddcdddb	TRUE
aacdcaadabbdbdccaba	TRUE
aadbdcccdbcabaaccdd	TRUE
abaacbcdadabbadabadbb	TRUE
abaadcdbdddbcacbddaba	TRUE
acaaadcabbbadbadcbbba	TRUE
acaabddddcccddaabacba	TRUE
adaaabadbbdcacccadddc	TRUE
adaabaccdaacaabcbbadc	TRUE
adaaddbdcacdccadaddbd	TRUE
aabcdccdddcdabcddcd	TRUE
aabaaacdbbdabdccbacdb	TRUE
aabacdabdddbdbadddbda	TRUE
aabadcacdaccabdbbadbb	TRUE
aacaadddabacaadccccac	TRUE
aacabdccdddcacccbbbba	TRUE
aadaacddadadbccaabbcd	TRUE
aadacdabdbadbaabaaaaa	TRUE
aadadbbbdabcabaccbdbd	TRUE
aabcdbbdbcccccccadc	TRUE
aaababdbaabcdbcccbddb	TRUE
aaacaaccdaababbaacab	TRUE
aaabcadababbbccbdbbd	TRUE
aaadababacabcabcaddb	TRUE
aabacadaadddcbcdccad	TRUE
aabcdcdaddcaadcdaacd	TRUE
aabdbacdaaaccbbabdad	TRUE
aacccdaabaccdbdcaadc	TRUE
aacdbaabdbdcacabbaab	TRUE
aadcbabcbaabaadcdaac	TRUE
aaddcaabaabbbdbadaac	TRUE
abaadcdccbabdcddcdca	TRUE
ababbdacadcbadcdbaab	TRUE
acaabbbbbdabdaaccbbb	TRUE
acabcacdbaabdadddacb	TRUE
adaacabcbbdbacbbdbdc	TRUE
adabacaaddacbabccdbd	TRUE
baaaaabcdaccbdcabdcb	TRUE
baacdaddbdcabcacadcb	TRUE
baadcdaadaaacdcddbcc	TRUE
caaaddddcbacbbaacddc	TRUE
caadaacdcbbadccdacbc	TRUE
daaabaadadaaaadcdcaa	TRUE
daabccacbdcccdaddadb	TRUE
aaaaaaddacccdaabbdadd	FALSE
aaabdaabdabdbdcddbddb	FALSE
aaacdacbdccadcaddabda	FALSE
aaabadaccccadcabcaacb	FALSE
aaadcbcbbdcaaadabbcbd	FALSE
aaaabccbdbdbbdacbdaca	FALSE
aaabcdbacbccadaaaddda	FALSE
aaacdbdadaacadaadbbbc	FALSE
aaadbbdddbdabccabccad	FALSE
aaaaadaaddbacdcbbabbc	FALSE
aaadabbbdaddcbaaacaca	FALSE
aaaccdbdbcbcdcbbabadc	FALSE
aaadaadbaaacdacbcddca	FALSE
aaacdbddaccdbaccaacdc	FALSE
aaabbccccaacaaacbcdcd	FALSE
aaacbbcbddcbcaaacbcac	FALSE
aaadaacdbccacddacddab	FALSE
aaaaaddabccabadaaaccd	FALSE
aaadaaaaadbadbacdaddb	FALSE
aaacdcdbbdbaaadabbcdc	FALSE
aaabdbacddddbaacbaadd	FALSE
aaacbadcadbdcbcaacabd	FALSE
aaaacdbdbccaccbbdcbbd	FALSE
aaadcaaddaacbdacabdcb	FALSE
aaabdadaadcccacbccdbd	FALSE
aaacadcaaaadcdcabbdad	FALSE
aaaabcbcaabaabcccacad	FALSE
aaabbabcccaaaaaabaaab	FALSE
aaadabcaabdddddbbccbb	FALSE
aaacbbaaadbdbaacabbbb	FALSE
aaaacbbdbdadbbdbaacbb	FALSE
aaaddaadcabdbddccdcbc	FALSE
aaaabbddaacaadbcdcbcc	FALSE
aaadbdacccbdbccdbcbdb	FALSE
aaaaaabdacccbcabdadbd	FALSE
aaabcbacbddbcabaccacd	FALSE
aaacbcbaadcadaadddbcd	FALSE
aaaacddcddadbcdbbbaab	FALSE
aaadddaadabdccbbccbbb	FALSE
aaaabcbdabccbdcdbacda	FALSE
aaadbdbddaddacdaaddba	FALSE
aaaaaadaaabddbcdbdddb	FALSE
aaabcbdbbcddcbcbdcbad	FALSE
aaaccaabaccbaddadcadd	FALSE
aaabdcddbabaddbbdcdca	FALSE
aaacbaadacccdcbadcaad	FALSE
aaabbbbbccddbaacabaad	FALSE
aaadcdabcaadcbdcabadb	FALSE
aaaacadaaaadbaccccddd	FALSE
aaadbbaddbdcddddadbba	FALSE
baaaaaaddacccdaabbdadd	TRUE
baaabdaabdabdbdcddbddb	TRUE
baaacdacbdccadcaddabda	TRUE
caaabadaccccadcabcaacb	TRUE
caaadcbcbbdcaaadabbcbd	TRUE
daaaabccbdbdbbdacbdaca	TRUE
daaabcdbacbccadaaaddda	TRUE
daaacdbdadaacadaadbbbc	TRUE
aadbbdddbdabccabccad	TRUE
abaaaadaaddbacdcbbabbc	TRUE
abaadabbbdaddcbaaacaca	TRUE
abaaccdbdbcbcdcbbabadc	TRUE
acaadaadbaaacdacbcddca	TRUE
acaacdbddaccdbaccaacdc	TRUE
adaabbccccaacaaacbcdcd	TRUE
adaacbbcbddcbcaaacbcac	TRUE
aadaacdbccacddacddab	TRUE
aabaaaddabccabadaaaccd	TRUE
aabadaaaaadbadbacdaddb	TRUE
aabacdcdbbdbaaadabbcdc	TRUE
aacabdbacddddbaacbaadd	TRUE
aacacbadcadbdcbcaacabd	TRUE
aadaacdbdbccaccbbdcbbd	TRUE
aadadcaaddaacbdacabdcb	TRUE
aabdadaadcccacbccdbd	TRUE
aacadcaaaadcdcabbdad	TRUE
aaaabcbcababaabcccacad	TRUE
aaabbabcccaaaaaababab	TRUE
aaadabcababdddddbbccbb	TRUE
aaacbbaaadbdbaacababbb	TRUE
aabacbbdbdadbbdbaacbb	TRUE
aabddaadcabdbddccdcbc	TRUE
aacabbddaacaadbcdcbcc	TRUE
aacdbdacccbdbccdbcbdb	TRUE
aadaaabdacccbcabdadbd	TRUE
aadbcbacbddbcabaccacd	TRUE
aadcbcbaadcadaadddbcd	TRUE
abaacddcddadbcdbbbaab	TRUE
abadddaadabdccbbccbbb	TRUE
acaabcbdabccbdcdbacda	TRUE
acadbdbddaddacdaaddba	TRUE
adaaaadaaabddbcdbdddb	TRUE
adabcbdbbcddcbcbdcbad	TRUE
adaccaabaccbaddadcadd	TRUE
baabdcddbabaddbbdcdca	TRUE
baacbaadacccdcbadcaad	TRUE
caabbbbbccddbaacabaad	TRUE
caadcdabcaadcbdcabadb	TRUE
daaacadaaaadbaccccddd	TRUE
daadbbaddbdcddddadbba	TRUE
aaaaaabaabbcadcdaddacb	FALSE
aaabcbdadbccdaddaabddc	FALSE
aaadbaaaddaacbddaccddc	FALSE
aaaadacccdabadaabbbbdb	FALSE
aaaccbccccabaddbdadadd	FALSE
aaaacbcbcbdcbcbaaaccab	FALSE
aaaccbcdbbcbcbbcbdaddb	FALSE
aaabbdabdcacadbabbddcd	FALSE
aaacddbdccbccadabbbdcb	FALSE
aaaadbcabbdadcacbaacaa	FALSE
aaacdbabdbbacddddaccca	FALSE
aaaabbcbbbdacabcdabcdc	FALSE
aaacabaaabcdadcabaadad	FALSE
aaaaaaaaadbcdbbabdadad	FALSE
aaabcccdbdadcddccbbcaa	FALSE
aaadbadcaaddaaaabccbbb	FALSE
aaabdcdadccccaacbbdbdc	FALSE
aaadcbbabcddacbddbbdaa	FALSE
aaabbbbdabbcbabaadbbda	FALSE
aaadacadadcdabdcccbcdb	FALSE
aaaadacbdadaaabcdcbabd	FALSE
aaacbbdadcacbcbbbacbac	FALSE
aaaaabadcddbbadddcdaac	FALSE
aaabdbabcbadabbbbdadcb	FALSE
aaadbdadabbddddcabdddd	FALSE
aaacbbaddcdddbcccccdba	FALSE
aaaaaaabadaadbcabbbbbb	FALSE
aaabadcadaabbbbcdcdcdc	FALSE
aaabbbabccdcaabcacbddb	FALSE
aaadaabbbbddcdacdabacc	FALSE
aaaaaadadabbdcdbcabcad	FALSE
aaacacaaddadbdbcbdbadd	FALSE
aaaddaaddaacadbcdddccd	FALSE
aaabdacdcaadabadacdbcd	FALSE
aaadbbabcbccdcabcdabcd	FALSE
aaabaaaddcabaadacbddcc	FALSE
aaacdcbbbdacdabccdaadc	FALSE
aaaacbddbadcccabbdbcba	FALSE
aaacacadabcdbaabaccbca	FALSE
aaaddbbaacadcabcabddcb	FALSE
aaabbadcbdbccbbadbaadb	FALSE
aaadabddacddacaacdbddb	FALSE
aaaaddaddcdabcdaccdacb	FALSE
aaadaabcacaacddbddcacc	FALSE
aaaadcdaddbacadbdaddcb	FALSE
aaaccbadcdddaadbcaccdc	FALSE
aaaabbcbacabdbdcdddbcd	FALSE
aaacabadabdadbdaddbddd	FALSE
aaaddbaadbdcbccadacadb	FALSE
aaabcdcbbacccdaaadddcd	FALSE
baaaaaabaabbcadcdaddacb	TRUE
baaabcbdadbccdaddaabddc	TRUE
baaadbaaaddaacbddaccddc	TRUE
caaaadacccdabadaabbbbdb	TRUE
caaaccbccccabaddbdadadd	TRUE
daaaacbcbcbdcbcbaaaccab	TRUE
daaaccbcdbbcbcbbcbdaddb	TRUE
aabbdabdcacadbabbddcd	TRUE
aacddbdccbccadabbbdcb	TRUE
abaaadbcabbdadcacbaacaa	TRUE
abaacdbabdbbacddddaccca	TRUE
acaaabbcbbbdacabcdabcdc	TRUE
acaacabaaabcdadcabaadad	TRUE
adaaaaaaaadbcdbbabdadad	TRUE
adaabcccdbdadcddccbbcaa	TRUE
adaadbadcaaddaaaabccbbb	TRUE
aabdcdadccccaacbbdbdc	TRUE
aadcbbabcddacbddbbdaa	TRUE
aababbbbdabbcbabaadbbda	TRUE
aabadacadadcdabdcccbcdb	TRUE
aacaadacbdadaaabcdcbabd	TRUE
aacacbbdadcacbcbbbacbac	TRUE
aadaaabadcddbbadddcdaac	TRUE
aadabdbabcbadabbbbdadcb	TRUE
aadadbdadabbddddcabdddd	TRUE
aacbbaddcdddbcccccdba	TRUE
aaaaaababadaadbcabbbbbb	TRUE
aaababdcadaabbbbcdcdcdc	TRUE
aaababbabccdcaabcacbddb	TRUE
aaadababbbbddcdacdabacc	TRUE
aabaaadadabbdcdbcabcad	TRUE
aabcacaaddadbdbcbdbadd	TRUE
aabddaaddaacadbcdddccd	TRUE
aacbdacdcaadabadacdbcd	TRUE
aacdbbabcbccdcabcdabcd	TRUE
aadbaaaddcabaadacbddcc	TRUE
aadcdcbbbdacdabccdaadc	TRUE
abaacbddbadcccabbdbcba	TRUE
abacacadabcdbaabaccbca	TRUE
abaddbbaacadcabcabddcb	TRUE
acabbadcbdbccbbadbaadb	TRUE
acadabddacddacaacdbddb	TRUE
adaaddaddcdabcdaccdacb	TRUE
adadaabcacaacddbddcacc	TRUE
baaadcdaddbacadbdaddcb	TRUE
baaccbadcdddaadbcaccdc	TRUE
caaabbcbacabdbdcdddbcd	TRUE
caacabadabdadbdaddbddd	TRUE
caaddbaadbdcbccadacadb	TRUE
daabcdcbbacccdaaadddcd	TRUE
aaaaaaacccccbadbbaacacc	FALSE
aaacddbcabcdaabcbbdddcc	FALSE
aaadbbaabadacbabbaadaba	FALSE
aaacabaadcccdcdaaabdcad	FALSE
aaabdccdcbdaaaacabccdda	FALSE
aaaabcbcbddddbadabdbdad	FALSE
aaabcbcbaddbbdcbbdabdcc	FALSE
aaacaddaaddacccbdbcdbbc	FALSE
aaabdadaacccbbbacccdadb	FALSE
aaaadcbddcdccdcadaccdcc	FALSE
aaabbabdccbabacadbdbcca	FALSE
aaaaadbcccadbbcabadaccc	FALSE
aaabadcdadccaddadbaccbd	FALSE
aaadddaacbbbaabdccaabcd	FALSE
aaacdbdadbbbaaacdaccddd	FALSE
aaadbbabacccbdacbccdddd	FALSE
aaabbcbddddcacccdabbaad	FALSE
aaaaccaabbaddbadcadbcbd	FALSE
aaacdbacaacaddcccbdadda	FALSE
aaaddcacacdcabadcadacbb	FALSE
aaacbacdadcdaaccbabddbd	FALSE
aaadcbacdbbdddacdcacdac	FALSE
aaacadcacbccaccbcbbcbda	FALSE
aaadaaabdccdddccdbdcaac	FALSE
aaabaaabbacdcdbacbcbadb	FALSE
aaadbdcdcbaacacabbbabcc	FALSE
aaaacbabaaabdcadbccccba	FALSE
aaacadbaacbabbbddbacaab	FALSE
aaabaddabcbcbabaadabdcb	FALSE
aaadacabbddaaabacbbdbaa	FALSE
aaabbabaaaccadcaddadbab	FALSE
aaacbabcdbbacddbabbabcc	FALSE
aaadccbbbcacacbdacbbbcd	FALSE
aaaadbbadadcbadbcaadbcd	FALSE
aaabbbbccdccbabbbdabbcd	FALSE
aaaacdadbacddbcbadaabbd	FALSE
aaabcddcdccaabcddbdbbba	FALSE
aaaddabadaadcdabcbdacdb	FALSE
aaacbddcbbdaabacbdaaaaa	FALSE
aaadbccbcaccaddddcbbdca	FALSE
aaacccbabcdacbadbbdaaac	FALSE
aaabddccbbcddcabcaccbbc	FALSE
aaaabcbddabccaaadcddaab	FALSE
aaabbbcbbbcbbabbdcacdda	FALSE
aaaabcabcbdcadaaadaacdb	FALSE
aaabbadbadacaadbbaadccd	FALSE
aaaaaaccbccabcbdbccddbb	FALSE
aaabacadcbaacabdbdcdbbd	FALSE
aaaaaabdccbdbcbbacbaaac	FALSE
aaabadcdddabdcdbbbccaab	FALSE
baaaaaaacccccbadbbaacacc	TRUE
baaacddbcabcdaabcbbdddcc	TRUE
baaadbbaabadacbabbaadaba	TRUE
caaacabaadcccdcdaaabdcad	TRUE
caaabdccdcbdaaaacabccdda	TRUE
daaaabcbcbddddbadabdbdad	TRUE
daaabcbcbaddbbdcbbdabdcc	TRUE
aacaddaaddacccbdbcdbbc	TRUE
aabdadaacccbbbacccdadb	TRUE
abaaadcbddcdccdcadaccdcc	TRUE
abaabbabdccbabacadbdbcca	TRUE
acaaaadbcccadbbcabadaccc	TRUE
acaabadcdadccaddadbaccbd	TRUE
acaadddaacbbbaabdccaabcd	TRUE
adaacdbdadbbbaaacdaccddd	TRUE
adaadbbabacccbdacbccdddd	TRUE
aabbcbddddcacccdabbaad	TRUE
aabaaccaabbaddbadcadbcbd	TRUE
aabacdbacaacaddcccbdadda	TRUE
aabaddcacacdcabadcadacbb	TRUE
aacacbacdadcdaaccbabddbd	TRUE
aacadcbacdbbdddacdcacdac	TRUE
aadacadcacbccaccbcbbcbda	TRUE
aadadaaabdccdddccdbdcaac	TRUE
aabaaabbacdcdbacbcbadb	TRUE
aadbdcdcbaacacabbbabcc	TRUE
aaaacbababaabdcadbccccba	TRUE
aaacadbaacababbbddbacaab	TRUE
aaabaddabcbcbabaababdcb	TRUE
aaadacabbddaaababcbbdbaa	TRUE
aaaababaaaccadcaddadbab	TRUE
aabcbabcdbbacddbabbabcc	TRUE
aabdccbbbcacacbdacbbbcd	TRUE
aacadbbadadcbadbcaadbcd	TRUE
aacbbbbccdccbabbbdabbcd	TRUE
aadacdadbacddbcbadaabbd	TRUE
aadbcddcdccaabcddbdbbba	TRUE
aadddabadaadcdabcbdacdb	TRUE
abacbddcbbdaabacbdaaaaa	TRUE
abadbccbcaccaddddcbbdca	TRUE
acacccbabcdacbadbbdaaac	TRUE
acabddccbbcddcabcaccbbc	TRUE
adaabcbddabccaaadcddaab	TRUE
adabbbcbbbcbbabbdcacdda	TRUE
baaabcabcbdcadaaadaacdb	TRUE
baabbadbadacaadbbaadccd	TRUE
caaaaaccbccabcbdbccddbb	TRUE
caabacadcbaacabdbdcdbbd	TRUE
daaaaabdccbdbcbbacbaaac	TRUE
daabadcdddabdcdbbbccaab	TRUE
aaaaaacaacdcbbbcbabcbcdd	FALSE
aaabccaccccbbaadbcaddada	FALSE
aaadacadcdbcccbbabdabdaa	FALSE
aaabaacddacaacabadbadacb	FALSE
aaaccddaabdcadbbbccabbda	FALSE
aaaabbdcdbbabdbbabdddcdb	FALSE
aaacaccdabbaaccabcacacbd	FALSE
aaadddcbcbdaaadbdbacabca	FALSE
aaaccdabbcaaadccbcbacadd	FALSE
aaaabacacaaaccadbcaddddb	FALSE
aaacbabdadbcaccadcbadcad	FALSE
aaaaacabadcdcdbdbabdbdcc	FALSE
aaabdbbadbacbbabbbbbdbcd	FALSE
aaadbdddbbcaaabdabdcacbc	FALSE
aaabbbaadbaabccaacbaadcd	FALSE
aaadaccbdddbdaacabbbabdb	FALSE
aaabcdbdbcbbcadcbbbacdca	FALSE
aaadcdacbaaabdbbaacabdad	FALSE
aaabcaacdbadcabbcbdaaadc	FALSE
aaadbbcdcaddcdacdbcccbac	FALSE
aaabbbddaaaabbdcccddcadd	FALSE
aaadaadddaaccbdbddaaaaac	FALSE
aaabadbcbadbdabcbabbdabc	FALSE
aaadabbcbdcdbbcbccbaabca	FALSE
aaabdbbcaadbdcbdbcdbabca	FALSE
aaadcadaadbdddcbbabcaaca	FALSE
aaaabcabcddbcbaabaddabcc	FALSE
aaabadbbcacabbaabaaabbbb	FALSE
aaabcabbadbaabccabaaacdb	FALSE
aaacddbadcbcaabbdbbdbbdc	FALSE
aaaddbdadcccdbabddcccbad	FALSE
aaabbcbcacbbaccbdadaabdc	FALSE
aaacddabbcdadabacaaadcab	FALSE
aaaadbbdbccdbacacacacdcb	FALSE
aaaccdacabdaddcbcaadbaad	FALSE
aaaacdabdcdbcacbcddadcbb	FALSE
aaacbaabcbbcabcbccbccccb	FALSE
aaaaabaadaabdbbdbdbacddb	FALSE
aaabdbdacadbbcabbacacddd	FALSE
aaaaabbadcbbccaacdaadcca	FALSE
aaabdcbacadbadcdbadbdcbb	FALSE
aaadccdbadacdadadbcdabbb	FALSE
aaabcdcaacabdabcabaabaac	FALSE
aaadbbcadbaddbdbcdccccba	FALSE
aaabacccabdbdaabaccaadca	FALSE
aaacdcaddbcbdcaddcbbbcdc	FALSE
aaaabcacbcdacbddabbbacdb	FALSE
aaacbcaccbdcbdaccacbaacc	FALSE
aaaabbdbadccbcdcadbbbbdd	FALSE
aaacaccbddacddbdaccdaacb	FALSE
baaaaaacaacdcbbbcbabcbcdd	TRUE
baaabccaccccbbaadbcaddada	TRUE
baaadacadcdbcccbbabdabdaa	TRUE
caaabaacddacaacabadbadacb	TRUE
caaaccddaabdcadbbbccabbda	TRUE
daaaabbdcdbbabdbbabdddcdb	TRUE
daaacaccdabbaaccabcacacbd	TRUE
daaadddcbcbdaaadbdbacabca	TRUE
aaccdabbcaaadccbcbacadd	TRUE
abaaabacacaaaccadbcaddddb	TRUE
abaacbabdadbcaccadcbadcad	TRUE
acaaaacabadcdcdbdbabdbdcc	TRUE
acaabdbbadbacbbabbbbbdbcd	TRUE
acaadbdddbbcaaabdabdcacbc	TRUE
adaabbbaadbaabccaacbaadcd	TRUE
adaadaccbdddbdaacabbbabdb	TRUE
aabcdbdbcbbcadcbbbacdca	TRUE
aadcdacbaaabdbbaacabdad	TRUE
aababcaacdbadcabbcbdaaadc	TRUE
aabadbbcdcaddcdacdbcccbac	TRUE
aacabbbddaaaabbdcccddcadd	TRUE
aacadaadddaaccbdbddaaaaac	TRUE
aadabadbcbadbdabcbabbdabc	TRUE
aadadabbcbdcdbbcbccbaabca	TRUE
aabdbbcaadbdcbdbcdbabca	TRUE
aadcadaadbdddcbbabcaaca	TRUE
aaaabcabcddbcbaababddabcc	TRUE
aaabadbbcacabbaabababbbb	TRUE
aaababbadbaabccabaaacdb	TRUE
aaacddbadcbcababbdbbdbbdc	TRUE
aaaddbdadcccdababddcccbad	TRUE
aabbbcbcacbbaccbdadaabdc	TRUE
aabcddabbcdadabacaaadcab	TRUE
aacadbbdbccdbacacacacdcb	TRUE
aacccdacabdaddcbcaadbaad	TRUE
aadacdabdcdbcacbcddadcbb	TRUE
aadcbaabcbbcabcbccbccccb	TRUE
abaaabaadaabdbbdbdbacddb	TRUE
ababdbdacadbbcabbacacddd	TRUE
acaaabbadcbbccaacdaadcca	TRUE
acabdcbacadbadcdbadbdcbb	TRUE
acadccdbadacdadadbcdabbb	TRUE
adabcdcaacabdabcabaabaac	TRUE
adadbbcadbaddbdbcdccccba	TRUE
baabacccabdbdaabaccaadca	TRUE
baacdcaddbcbdcaddcbbbcdc	TRUE
caaabcacbcdacbddabbbacdb	TRUE
caacbcaccbdcbdaccacbaacc	TRUE
daaabbdbadccbcdcadbbbbdd	TRUE
daacaccbddacddbdaccdaacb	TRUE
aaaaaabaccabbdddbdaddbccc	FALSE
aaabcddbbdcbacbbbacbbadcc	FALSE
aaadbdaddbbcddddadadddcbd	FALSE
aaabaccbbcbccddbcdcdbcddb	FALSE
aaacddcbcccbacbcaacabddbd	FALSE
aaaadbbdbbdccddaaadcbbaab	FALSE
aaaccadbbaddcabcbcccadcca	FALSE
aaabbbaddcbdacacdbcbacaaa	FALSE
aaadaaabcccdcdbcccbbbdabb	FALSE
aaabacbabccddadcbbbdadacd	FALSE
aaacdadbcdbdacccdabddbbcc	FALSE
aaaaccbacccbcdbddcdaddcbc	FALSE
aaacbbcbaacccabacdacbbdbc	FALSE
aaaaadccaadabacddcbcbdcaa	FALSE
aaacabcabaccbadacaccbadaa	FALSE
aaaddcbbaaadabaacdbadcaab	FALSE
aaacddaddcbccdcbdabdabbcd	FALSE
aaaabbbddbcdaacaacaaadaac	FALSE
aaacbbdaccdaabcadabacdbca	FALSE
aaaaacaadcdaddbdcabccbbdd	FALSE
aaacaaaacdbdbcadcbadbacbc	FALSE
aaadcdacbdbbcabadbabacbcd	FALSE
aaabdaacddcdaacabbdcaaabd	FALSE
aaadcbbcddabccccaadadaadb	FALSE
aaacbbcdbccdbbadcdabbbadc	FALSE
aaaabadcbdbacbbcaddcabbdd	FALSE
aaaacacabcbbcdabbcddacbda	FALSE
aaabbbbbcbbadaabbbcabdabc	FALSE
aaabdbcccdabbcdbdbcbbdabd	FALSE
aaacdbdcbdcaabbbbadcbacdb	FALSE
aaadcccbadcaabbdadbacddda	FALSE
aaaadbccacdccbcdbcbccbaab	FALSE
aaacbdbbcacaabbdcadabccad	FALSE
aaaaacbabdaabccadabbbaaaa	FALSE
aaacadcaccacdddbcbbbabadc	FALSE
aaaabbbcbbbbcdcdaaabadbac	FALSE
aaacbcdcbbdadbccdbbdabaab	FALSE
aaaabbbddcabbcbcabbaaaaba	FALSE
aaacaccdcbdabddacdbbaccda	FALSE
aaadddabdadbccbabaacdbabc	FALSE
aaacaacacaddddaaddbdcbdab	FALSE
aaadcccdaaabcbbadbabcccdb	FALSE
aaabcbacaadcdacaabcdbaccd	FALSE
aaadcabdaacadaaaaccaaadbd	FALSE
aaabacbdbacccdccaadccabdd	FALSE
aaacdadaaabcdbcbdadaabbaa	FALSE
aaaacbbbddadadabcdddbbdba	FALSE
aaaccabccaacdddddbdbaaaca	FALSE
aaaacbacbbbdabcdbaacbbbca	FALSE
aaacbbcaabcdadbddbbbaabcb	FALSE
baaaaaabaccabbdddbdaddbccc	TRUE
baaabcddbbdcbacbbbacbbadcc	TRUE
baaadbdaddbbcddddadadddcbd	TRUE
caaabaccbbcbccddbcdcdbcddb	TRUE
caaacddcbcccbacbcaacabddbd	TRUE
daaaadbbdbbdccddaaadcbbaab	TRUE
daaaccadbbaddcabcbcccadcca	TRUE
aabbbaddcbdacacdbcbacaaa	TRUE
aadaaabcccdcdbcccbbbdabb	TRUE
abaabacbabccddadcbbbdadacd	TRUE
abaacdadbcdbdacccdabddbbcc	TRUE
acaaaccbacccbcdbddcdaddcbc	TRUE
acaacbbcbaacccabacdacbbdbc	TRUE
adaaaadccaadabacddcbcbdcaa	TRUE
adaacabcabaccbadacaccbadaa	TRUE
adaaddcbbaaadabaacdbadcaab	TRUE
aacddaddcbccdcbdabdabbcd	TRUE
aabaabbbddbcdaacaacaaadaac	TRUE
aabacbbdaccdaabcadabacdbca	TRUE
aacaaacaadcdaddbdcabccbbdd	TRUE
aacacaaaacdbdbcadcbadbacbc	TRUE
aacadcdacbdbbcabadbabacbcd	TRUE
aadabdaacddcdaacabbdcaaabd	TRUE
aadadcbbcddabccccaadadaadb	TRUE
aacbbcdbccdbbadcdabbbadc	TRUE
aaababadcbdbacbbcaddcabbdd	TRUE
aaaacacabcbbcdababcddacbda	TRUE
aaabbbbbcbbadababbbcabdabc	TRUE
aaababcccdabbcdbdbcbbdabd	TRUE
aaacdbdcbdcaababbbadcbacdb	TRUE
aaadcccbadcaababdadbacddda	TRUE
aabadbccacdccbcdbcbccbaab	TRUE
aabcbdbbcacaabbdcadabccad	TRUE
aacaacbabdaabccadabbbaaaa	TRUE
aaccadcaccacdddbcbbbabadc	TRUE
aadabbbcbbbbcdcdaaabadbac	TRUE
aadcbcdcbbdadbccdbbdabaab	TRUE
abaabbbddcabbcbcabbaaaaba	TRUE
abacaccdcbdabddacdbbaccda	TRUE
abadddabdadbccbabaacdbabc	TRUE
acacaacacaddddaaddbdcbdab	TRUE
acadcccdaaabcbbadbabcccdb	TRUE
adabcbacaadcdacaabcdbaccd	TRUE
adadcabdaacadaaaaccaaadbd	TRUE
baabacbdbacccdccaadccabdd	TRUE
baacdadaaabcdbcbdadaabbaa	TRUE
caaacbbbddadadabcdddbbdba	TRUE
caaccabccaacdddddbdbaaaca	TRUE
daaacbacbbbdabcdbaacbbbca	TRUE
daacbbcaabcdadbddbbbaabcb	TRUE
aaaaaaaadddbddbadbbcaacbab	FALSE
aaadbbbdccbbccbabccdddadcd	FALSE
aaacbbcadbbccbccaccadaccac	FALSE
aaadacddcacddaccbbacccddcc	FALSE
aaacabbcbadbacacdbddacbcad	FALSE
aaaacbbcabaccbdacdccbbcbda	FALSE
aaabdcadaccdadcdbccbdcbbaa	FALSE
aaadadcabdddabcdbabaabdccc	FALSE
aaabcbdbcdddaaabddcacbacad	FALSE
aaaacbdcdbdbacaabcbdcacbcb	FALSE
aaabbdbbbbdbabccbaaccbdaaa	FALSE
aaaadcabcaabcabcaccddcdcda	FALSE
aaabdbcadbaadcdbbabbbadddd	FALSE
aaaadbaaadcbdcacbddaaddbbd	FALSE
aaabddbbcbcbbbbbccbbdbadbc	FALSE
aaadaaadcbaacbdbacddaaabdc	FALSE
aaabbabcaaddcadcbcabdaacda	FALSE
aaaaddddcbdacdddbcddabaabb	FALSE
aaabdaccbbbdaaadabcabdddba	FALSE
aaaaabccabaaadbcdddbbbbdad	FALSE
aaadcbbccdabaddabcacccdadc	FALSE
aaacbcddacdccdcbbcdcbadbdd	FALSE
aaadbacbdbdadddbdbbbccdbcb	FALSE
aaacbaabcddccccbdcbdacbccc	FALSE
aaabdddadbddabbbddcbbcacac	FALSE
aaaabacadcacdaadadbbbddaac	FALSE
aaaabbcaadddbacdbcabbabacb	FALSE
aaadddbacbddcbbbaacabdbcab	FALSE
aaabaaaadcadacbcdddbacaddc	FALSE
aaabcabbadbabbbdcaaabaddbb	FALSE
aaacbabddbabdaccabcbccdadd	FALSE
aaaadcabcbdcaaddcdadaadbac	FALSE
aaabadbbaddbcaaadcbbdaaaac	FALSE
aaaaabbbdcbabadadbbadccabd	FALSE
aaadcabcddaccbacaccbddadbc	FALSE
aaacbdbaaabdbbdbdacabbbddc	FALSE
aaaddbcbaadbcddddbbadddbcd	FALSE
aaacdaddabaaaacbdabdaabaad	FALSE
aaadacdadbbabbcdbaaadbdadb	FALSE
aaacadacccbdddadbdddbaadab	FALSE
aaaacadcdbccbcbbbdcbbbcbbb	FALSE
aaabbacbcbbdcbbdcadcdbcacd	FALSE
aaaabadcbaddccaaabdddadcbc	FALSE
aaabbdcaaabcdccabbacdcbccb	FALSE
aaaabdbbddcacddbbbdacaaaad	FALSE
aaabbbdddcdcdcaddabbccbbbd	FALSE
aaaabdcabaacbbdbcaabdabbcc	FALSE
aaabdccbcbccbabdbcaabaacaa	FALSE
aaaaaccabcdacdcdbcdbdcadab	FALSE
aaadccccdbbaaacaabccacdabd	FALSE
baaaaaaaadddbddbadbbcaacbab	TRUE
baaadbbbdccbbccbabccdddadcd	TRUE
baaacbbcadbbccbccaccadaccac	TRUE
caaadacddcacddaccbbacccddcc	TRUE
caaacabbcbadbacacdbddacbcad	TRUE
daaaacbbcabaccbdacdccbbcbda	TRUE
daaabdcadaccdadcdbccbdcbbaa	TRUE
aadadcabdddabcdbabaabdccc	TRUE
aabcbdbcdddaaabddcacbacad	TRUE
abaaacbdcdbdbacaabcbdcacbcb	TRUE
abaabbdbbbbdbabccbaaccbdaaa	TRUE
acaaadcabcaabcabcaccddcdcda	TRUE
acaabdbcadbaadcdbbabbbadddd	TRUE
adaaadbaaadcbdcacbddaaddbbd	TRUE
adaabddbbcbcbbbbbccbbdbadbc	TRUE
aadaaadcbaacbdbacddaaabdc	TRUE
aabbabcaaddcadcbcabdaacda	TRUE
aabaaddddcbdacdddbcddabaabb	TRUE
aababdaccbbbdaaadabcabdddba	TRUE
aacaaabccabaaadbcdddbbbbdad	TRUE
aacadcbbccdabaddabcacccdadc	TRUE
aacacbcddacdccdcbbcdcbadbdd	TRUE
aadadbacbdbdadddbdbbbccdbcb	TRUE
aadacbaabcddccccbdcbdacbccc	TRUE
aabdddadbddabbbddcbbcacac	TRUE
aaababacadcacdaadadbbbddaac	TRUE
aaaabbcaadddbacdbcabbababcb	TRUE
aaadddbacbddcbbbaacababcab	TRUE
aaababaaadcadacbcdddbacaddc	TRUE
aaabcababadbabbbdcaaabaddbb	TRUE
aaacbabddababdaccabcbccdadd	TRUE
aabadcabcbdcaaddcdadaadbac	TRUE
aabbadbbaddbcaaadcbbdaaaac	TRUE
aacaabbbdcbabadadbbadccabd	TRUE
aacdcabcddaccbacaccbddadbc	TRUE
aaccbdbaaabdbbdbdacabbbddc	TRUE
aadddbcbaadbcddddbbadddbcd	TRUE
aadcdaddabaaaacbdabdaabaad	TRUE
abadacdadbbabbcdbaaadbdadb	TRUE
abacadacccbdddadbdddbaadab	TRUE
acaacadcdbccbcbbbdcbbbcbbb	TRUE
acabbacbcbbdcbbdcadcdbcacd	TRUE
adaabadcbaddccaaabdddadcbc	TRUE
adabbdcaaabcdccabbacdcbccb	TRUE
baaabdbbddcacddbbbdacaaaad	TRUE
baabbbdddcdcdcaddabbccbbbd	TRUE
caaabdcabaacbbdbcaabdabbcc	TRUE
caabdccbcbccbabdbcaabaacaa	TRUE
daaaaccabcdacdcdbcdbdcadab	TRUE
daadccccdbbaaacaabccacdabd	TRUE
aaaaaadaaabcbbcbaaacabcabdc	FALSE
aaadaadbddddcadbadbdbcaadaa	FALSE
aaaaaaaaacdadbcccbdddbbabac	FALSE
aaabdccccabaaaccccacabcccac	FALSE
aaaccabbcbcbbdddbbcdddbccdb	FALSE
aaabcaabaddddbcddccbdbccbaa	FALSE
aaacbbdacbccabbdddabbcddacb	FALSE
aaadbaabaccbdacdadcdcccdaab	FALSE
aaaaabcbccdcdbaddbdbcadddcb	FALSE
aaabcadacccddacccacdbbdaabb	FALSE
aaacacdabddabcbaacdccdbacda	FALSE
aaabbacacdaccaaaabdbbcccbdc	FALSE
aaacbbdacdabcabcadcbbabacdd	FALSE
aaabaadcbabbcbcacadbbbdccab	FALSE
aaadcaddbbbcaaccacbddbbdaba	FALSE
aaabddaaaccbacdbacacaabadda	FALSE
aaacacbbdbcddbcbadadbdaaaba	FALSE
aaaadcddaccccabbaddadcccbab	FALSE
aaadcbdbcbcdcaacacdacdcadbb	FALSE
aaaadbbcabbcdacdcabdccbdbdc	FALSE
aaaddabcacdcaccadbddcdcdbdb	FALSE
aaaaacdadbcdabaaaabcaabdccc	FALSE
aaadbbbcddadbaabdbccddbdddd	FALSE
aaabaccaccabddccbbdaadccbaa	FALSE
aaadccdadbccddccbdcdbbccddb	FALSE
aaaaabdcbacdddcbdcbacacbabb	FALSE
aaaacbacacbdbbbdacabaddcdbb	FALSE
aaabdabaabccdcaadbdccdbbcda	FALSE
aaadabbabdbaacccabbabcbcccb	FALSE
aaacabbccbcbcbabdccbacbdbac	FALSE
aaaccacbccbacacbcaabddaacca	FALSE
aaabacbdcdbabcbacaacacadacd	FALSE
aaacabddbbadadcbddbbdbcbabc	FALSE
aaaadddabddbbbdadddccbbacda	FALSE
aaadbcbdcabbbabdbbdacdbbbda	FALSE
aaaaacabbadcaabbdcbbaaabbcc	FALSE
aaadaaaacccdbbdadadbbdcdccc	FALSE
aaaccabdbabaacabcddbcbcdadc	FALSE
aaabdadadbddbaaabdbaaabcabc	FALSE
aaacdadddbbcadaadcdabddacbc	FALSE
aaabdbccddadabaaaabacacddbc	FALSE
aaacbdddbdcbdbaadadbcbbbdad	FALSE
aaabbcadbcddaddbcccbdcbaaab	FALSE
aaacbabbaaacccadadbbabcbcad	FALSE
aaaacdaadbabbcbdddccbdcdbcd	FALSE
aaadcacbdabaacadbbadbabdcdd	FALSE
aaaabccaaaabdabaadcadaccddb	FALSE
aaaddaccbaccdcadcbbaaabdaba	FALSE
aaaabacdccdacbdcbddabcaccca	FALSE
aaadbbbdabbbacdbbabacbaabca	FALSE
baaaaaadaaabcbbcbaaacabcabdc	TRUE
baaadaadbddddcadbadbdbcaadaa	TRUE
caaaaaaaaacdadbcccbdddbbabac	TRUE
caaabdccccabaaaccccacabcccac	TRUE
caaaccabbcbcbbdddbbcdddbccdb	TRUE
daaabcaabaddddbcddccbdbccbaa	TRUE
daaacbbdacbccabbdddabbcddacb	TRUE
aadbaabaccbdacdadcdcccdaab	TRUE
abaaaabcbccdcdbaddbdbcadddcb	TRUE
abaabcadacccddacccacdbbdaabb	TRUE
abaacacdabddabcbaacdccdbacda	TRUE
acaabbacacdaccaaaabdbbcccbdc	TRUE
acaacbbdacdabcabcadcbbabacdd	TRUE
adaabaadcbabbcbcacadbbbdccab	TRUE
adaadcaddbbbcaaccacbddbbdaba	TRUE
aabddaaaccbacdbacacaabadda	TRUE
aacacbbdbcddbcbadadbdaaaba	TRUE
aabaadcddaccccabbaddadcccbab	TRUE
aabadcbdbcbcdcaacacdacdcadbb	TRUE
aacaadbbcabbcdacdcabdccbdbdc	TRUE
aacaddabcacdcaccadbddcdcdbdb	TRUE
aadaaacdadbcdabaaaabcaabdccc	TRUE
aadadbbbcddadbaabdbccddbdddd	TRUE
aabaccaccabddccbbdaadccbaa	TRUE
aadccdadbccddccbdcdbbccddb	TRUE
aaaaabdcbacdddcbdcbacababb	TRUE
aaaacbacacbdbbbdacababddcdbb	TRUE
aaabdabababccdcaadbdccdbbcda	TRUE
aaadabababdbaacccabbabcbcccb	TRUE
aaacabbccbcbcababdccbacbdbac	TRUE
aaaccacbccbacacbcababddaacca	TRUE
aabbacbdcdbabcbacaacacadacd	TRUE
aabcabddbbadadcbddbbdbcbabc	TRUE
aacadddabddbbbdadddccbbacda	TRUE
aacdbcbdcabbbabdbbdacdbbbda	TRUE
aadaacabbadcaabbdcbbaaabbcc	TRUE
aaddaaaacccdbbdadadbbdcdccc	TRUE
aadccabdbabaacabcddbcbcdadc	TRUE
ababdadadbddbaaabdbaaabcabc	TRUE
abacdadddbbcadaadcdabddacbc	TRUE
acabdbccddadabaaaabacacddbc	TRUE
acacbdddbdcbdbaadadbcbbbdad	TRUE
adabbcadbcddaddbcccbdcbaaab	TRUE
adacbabbaaacccadadbbabcbcad	TRUE
baaacdaadbabbcbdddccbdcdbcd	TRUE
baadcacbdabaacadbbadbabdcdd	TRUE
caaabccaaaabdabaadcadaccddb	TRUE
caaddaccbaccdcadcbbaaabdaba	TRUE
daaabacdccdacbdcbddabcaccca	TRUE
daadbbbdabbbacdbbabacbaabca	TRUE
aaaaaaadddddddbdabddcbadadac	FALSE
aaadbdabccadacbbbcacabdbcbdc	FALSE
aaacdcbaccbbbccbcadddadbdbab	FALSE
aaaaccbbccbaabccccdacdcdcddd	FALSE
aaacaaacdaadbdbadaabbcdbdaab	FALSE
aaaacbbacbcccdbaaabdbaacddbb	FALSE
aaabcdadaabbabbbcdcccabadaaa	FALSE
aaadcdbabaccacaadddcdcbadbad	FALSE
aaaccdbaddcbbcdcbdaabbabcbdc	FALSE
aaadbddadddbadaddbaccdbdcdbc	FALSE
aaacbdddcccccddcdbdcaaabddbc	FALSE
aaaddccdaacbbcaabacbbdadbdbc	FALSE
aaacdcaadcdbabccbbcbdacdadcc	FALSE
aaadabdbbbbbaaacbbbbabacbccb	FALSE
aaacadbccccccbbdccdadaabcbba	FALSE
aaadcaccacbdcadaccbcdcadbdda	FALSE
aaacbddaddcacdbcbbdbdacddbac	FALSE
aaaddcaaddabdaadccbadabbacac	FALSE
aaacdacdbbbcabacacddbdcacbca	FALSE
aaadadcaaaadddacccbddadbdbab	FALSE
aaacaaaacadddbbdcdabbbabadab	FALSE
aaaabcbdbabcbdcbcbdabbcabdcc	FALSE
aaabbabdadabaccabddcabdaaaba	FALSE
aaadbaacdcbccbbbdcdbbacddadc	FALSE
aaacdadcccbdcacbbbadccbcadcb	FALSE
aaaadccbbcbdccdddaadbaadabac	FALSE
aaadaddbabbbbcbabacabacbcbca	FALSE
aaadcdddaabaddbaadcdabbadbba	FALSE
aaabcadaddaddcabaabdcbccadda	FALSE
aaacdabaccbddcbabbabdaaaccdc	FALSE
aaaaddadbbdccaccacdadbbdbabc	FALSE
aaadccddcbcdbdaabcbacdbabbbd	FALSE
aaacbbcdbbbdbcaddaabbcadaada	FALSE
aaadbdbacadbbcbcddddbaabbcac	FALSE
aaacbdcbbacddcddaacddbadccab	FALSE
aaadaabdbdbdcbacccbddddccdbd	FALSE
aaabcadadccbcaaadddaacdcabdd	FALSE
aaaabddacccabbbccbbdcdcdadab	FALSE
aaadccaccccbcbbcbaacbccacbcd	FALSE
aaacccbadccacbaccdabaabadaab	FALSE
aaadcaddaadcdaacdaaadbabcbbd	FALSE
aaacdaccacdccbbccbadcccdbccd	FALSE
aaaaccdbbacdbcbccbaaaabddadc	FALSE
aaabcbacbabcbaacdabdccbabbcc	FALSE
aaaadcbddaabdccadabcbccabdcc	FALSE
aaabbbcacaaabdaaacbdddbbbcab	FALSE
aaaadcbdadcbccbbcdcbdbbbcbad	FALSE
aaabdaabcdbaacccdcbaadcbaada	FALSE
aaaaacbaaaadadcacbbbccacbddd	FALSE
aaadccccccddbaadbadbdaabcaca	FALSE
baaaaaaadddddddbdabddcbadadac	TRUE
baaadbdabccadacbbbcacabdbcbdc	TRUE
baaacdcbaccbbbccbcadddadbdbab	TRUE
caaaaccbbccbaabccccdacdcdcddd	TRUE
caaacaaacdaadbdbadaabbcdbdaab	TRUE
daaaacbbacbcccdbaaabdbaacddbb	TRUE
daaabcdadaabbabbbcdcccabadaaa	TRUE
aadcdbabaccacaadddcdcbadbad	TRUE
aaccdbaddcbbcdcbdaabbabcbdc	TRUE
abaadbddadddbadaddbaccdbdcdbc	TRUE
abaacbdddcccccddcdbdcaaabddbc	TRUE
acaaddccdaacbbcaabacbbdadbdbc	TRUE
acaacdcaadcdbabccbbcbdacdadcc	TRUE
adaadabdbbbbbaaacbbbbabacbccb	TRUE
adaacadbccccccbbdccdadaabcbba	TRUE
aadcaccacbdcadaccbcdcadbdda	TRUE
aacbddaddcacdbcbbdbdacddbac	TRUE
aabaddcaaddabdaadccbadabbacac	TRUE
aabacdacdbbbcabacacddbdcacbca	TRUE
aacadadcaaaadddacccbddadbdbab	TRUE
aacacaaaacadddbbdcdabbbabadab	TRUE
aadaabcbdbabcbdcbcbdabbcabdcc	TRUE
aadabbabdadabaccabddcabdaaaba	TRUE
aadbaacdcbccbbbdcdbbacddadc	TRUE
aacdadcccbdcacbbbadccbcadcb	TRUE
aaaadccbbcbdccdddaadbaadabab	TRUE
aaadadababbbbcbabacabacbcbca	TRUE
aaadcdddaabaddbaadcdababadbba	TRUE
aaabcadaddaddcababbdcbccadda	TRUE
aaacdabaccbddcbabababdaaaccdc	TRUE
aabaddadbbdccaccacdadbbdbabc	TRUE
aabdccddcbcdbdaabcbacdbabbbd	TRUE
aabcbbcdbbbdbcaddaabbcadaada	TRUE
aacdbdbacadbbcbcddddbaabbcac	TRUE
aaccbdcbbacddcddaacddbadccab	TRUE
aaddaabdbdbdcbacccbddddccdbd	TRUE
aadbcadadccbcaaadddaacdcabdd	TRUE
abaabddacccabbbccbbdcdcdadab	TRUE
abadccaccccbcbbcbaacbccacbcd	TRUE
abacccbadccacbaccdabaabadaab	TRUE
acadcaddaadcdaacdaaadbabcbbd	TRUE
acacdaccacdccbbccbadcccdbccd	TRUE
adaaccdbbacdbcbccbaaaabddadc	TRUE
adabcbacbabcbaacdabdccbabbcc	TRUE
baaadcbddaabdccadabcbccabdcc	TRUE
baabbbcacaaabdaaacbdddbbbcab	TRUE
caaadcbdadcbccbbcdcbdbbbcbad	TRUE
caabdaabcdbaacccdcbaadcbaada	TRUE
daaaacbaaaadadcacbbbccacbddd	TRUE
daadccccccddbaadbadbdaabcaca	TRUE
aaaaaabbbccbaacdbbaadbacccbda	FALSE
aaabdadcbbabbddcacacdccacdbcd	FALSE
aaaddabbccaccaabbaabbdbcaddac	FALSE
aaabdaddcaddcbabaacabbabcbadb	FALSE
aaadcdcbddaaddabdabbdaccdacac	FALSE
aaabcccdbbcabaddaddaacbccdacd	FALSE
aaadcbdcbcbbacbcdacddbabadcbb	FALSE
aaacaadbddadbdcacadcdbbadacbc	FALSE
aaadcdbadcdabcddcadbbcabbdbba	FALSE
aaabcacaadcacdbabbccdddbbdaba	FALSE
aaadbcdbadbddcabcaaabddacbadb	FALSE
aaabacbcbacabacdaddbaacaabdad	FALSE
aaaccbcbcbddbbcaacadbcaabdadd	FALSE
aaaacacbadccbadabbcbddddcdcda	FALSE
aaacaadbcabdbcaddabadcddbaddc	FALSE
aaabacaaddabcdccbcbbcadaddbad	FALSE
aaacdbbdccadcacccbcbabcabcdca	FALSE
aaaaddabbcdcbbadcabdbdabbbddb	FALSE
aaaccdaadaddbcdabacdabdbbcbda	FALSE
aaaadbbbaacdabaccacbbacadccca	FALSE
aaacdcbdcdacbadccbbccbdbbaabb	FALSE
aaaacbdadbdddabddbcbcabaaaaad	FALSE
aaacaddaacaacdabadaadbdbcabcc	FALSE
aaabaddcaacabbbabaaabbbdccabb	FALSE
aaadabcaabcaadaaacabdcdbabdbd	FALSE
aaaaacbcdbbdaaddabbadaacbabaa	FALSE
aaaadbcbcadbcdbdbdbdbbaddabbd	FALSE
aaabbcabbbacacabacccdbadcdddc	FALSE
aaabbbcabbdbdbcadccbbaabcbdca	FALSE
aaacdbdaadccacdcabaacaaddbaca	FALSE
aaadccacbcaaadbadabcbcdbbacab	FALSE
aaaaccbdadcbddcbddbcaadcbdbab	FALSE
aaacbccbacaaadabdccbacbcacaac	FALSE
aaaaacabdaccbcacdadddaacaaaab	FALSE
aaabdacbaacbbbccacdbdbaabbaca	FALSE
aaadcbdcbbabccdcdadccbbcadcdc	FALSE
aaabcbddabbccadcbbbccaadccbdd	FALSE
aaadcbadbddadddbadaadbcccdaac	FALSE
aaabbccbabaacbcccbaadddaadabb	FALSE
aaadbdadbaacdaaadcbaddbbacabd	FALSE
aaabaccccadbabccdadacaaacacbd	FALSE
aaacdbbdbaacddbcaacabbbabcabc	FALSE
aaaaddbaacaadcaacadabcabbdacc	FALSE
aaacdcccdbddaabbaabaaacddbada	FALSE
aaaaccbbbbccdbcbbaacbcabaabaa	FALSE
aaacdadccbcccbbdbcdbddbcdbaaa	FALSE
aaaadbabccbadddcadbcabbbbdccd	FALSE
aaaccddcbbabccacdcbaaddaabaad	FALSE
aaaabadbbdacbabbabacaaaacbbab	FALSE
aaacadabcaabddadccaadadcacbaa	FALSE
baaaaaabbbccbaacdbbaadbacccbda	TRUE
baaabdadcbbabbddcacacdccacdbcd	TRUE
baaaddabbccaccaabbaabbdbcaddac	TRUE
caaabdaddcaddcbabaacabbabcbadb	TRUE
caaadcdcbddaaddabdabbdaccdacac	TRUE
daaabcccdbbcabaddaddaacbccdacd	TRUE
daaadcbdcbcbbacbcdacddbabadcbb	TRUE
aacaadbddadbdcacadcdbbadacbc	TRUE
aadcdbadcdabcddcadbbcabbdbba	TRUE
abaabcacaadcacdbabbccdddbbdaba	TRUE
abaadbcdbadbddcabcaaabddacbadb	TRUE
acaabacbcbacabacdaddbaacaabdad	TRUE
acaaccbcbcbddbbcaacadbcaabdadd	TRUE
adaaacacbadccbadabbcbddddcdcda	TRUE
adaacaadbcabdbcaddabadcddbaddc	TRUE
aabacaaddabcdccbcbbcadaddbad	TRUE
aacdbbdccadcacccbcbabcabcdca	TRUE
aabaaddabbcdcbbadcabdbdabbbddb	TRUE
aabaccdaadaddbcdabacdabdbbcbda	TRUE
aacaadbbbaacdabaccacbbacadccca	TRUE
aacacdcbdcdacbadccbbccbdbbaabb	TRUE
aadaacbdadbdddabddbcbcabaaaaad	TRUE
aadacaddaacaacdabadaadbdbcabcc	TRUE
aabaddcaacabbbabaaabbbdccabb	TRUE
aadabcaabcaadaaacabdcdbabdbd	TRUE
aaaaacbcdbbdaaddabbadaacbabab	TRUE
aaaadbcbcadbcdbdbdbdbbaddababd	TRUE
aaabbcabbbacacababcccdbadcdddc	TRUE
aaababcabbdbdbcadccbbaabcbdca	TRUE
aaacdbdaadccacdcababcaaddbaca	TRUE
aaadccacbcaaadbadababcdbbacab	TRUE
aabaccbdadcbddcbddbcaadcbdbab	TRUE
aabcbccbacaaadabdccbacbcacaac	TRUE
aacaacabdaccbcacdadddaacaaaab	TRUE
aacbdacbaacbbbccacdbdbaabbaca	TRUE
aacdcbdcbbabccdcdadccbbcadcdc	TRUE
aadbcbddabbccadcbbbccaadccbdd	TRUE
aaddcbadbddadddbadaadbcccdaac	TRUE
ababbccbabaacbcccbaadddaadabb	TRUE
abadbdadbaacdaaadcbaddbbacabd	TRUE
acabaccccadbabccdadacaaacacbd	TRUE
acacdbbdbaacddbcaacabbbabcabc	TRUE
adaaddbaacaadcaacadabcabbdacc	TRUE
adacdcccdbddaabbaabaaacddbada	TRUE
baaaccbbbbccdbcbbaacbcabaabaa	TRUE
baacdadccbcccbbdbcdbddbcdbaaa	TRUE
caaadbabccbadddcadbcabbbbdccd	TRUE
caaccddcbbabccacdcbaaddaabaad	TRUE
daaabadbbdacbabbabacaaaacbbab	TRUE
daacadabcaabddadccaadadcacbaa	TRUE
