aaaaaaaacaadadacdcdc	TRUE
aaacdadaaaccdbbddada	TRUE
aacaacdaccbccacbcccb	TRUE
aacbdcaaaadddcbddaca	TRUE
aacdaccdccdddbcbdccc	TRUE
aadacdcdbcbccbdddbcb	TRUE
aadcbbccdddbcadadbcc	TRUE
aaddbbccdacbcddcdcac	TRUE
ababdbccccadcdbdccbd	TRUE
abadadabdacddaccdcbc	TRUE
abcaccbdadbdaddacbcd	TRUE
abcccacdbabadbcddcab	TRUE
abcddbcbccddabacadcd	TRUE
abdbcaddbacadbcdadcd	TRUE
abdcddccdbdabcabdbcd	TRUE
acaacccddacdbdbddacb	TRUE
acacacddddaaddcdadcd	TRUE
acacddccbcacbacccccc	TRUE
acaddacddcccccdbdbdb	TRUE
acbbbbcdcadcdacacccd	TRUE
acbcbcdcbcbbdcdddbdc	TRUE
acbdadcabdaccacaccdc	TRUE
acbddddddbccddbdaddc	TRUE
accbabcdccdbdbdbdabc	TRUE
accbdccbbdcbcbcdaddd	TRUE
acccccdbdddabcddacca	TRUE
accdbccccbdabdcaccdb	TRUE
acdaaadaadcadcadacbc	TRUE
acdaddcacadbcbbdcccb	TRUE
acdbdbddcabdaccbddab	TRUE
acdcbddcbadadbadabdb	TRUE
acddacbcdabdcbddbadd	TRUE
acdddbdadcccbcadbccc	TRUE
adabccdabadadcabcdad	TRUE
adaccaadcccccbcddddd	TRUE
adadadbadddabacddcad	TRUE
adaddcdaddbcbbbcddbd	TRUE
adbbdbdadbdaacbcbbca	TRUE
adbccccbcaadcddaccca	TRUE
adbdbdbbbdadbccdcbdb	TRUE
adcaadbbcacbdaacadbb	TRUE
adcbadbcbdcdbcbadcba	TRUE
adcbddccbadbabddacbc	TRUE
adcccdcbdaddacabdddc	TRUE
adcdcabdadacacadddda	TRUE
addabacdbdacabcadacb	TRUE
addbacabcdddaddcccdb	TRUE
addbdcbadaccbcabcadc	TRUE
addccdbbbcbbbdcddaad	TRUE
adddbccacbadaccddabc	TRUE
aaaaaaaacaabcdabbbac	FALSE
aabbccddbaadabccdbcd	FALSE
aacddababdbbaccbbddd	FALSE
abaadbaccbbbddccccda	FALSE
abbdbadbddbbabdbbbcd	FALSE
abdadabbbacbccacaaad	FALSE
acbaacbddbcbdcdbabcd	FALSE
acccbbdadbaadcbccabd	FALSE
adaadbaabddacccadbda	FALSE
adbdbcbbbddcccbadbca	FALSE
addbccdaabbcdbcbaaba	FALSE
babaaaadaccdccacbbbc	FALSE
bacaccdcdccaacaddabd	FALSE
badcbcdbdacaddbcdacb	FALSE
bbadcbabccbddabddaab	FALSE
bbcbabcdadaaabdacdcb	FALSE
bbdcbcbdccdcbdaabdcb	FALSE
bcacdadaaadcccabbddd	FALSE
bcbdcdaadadadaaabacd	FALSE
bcdabbaabadaaaccbcac	FALSE
bdabaddcabdbadbabcda	FALSE
bdbbdbcccdcdcaddddbd	FALSE
bdcbdbdbabaccbbadadc	FALSE
bddcdbdbdccdadcdcaba	FALSE
caadbddccabccbbcdaba	FALSE
cabddddcdaadcdacbacc	FALSE
cadbcacdabbabbaaaddb	FALSE
cbabccdcbaaddcaddccc	FALSE
cbbcccbcdadbbddbdbdb	FALSE
cbcdababddcccdadbdad	FALSE
cbddccbbacbadddbbbaa	FALSE
ccbadccbabdccdbaaada	FALSE
cccbcadbaaccbadacdac	FALSE
ccddcbabadbbbdbbcabd	FALSE
cdbaccbabbabcdadaabc	FALSE
cdcbadcdcccbabccabca	FALSE
cddbdabbdcbddabbbccc	FALSE
daacdbacccbbbbdacabc	FALSE
dacbaadcbdabdcddabcc	FALSE
dadbbadbbdcacbbccbdc	FALSE
dbabbccbbbadbbabbdab	FALSE
dbbbdadcadaacacbcdaa	FALSE
dbccccadcbacdcdaaaac	FALSE
dbddccdbcacdaacaccab	FALSE
dcbaabdbcabbabaaacbb	FALSE
dccaddbaadbdbabdcaaa	FALSE
dcdbbbadcaddaaacbdcb	FALSE
ddabcdaadaddcbaacdab	FALSE
ddbccbdcbaddcdbddccb	FALSE
ddcdbbcadaaabcbdccab	FALSE
aaaaaaaaaddcacbbbcccb	TRUE
aaaccccadcacdadcbcdac	TRUE
aaaddaccddbcacaccaddb	TRUE
aacbccdbcaacdcccacdbb	TRUE
aaccdcdcaddadacbdacaa	TRUE
aadaccacbdcbcccddcddb	TRUE
aadbdcaccadbcdbcdcddd	TRUE
aadcddaaacbddaacbbcad	TRUE
ababdadcddcdddccacabd	TRUE
abadbdacdbccdacbddccd	TRUE
abcadddddacdcadcdacca	TRUE
abcccbcdadbacabadcdbd	TRUE
abcddcdcadacbcbadbcdc	TRUE
abdbcccdcacccbdcbabca	TRUE
abdcddccbdccbcddcadbd	TRUE
acaacbcdacbccbddaadca	TRUE
acabddadadcddccbcacbd	TRUE
acacdaccdaaddacdcbdca	TRUE
acadcadcbdcaaaacbdcda	TRUE
acbaccabaccdbcddbacbc	TRUE
acbbdaccccccaacadccdb	TRUE
acbccbdacbcbbcbcdaddd	TRUE
acbdbbdbbdddadcaadacd	TRUE
accaaacbddaddccddcddb	TRUE
accadccadacaddccbcbac	TRUE
accbddaaacbcdcadcbdbd	TRUE
accccdbdbbbdbcbbdcccd	TRUE
accdcbcbdbcddccdabadb	TRUE
acdacdccabaccddbccadc	TRUE
acdbccaacbccccdacddda	TRUE
acdcbcbdcaaadccdcaddd	TRUE
acddacbcbbdbcddddacbc	TRUE
acdddccabdcadccdbddcc	TRUE
adabcccbcccdbcbdbdccc	TRUE
adaccaddcabdbcadbacdb	TRUE
adadadddadadbbcadccad	TRUE
adaddbdbcdbcacbdaccdc	TRUE
adbbcccacacaccdadadaa	TRUE
adbccacdbdaccacaadccb	TRUE
adbdacdbdaadbbdcccddd	TRUE
adbddbdbcdbcdacddadcd	TRUE
adcadbcbcdddbdbcaaada	TRUE
adcbdadbcdbccbbbdcadd	TRUE
adcccacdadaacdcdadddc	TRUE
adcdaccaddbcbcbcacdaa	TRUE
adcddcdcccaacadaadddd	TRUE
addadcabaddadadacbdba	TRUE
addbdaacaacddadadcddd	TRUE
addccabddddabcbccdccb	TRUE
adddadddcdcdbccccacdd	TRUE
aaaaaabcacacdaaabadbb	FALSE
aabbcbccddbcbcdccbbac	FALSE
aaccbdadcdacabcacabdc	FALSE
aaddcabbccabadbcbbcab	FALSE
abbaddabccdcbbdcacccc	FALSE
abccbbbdbbddddbaccaab	FALSE
acabaaccdacddabacbabb	FALSE
acbdacbdcdadbbbbadcca	FALSE
acdabdaddadcbddbaadca	FALSE
adacbddaddbbccbcbacda	FALSE
adcbbdcdbacbcdcaddcdb	FALSE
baabadadcacbbbbaacdcc	FALSE
babcacdbddbbadbccacca	FALSE
baccdcdbdacdcbcbbbccb	FALSE
bbaabddaaddbcdaaadacb	FALSE
bbbbbcabaabdaadbbdddc	FALSE
bbcbcccdbdabbabbaaabd	FALSE
bbdcdadbccbbbabcdcccb	FALSE
bcbaaaddcaccaaadcbbcd	FALSE
bccacadbbadaacadabcca	FALSE
bcdacdaddaacbccddcdab	FALSE
bdabdbbadbcbaabdbaadb	FALSE
bdbcacbbacbabcccabadb	FALSE
bdccbadadbdaadcbadcdc	FALSE
bddcbbbbadddddddcabaa	FALSE
cabaabddccdbbcbdbdbab	FALSE
cacbaccbbbdcacdcbacab	FALSE
cadbcbacdaadddaddcdcd	FALSE
cbadbcaccddddbccdaadb	FALSE
cbbddbcbbbdbaadbcddba	FALSE
cbdadcbaadaaabcccdbda	FALSE
ccabdcababccbdbcabadc	FALSE
ccbcbbdcdadcbcababbbd	FALSE
ccccdcacbdadccaaacdbd	FALSE
ccddcdbcadbbadacccbac	FALSE
cdbaccbbdbbbadaacddbb	FALSE
cdcadccddcccbacbadddb	FALSE
cddbdcdcbaacadaabbadc	FALSE
daadabbccaadcbbdcccda	FALSE
dabddaabdacdcbcbdaaaa	FALSE
dadacacaddbccdbcbdcbc	FALSE
dbabcabaadadbbbcadbcb	FALSE
dbbcdabddddbcbaaadcca	FALSE
dbdabaaddcbccdcbccddc	FALSE
dcabbcbdccabcaddaadaa	FALSE
dcbbdcbbababbacacbbdd	FALSE
dccdbddabbccbabadcabc	FALSE
ddaabcacdcaababdaaadd	FALSE
ddbbadbbdcbadcdbcddbb	FALSE
ddcccdccdbdcabdacadac	FALSE
aaaaaacccddcadcbcdccda	TRUE
aaaccaadbbccdaccbdccda	TRUE
aaadcccbdaadbdaddaadac	TRUE
aacbcacbdcddbbcbdaaadb	TRUE
aaccdaadccbcaadcdbbbdd	TRUE
aadacadbbddaadbdacddac	TRUE
aadcacaacadacaccaacaac	TRUE
aaddcaadcddbcadbcbcbdd	TRUE
ababddbcddabcdaddababa	TRUE
abadaccadabcbacadbdbdc	TRUE
abcacbdcccadbdcdcbcbab	TRUE
abccbdddabdbdabadcacca	TRUE
abcddbcaccdcbadcdccadb	TRUE
abdbcdadccdcdbadddccab	TRUE
abdcdadbadacbdcbcbccad	TRUE
abdddcdbdbabdcbcbaddcb	TRUE
acabccdddbcbcdcabacbcd	TRUE
acaccbadbddbdacdabdbad	TRUE
acadbabdcadbddbadbcdbd	TRUE
acadddddddcbcacdbcacda	TRUE
acbbdbcbcdbcccccdddcdd	TRUE
acbccdadbddbdacbdccdbc	TRUE
acbdcabdadbccbabcbacbd	TRUE
accabaddcabcccddcacacc	TRUE
accbacccbccdbacbdbcadd	TRUE
acccabadbabadcccccddba	TRUE
accccdcdbcaddcdbdcdaaa	TRUE
accdcaccbcabdcacccdcad	TRUE
acdaadaadcdadaacacaacd	TRUE
acdadddcaddcaddaddadbc	TRUE
acdcaacadbbcacbcbbccbc	TRUE
acdcdaadddcbdacbbdcdca	TRUE
acddcdbccabcbacdbadbdd	TRUE
adaaddbdaadbbcdacadbdd	TRUE
adacaddcbcccbbccccbcbd	TRUE
adacddbcadbacdcbddddcc	TRUE
adaddaccaadbbbbccdbcdd	TRUE
adbbbbbdacbcaadbdacdad	TRUE
adbcbddaadadacbddcacdc	TRUE
adbdabcdccddcadaccabcc	TRUE
adbddabccdcdddbcddcdcc	TRUE
adcadabadabdacddbcacdb	TRUE
adcbcdabdcbdcabdabdcba	TRUE
adccbcccbdaccaadbccdcc	TRUE
adcdacacdcaaaccaddcdda	TRUE
adcddacdbcbadaccccdbda	TRUE
addaccddcacbdbcbbcccac	TRUE
addbcbadbccdcabcbddbdc	TRUE
addcbddaaaccbdccdbcaaa	TRUE
adddadcddccadbdcdddadc	TRUE
aaaaaababcddcbdccbabdc	FALSE
aabbbcbccdbcdbbacdcccd	FALSE
aaccdabcbbaccbabcaabdb	FALSE
aadddaccdaadbcbadbdbdc	FALSE
abbbbbacacddcdcdbacaba	FALSE
abccccbdcbcccaabbaabcd	FALSE
acabaaacabdbdcdcadabad	FALSE
acbdaacaabdacbdacabddc	FALSE
acdcabdbdbaacacbaaadac	FALSE
adbacabdcddbcdcbdaaaab	FALSE
adcdcccbbbadcdcbcacccb	FALSE
baabaaddbdcabbbbadbacc	FALSE
babccbcdbcbabccbcdcbaa	FALSE
badaadadadababcabacdcb	FALSE
bbabcdcbcbaaccabcabdbb	FALSE
bbbcbcaabdaddcdcaaccdb	FALSE
bbcddbcaccccbcdddcbbab	FALSE
bcaabcacabaaaabbcadcab	FALSE
bcbcabcbdcbcadbdcdbdcc	FALSE
bccdadccabacccdddcacca	FALSE
bdaacdbdbdacabaadddbdb	FALSE
bdbcaccddadacacdbbccad	FALSE
bdccaadaaabdadaabbacda	FALSE
bdddabcdbcdcbaccdcacdd	FALSE
cabaacadcadbabcaabddcc	FALSE
cacbcdddcccdcbadaccbcc	FALSE
caddacdabbdddcbababaaa	FALSE
cbaddaacdabbbcabdacccc	FALSE
cbcacbdccddaadcdbacbbd	FALSE
cbdbccbbddadadcddcaccc	FALSE
ccacdbadabccaccddacadc	FALSE
ccbdbdcdddbdadddbccacb	FALSE
ccdabcbbaacaaccbcadaad	FALSE
cdabdbababbdabbadabdab	FALSE
cdbbdbabdcbcdbddcababa	FALSE
cdcccaabddabbaaabcdacd	FALSE
cddcdcbaaacabdadcccabc	FALSE
daadbabcbacadbcbadacbc	FALSE
dabddccbcbacacaaabdddc	FALSE
dadbaddabbbbcabaaaabda	FALSE
dbabcdcdabacbbcdbdbadc	FALSE
dbbcaadcabdadbacabcddc	FALSE
dbcdabaadbcdababdaabab	FALSE
dbddccccdbbabcbddbaadd	FALSE
dcbaadacaaaadadaabbcba	FALSE
dccacdacbbcccbcbaddadb	FALSE
dcdbcaddbabcaccdbcaaad	FALSE
ddabdaaaddbdbadadddaaa	FALSE
ddbccacacbdabccddcccab	FALSE
ddccddbdccdaadcccddccb	FALSE
aaaaaaacdbccdbccacbbddc	TRUE
aaaccbbcbdbbddbddaaadad	TRUE
aaadddbcccdaaddbcccdaaa	TRUE
aacbcdaddccbcccccdbcbdd	TRUE
aaccdddbddadcdbbbcbddad	TRUE
aadaacacbdcbcbbdaadacdd	TRUE
aadcbcbdacbcdbcdacbddda	TRUE
aaddccacacccbbbddacbbca	TRUE
abacabcabccadddaddcdacb	TRUE
abadbacdcbdcbddbccbccdc	TRUE
abcadbdbcaddadcddcbdcbc	TRUE
abcccbcdbdadcabcccddccd	TRUE
abcddbdddaddbddccacadad	TRUE
abdbcccdcabdccbdddcacac	TRUE
abdcddcbabadbdcbccbcbcc	TRUE
acaacbbccbcbcbddbbbbccd	TRUE
acabdcdcababcccbddcdaba	TRUE
acacccbdadacdbdcbbcdbda	TRUE
acadbbddccaccbdddcddadc	TRUE
acbacadadbadccccbadcbca	TRUE
acbcacabcbdbaccdadbacdd	TRUE
acbcddacabadbadacbdaddd	TRUE
acbdcddaadcccccccaadcbb	TRUE
accacdbcdadcbdcdbacbcdb	TRUE
accbcdbcabdcbdcccacccad	TRUE
acccbdbccdbbbdaadbdddcb	TRUE
accdadadcbdcbccddddddbb	TRUE
accddcccbdaaddbddacacca	TRUE
acdadaccbacccddcbcdbdac	TRUE
acdbccdaddacbbcdcadcaca	TRUE
acdcbbdaaadaaacbdcacccd	TRUE
acddabdbaddcabcdcddddad	TRUE
acdddacdcbddbbbdccdccbd	TRUE
adabadcadcddbcddbcdcbdc	TRUE
adaccbdacdcadabcdcacbab	TRUE
adadbabdacabccddcbccdbc	TRUE
adadddacaaacdaccbccddbb	TRUE
adbbcdcdacbbbbbdbdbcbca	TRUE
adbcccbcbbbbddacdbdbddb	TRUE
adbdbcdadaacaaddddcaccb	TRUE
adcaacbcdcaacdddccbccac	TRUE
adcbababdbacbabacadcabd	TRUE
adccaaacbbcbbdaacccbdaa	TRUE
adccdbcdabccbccbdcadadc	TRUE
adcdcbabdbdacbababdcabc	TRUE
addaadacaacdbdaddbdcdbc	TRUE
addaddbccdacccdabcbdcbc	TRUE
addbdccdaaddadadaaddcca	TRUE
addccbdadbcccdbabdbcddb	TRUE
adddbcbdccdbdaaadccdadd	TRUE
aaaaaccdcadabcbdbcddacb	FALSE
aabbbcaabcacbcdbcacdccb	FALSE
aaccabcdcddcadbaabadabb	FALSE
aaddabdbbacaabbcdcbdaba	FALSE
abbaccaddadaaaacbdcdaad	FALSE
abcbdddcbbdadcdaaacabbd	FALSE
abdddcabadddbcbadabbcca	FALSE
acbbabdbacbcbaacdbcdcaa	FALSE
accccddbdaddcbbadddccca	FALSE
adaacdabcbdaaacdbaaacca	FALSE
adbcccaadabbcccbdcacbcb	FALSE
addbcbdcbdddbccddaabaac	FALSE
baacdbbdcdbbdaacabcacdb	FALSE
babcdabbdbdbaddbdaadadd	FALSE
badaaabaadacaddbccccdac	FALSE
bbabbdaddadaccdbdcadbbb	FALSE
bbbbddbccaccccacacadaca	FALSE
bbccdadddbccccbdcbbdbcc	FALSE
bbdddabdbbcacadcabdcbcc	FALSE
bcbadcccacbcacbaabbddbb	FALSE
bccbcbbcacbccbaaabbccab	FALSE
bcdccbdabcababcdbdcacaa	FALSE
bdbaaccdaacdadabaddddaa	FALSE
bdccabaddbdddaccddbdbca	FALSE
bddcdcdaddbbcaadddbcbad	FALSE
caaddacdccbbdbdcdcabcab	FALSE
cacabcdbaadccdabcabbdac	FALSE
cadaddaddcbbaaccbbbbcad	FALSE
cbabcacbdabcdbcbcdcdbdd	FALSE
cbbcbbbabdabacccbcdbcbd	FALSE
cbcdaacababcbacbcbcadad	FALSE
cbddddbbdcbcabccacbbdab	FALSE
ccbaadcadcbbacbcdbcbbba	FALSE
cccbadcaaccdddadddababa	FALSE
ccdccdccaacacaccddddaba	FALSE
cdadadbccacccadddddcaad	FALSE
cdcabacdabdbabcddbcadca	FALSE
cddbcdcccdacccbaacdcdbb	FALSE
daacdacabcbabcbcacdadca	FALSE
dabddbdccdcaabaacbaacab	FALSE
dadaabacbddadbbddbaddac	FALSE
dbabbbdbacbcdbbccdaaddd	FALSE
dbbccdcbcbababcbbdcabab	FALSE
dbdaabcadddadbaccdccabc	FALSE
dcaaddaababbbbadcccbcba	FALSE
dcbccbaddbcaacadccccccd	FALSE
dccddbbbdbdbabddcbdbcab	FALSE
ddabccccbaddbcbaaacbbda	FALSE
ddbbbcacdacdcadaccacabb	FALSE
ddcdbdcaddabcabadcbcadb	FALSE
aaaaaaadaadbdddbbbcbccaa	TRUE
aaaccbccbbddacdacbbcdcdd	TRUE
aaaddcadccaaddacbcbccacd	TRUE
aacbccdcaaadcccdddcaacac	TRUE
aaccdddcacdbcdccdbdcdbcb	TRUE
aadacbbdccaddbdbbcdcbbcb	TRUE
aadcadaadcccacbccbdbdbcc	TRUE
aaddccadacccddaddcddaadc	TRUE
abacacccdacacbddbabcacdd	TRUE
abadbccddbdccacbcdadbcbc	TRUE
abcbacbadadcbabdacacbcda	TRUE
abcccdddccacbdcdadcddcbc	TRUE
abdabcaccdcbddadcbccbdcd	TRUE
abdbdcdadaccddddadccbccc	TRUE
abddadacdbdbdccdbdabdcba	TRUE
acaaccaaddddcdcacadccdcc	TRUE
acacaccbcadbdcabcabacdbc	TRUE
acacdbbbbdbddddcddcacaca	TRUE
acadbdddbadacdbadcadbadb	TRUE
acbabcdcbdcacbdbabccccdd	TRUE
acbcabcacaddcbdbdacacacc	TRUE
acbcdbbccccbdaacccbdcbbd	TRUE
acbdccdaacadbcaadcdcaadd	TRUE
accacbccccccdadbcbddaaaa	TRUE
accbbcccaacccddcdcdbbdcd	TRUE
accbddddbdacacacddbbbbcb	TRUE
accccddaddbcbcabcabddccc	TRUE
accdbdccbddcadccddcdbcca	TRUE
acdabcbcdcbccdabcabddadc	TRUE
acdbacdddadcabdaddcbcdad	TRUE
acdbdddcadbccbcdccdaaddc	TRUE
acdcdccccbdcadcadbbddadb	TRUE
acddcbdcbccdbddccacbcccd	TRUE
adaadddbbbbccdbbccdddcad	TRUE
adacbadaddabadbacccdacda	TRUE
adacdccabdcbabadcddcbdbd	TRUE
adaddabccdacbacdcbcbcddd	TRUE
adbaddbaddcacbcabdadacdc	TRUE
adbcbcdbcbcbddcbbcdcbbdb	TRUE
adbdaaddaacaaccadadcaaac	TRUE
adbddbdcabcbdcdcbddcadcd	TRUE
adcadaccccadddcdacdbbdda	TRUE
adcbcddcaccdbcddacddbcda	TRUE
adcccacddcbbbcacddacacad	TRUE
adcdadbcbabcdbdcbcaccdca	TRUE
adcdddcccdcbcccccadddacb	TRUE
addaddccdacbccdcdcdbdcdb	TRUE
addbdddddbadbdadbdabdddb	TRUE
addccccdcbaddbcdabcbcacb	TRUE
adddbacddbadcbadcbddaddb	TRUE
aaaaaaabcadaabbaacdcdadc	FALSE
aabbacdcacbdaddbcdbbaabd	FALSE
aacccabdbbacbadaadacabbb	FALSE
abaabaabdcccbddacadddbbb	FALSE
abbcaadbdcdcdbbcbcadabdd	FALSE
abcdbbabdacaabdcbbdaacda	FALSE
acaaaaacdccbbaabddddbadb	FALSE
acbbaabdadcabddcaaaaadab	FALSE
acccadbcaddddbdccaaabbac	FALSE
acddccabaccbbccddbbdbadb	FALSE
adbbcbaaccdbaacabcbdbbab	FALSE
adcdcbbcabddaaabccdcacac	FALSE
baaacdcddccdadcdcbdbbbba	FALSE
babcacccabcdadddccdcdabc	FALSE
badabbcbbdbacbadcaddccbd	FALSE
bbaadcbbcaddbbbaacbbcbac	FALSE
bbbbcccddddaabbcbbacbdda	FALSE
bbcbcbbadbdcaacacaacdcbb	FALSE
bbdcdadcadcccbadbbbbcdda	FALSE
bcbbaaadabdddccccadbcaca	FALSE
bccadbaabcdcaaaacbddcadb	FALSE
bcdbadbddabadabaccabadbd	FALSE
bdabdaddbbdabcbccbbdabaa	FALSE
bdbcdaabbbbcaaadaadccadd	FALSE
bddaadcddcbbbcdbcddcdcdd	FALSE
caabcabdcadcbabadbbbbcab	FALSE
cabccdbbbbdadccbdbbdacdd	FALSE
cacdacbcaadddbdcabdddcba	FALSE
cbaacabcbaccdbbdbabaacbd	FALSE
cbbbbadcadacccbaaacdbabd	FALSE
cbccbabacbbacdccdcbdcbac	FALSE
cbdddcacaabbbccdaaacabbd	FALSE
ccbaadcbbddacdcbbdddadbc	FALSE
cccbcbbacacddaabccbcdacb	FALSE
ccdcdccddccabdddcadcbcad	FALSE
cdaddbdaabcacadbdadbdcbb	FALSE
cdcbcadbacbbddabacdadadd	FALSE
cdddcdaaccaabbbdcbddcdbd	FALSE
dababacbadbbbdaabbdbdbbd	FALSE
dacacbcacabcacbdacbddadd	FALSE
dadbddcbcddaddadcaaaacbc	FALSE
dbaccaaabdbdccbddcbdbbbc	FALSE
dbbdaaabcabdaddbabbdddbc	FALSE
dbcddbbcccadadaccdbbbbcb	FALSE
dcabadddabaaccdccdaacbba	FALSE
dcbccccadddacbbcdcddbaaa	FALSE
dccddbbaaadcaddacabcabba	FALSE
ddaabdcacbbbcdabdcabbdbd	FALSE
ddbbcbaabddaaddabcbacbbd	FALSE
ddcdacbdaccdacdbbddacccd	FALSE
aaaaaaaaddccdbdccbbcaacbd	TRUE
aaaccdaacacbdddbdbddacadb	TRUE
aacaadbdbcadbbbcbddbbccac	TRUE
aacbddbdbdcbcdcbcaaaccaac	TRUE
aacdbbcacdcdcaaacdddddddd	TRUE
aadadbdcadaccadadbdddcbbd	TRUE
aadcaddaadddbdccaaacbcacc	TRUE
aaddcacbbdcacaaaacaccccbb	TRUE
abacbcdacdabdbaccdddababc	TRUE
abadcbccdcbddcdacdddcdaca	TRUE
abcadcdcacdacccdbdddbddab	TRUE
abcccbccccdbcadaccccabddb	TRUE
abcdddacadcacdacdabcddabc	TRUE
abdbcdabdacbcbabcdabadbcc	TRUE
abddacacdccbcadcdbcdbaddb	TRUE
acaacccdacccccbcbbcddbbbc	TRUE
acacacbcbdbbcddacddccccdb	TRUE
acacddaadddacacbdddddcdad	TRUE
acadccbddbbddadcdaadcdcbd	TRUE
acbaddacadcddacdadacbccab	TRUE
acbcbbdcbdbddacdcbcbccdbb	TRUE
acbcdccdcaacaadacdcbdbcaa	TRUE
acbdcdbacbccdcddbcdbcdbab	TRUE
accaccaaccadccdcdbcbdddca	TRUE
accbcaddddcdcdaaccaddddbc	TRUE
acccbaddacbcbcaccdbdbddca	TRUE
acccddccdcdddcbdadddadaaa	TRUE
accddaaaddddccaaddcbccaca	TRUE
acdaccdbdacabcdddbdacbdab	TRUE
acdbccddadbbccaaacdcbddcd	TRUE
acdcbddcdacbdbcbdadcdabda	TRUE
acddbacdadaccaddacadbcbab	TRUE
acdddcdddcdcddccdaddcbabd	TRUE
adabcacdcccabacbccdbaddda	TRUE
adaccbabdaccacdbdcdacdccd	TRUE
adadbcbcbcadcabdcdcddbacd	TRUE
adadddadaaccddcbdcdcbbcbb	TRUE
adbbccdaacbdbbcddaccadaca	TRUE
adbccbcdcbcdddcadbbdcbcca	TRUE
adbdadcadcacadcabddaccccc	TRUE
adbddbdcbdbddcbdbdabdccbc	TRUE
adcadbccbddddccbdaaadaaad	TRUE
adcbcdccdcabccdbcadbabccb	TRUE
adccbddcacccbcbdbcdaccacd	TRUE
adcdaccacaacaaccaaacdcbca	TRUE
adcddcccbadddbcaddbdbaddb	TRUE
addaddadbcdbcdcbcdcdcbddd	TRUE
addbddbcbdbbcdddaccdbcaac	TRUE
addcdaaadccbdaaddbbdacacb	TRUE
adddbcbccccdaccbddaddcddd	TRUE
aaaaaacdaabccbcaaadacbcaa	FALSE
aabbacdbbddccadbadbaacbab	FALSE
aaccaabcbddcbcbddaaaddacb	FALSE
aadcdcadbccadabdbaacdacba	FALSE
abbadbbabdcdcddbcacbadabd	FALSE
abcbabddaddcdbbdcdabddaba	FALSE
abdcbbaaaaacaacabddbcacbb	FALSE
acadaaddcbcddadddbdbbabda	FALSE
accbadaabaababdacbdbbbbac	FALSE
acdcbbcbdbdcabcbcbbbcdacc	FALSE
adbababbaadabbaaccacccaba	FALSE
adcdacbcdabbbadaabaadabbb	FALSE
baabaccaaabcbadbdadbddcdc	FALSE
babdbcbabbdcdccccbddbcbbc	FALSE
badabccbcdbdbcadcadbcaacb	FALSE
bbabccabddbbcadaddbcaaada	FALSE
bbbcbcdbdbbbdbbbbcdcadcdd	FALSE
bbcdabdbccdacaabcbabacdac	FALSE
bcaaaccccdadcdacdcccdcbad	FALSE
bcbbacccbbccadaabbbdddbac	FALSE
bccbdcdbaccadabcdddbdacbd	FALSE
bcdccddaddbbbaacbbadacdab	FALSE
bdbaaaaaadbdaddbcbdbcabca	FALSE
bdcbadaadaddbabcbbddcbbbb	FALSE
bddcdabcdbacaaddaddcbdcba	FALSE
caadababacadddaabadcdddba	FALSE
cacaacabbcadbbaabdaccdcdb	FALSE
cadbadbcacbcaccdaccdbacdb	FALSE
cbabccaacbbddddacdbccadbc	FALSE
cbbdabbaaacbaccdbdcaabcba	FALSE
cbdacbccabacbcaaacdbaadda	FALSE
ccabcdbbdbabdccacaacdbada	FALSE
ccbccbdbdcccaaadccbbdbcba	FALSE
cccdbbdddcdabdbdbdbbaaadd	FALSE
ccddbbddbdbcdbaddcabbdaaa	FALSE
cdbacbcdddacccdccdaaddadc	FALSE
cdcbbbaadbbacaaadbbdccbcd	FALSE
cddcacbccdaaddababaadacdd	FALSE
daadadbdccddcdddabbcbcbbb	FALSE
dabdcdbbcbcadcdbbbbdaadac	FALSE
dadbadcbaabdadaabcdaadbbd	FALSE
dbabcdddaaacddbabbbaddbca	FALSE
dbbcaaaadbcaabaabbadaddbd	FALSE
dbdabddaabdbcabcaddcaacdc	FALSE
dcacaadaaaabcbdacbbbadbcd	FALSE
dcbccdcdabbacbcccbcdbdcbb	FALSE
dccddbcbdbcbbadbcdadaacda	FALSE
ddabcbdbccbdaabcdddacbddd	FALSE
ddbcabbcbccdcbbcadabcabaa	FALSE
ddcdbbbcdccadabcacbadacba	FALSE
aaaaaaaadaccbbdcbcbcccdbcc	TRUE
aaaccbbdbdaacacdcacbbbbdda	TRUE
aaaddadcccaccdadbdbccccbdb	TRUE
aacbccacdbbcbbcadcaddcdcda	TRUE
aaccddadccdbbccdcdbbdcbbdd	TRUE
aadacaddaccdcadadbdaaadbcc	TRUE
aadbddaacadcdddaadbcdadbbb	TRUE
aaddcbbdccbdccacadaadcbcbb	TRUE
ababddabdddacdacdababcabca	TRUE
abadbdaddcacddcbddadaccddc	TRUE
abcadacdabadcbdccdcdccdbcb	TRUE
abccaddcdcacdcbdccacccdcda	TRUE
abcdcabdadcbabddcbcdadcabd	TRUE
abdbabacbadaddacbdcacbabcd	TRUE
abdcbdcabcabccabcadcdcddba	TRUE
abdddacacbdccdcabddadabcba	TRUE
acabcbccbcddcacbcaddabcaba	TRUE
acaccbcdbbddccdacdccadbbcc	TRUE
acadbcbccacdbdcbadbcdbcbdb	TRUE
acbabcbcdacdbcbabcadddddad	TRUE
acbbdaadccbcdcdacbbcbccdcc	TRUE
acbccdabdadbdccaddbacdccad	TRUE
acbdbdbcdcbdbcccbccccdcdab	TRUE
accaacbdcbcdddcdaadcddbdcd	TRUE
accbaddbdddbcdabddbdcdadcb	TRUE
acccaadcdcaadddacddacbdbca	TRUE
acccdbdabccbdbadcccbccbabd	TRUE
accdcbbbbbbcaccbdbccdcbcac	TRUE
acdaccabadabacaddcbacbcacc	TRUE
acdbcccdcacddbcababdabadcc	TRUE
acdcbdcdcdaccacddabadacbcc	TRUE
acddbcaccccdbcdadbccbcacca	TRUE
acddddcaacdacddacdbdcdbdac	TRUE
adabcdadbddadcdcdbabdadacb	TRUE
adaccabcbddddccacabdcbadac	TRUE
adadadbcacbbcdbbcacadbdcca	TRUE
adadddaadccddbbbcacbbcaddc	TRUE
adbbdaacbcddcadbcccacddbdb	TRUE
adbccbcadacacbadddcccddcab	TRUE
adbdbcacdddddbcabccacbdacc	TRUE
adcaacaaccadcdaadbccdddcad	TRUE
adcadcddadbdabacbcccdabdca	TRUE
adcbdcabcabcabddcadabccbcd	TRUE
adccccacadbaccaddcdbacdccd	TRUE
adcdbababdbadcdddccdbdadcd	TRUE
adcdddcdbacdabcadcddabdbad	TRUE
addadcaacdcbdccdcdaadaaacb	TRUE
addbdaadcbdbbcadbcaaacbcac	TRUE
addccbbbdccdadcbbccacdaadd	TRUE
adddbcaddcbbcdbbbdcacadcdc	TRUE
aaaaaabadaddbcbaddacdccaba	FALSE
aabbbbcaaaabacbbcbabdcacbd	FALSE
aaccbdccacddcaabdbbddcdacb	FALSE
aaddddccbbcadaddbaaadddcba	FALSE
abbbbadaadabbdbbccccbccaca	FALSE
abccdbcadcbdccbbdbdadccdaa	FALSE
acabcbdbdaddacaadadcdbcacc	FALSE
acbccbdbcddadbaaabaaddbdcc	FALSE
acdadbbadcbbbcbccdacbaddbd	FALSE
adacacdbbdbccbbaccbadabdad	FALSE
adbcccaccabcbaddaacbccaabd	FALSE
addbaadbcbcabcddaddccadacd	FALSE
baaccaccdadadcadbabccabcab	FALSE
babdddaabcddaaaccdaaabccac	FALSE
badaccabdbcdbcacbbaabdbbdc	FALSE
bbabbabbbdadabbbabdbbdbdbc	FALSE
bbbcacdadddabbabcdcdbdbddc	FALSE
bbcdbcaabbabccccbbdddadddb	FALSE
bcaabccbdacddabcbccdbaabac	FALSE
bcbbdadccaadbcdcabcbbbcaac	FALSE
bcccdccabaaadbaccdcdacccac	FALSE
bcddcbabcbadddabadcabdcbab	FALSE
bdbaadabdbcaaaababaaaacbcb	FALSE
bdcbbbbdcbbdbadbaccbdcacac	FALSE
bdddaddccdcacabbdadacaaadd	FALSE
caaddacddcaacdbdcbcddbbadb	FALSE
cacaaacdcbbbabdbbbdbbcadac	FALSE
cadacaaadaccacbabdadcdcdca	FALSE
cbababcabcccccdccdbbacdcab	FALSE
cbbcbaabadbccaabdccbcaddda	FALSE
cbcdcddcbcdcaadcdbdaddccaa	FALSE
ccaaccadabaacbddcadbbabada	FALSE
ccbbbcdbdcbcadaaadaccbaccb	FALSE
cccbdbddacdccaccdadcbdadac	FALSE
ccdcdaabdddccdaaaaacdcbbcc	FALSE
cdadcccbbacccbdddbdbddccaa	FALSE
cdcabacadcacacadaacdbdcdcc	FALSE
cddcbbbccdacbdacadacddbcdd	FALSE
dabaadbcacabdcadbdcbabbbdc	FALSE
daccbccdbbacdcbcabddcddcab	FALSE
daddbadcdaaacdabcdbdbbccdb	FALSE
dbbabdabbddccbdbcaaaabcbcc	FALSE
dbcadccbacccbcabbbcbcdcddc	FALSE
dbdcabdbcaddbccdbbaabcccbc	FALSE
dcacddbaaadaabbbcccaabbaad	FALSE
dcbdddaabcdcddbcadadcbcdbb	FALSE
dcdadbdacacdcccabbaadaadaa	FALSE
ddabccacbdadadadbcdcbdbdab	FALSE
ddbbdbcdbabccacdbbdcddbbac	FALSE
ddccbdaabaaddacdbddaadcabd	FALSE
aaaaaaccbbcdadbbccbdcccccbc	TRUE
aaacccaadbcbbbddaacbddcacaa	TRUE
aaaddcbdaadcadcdacbdbbbccbd	TRUE
aacbcdaddbbcddbdadcdadddddc	TRUE
aaccdbdbccdcaadaccaacbcdbbd	TRUE
aadaccbddacbdcaacaadaaaaaaa	TRUE
aadcadcddacdddbcdbcddccdaaa	TRUE
aaddcdacbbbccbdcacdacdbbdbc	TRUE
abacaccaddcbadaccabacbcbcbd	TRUE
abadbacabcadbcddcadadaddcbc	TRUE
abcaccabcdadabadbaddddcadad	TRUE
abccbcdacddbaddcdcdccccbacc	TRUE
abcddccdbddbcddadcdadbcdbcc	TRUE
abdbcbdbcdbdadcdcdacabccadb	TRUE
abdcdcbcadddcdbadcacbcbcbda	TRUE
acaaccaaaadcbcbdccdcbbdddaa	TRUE
acacacbcaccdddaacaccdcacccb	TRUE
acacdbccbabdbcbdcdbccacacac	TRUE
acadbdcdbbbccdadbddddbbddcb	TRUE
acbacdbaccbaccabcadcdaccccb	TRUE
acbcacddbcccdcbdadadcdaddbc	TRUE
acbcdcdcbcdbbccadbbdcbcccca	TRUE
acbdcbaccdbacdacacacabdbdca	TRUE
accabcdcccdadcdaddcccccacdb	TRUE
accbbcbccdbdbcdadbbbbccdbca	TRUE
acccaadcbdcdcaccccddcccdaac	TRUE
acccdbbdaaadbdbcdcbdcddccaa	TRUE
accdccbcdaccbddccbcccddccba	TRUE
acdacbcbadcdbadbcadaccddcbd	TRUE
acdbccdcdbdacacabacdaddbdcc	TRUE
acdcbcdbaddadddcaccabdcbddb	TRUE
acddabacacddaccacacabcacadc	TRUE
acdddccacaaacaacdcaaaccddad	TRUE
adabccbcbacdbccddcdcdccbdba	TRUE
adaccccbacddcdbaddadcacaddb	TRUE
adadcadcdcbccdcadcdadacbcad	TRUE
adbabdddaccacbccdbdacabdada	TRUE
adbbdddbddbcdacdbcaacbcdadb	TRUE
adbcccccbcddddabccdbacbacda	TRUE
adbdbadcccccabdccbcbadadbca	TRUE
adbdddcdcbdbadcddccdacbdddd	TRUE
adcadbcdbadacccbabadadbdddc	TRUE
adcbdbcadbdabacadcddabadbcb	TRUE
adcccbcadcadcddcbddbbbcaccc	TRUE
adcdadcbcccacbdcbdaacaaadaa	TRUE
adcddccdbddbcdadbcbdcdcbcbd	TRUE
addadbdccccbdccdddddcbdccbc	TRUE
addbddaaacdbbccacbdcbcaddaa	TRUE
addcdaaccddcdadbbddcdbbdacb	TRUE
adddbcdaddbddcdcccbddbdcdbd	TRUE
aaaaaaacadbbbbaddccbccdaaca	FALSE
aabbdaadbbaaaccdbdbbdddbcdb	FALSE
aacccacccdbacbccabdabdddaca	FALSE
abaabacaacdbdbacaadcadaacac	FALSE
abbbdddccddbbbdddadaadcdbdd	FALSE
abccdaddcdbdbddadaacadcadab	FALSE
abddcbababdcbaaadaccbaaccdc	FALSE
acbadcaccdaaccadcabbcabcaac	FALSE
accdbbbcbbabbcadddaaababcab	FALSE
adabcbcddcddbdbabdcdcbbaaba	FALSE
adbcbdbbcbdadcbbcbadccddcdb	FALSE
addadcabdbddbcaacccbcdcbbcc	FALSE
baabdacbbdadacdbdbcdacdbdbb	FALSE
babcadaaccbadcdbdbbbadbbcdd	FALSE
baccdacbbbbdddabacccbdbacac	FALSE
baddcdadaccdaddddddcbddacaa	FALSE
bbbbaadadccdabadcbbacdaddad	FALSE
bbccbbddbcdabdbabcaadccbbac	FALSE
bcaacabadbbbcbbbcdbdabcadbb	FALSE
bcbadadcacaaaacaacddaaababd	FALSE
bccbbddbdbbbaaddcacbbabccdd	FALSE
bcdbcdbabbdbbdcacaaadcddcdd	FALSE
bdadacbbbbbccabcaacaaabcbab	FALSE
bdcaadddbbdcccbaccbdcbcdbbd	FALSE
bddacaccbdbdccbabbdcbdbbddb	FALSE
caacbadaccbadbbbabbcadbabad	FALSE
cacaaabaabddcccddcaadcbabac	FALSE
cadbbaaabbbbdccaaadccdaacdc	FALSE
cbabbcaadbababbdadaacaacabd	FALSE
cbbcdbcdcccacbdccdaccddbaaa	FALSE
cbcddaaccdcccadabbbbadcacba	FALSE
ccaacacccbdcdacbbbccaaadbaa	FALSE
ccbbabbbbdddbcbcaadccdccdaa	FALSE
cccbcccbcdaabbacbcabdacdbbd	FALSE
ccdcacabdabbaabdccacacbbddb	FALSE
cdadcbdddbddadcbdbdbcdcbcab	FALSE
cdcabdbdddabbbdccccacbccdbd	FALSE
cddbbbabbcabbcbabbdbbdcaacb	FALSE
daacbadcdabbccbcdbbbdcdcbcc	FALSE
dabdbdaadbabcadcabaadadcdcb	FALSE
dadababdbacdcdacbaadbccacac	FALSE
dbacbbbbbcdcccaddbddaaaccba	FALSE
dbbddbdbbdadaccadcbbcbdbcad	FALSE
dbdaccaabcaababcddbdbabaadd	FALSE
dcabbbabccbaacbbccddbcbabda	FALSE
dcbdadccadbddbdabdcdcdbbcaa	FALSE
dccddcaaabcadbbbdddaacdbacb	FALSE
ddabababdccacabadbcabbbbacd	FALSE
ddbcbadacddccaccacbdbdacbdd	FALSE
ddcddbaabccbbbaabdcdbcdcdbb	FALSE
aaaaaaaccbdddadaacddddcbbcac	TRUE
aaacccddbbbddacccadadbbcbbda	TRUE
aaaddadddbbdbccbcacddddcdbcb	TRUE
aacbcbcacccbddaccdadaddaadcb	TRUE
aaccdbcbdcbcdccadacadddacdad	TRUE
aadaadadbccdacbcbcdacbdbbdac	TRUE
aadbddbdbcddacacddacdbdcddac	TRUE
aaddaddcdbdcbcccbcadbddaadda	TRUE
ababdbaccdcdbdddbddbddbcdccb	TRUE
abadadccdddcadcdabcabddcacda	TRUE
abcadcadbaddacadbaccdabccdda	TRUE
abccccccaccbdabdbddaddcdacdb	TRUE
abcddcadcabcdcbacacdcacdcbcd	TRUE
abdbaddcdbcdacbcdbdaccbabcbc	TRUE
abdcccccaccdaccadbccacdcbddb	TRUE
acaaacacdcbccbccccdbbbccdbbb	TRUE
acabddbdbccbabdbddbaddcddbdd	TRUE
acacccddbdaaaddccaaaacaadcbb	TRUE
acadbdcddcabdacddcdacbcdbaba	TRUE
acbaccbddbddacbabacddacbddcb	TRUE
acbbddacbcbdcaccaaddcbbbbdad	TRUE
acbcccadcbcdacadcddddabcbadd	TRUE
acbdbcbabddacabcccdcccadabcd	TRUE
accaaaaddbddddacccadcccacbcc	TRUE
accaddbddddddacacbcbcabddacc	TRUE
accbdbddadcdbbcbbbdacdddcdcc	TRUE
acccccddbcabcacdbcacccddbaca	TRUE
accdcabdbacdccacddaccdabcabc	TRUE
acdacbbddcdaddbbccacadadbdbc	TRUE
acdbadddddadacdacbcbdadaccab	TRUE
acdcacabcbddcdcbcddbabacadcc	TRUE
acdcdbcbdbacbabdbdabacddbdbd	TRUE
acddcaddbdbccccacaacdccadaca	TRUE
adaacddccdccbddddcaddbcbdccb	TRUE
adacaccccabdbccaccacacdbcdbd	TRUE
adacdabadddbadacbcdddadccbdd	TRUE
adadbdbccdccddabccacddbdacca	TRUE
adbaccbadccdbcccaccbcdbcccbd	TRUE
adbcacddbccbcdcbbbcbdbdddcbb	TRUE
adbcdbdacaddbbdddbdcbbcbcbcc	TRUE
adbdcbdabcdcdabdbcbccadabdcc	TRUE
adcaccadaadadacaadaadacaadcd	TRUE
adcbcbabaddbdacdbcacabdccacc	TRUE
adccbadccbdcbcbdbdddacdabcab	TRUE
adccddddbcbcdbababaddcabdbad	TRUE
adcdddbcddbadcadccdbdccabccb	TRUE
addadddbccdbabadcdddbcadbabc	TRUE
addcabacdcabadcabdadbdbabcba	TRUE
addccdcdadccadcddccbdadbccab	TRUE
adddbdabacadaddbdbdbcdbdbcdb	TRUE
aaaaaabaacbbdbaaccbadbadddaa	FALSE
aababdccbbccacccccbccdbcdcbc	FALSE
aacbdaaccabcacadbdadddcadbcd	FALSE
aadcddadaaabcdbdadcbbaadbabd	FALSE
abbaabacdadcddcaadacbccadccc	FALSE
abcbaddbdcaacdbdaccbaabcccbc	FALSE
abddcbbdabdadcadccaacdcbdbab	FALSE
acbbbdcbadddbbaaadddacaddbcc	FALSE
acccadcacacababddacadacbccbb	FALSE
acddbddaddcddaddcababacaaaaa	FALSE
adbbdadbcbadcacdcbcddadaaacb	FALSE
adcdbbbcbcaaaccbbcaabdacaacd	FALSE
baaaddcacaddbabcabccddddbccc	FALSE
babbddcdabaabbadcdaaddaaddaa	FALSE
bacdbdcbbdbccdbdbdbabdcbbddb	FALSE
bbaabdadcdccbdaccabdaacccdba	FALSE
bbbbdcdacadadaaaadbbccacbcac	FALSE
bbcdddabcbdbadbadadacdcbcbdc	FALSE
bcabaababbaaaccacadbcaabacca	FALSE
bcbcabbcddbdaadaddcddbbbcccd	FALSE
bccdacadacdaaaddadadcadddadc	FALSE
bdaaabbcddbaaabccabccddacdbd	FALSE
bdbbbaadbdadccddaccccbabdbbb	FALSE
bdcccabccacdbacdbcbdaabacccc	FALSE
bdddddbcdbcaadacdacbddcbabca	FALSE
cababccccabdabbdbbadddddddab	FALSE
cacbbdadacaacdddbdbbbbdbddad	FALSE
cadcdaadccdadbcbabbdadbcbada	FALSE
cbadcaccacacabcacbdcdadbaacd	FALSE
cbcbabbacbadbbbbcdbcbdcbcbcd	FALSE
cbdbbdbabddacbacbcdabaaabcda	FALSE
ccacdadadbbdcdcdaddbdbddbbbd	FALSE
cccaaccbabdbaccddbccabdbdcca	FALSE
ccdacdaabccccadbababbdbcdcca	FALSE
cdabaacacadccdbbcccaddcacaab	FALSE
cdbbdcbcababddabdbadbdddadbd	FALSE
cdccbbcbcadaabcdbcadbdaaaaac	FALSE
cdddabdcbdadcdcccccbbaccbbca	FALSE
dabaabcbbabdbadbcdacbbbbdaad	FALSE
dacacaadcadacbacbdcbbcbddccb	FALSE
dadcaadabccacbcabbcbccdaadbb	FALSE
dbadaacdabbadcddcbbbbbadbbab	FALSE
dbcabcbdcaccadcaadbbaacabbbb	FALSE
dbdabbadbbcabaabcbcabdcadbbc	FALSE
dcabaccdbaacdcdbcaacccbdaccc	FALSE
dcbcddbdabaaccabbabbbcbbabbd	FALSE
dcdabbbadcdaddcbbaaaddabacda	FALSE
ddaacbdbcbddacdbddadbcadddcb	FALSE
ddbbdbbbacabcdcbbdbccbddaacd	FALSE
ddcccabddcbabababaabbbbcccbd	FALSE
aaaaaacccdddacaddccbbdddbcbda	TRUE
aaaccddddcadddbdbcdbcccbdcadc	TRUE
aaaddcdaadadbdadcdcdcbdbcaccd	TRUE
aacbcdcadbbbdcddcacadadcacbcb	TRUE
aacdbccaccdadcdbddcaccbbddbbc	TRUE
aadadbdbdcbcdbbdaddddbcccdadc	TRUE
aadccaddddcaccdbcbcadddcccbcd	TRUE
aaddddcdcbddadbbccdccadaacdbc	TRUE
abaccabcacdbdddadacddadaccdcb	TRUE
abaddccbacbccacbcacddacacacda	TRUE
abcbcddcacccbdbccbadbcddbcdcd	TRUE
abcdacbdcacadddcddcabcddadbcb	TRUE
abdacccabacdcaccddadabdabdbdc	TRUE
abdcacdddabdcbdcacbcdacbdccab	TRUE
abdddacdbcbdacdddcccadaddddac	TRUE
acabaddabcbabaccadddacacbdddb	TRUE
acaccabdadbccdabcbddaccabcdcc	TRUE
acadacccaddcccbdbcadabaddccdc	TRUE
acaddbbdaadbdcdbcdbcbbcdbdbdd	TRUE
acbbcbbdaacccdcdcccdadacdcadb	TRUE
acbcbdcacaddadcddbadaccacbdac	TRUE
acbdacaccbddcdbbdcccbbdccdcac	TRUE
acbddbccbcadcacddcbcbdacdbacc	TRUE
accaccccddadcadcdadbdddadcbdc	TRUE
accbcaddddcdcdaddcbccadcddacc	TRUE
acccbcbbcccdbbbdddacdacdaadbb	TRUE
acccddadccbbbbcacbbccacbddcca	TRUE
accdcddccaadaccaacbcbcbcdadca	TRUE
acdaccadbdbddddbccdcdcabdbdbc	TRUE
acdbcbcdaadcbddccacbddbccbbdc	TRUE
acdcbbbcddbbbbcbcacdbbbbddaaa	TRUE
acdcddcdadcddacaddcbddaaaddaa	TRUE
acdddadcddbdacccdbccbdbdabcad	TRUE
adaaddbdadbdbbdadbddccdbdbbdc	TRUE
adacbdccbdbdbcdcccddaddccddcb	TRUE
adadadccddacaddcddbcdccbcdcdc	TRUE
adaddddaaadadaccadacacaacaadd	TRUE
adbbcdadccdcbcbdadcaaacdcbdcc	TRUE
adbcccccdadbcddadcbabcdcccadd	TRUE
adbdbaccadbaddcbcbabcccbcddbd	TRUE
adbddcadcbcdbbbbdbbdaaadccacd	TRUE
adcadbddbdcccacdcdddbccddbcad	TRUE
adcbdacadcaccadacaddabcccabcd	TRUE
adccbddaccbcddaddabacddbadacb	TRUE
adcdacacacbacddaccddabacbcada	TRUE
adcddbcbdccbcccddaadcbdacdcdb	TRUE
addacdbcdaddcccacbddbdadacaad	TRUE
addbccbdabcaddccddbcdabdcbaca	TRUE
addccaacacacddadaccacaddbcacb	TRUE
adddbcbcadaddacbdabadcdacdbdc	TRUE
aaaaabcacacaabdcdabdaabbaccdb	FALSE
aabbdbaddaccbcabcbddbcdaabbbd	FALSE
aaccddcdcddbacabbaaacccccbccc	FALSE
abaaaabacbabbdcdbabccbaccaaad	FALSE
abbbaacdcacccddcccadaaddaaacc	FALSE
abcbbdbccaabcacddacbdcdaabdba	FALSE
abdcbdbcaadbdaaddbcbaabaddbbd	FALSE
acadbcbddabaaacbabdbddadccadb	FALSE
accaabdbcbaccdbaadcbbaadccadb	FALSE
acdbacbddaadcdcacbdddcadccdcd	FALSE
adacccabddbddcdcbbcbbbacdcadc	FALSE
adcabbdbccbdbbaabbdacddddbcac	FALSE
addbbcbbcbacabddbcdaddcbaabcd	FALSE
baacdacccbaadbaacacadbccaacac	FALSE
babddbcaadbdaabcdbcbadcdadccc	FALSE
badabccddddcadbadadbbdabdcccd	FALSE
bbabcaadcbacbcdcbaadbbcdcbcda	FALSE
bbbcaadbacdadaabbadddaddcdada	FALSE
bbccdadadcaccacabddacddcbbcbc	FALSE
bbddcccaaadcbbcdcccabdddbbdcd	FALSE
bcbacacadbdbbdbddcaaacbcdbcac	FALSE
bccbcdbbbacbabadabbccdbabbcdd	FALSE
bcdcbbacdcdddcccdbccdbabacabd	FALSE
bdadcddaaabbddbcabbcdabaccacc	FALSE
bdcbdabbbccacbabdabbaccddbabd	FALSE
bddcddbbaadcbaccbbbcabbbcabad	FALSE
caadadbcabadacacdadacdcaccdcb	FALSE
cacabcbcdbdbcadabdcbddbdddcba	FALSE
cadcaacbcaadcabaabababdbdbcca	FALSE
cbadacabaacaabdadbbcbbacabdca	FALSE
cbbdcbbddbadbacdcbdcbbdcdabdc	FALSE
cbdaddadbcbbdccbabaaaabccaadd	FALSE
ccacdadbbabcbdbdbddaadaddbccc	FALSE
ccbdbdacadbdacaacccccabdabaac	FALSE
ccdadcacdbabcdcacbdadbbccbaca	FALSE
cdabcaaadcdddaddadbccbdcdbddc	FALSE
cdbcacabaadddaccadcbbcccccbda	FALSE
cdcddbdadcbbccdbdbcbabcbbbabb	FALSE
daabbacadbacbbcbdcdbcdbdcbbdb	FALSE
dabdbcdbdcdcdcbaddbdaacbccbbb	FALSE
dadadcabcbabcbabdbbbaadcbaacd	FALSE
dbabdccabababcabbccbbcddddcac	FALSE
dbbdcbabbddabccbddaacaacddaaa	FALSE
dbdbdabaaabcbbdcadcacbbcdcdaa	FALSE
dcacadbbcccadbdacacdadbbcccdb	FALSE
dcbdabdbdacccbbdabadbadcbabca	FALSE
dcdaaaadacdbcbabdcdaabbdbacbd	FALSE
ddabadbaddcabdbdccaaacbccacbb	FALSE
ddbbdacbaccbdcaabbacdacabbaca	FALSE
ddccdddbcddccadcbaadbaaaaadba	FALSE
