aaaaaaacdccbbadaadabadbbbbbbaba	TRUE
aabbbddaadaaaaaccabdcccbdabbadc	TRUE
aadbbcaccdccaabdadbdaccacabacac	TRUE
abbadbdbcbbacdaabcdabcabcbaccab	TRUE
abdbdbaabdcacbdccbadababbdabcbb	TRUE
acccbbcaabcacacaccbcbcccdacaacd	TRUE
adbbbdbddbcaddaabdddcaabcbbacad	TRUE
addcbadbdcccbabbbacbcbddccacabb	TRUE
babacdbbcaccadbdbccacbbccacabaa	TRUE
badaaadaddcdcbccdadddbabccbbaab	TRUE
bbacaccbcbcbabdbaacaacaabaccbad	TRUE
bbccbdcaaccabaccaaabacdabdbbadc	TRUE
bcaacbbbcbbcccacdabcaaabadbbabd	TRUE
bdababccbbbdbcbbbaccbbacdababba	TRUE
bdcbcbabacabbabadaddaddbddcbdbc	TRUE
caddaaccdaddbabaddbdbdadbdbbcbb	TRUE
caccaccbaaccbabbadaabcabbdcabba	TRUE
ccbbcbcabdbcbcbcccbaaabadcbcbcc	TRUE
daabaddadaadabcadcbcadabbcacbca	TRUE
dabdddbdddbbdaacabadbdabcdaaddc	TRUE
dbaabdaaccacaddbdbbaaadabaaadcd	TRUE
dbbddbdcbbdccbbbcbbabbacaccadac	TRUE
dcabbdddbcacbbcbcbdbbaaabbaaaab	TRUE
ddaadbbbbabcdbddbdadcaaabbbcddd	TRUE
ddbddaacbddadaabdacddabaadadcbb	TRUE
aaaaaaacccbbadaadabadbbbbbbaba	FALSE
aabbbddaadaaaaaccabbcccbdabbadc	FALSE
aadbbcacccccaabdadbdaccacabacac	FALSE
abbadbdbcbbacaabcdabcabcbaccab	FALSE
abdbdbaabdcacbccbadababbdabcbb	FALSE
acccbbcaabcacacaccbcbcccaacaacd	FALSE
adbbbdbddbcaddaabdddcaabcbbacab	FALSE
addbbadbdcccbabbbacbcbddccacabb	FALSE
babaadbbcaccadbdbccacbbccacabaa	FALSE
badaaadaddddcbccdadddbabccbbaab	FALSE
bbacaccbcbcbabcbaacaacaabaccbad	FALSE
bbccbcaaccabaccaaabacdabdbbadc	FALSE
bcaacbbbcbbcccaccabcaaabadbbabd	FALSE
bdababccbbbabcbbbaccbbacdababba	FALSE
bdcbcbabacabbabadaddaddbddcbcbc	FALSE
aaddaaccdaddbabaddbdbdadbdbbcbb	FALSE
caccaccbaaccbabbadaabcabbacabba	FALSE
ccbbcbcabdbcbcbcccbaaabaacbcbcc	FALSE
daabaddadaadabadcbcadabbcacbca	FALSE
dabdddbdddbbdaacabadbdabadaaddc	FALSE
dbaabdaaccacaddbdbbaaadabaaadcc	FALSE
dbbddbddbbdccbbbcbbabbacaccadac	FALSE
dabbdddbcacbbcbcbdbbaaabbaaaab	FALSE
ddaadbbbbabadbddbdadcaaabbbcddd	FALSE
ddbddaacbddadaabdaaddabaadadcbb	FALSE
aaaaabbaaadbdbcabcacabadacacadbb	TRUE
aabdaaddbcacacacbbcbbaadcadbddbc	TRUE
aaddabadbbdbcaaabcdbbccbbcdaadbd	TRUE
abbbdbcdbbbbddcbbaccabccdaacbbac	TRUE
abdcdddbadddbabcbddbadbbbdabcbcc	TRUE
accbccbaadacdbaaaabbabacbcbaaaaa	TRUE
adbabadbbcbccbbaccbdbdaaddcdbbaa	TRUE
addbbcdbddabbaabaaccabaddddaabba	TRUE
babadadbcddddacadbbbcacccbcbbcca	TRUE
badadabbddbbadcbddccaccacaaddcab	TRUE
bbaddbabbcdaaddcddbbabbadabbbbda	TRUE
bbcccacaacbcccadbadcbbacbcabdbca	TRUE
bcabdcaaacbcbdddbbdacbbbccaabcaa	TRUE
bdabbaabdabaccdaacacababbccdcaaa	TRUE
bdbdbddbaadadbaabccadcdaabbbacba	TRUE
bdddddbdabaddbdcadcbccbbcbccadcc	TRUE
cabbaccccbcbbbbdcaaccacccabbdbca	TRUE
ccaccbdaaaacacaaacabccaccbbaadac	TRUE
daabaabddbaadbadcaaccabacdbcdbdd	TRUE
dabddaadabcbccaaaccbdccaabbbadca	TRUE
dbaaccdcbbbacaaaacaadbadabddddbd	TRUE
dbbdaababbaabbcbccacbbadbcddbcba	TRUE
dcaaabaaabbdcaabbdbdbbbabadbdddc	TRUE
ddabbddabdcaaaabcbbaccbdcaadddbd	TRUE
ddcabbdddbbcadbadbbbcabbabbcabcc	TRUE
aaaaabbaaadbdbcabcacabaaacacadbb	FALSE
aabdaaddbcacacacbbcbbaadbadbddbc	FALSE
aaddabadbbdbcaaabcbbbccbbcdaadbd	FALSE
abbbdbddbbbbddcbbaccabccdaacbbac	FALSE
abdadddbadddbabcbddbadbbbdabcbcc	FALSE
accbccbaadadbaaaabbabacbcbaaaaa	FALSE
adbabadbbcbccbbaccbdbdaaddccbbaa	FALSE
addbbdbddabbaabaaccabaddddaabba	FALSE
babadadbcddddacabbbcacccbcbbcca	FALSE
badadabbddbbadbddccaccacaaddcab	FALSE
bbaddbabbddaaddcddbbabbadabbbbda	FALSE
bbcccacaacbcccadbadcbbacbcabbbca	FALSE
bcabacaaacbcbdddbbdacbbbccaabcaa	FALSE
bdabbaabdabaccaaacacababbccdcaaa	FALSE
bdbdbddbaadadbaabccadccaabbbacba	FALSE
bdddddbdabaddbdadcbccbbcbccadcc	FALSE
cabbaccccbcbbbbbcaaccacccabbdbca	FALSE
ccaccbdaaaacacaaacabccaccbbaaac	FALSE
daabaabddbaadbadcaaccabacabcdbdd	FALSE
dabddaadabcbccaaaccbbccaabbbadca	FALSE
dbaaccbcbbbacaaaacaadbadabddddbd	FALSE
dbbdaababbaabbcbccacbbadbbddbcba	FALSE
dcaaabaaabbddaabbdbdbbbabadbdddc	FALSE
ddabbddabdcaaaabcbbaccbdaadddbd	FALSE
ddcabbdddbbdadbadbbbcabbabbcabcc	FALSE
aaaaaadcbbbdabadcbcbadbdbadbdccbc	TRUE
aabcabdabcccaccdbaaddababcbbcabcc	TRUE
aadbdcabadcdabdbbbacbcacbacacbacc	TRUE
abbabbdddcbccabcacdacaccbabbdaddb	TRUE
abdababdacbbcbccbbddabdaaadcdcbaa	TRUE
acbbbbbcccbcbcddbaadcbaacacabadbc	TRUE
adadaacabbadbdaadadddadbcabcdbbab	TRUE
addaabaabacabcbcadbbdbcaaabdbbacb	TRUE
baacababbbcadabbabbddbddcababdabb	TRUE
baccbcbcddbaaabdaabbcacdbccaababa	TRUE
bbaadbaddbcbaabdacaaacacabbbcbbdd	TRUE
bbbdabdccbcbaadbbaaaadddbcadbacaa	TRUE
bcdadbbadbabdacacbcdabbcabbccaccb	TRUE
bdabacaabaacaabbabbadbcdaadccbbba	TRUE
bdcddaddcadaccaabbbaaababbbbcccaa	TRUE
cdbaaadddbabdbbdbaaabcaabddbacaba	TRUE
caccaaccbccdccacaadbdaaddbaabcccb	TRUE
ccbacdbbcbaacbdbaddcccacccbccacaa	TRUE
daaadbccbbddbdcdabdaadcccbbcaabcc	TRUE
dabdbdbbcacbbcddbaaaccbcaacbacccd	TRUE
daddbbdbbdbbcaadddbadbaabbbdbdcbd	TRUE
dbbbdaadaddaadbbbbadbabbcaddccadc	TRUE
dbdbadccacbbabddbbddccbdcaabccbba	TRUE
ddaacbccadabcabaacbabcabcbbdbbadc	TRUE
ddbdaaddbadbaacccbccaccadcaaabddb	TRUE
aaaaaadbbbbdabadcbcbadbdbadbdccbc	FALSE
aabbabdabcccaccdbaaddababcbbcabcc	FALSE
aadbdcababcdabdbbbacbcacbacacbacc	FALSE
abbabbdddcbccabcacaacaccbabbdaddb	FALSE
abdababdacbbcbccbbddabdaaadbdcbaa	FALSE
acbbbbbcccbcbcddbaadcbaacacababc	FALSE
adadaababbadbdaadadddadbcabcdbbab	FALSE
addaabaabacabcbcadbbdbcaaabcbbacb	FALSE
baacababbbcadabbabbddbddcabababb	FALSE
baccbcbcddbaaabdaabbcacbbccaababa	FALSE
bbaadbaddbabaabdacaaacacabbbcbbdd	FALSE
bbbdabdccbcbaadbbaaaadddbdadbacaa	FALSE
badadbbadbabdacacbcdabbcabbccaccb	FALSE
bdabacaabaacaabbabbadbddaadccbbba	FALSE
bdaddaddcadaccaabbbaaababbbbcccaa	FALSE
dbaaadddbabdbbdbaaabcaabddbacaba	FALSE
caccaaccbccaccacaadbdaaddbaabcccb	FALSE
ccbaccbbcbaacbdbaddcccacccbccacaa	FALSE
daaadbccbbddbdbdabdaadcccbbcaabcc	FALSE
dabdbdbbcacbbcddbaaaccbcaacbacccb	FALSE
daddbbdbbdbbbaadddbadbaabbbdbdcbd	FALSE
dbbbdaadaddaadbbbbadbabbcaddccaac	FALSE
dbdbadccacbbabddbbddccbccaabccbba	FALSE
ddaacbccacabcabaacbabcabcbbdbbadc	FALSE
ddbdaaddbadbaacccbccaccaacaaabddb	FALSE
aaaaaadbabdbacaaacacbdabaacbabbdbb	TRUE
aabbbbacdabdcddabaabdbcabbcbaabccb	TRUE
aadbcaadcabbccbbaababbdcccabcccbac	TRUE
abbabdddbaccbbbbbccaacdcddbdbddccb	TRUE
abdaaabddbdcdbdbddbadddbdacdaaddcb	TRUE
acbabcdbaadddcadaddbabaaabbdbadcca	TRUE
adadadddabacdbacbcacbbcbdbccbacacc	TRUE
addacaacaabddadddadaaaabdaabadbcdb	TRUE
baabdddabadcbdcacbccabbadacacbaaac	TRUE
bacbacaddddbbbaacadbdbbdddcbcbbbcc	TRUE
bbaadddbaabbbbababadbbacbcabdcdbda	TRUE
bbcaaccabdadbbbdcbdbabdddadacacacb	TRUE
bcbdadbabacaaacccccacacbccabbabdbd	TRUE
bdabbddcdbcdbddbadaaaddabdbbbdcaab	TRUE
bdcbbacdcbbcbacbabcbabbcccccacdcca	TRUE
cadadbabadaddadbcbcaccabcbcbcdaadc	TRUE
caddabdcdddaabbaadccacbbaacaabbaba	TRUE
ccbbaccbdadcbdcccbacaaaaaccbbcbcaa	TRUE
daababbacbbdabaaccbaaabdbbcacccbcb	TRUE
dacbdcccbbdbddadddbabdbddbbbbaadad	TRUE
dadddabcbadbadaaccbaddbbbcccbaaaaa	TRUE
dbbbdadadadbbcdaccdbdbbbaaabaaadbb	TRUE
dbdcaaabccbcdbaddbadbdcbdbdadaaacb	TRUE
dcdbddbbbcddaabaaddaddcbbbccbbcaac	TRUE
ddbbbbdabdccbcbacbabddaadcadddaabc	TRUE
aaaaaadbabdbacaaacacbdabaadbabbdbb	FALSE
aabbbbacdabdbddabaabdbcabbcbaabccb	FALSE
aadbcaadcabbccbbaababbccccabcccbac	FALSE
abbabdddbaccbbbbbccaacdbddbdbddccb	FALSE
abdaaabddbdcdbdbddbadddbdabdaaddcb	FALSE
acbabcdbaadddadaddbabaaabbdbadcca	FALSE
adadadddababdbacbcacbbcbdbccbacacc	FALSE
addacaacaabddadddadaaaabdaabadbadb	FALSE
baabdddabadcbdcacbccabbacacacbaaac	FALSE
bacbacaddddbbbaabadbdbbdddcbcbbbcc	FALSE
bbaadddbaabbbbababadbbacbcabcdbda	FALSE
bbcaaccabdadbbbdbbdbabdddadacacacb	FALSE
babdadbabacaaacccccacacbccabbabdbd	FALSE
bdabbddadbcdbddbadaaaddabdbbbdcaab	FALSE
bdcbbacdcbbcbacbabcbabbcccccacacca	FALSE
aadadbabadaddadbcbcaccabcbcbcdaadc	FALSE
caddabdbdddaabbaadccacbbaacaabbaba	FALSE
ccbbaccbdadabdcccbacaaaaaccbbcbcaa	FALSE
daababbacbbbabaaccbaaabdbbcacccbcb	FALSE
dabdcccbbdbddadddbabdbddbbbbaadad	FALSE
dadddabbadbadaaccbaddbbbcccbaaaaa	FALSE
dbbbdadadadbbadaccdbdbbbaaabaaadbb	FALSE
dbdcaaabccbcdbaddbadbddbdbdadaaacb	FALSE
dcdbddbbbdddaabaaddaddcbbbccbbcaac	FALSE
ddbbbbdabdccbcbacbabddaadbadddaabc	FALSE
aaaaababcccaccabcabcdacaccaabddbdab	TRUE
aabdacccbbbdabcccccacacdddbbababdba	TRUE
abaaadaaadbabbbbdbdcbaabcdcbaabadcb	TRUE
abbbbdaddbbabdabdcbcaadbbcbcbabcbdd	TRUE
abdbdaaccabbcabbdcccbaaaccaaadacabc	TRUE
acadbddabccdbabadbbbaabbbbbdbbcccbc	TRUE
adbccadacccacaddbbaadbbdcabcbcaccbc	TRUE
addbddbbadaababdaaabbdccabdbcbbcbda	TRUE
baaddbabdaccacbcacbabcbbdbdbbbcaadb	TRUE
badaadaadaabdbdadadbaadcdcaaaacadcc	TRUE
bbadaabaaddadacdccaccbaacbdbabdbcac	TRUE
bbcbabdbdbadbadcaddbaccababccbcabcc	TRUE
bcabacddbdbbddccadccbbcaabcccbbbabb	TRUE
bdabdcccbcabadabbbbcbaabdcaacaabbbb	TRUE
bdcbaaabbbaaabcabccdcbabdbbbbbbddcc	TRUE
caddabdbdadddbddbabaaddccbbaaabbadc	TRUE
cbabcdbdaabaadcabbbbdadbdbabbbabacb	TRUE
ccbcacabdacdaadaabababbabaddbacaaaa	TRUE
daabbaddabbbbbdbddbcadbcabbccddddaa	TRUE
dacaacbcbbdbaaabbbdbbbdbddaaccccdcc	TRUE
dbaccbabbacbaddddbaaddddadbddbccccd	TRUE
dbcbbcbcbbcdacabccabccaaaddbdbabaca	TRUE
dcacbbabbbabcabcabbcbbddababaadaacd	TRUE
ddabbaddacabdbdbbddbadcbbaaabacbddd	TRUE
ddbdcbaabaaacaccbdcddabaadcbbacbbcb	TRUE
aaaaababcccaccabcabcacaccaabddbdab	FALSE
aabdacccbbbcabcccccacacdddbbababdba	FALSE
abaaadaaadbabbbbdbdcbaabcdcbaabaacb	FALSE
abbbbdaddbbabdabdcbcaabbcbcbabcbdd	FALSE
abdbdaaccabbcabbacccbaaaccaaadacabc	FALSE
adadbddabccdbabadbbbaabbbbbdbbcccbc	FALSE
adbccaacccacaddbbaadbbdcabcbcaccbc	FALSE
addbddbbadaababdaaabbdccabdbcbbcbaa	FALSE
baaddbabdaccacbcacbabcbbdbdbbbaaadb	FALSE
badaadaadaabdbdadadbaadcdcaaaacacc	FALSE
bbadaabaaddadaccccaccbaacbdbabdbcac	FALSE
bbdbabdbdbadbadcaddbaccababccbcabcc	FALSE
bcabacddbdbbddccabccbbcaabcccbbbabb	FALSE
bdabdcccbcabadabbbbdbaabdcaacaabbbb	FALSE
bdcbaaabbbaaabcabccdbabdbbbbbbddcc	FALSE
aaddabdbdadddbddbabaaddccbbaaabbadc	FALSE
cbabcdbdaabaadabbbbdadbdbabbbabacb	FALSE
ccbcacabdaadaadaabababbabaddbacaaaa	FALSE
daabbaddabbbbbdbddbcaabcabbccddddaa	FALSE
dacaacbcbbdbaaabbbdbbbdbddaacccccc	FALSE
dbaccbabbacbaddddbaaddddadbddbcccc	FALSE
dbcbbcbcbbcaacabccabccaaaddbdbabaca	FALSE
dcacbbabbbabcabcabbcbbddababaadaad	FALSE
ddabbaddaabdbdbbddbadcbbaaabacbddd	FALSE
ddbdcbaabaaacaccbbcddabaadcbbacbbcb	FALSE
aaaaacaaacaabcaaaacbcadcaadaabdaddca	TRUE
aabbcacaccacbbccacaacdbbabdcbaddadda	TRUE
aadcdadadaadabbaacddbbbddddadadaaddd	TRUE
abbabdabddbdadacdbabacabacacaabbbcda	TRUE
abdbabdbadaaabdaabddadcdcbacaaaaaadb	TRUE
accbcdaaaabdadbbbdddcababadddaddbbda	TRUE
adbabddaadaaaddadaddbdbbcdacaddabcbb	TRUE
addbcbcadadbabadbdababdbdaaacbdadbdc	TRUE
baadbdbddccdbdcddadbdabdbacaaccacabb	TRUE
bacccabbbaacacccbbbcabdcabcadddbabdb	TRUE
bbacbaaaaabdaadbcaadabbbbcbbaabcbbcb	TRUE
bbcbbcdababdaaaddbbdaddcadabcabbcaca	TRUE
bcbaababcabcaadaccbccbacbcaccacbbbdb	TRUE
bdaddadbaaddcbbacbbcbdaabdbbcdbddcaa	TRUE
bddaadbbdbdbabbbbabacbbdcadbbbaadadc	TRUE
cdddaaaacaacbbaaababcaacadbaabaaadac	TRUE
cbbbbbbcbaabaaabcccccbaabcaadbcaadac	TRUE
cdbdaabbaadaaababddcbabdddaabddccacb	TRUE
dabadbbacbcabacdbbcabdadbaadabbcbabb	TRUE
dadbbbbcbbdaabccbcbacaaabcaaadaacacb	TRUE
dbadadabbbbdcdbaaccacbdcabbcccabbbbc	TRUE
dbcbaababbcaccdbaababbcadbdbbbbdbbcc	TRUE
dcaacbbbbbcaabdabdbaaabdcabacccbdbac	TRUE
ddabdbbddabbbacbdcaabcbdddbbadadcbcc	TRUE
ddbddbabdadcdaaaddbaabbbbddacbdcbcab	TRUE
aaaaacaaacaabcaaaacbcadaaadaabdaddca	FALSE
aabbcacaccacbbccacaacdbbabdbbaddadda	FALSE
aadcdadadaadabbaadddbbbddddadadaaddd	FALSE
abbabdabddbdadacbbabacabacacaabbbcda	FALSE
abdbabdbadaaabdaabddadccbacaaaaaadb	FALSE
accbcdaaaabdadbbbddddababadddaddbbda	FALSE
adbabddaadaaaddadaddbdbbccacaddabcbb	FALSE
addbcbcadadbabadbdababdbdaaadbdadbdc	FALSE
baadbdbddccdbdbddadbdabdbacaaccacabb	FALSE
bacccabbbaacacccbbbcabccabcadddbabdb	FALSE
bbacbaaaaabdaadbcaaaabbbbcbbaabcbbcb	FALSE
bbcbbcdababdaaaddbbdaddadabcabbcaca	FALSE
bcbaababcabcaadaccbccbacbcaccacbbbb	FALSE
bdaddadbaaddcbbacbbcbdaabdbbadbddcaa	FALSE
bddaadbbdbdbabbbbababbdcadbbbaadadc	FALSE
bdddaaaacaacbbaaababcaacadbaabaaadac	FALSE
cbbbbbbcbaabaaabcccccbaabcaadbaaadac	FALSE
cdbdaabbaadaaababddbabdddaabddccacb	FALSE
dabadbbacbcabacdbbbabdadbaadabbcbabb	FALSE
dadbbbbcbbdaabccbcbacaaabcaaaaacacb	FALSE
dbadadabbbbdcbbaaccacbdcabbcccabbbbc	FALSE
dbcbaababbcaccdbaababbdadbdbbbbdbbcc	FALSE
dcaacbbbbbcaabdabdbaaabdcabacccbbbac	FALSE
ddabdbbddabbbabdcaabcbdddbbadadcbcc	FALSE
ddbddbabdadddaaaddbaabbbbddacbdcbcab	FALSE
aaaaacadaabdaaabdabdcdbacbabaababaaaa	TRUE
aabadbccddaadbddcdbcbabaaaccaaabaacbc	TRUE
aadbabdcabcdbbabbcbcacbccbbaabbdabaab	TRUE
abbabaccbabccbbbbbcaccacadcacaabccabd	TRUE
abdbbbbaaccbabcaaddcdbdaccbabacaacaab	TRUE
accacdaddaadadaccabcdcacabbbcbcbaacaa	TRUE
adbabddaaabddacabacccaadadacbcaccdabc	TRUE
addadadabdadacbcbcacdccdadadadbbcabab	TRUE
bababbbdddcddbbaabdbbbaaacdabdabdbabc	TRUE
badadbadadbacadaddbabcacaaacacaccbdba	TRUE
bbacbcbdddabbabbbdbabbadcdbacbccacbba	TRUE
bbccaddacbaadaadbbdbadbdbbadaaabbcacb	TRUE
bcaababbcccbacaaaacacbbcbbcbdbcdabdcc	TRUE
bdabdbabdaacbcbdcaaabcaadaaddaaccaacb	TRUE
bdbdbcbcdcbcabbccbcaccbdabbcbbccaacac	TRUE
bdddbcaaabdddaaadbccbbbdbadaababadbdb	TRUE
cacaacbbcaaadccdbbbcabcabaaaaccaaaaca	TRUE
ccbcabdaadabdbdbdcbacbacbbdccbcbcacab	TRUE
daabcbcbaabcaaaaccbaccbabcbdddbcbaadb	TRUE
dabdcbabccbbccbccccaabcbdabccbacbabdb	TRUE
dbaaddbbbbccbbacbbdbbcbaaddcacbababaa	TRUE
dbbbddadadaabbddbcdadbdbddadcbacbdcbb	TRUE
dcaddbdabbcacbbbcdadadabdbcbacabbccac	TRUE
ddaabddbaadbdacbbbabddddaabacaaaacbdb	TRUE
ddbcbacadacddbdddbbdcbbcccbaaacabaaab	TRUE
aaaaacadaabdaaabdabdcbbacbabaababaaaa	FALSE
aabadbccddaadbddcabcbabaaaccaaabaacbc	FALSE
aadbabdcabcabbabbcbcacbccbbaabbdabaab	FALSE
abbabaccbabccbbbbbcaccacacacaabccabd	FALSE
abdbbbbaaccbabcaadddbdaccbabacaacaab	FALSE
accacdaddaadadaccabcbcacabbbcbcbaacaa	FALSE
adbabddaaabddacabacccaadadacbcacccabc	FALSE
addadadabdadacbcbcacaccdadadadbbcabab	FALSE
bababbbdddddbbaabdbbbaaacdabdabdbabc	FALSE
badadbadadbacadaddbabcacaaacacaccbba	FALSE
bbacbcbdddabbabbbdbabbadddbacbccacbba	FALSE
bbccaddabbaadaadbbdbadbdbbadaaabbcacb	FALSE
bcaababbcccbacaaaacacbbcbbcbabcdabdcc	FALSE
bdabdbabdaacbcbacaaabcaadaaddaaccaacb	FALSE
bdbdbcbccbcabbccbcaccbdabbcbbccaacac	FALSE
bdddbaaabdddaaadbccbbbdbadaababadbdb	FALSE
cacaacbbcaaadccbbbbcabcabaaaaccaaaaca	FALSE
ccbcabdaadabdbdbdcbacbacbbccbcbcacab	FALSE
daabcbcbaabcaaaaccbaccbabcbdddbdbaadb	FALSE
dabdcbabccbbccbccccaabcbabccbacbabdb	FALSE
dbaaddbbbbccbbacbbdbbbaaddcacbababaa	FALSE
dbbbddadadaabbddbddadbdbddadcbacbdcbb	FALSE
daddbdabbcacbbbcdadadabdbcbacabbccac	FALSE
ddaabddbaadbdabbbabddddaabacaaaacbdb	FALSE
ddbcbacadabddbdddbbdcbbcccbaaacabaaab	FALSE
aaaaaaadbabddcdcccacdadbdadddddbbaccbb	TRUE
aabbcadabbadbacaacbbaabbdabaacaababbbb	TRUE
aadcaabaaccddaacdddddabbdcabbbbbcbccca	TRUE
abadddbdbabccabdcdabaabccabbbabaabbcab	TRUE
abdacccbacbaabbbdacdaadbbabaabbdbcaabc	TRUE
accadadadaabadbcbbacbcbababbaaacabbbda	TRUE
adbadadabdaddbbacbdbacabddbcccacaaabcc	TRUE
addbbaabdbbbcababdddadbdbbadabcbddaadb	TRUE
baaddddbdcacddaabdbabcbcbcbdcaabbbcaaa	TRUE
badabaaadbadcabddbbdcaabbaacccadccacbc	TRUE
bbabdbcdaabcaaadaaadaadadbdbaaaabaaacc	TRUE
bbcacbabaadbcbbbaabbdbbdbbabbbbdbdabdd	TRUE
bcaccccbbcdcbabadbbaaaaaabaabaabdbddda	TRUE
bdaccbcbaccabcbbcbcbcbcdbdbcabadadbdbd	TRUE
bdcccbdabcddbbbbbbadaabdabacabbabbcbba	TRUE
cdabbdaadbadadaabdbdabbbddbabdbbccdaad	TRUE
cbbcabbccbadbacbcccacddbbadaaddadaaaaa	TRUE
ccdaccddcabbbabbcbcaaaabbbbccbabcaccac	TRUE
daadbadbcbabbbcbbababacddaadabaddcdbaa	TRUE
dadaaabddbbddabbaacbbbdcabbbccdabbcaba	TRUE
dbaccabdccabaacaabbccbaccaabbacabbcbdc	TRUE
dbcbbacaaaabccbbadaaabaaacddaaadaddabc	TRUE
dcddbdddbdabdbaadccaccacbbdaabdaabdcbc	TRUE
ddaadaccaabcbababadccdaaddbcbabcbcacca	TRUE
ddbdadbbdcddababdacabcacabccbaacbcadcb	TRUE
aaaaaaadbabdddcccacdadbdadddddbbaccbb	FALSE
aabbbadabbadbacaacbbaabbdabaacaababbbb	FALSE
aadcaabaaccddaadddddabbdcabbbbbcbccca	FALSE
abadddbdbabccabccdabaabccabbbabaabbcab	FALSE
abdacccbacbaabbbcacdaadbbabaabbdbcaabc	FALSE
accadadadaabadbcbbacbcbababbaaacabbbaa	FALSE
adbadadabdaddbbacbbacabddbcccacaaabcc	FALSE
addbbaabdbbbdababdddadbdbbadabcbddaadb	FALSE
baaddddbdcacddaabdbabcbcbcbccaabbbcaaa	FALSE
badabaaadbaddabddbbdcaabbaacccadccacbc	FALSE
bbabdbcdaabdaaadaaadaadadbdbaaaabaaacc	FALSE
bbcacbabaadbdbbbaabbdbbdbbabbbbdbdabdd	FALSE
bcaccccbbccbabadbbaaaaaabaabaabdbddda	FALSE
bdaccbcbaccabcbbcbcbcbcdbdbabadadbdbd	FALSE
bdcccbdabaddbbbbbbadaabdabacabbabbcbba	FALSE
adabbdaadbadadaabdbdabbbddbabdbbccdaad	FALSE
cbbcabbccbabbacbcccacddbbadaaddadaaaaa	FALSE
ccbaccddcabbbabbcbcaaaabbbbccbabcaccac	FALSE
daadbadbcbabbbcbbababacddaadabaddbdbaa	FALSE
dadaaabddbbddabbaacbbbcabbbccdabbcaba	FALSE
dbaccabdccabaacaabbccbaccaabbacabbcbcc	FALSE
dbcbbacaaaabccbbaaaaabaaacddaaadaddabc	FALSE
daddbdddbdabdbaadccaccacbbdaabdaabdcbc	FALSE
ddaadaccaabcbababaccdaaddbcbabcbcacca	FALSE
ddbdadbbdcddababdacabcacabccbaacbcacb	FALSE
aaaaadababbbaaadddaddabdcbdbdbdbbcddbbb	TRUE
aabcabcccaabaacdbaabdbcababadbaadbadaab	TRUE
aaddbbbddcbababbbadddbabcaabcaabdadbbdb	TRUE
abbbbbbddbbdcaaacabbbcaccccdbbbdadbaacd	TRUE
abdbddacbbdababdbabcacbbdbddbdcabacabcc	TRUE
acbdbabaabbddbabaacbcaaccbaaabccdacabcc	TRUE
adbbbbbbbaabaaddcbddaaadbdcaadcababbabb	TRUE
addbcabbadaddabbaddabdacbccbbbddbbbaacc	TRUE
baadbbbdbacccacbcccabaacbbdbbdbbaaacdcc	TRUE
bacbbbcccccbccaacbccabcbcbbabdbcaccadbc	TRUE
bbabddbdbbaadabcbcbbadacdaadddbbdbadacc	TRUE
bbbddabdcbaacaccacadbdbbbcabaababdbaabc	TRUE
bcbdadadaaabaddbdadddaaddcbbacadaddbada	TRUE
bdacbbabbddadddbdadababdcdaddaacbccccbc	TRUE
bdcaadcaacaabaadadadbabdaaddabcbaacaabb	TRUE
bdddddacbaacbababcdaaabccacbbbbacddccaa	TRUE
cbababbacabbcbadbbbadaabadcbdddddbdbaad	TRUE
cccacccaaabcaacbcdbbdaddcaaaabdaccbcccb	TRUE
daacbabbcacaabbcbcdbbdccaacbcaaadccbbcb	TRUE
dacbcbcacadaccaabbbccccdbabddcbabaacaba	TRUE
dbabcbadaaabadbbaabbadddddacaadbaadccab	TRUE
dbbdcccbaabacbaaaadbbacaacabbaacdaaccbc	TRUE
dcbdbbdddcabbcbaabccbbbbabaccccdbbabaad	TRUE
ddabcbccccabaadcaccaabcccccbabbaacddbca	TRUE
ddbdddcdcbbcaacabbbddacbbbccacbbbbccbbc	TRUE
aaaaadababbbaaadddaddabdcbdbdbdbbaddbbb	FALSE
aabcabcccaabaacdbaabdbababadbaadbadaab	FALSE
aaddbbbddabababbbadddbabcaabcaabdadbbdb	FALSE
abbbbbbddbbdcaaacabbbcaccccdbbbdadbaac	FALSE
abdbddadbbdababdbabcacbbdbddbdcabacabcc	FALSE
adbdbabaabbddbabaacbcaaccbaaabccdacabcc	FALSE
adbbbbbbbaabaadddbddaaadbdcaadcababbabb	FALSE
addbdabbadaddabbaddabdacbccbbbddbbbaacc	FALSE
baadbbbdbacccacbcccabaacbbdbbdbbaaacacc	FALSE
bacbbbcccccbccaacbccabcbcbbababcaccadbc	FALSE
bbabddbdbbaadabcbcbbadabdaadddbbdbadacc	FALSE
bbbddabdcbaacaccacadbdbbbabaababdbaabc	FALSE
bbbdadadaaabaddbdadddaaddcbbacadaddbada	FALSE
bdabbabbddadddbdadababdcdaddaacbccccbc	FALSE
bdcaacaacaabaadadadbabdaaddabcbaacaabb	FALSE
bdddddacbaacbababcaaaabccacbbbbacddccaa	FALSE
cbababbacabbcbadbbbadaabadabdddddbdbaad	FALSE
cccacccaaabcaacbcdbbdadddaaaabdaccbcccb	FALSE
daacbabbcacaabbcbcdbbdccaacbcaaabccbbcb	FALSE
dacbcbcacaaccaabbbccccdbabddcbabaacaba	FALSE
dbabcbadaaabadbbaabbadddddabaadbaadccab	FALSE
dbbdcccbaabacbaaaadbbacaacabbaacbaaccbc	FALSE
dabdbbdddcabbcbaabccbbbbabaccccdbbabaad	FALSE
ddabcbccccabaaccaccaabcccccbabbaacddbca	FALSE
ddbddddcbbcaacabbbddacbbbccacbbbbccbbc	FALSE
aaaadbbdadcbcbbaccccbacbdbdcaabbbddaaaba	TRUE
aabbbddcadbdbdaadbabdacaaaacbcccbcabcdbb	TRUE
aadddabddbbbbbbcdcabbcabaddadaaadadcbbbb	TRUE
abbbbbbaaddaadcaabcdbabcbbdcbacabbbcbacc	TRUE
abdcdbdaabdcabcaacadbdbbdbabadadbdbdabca	TRUE
accbcabbcacccbaccbccaaabbdbaacabbadcbbab	TRUE
adbbabaccccbcacaccabcdbaabaccbacddbaddbd	TRUE
addcabaacabcbcbcddcbdbddbbaadabcbacbbacb	TRUE
babaabdacabbbbbbdaaaddcabaabccababbadbba	TRUE
badaadbabddaaacadadbbdcabccaacdbbadacbbc	TRUE
bbabdddbbbdabbcdddcbbddbdbabdbbaaaaddaca	TRUE
bbcaaacababaaccacdddaaababcdcbcabaacbaac	TRUE
bcddaddabbadacccabcbbcacdcbcacaccacbabba	TRUE
bdababbaddddcbabbcdbbdbbaacbbbcadbbcbccb	TRUE
bdbdabaacabdbcddbdddabdabbaaaaadadaddcac	TRUE
bdddddcbccdbcaaaaddbbbbadabaaaadddabcacb	TRUE
cacbddaabbacabbabbbbadbbaabbcbcbaaabcabb	TRUE
cccaaaacacdaccbbbcacbbccbcbababacadaaaac	TRUE
daabdbddbabddacacadddbccabcabcbbbbdcacba	TRUE
dacaabdaddbadaaacacbbbccbaabcbaacdcbbbac	TRUE
dbaadbacabdaadccbabcccbcbcacdaaabcbbcccc	TRUE
dbbcbbbbcabbcbcabbbcadccdbcbccabccbcabac	TRUE
dbdbddaababdabbbcdbbababdaddababccbdacbb	TRUE
dcaabbdadbbaaccbacbaabaaaacbbccbdddddbad	TRUE
ddbbcdddddbdbbdadacdbadbaadabbccabbacabc	TRUE
aaaadbbdadcbcbbaccccbacbdbddaabbbddaaaba	FALSE
aabbbddcadbdbdaadbabdacaaaacbcccbcabcbbb	FALSE
aadddabddbbbbbbccabbcabaddadaaadadcbbbb	FALSE
abbbbbbaaddaadcaabcdbabcbbbcbacabbbcbacc	FALSE
abddbdaabdcabcaacadbdbbdbabadadbdbdabca	FALSE
accbcabbcacccbaccbccaaabbdbaacabbacbbab	FALSE
adbbabaccccbcacaccabccbaabaccbacddbaddbd	FALSE
addcabaacabcbcbcdddbdbddbbaadabcbacbbacb	FALSE
babaabdacabbbbbbdaaaddcabaabccababbaabba	FALSE
badaadbabddaaabadadbbdcabccaacdbbadacbbc	FALSE
bbabdddbbbdabbadddcbbddbdbabdbbaaaaddaca	FALSE
bbcaaacababaaccacdddaaababcbcbcabaacbaac	FALSE
baddaddabbadacccabcbbcacdcbcacaccacbabba	FALSE
bdababbaddddcbabbcdbbdbbaacbbbcacbbcbccb	FALSE
bdbdabaacabdbaddbdddabdabbaaaaadadaddcac	FALSE
bdddddcbccdbaaaaddbbbbadabaaaadddabcacb	FALSE
cacbddaabbacabbabbbbaabbaabbcbcbaaabcabb	FALSE
cccaaaacacdaccbbbcacbbccbcbababacacaaaac	FALSE
daabdbddbabddacacadddbccabcabcbbbbbcacba	FALSE
dacaabdaddbadaaacacbbbccbaabcbaaccbbbac	FALSE
dbaadbacabdaadccbabcccbcbcacaaaabcbbcccc	FALSE
dbbcbbbbcabbcbcabbbcadccabcbccabccbcabac	FALSE
dbdbddaababdabbbdbbababdaddababccbdacbb	FALSE
ddaabbdadbbaaccbacbaabaaaacbbccbdddddbad	FALSE
ddbbddddddbdbbdadacdbadbaadabbccabbacabc	FALSE
aaaaaadbdbddcccaddddbdddbaaaadcabbcdbaacb	TRUE
aabcabacbccccbaccabbcdbbdbaaadbadabbddcbd	TRUE
aaddbdcbbbbadddadddbcdaabaaaadacaaababaaa	TRUE
abbabbbddaaddadddabadcbabbdaacaadddcacbba	TRUE
abdbaddbbcbbcabccacbcccabdccddcbcabacabcb	TRUE
acbdaabbdcbddabbdaadacabcbcabbbabbccbbaca	TRUE
adbaaccaabbcccadcdabdbadaabdaddbbbbcccbcb	TRUE
addabbdbabbdbabdadabdbacddcdbadbdcbabccbb	TRUE
baacdabddcdbdaadabdbaabbbbdaaaaabdadbdbdc	TRUE
bacdccbcccccbaaabcabaabbcacdbdddbdabacaba	TRUE
bbaadbdbadddbabbabdbddaabcbbbabdbbbcccadb	TRUE
bbbdbcaddaaddbadabbbabbdddadbbccabdaabaab	TRUE
bcddaacbabccbbaccabbbbbbacccacbbacbacdddc	TRUE
bdabdcbcabbbcbccaacaaaccbbcadabcaddadbcca	TRUE
bdbdbaabbbaadbababdbdcbcccaddcdbbcaaaacca	TRUE
bddddaaaaccbbccaccaacbbbabbdcccddcacaacac	TRUE
cacbabbbabdaabbbabcabaadddbddaddbabaadcac	TRUE
ccbbbaabbbbcacbaaaaabaaabadaaccdacbbcbbaa	TRUE
daacbacaacaaacbcbbcbdbabbbabaadbdbbcbcdbb	TRUE
daccbbbcbcadddaabaaabacccbbccaabcbcaabdba	TRUE
dbabcaacdcbacacaaaaabbbbaacbdacbaabaabbca	TRUE
dbbdddadbaddcbaacacbacbbcdbbadbcbbadcbbbc	TRUE
dbdddbddbadadaddbdcdabbbdaadcbcbcbbccdbbd	TRUE
ddabdbadcbbcdcabcaaccdbabadaaaccbbabcbaac	TRUE
ddcddbdbaddddbcabbacaacaccbcdabdddcaacabb	TRUE
aaaaaadbdbddcccaddddbdddbaaaadcabbcbaacb	FALSE
aabcabacbccccbaccabbcdbbdbaaadbadabbddabd	FALSE
aaddbdcbbbbadddadddbbdaabaaaadacaaababaaa	FALSE
abbabbbddaaddadddabadcbabbaaacaadddcacbba	FALSE
abdbaddbbcbbcabccacbcccabbccddcbcabacabcb	FALSE
acbdaabbdbbddabbdaadacabcbcabbbabbccbbaca	FALSE
adbaaccaabbcccacdabdbadaabdaddbbbbcccbcb	FALSE
addabbdbabbdbabdadabdbacddddbadbdcbabccbb	FALSE
baacdabddddbdaadabdbaabbbbdaaaaabdadbdbdc	FALSE
baadccbcccccbaaabcabaabbcacdbdddbdabacaba	FALSE
bbaadbdbadddbabbabdbddaabcbbbabdbbbcccaab	FALSE
bbbdbbaddaaddbadabbbabbdddadbbccabdaabaab	FALSE
bddaacbabccbbaccabbbbbbacccacbbacbacdddc	FALSE
bdabdcbcabbbcbccaacaaaccbbcaaabcaddadbcca	FALSE
bdbdbaabbbaadbababdbdcbcccaddddbbcaaaacca	FALSE
bddddaaaaccbbccaccaacbbbabbacccddcacaacac	FALSE
cacbabbbabaaabbbabcabaadddbddaddbabaadcac	FALSE
ccbbbaabbbbcacbaaaaabaaabadaacccacbbcbbaa	FALSE
daacbacaacaaacbcbbcbdbabbbabaadbdbbcbccbb	FALSE
daccbbbcbcadddaabaaabacccbbccaabcbcaabba	FALSE
dbabcaacdcbacacaaaaabbbbaacbacbaabaabbca	FALSE
dbbdddadbaddcbaacacbacbbcdbbadbabbadcbbbc	FALSE
dbdddbddbadadaddbdddabbbdaadcbcbcbbccdbbd	FALSE
ddabdbadcbbcacabcaaccdbabadaaaccbbabcbaac	FALSE
ddbddbdbaddddbcabbacaacaccbcdabdddcaacabb	FALSE
aaaaaaabbadaddacbdcccdddaddabaaddbdbbdcbcc	TRUE
aabbadaaaddadbbbaaaccbcbdaabbabcbabadbdadd	TRUE
aadbbbaacaaaaacccbdddbddbabcbaddddaaabdcab	TRUE
abaddbdbbbadaccbaabcbcddcbaaaccbbadbbcbbac	TRUE
abdabbccbbacacdaacaaaaccdaadbaadaabdbbbaaa	TRUE
acbbccbaaccacaaacbaaddddbbbdcacaadcbcbccbb	TRUE
adadccddaddbabdaabadbdcbbbbaaccbdabaacaaac	TRUE
addaabaadaabdccddccaacaababcaabcbaabcbbdcb	TRUE
baabcbccdbacaadbbaadbbdabbadccbccbbbbcabaa	TRUE
badaabdbabdabcdbadadcbbdcaccbacaacccbacbbb	TRUE
bbabadaaaddadabbacbdbdabadcdaaaabacbaababc	TRUE
bbbcdacaaacaaabbcabbcacddabddabbbbacbacabb	TRUE
bcdbababbcccabbdaababdddbcabaccbccbcaabbac	TRUE
bdabababbaadaddaaaaddbbbadcdcabdcacbabbbab	TRUE
bdbddbddcabbbaabdcbaabcdbabababcbacacbcaaa	TRUE
caabbdaadcbbbabbabbddbbdbabdadadbcabcbbcab	TRUE
cbcabaaabbaabdddadbbabdddaddbccacbaccdaaac	TRUE
cadacbbcaacbbacadbdbdabcabaabcccacbabbabcc	TRUE
dabacabaaabccadcdbabdaabdbabdbbbabaddbaaca	TRUE
dadaddaccaddcacadbaaccbbcbabbabcaccaaaaaac	TRUE
dbacdcccaccbaaabddbbaadabbdadcacbababcccac	TRUE
dbbddbbbccabcbbbdbbbaacdbdccacacacbabaabab	TRUE
dcbdbbbbdcdaadddaaddbdbdadbdbabdcaacccabbb	TRUE
ddabcbbaabadbaabbadabaaadaddbaabadabdccadc	TRUE
ddbddbadacdbaabcbcbadaabbddabddbadbbadddbb	TRUE
aaaaaaabbadaddabbdcccdddaddabaaddbdbbdcbcc	FALSE
aabbadaaaddadbbbaaaccbcbbaabbabcbabadbdadd	FALSE
aadbbbaacaaaaacccbdddbddbabbaddddaaabdcab	FALSE
abaddbdbbbadaccbaabcbcddcbaaaccbbacbbcbbac	FALSE
abdabbccbbacacaaacaaaaccdaadbaadaabdbbbaaa	FALSE
acbbccbaaccacaaacbaaddddbbbdcacaaacbcbccbb	FALSE
adadccddaddbabdaabadbdcbbbbaaccbbabaacaaac	FALSE
addaabaadaabdccddccaacaababcaabcbaabcbbccb	FALSE
baabcbcccbacaadbbaadbbdabbadccbccbbbbcabaa	FALSE
badaabdbabdabddbadadcbbdcaccbacaacccbacbbb	FALSE
bbabadaaaddadabbacbdbdabadbdaaaabacbaababc	FALSE
bbbcaacaaacaaabbcabbcacddabddabbbbacbacabb	FALSE
bdbababbcccabbdaababdddbcabaccbccbcaabbac	FALSE
bdabababbaadaddaaaaddbbbaddcabdcacbabbbab	FALSE
bdbddbddcabbbaabccbaabcdbabababcbacacbcaaa	FALSE
aaabbdaadcbbbabbabbddbbdbabdadadbcabcbbcab	FALSE
cbcabaaabbaabdddadbbabdddaddbccacbaccaaac	FALSE
dadacbbcaacbbacadbdbdabcabaabcccacbabbabcc	FALSE
dabacabaaabccaccdbabdaabdbabdbbbabaddbaaca	FALSE
dadaddaccaddcacabbaaccbbcbabbabcaccaaaaaac	FALSE
dbaccccaccbaaabddbbaadabbdadcacbababcccac	FALSE
dbbddbbbccabcbbbdbbbaaadbdccacacacbabaabab	FALSE
dabdbbbbdcdaadddaaddbdbdadbdbabdcaacccabbb	FALSE
ddabbbbaabadbaabbadabaaadaddbaabadabdccadc	FALSE
ddbddbadaccbaabcbcbadaabbddabddbadbbadddbb	FALSE
aaaaaadbaabdbbcbabcabaacccabdbbccabcdadbdba	TRUE
aabbcabccccbaababbcbccdcbdbdaabadacccaaccca	TRUE
aaddbdbbbdbcabdbaaaabcccccbbbdbdbbdbccabbac	TRUE
abbbbdbadababbbbcbbcbdabbaadbcaaacdbbabccbc	TRUE
abdcbcababbcdaacaaccadcbbcabcbbabcaacccccab	TRUE
acadbadbbababdddabbdaadbadbcabcbbaaaaaabdaa	TRUE
adbcacabcbccaabacbbabdaaccababacadbcccbbbcb	TRUE
adddbdddcbdbccccbbcbbbbbcddddadbbdbbbcaabca	TRUE
babaadadbaabdabddabbcaccadacbabababacdcbcbb	TRUE
badacbbbcaabaabdaaccccbcbaabcddbaccaabcbbca	TRUE
bbabdbbabadadccbbaacccabadadcadabaaaacbacac	TRUE
bbbddbdadbdadbaabdddbdbdcacbabbdacaaacadbac	TRUE
bcddbaaabbbaadbcbbbaaadddbbbaaadbdadccbaaba	TRUE
bdaaddaabababaabbdabbcbbcbcbcdadbdbcadaacca	TRUE
bdbdbcbbbdbcbabcabcacccadbcbbbcccbacbccccaa	TRUE
cabadbdbbadaaabdbbddadbdbabbdbccadabbacbaac	TRUE
caccbabdadbbdbbdbbdcccbacacbaaabcbbabcbcaad	TRUE
cccbcbaaacdaccbbaaaabbabccaaccbcddabaabbddc	TRUE
daadacbadcababcabbbcbccccacacddbabdddadddca	TRUE
dacbcbaabbbbccccbababdcaadddbbacacccacabccc	TRUE
dbabdabadbbaccccdbabbbdcbaaabdddaadadbcbaac	TRUE
dbbdbcaadaadadabaadabbaaccabbbbabcbbbabcbda	TRUE
dbdddccadbcbacaaccbcabacdaabbadadaaacacabba	TRUE
ddabbabcccdaabaaadddababacbbccbcdabcbabacca	TRUE
ddbdaadcbbaddabdbbdcbbadaaaabbbbbadcbbccbac	TRUE
aaaaaadbaabdbbcbabcabaacccabcbbccabcdadbdba	FALSE
aabbcabccccbaababbcbccccbdbdaabadacccaaccca	FALSE
aaddbdbbbdbbabdbaaaabcccccbbbdbdbbdbccabbac	FALSE
abbbbdbadababbbbcbbcbdabbaadbcaaacbbabccbc	FALSE
abdcbcababbcaacaaccadcbbcabcbbabcaacccccab	FALSE
adadbadbbababdddabbdaadbadbcabcbbaaaaaabdaa	FALSE
adbcacabcbccaabacbbabcaaccababacadbcccbbbcb	FALSE
adddbddddbdbccccbbcbbbbbcddddadbbdbbbcaabca	FALSE
babaadadbaabdabddabbcaccacacbabababacdcbcbb	FALSE
badacbbbcaabaabaaaccccbcbaabcddbaccaabcbbca	FALSE
bbabdbbabadadccbbaacccabadadcaabaaaacbacac	FALSE
bbbddbdadbdadbaabdddbdbdcacbabbdacaaacabac	FALSE
bddbaaabbbaadbcbbbaaadddbbbaaadbdadccbaaba	FALSE
bdaaddaabababaabbdabbcbbcbcbcdadbdbcacaacca	FALSE
bdbdbbbbdbcbabcabcacccadbcbbbcccbacbccccaa	FALSE
abadbdbbadaaabdbbddadbdbabbdbccadabbacbaac	FALSE
caccbabdadbbdbbdbbdcccbacacbaaabcbbabcbcaab	FALSE
cccbcbaaaccaccbbaaaabbabccaaccbcddabaabbddc	FALSE
daadadbadcababcabbbcbccccacacddbabdddadddca	FALSE
dacbcbaabbbbccccbababdaaadddbbacacccacabccc	FALSE
dbabdabadbbaccccdbabbbddbaaabdddaadadbcbaac	FALSE
dbbdbcaadaadadabaadabbaaccabbbbabcbbbabcba	FALSE
dbdddccacbcbacaaccbcabacdaabbadadaaacacabba	FALSE
ddabbabcccdaabaaadddababacbbccbccabcbabacca	FALSE
ddbdaadabbaddabdbbdcbbadaaaabbbbbadcbbccbac	FALSE
aaaaaabdbdccbccabaabcdbabcaaaadccbcabcaabbcb	TRUE
aabbbdbdabbabbdaaadcbadadadacdbbacbbcbcaaabb	TRUE
aadbabbbdbbaaadcdbbbbaaddbbabdaaddddbcabbabd	TRUE
abadbdaddbbcbabcaccabcbdbcbcacbbbccbcbdcccbb	TRUE
abdbacacddadabdabbaddccbdaaacbccaaaabaacccbc	TRUE
accacaaabbcddbbbbdbbadbddacdabbdabddbbddabbc	TRUE
adbbaadbcabcccbcdbabdcbcabaaadcaacacaabccbca	TRUE
addbdbcaaadadaaabcacacdaabdbbabbbbdadbdabadb	TRUE
baaccadabdbadadabdcbddbbbaabadabbaaaadbaaacb	TRUE
bacaccdaaababcabacabbbcaaacbbddaddcbcabbbabc	TRUE
bbaaddaabccababdbabbdbdabbcaabdbabbdbbdadcac	TRUE
bbbddaaabacabbdccbccbcabbabdcbccabbcbccaccbc	TRUE
bbddbddcbaccddadbbcadaccbcccbaababbbbacbbbba	TRUE
bdababccbabbcbcccccbbcaadabddcadcccccabcbaab	TRUE
bdbcaaacaaacbcbaacabdadabbdacbcbccdccaabcbba	TRUE
bddcabdbdabaaacbbbacbabccabccbbaaddbbbdbbccc	TRUE
cabdaaddbddaddbddadddacbccabdccbacaaaabcacab	TRUE
ccbbbcbbccbbcbbdcbabbcbbdddbcbaabaacbacaccbb	TRUE
daadabaacdcacbaabaaaacaaabbdddbdddacacbbabab	TRUE
dacccbcadbbaadbbdddbaabbdbbbbaabadadccbcdcba	TRUE
dbaadbbcacaaadbbbcbacccadabbbabbbdadddbdcaab	TRUE
dbbdcdccdddbbdadbdddbabaaabdabdababdbabcbacb	TRUE
dbdddbcdaadddabbdbcbbcaacbaabaabcacadbadadbd	TRUE
ddaadbdbadbbadbddbadaaabadbcbaabdbbbdabcabcd	TRUE
ddbdbbaabadddcbddbdbacabccacbbaccbcbbbbbcdab	TRUE
aaaaaabdbdccbccabaabcdbabcaaaacccbcabcaabbcb	FALSE
aabbbdbdabbabbdaaadcbadadadadbbacbbcbcaaabb	FALSE
aadbabbbdbbaaadcdbbbbaaddbbabdaaddddbcabbaba	FALSE
abadbdaddbbcbabcaccabcbbbcbcacbbbccbcbdcccbb	FALSE
abdbacacddadabdabbaddccbbaaacbccaaaabaacccbc	FALSE
accacaaabbcddbbbbdbbadbddadabbdabddbbddabbc	FALSE
adbbaadbcabcccbcdbabdcbcabaaaacaacacaabccbca	FALSE
addbdbaaadadaaabcacacdaabdbbabbbbdadbdabadb	FALSE
baaccadabdbadadabddbddbbbaabadabbaaaadbaaacb	FALSE
bacaccbaaababcabacabbbcaaacbbddaddcbcabbbabc	FALSE
bbaaddaabccababdbabbdbdabbdaabdbabbdbbdadcac	FALSE
bbbddaaabacabbdccbccbcabbabacbccabbcbccaccbc	FALSE
bbddbddcbaccddadbbbadaccbcccbaababbbbacbbbba	FALSE
bdababccbabbcbcccccbbcaadabddcaacccccabcbaab	FALSE
bdbcaaacaaacbcbaacabdadabbdacbcbcccccaabcbba	FALSE
bddbabdbdabaaacbbbacbabccabccbbaaddbbbdbbccc	FALSE
cabdaaddbddaddbddadddacbccabcccbacaaaabcacab	FALSE
ccbbbcbbccbbcbbccbabbcbbdddbcbaabaacbacaccbb	FALSE
daadabaacbcacbaabaaaacaaabbdddbdddacacbbabab	FALSE
dacccbcadbbaadbbdddbaabbdbbbbaabadadccbcbcba	FALSE
dbaadbbcacaaabbbbcbacccadabbbabbbdadddbdcaab	FALSE
dbbdcaccdddbbdadbdddbabaaabdabdababdbabcbacb	FALSE
dbdddbdaadddabbdbcbbcaacbaabaabcacadbadadbd	FALSE
ddaadbdbadbbadbddbadaaabadbbaabdbbbdabcabcd	FALSE
ddbdbbaabadddcbddbdbacabccacbbaccbcbbbbbcaab	FALSE
aaaaaabaabaadabbdbdabbbdbadaadabbacdcccadabcb	TRUE
aabbaabbcccacdcddbbbbdaaabbdbddbbbddabbdbccbb	TRUE
aadbdacaabaddacaccbccbcdbcbaccccbbbaabbaabbab	TRUE
abbabbcadaaaddaaabdabbbababacddaddaccaaacabac	TRUE
abdbccbcbaaacaaddabbadaddaaaababdaabbcbbdcbcb	TRUE
acdadddbddbdbabbaaddccccbddbaaadbdadabacccbbc	TRUE
adbbabadbbbabbcbdabbbbabbacbaddabddaadbadacbc	TRUE
addcddddbcccbbbccbbbccbccaabbabbbacadbccbcacc	TRUE
babaababcccbbbcacabbddacabaaacccaadabbcaabccb	TRUE
badbdbdaaaabccabbbbabbcbbbdddbdaadbcaaddaabaa	TRUE
bbadddbaaadabbdaabddabaabbbdacaaddcdbaddbabab	TRUE
bbdaaabddaadbdadcddaddbaaabdbacdcbccbaacaacbb	TRUE
bcadcabdaddbadbddabdaadaabbbbabccaaabbaaccacc	TRUE
bdaccaabbcbccbcbcbabbacdadbdbddaacbbcacbcadca	TRUE
bdcabcbccbcacbcccbacbaabdaddbddcdbaaddbdccaac	TRUE
cbabadadbadaadddadcbcbdbdadbdaadbbbbbcbaabcca	TRUE
cbbbcaabccacacbcdbacacccdaaddbbaccbabaaccbbcc	TRUE
daaaababbbaddbcccadbbcccaaaadabcaacaccabbcacb	TRUE
dabbbabdaabaadccaacbbccaccadbccccaadbddbbbbbb	TRUE
dadbbabaaddadaadadbaccacaabbbcccbcaadbcdcbbba	TRUE
dbadddddabdadcccabbbbacbabcaabbdbbcaddcaabcbc	TRUE
dbcccbabacabdcbabcbbcbacccccaacabbadddddaadcc	TRUE
dcabbbbcbcaadcbabbdabddabbbdadaababdadaddadda	TRUE
ddadaccaaacaaaaccbaccabaccdbcbcbacbabadaccaab	TRUE
ddcaacccbcacaccccccdbaaccddabdddbccaaacaacbab	TRUE
aaaaaabaabaadabbdbdabbbdbadaadabbaddcccadabcb	FALSE
aabbaabbcccacacddbbbbdaaabbdbddbbbddabbdbccbb	FALSE
aadbdacaabaddacaccbccbcbbcbaccccbbbaabbaabbab	FALSE
abbabbbadaaaddaaabdabbbababacddaddaccaaacabac	FALSE
abdbccbcbaaacaaddabbadaddaaaababdaabbcbbacbcb	FALSE
addadddbddbdbabbaaddccccbddbaaadbdadabacccbbc	FALSE
adbbabadbbbabbcbdabbbbabbabaddabddaadbadacbc	FALSE
addcddddbcccbbbccbbbccbccaabbabbbacabbccbcacc	FALSE
babaababcccbbbcacabbddacabaaacccaaaabbcaabccb	FALSE
badbdbdaaaabccabbbbabbcbbbdddbdaadbdaaddaabaa	FALSE
bbadddbaaadabbdaabddabaabbbdaaaddcdbaddbabab	FALSE
bbdaaabddaadbdaddddaddbaaabdbacdcbccbaacaacbb	FALSE
bcaddabdaddbadbddabdaadaabbbbabccaaabbaaccacc	FALSE
bdaccaabbcbccbcbcbabbacdadbdbddaacbbcacbcacca	FALSE
bdcabcbccbcacbcccbacbaabdaddbddbdbaaddbdccaac	FALSE
babadadbadaadddadcbcbdbdadbdaadbbbbbcbaabcca	FALSE
cbbbcaabccacacbccbacacccdaaddbbaccbabaaccbbcc	FALSE
daaaababbbaddbcccadbbcccaaaababcaacaccabbcacb	FALSE
dabbbabdaabaadccaacbbccaccacbccccaadbddbbbbbb	FALSE
dadbbabaaddadaadadbaccacaabbbcccbcaadbdcbbba	FALSE
dbadddddabdadcccabbbbacbabcaabbbbbcaddcaabcbc	FALSE
dbcccbabacabcbabcbbcbacccccaacabbadddddaadcc	FALSE
dcabbbbcbcaabcbabbdabddabbbdadaababdadaddadda	FALSE
ddadaccaaacaaaaccbaccabaccdbcbcbacbabaaaccaab	FALSE
ddcaacccbcacaccccccbbaaccddabdddbccaaacaacbab	FALSE
aaaaaabbadbbdadabaacaacaaacdcacbbbbacbbaaacbdc	TRUE
aabbcababadadaaaaaabacaddadaaccccaacacbcbacaab	TRUE
aadbdbdddacbbbbbbcaaabadddbbdbabbbdddaacdccacb	TRUE
abbabdddabbbdcbdccaaccabacbbabbbacabddccbbbacb	TRUE
abdadddadbcbbcbbabacbbcbddbdaadadbcdbcbbacbbab	TRUE
accbcdacbacabacaaabadbaaddadbbabdbdbdbadcbbccc	TRUE
adbbabadcbbcbacdbbcadbbbddbbdaaaadabdabbbadacb	TRUE
addaddbbdbccbbababbabccaccbaaabdcadcabaacbbcbb	TRUE
baadbbadabcbabbbadbaaaadadbcdbdbbdabdccbcacbcb	TRUE
bacbbbabcbcccbbaaadddadbdbddbbacacbcdaaccacbca	TRUE
bbaadbabaadbbbdcbcabcccbdaddadababbdaddbdbcdca	TRUE
bbbdbdbccaaadcabcccbbbaacaacddbaaddaddbdabccba	TRUE
bcaaabbbabaacbaaaabacddacdacbaaaaccabbccbccbcc	TRUE
bdacaaacdaaadaaaaaadbbadbbbccbbacccbadcabcbcac	TRUE
bdbddadadadabbbbcaaaaadbadbbccbabcccbbbcaddbca	TRUE
bdddbdabdcadbbddbccdddabadadbbbbdbdadbadbdaccb	TRUE
cbaacacacbccccaabacdbacaaccadaddaadbdaddabdadb	TRUE
ccccbcaacabdbdaaabdbbaddbbdabbabadbbbdadbcdacb	TRUE
daaddaadaddcbaccbaccbaddddcbcccccaadabcbcbbaca	TRUE
dadabddaccccbcbcddbbbacaabbdabacbbbbccbcabbcba	TRUE
dbabdbabcbcbbbacadadddbbbddadcbaaddbdadabdbbdc	TRUE
dbbddacaaacdaaababaaddbadadaadcddadbacabaabbcb	TRUE
dcbdadababaabaabadddaadbbababcbaccadcaacbccabc	TRUE
ddabbadddbbaabbbaccabccabcaacbddbabddcbabbbdbc	TRUE
ddbddbdaabdbaababddbbaabbbaadddccadbbbdadcdbad	TRUE
aaaaaabbadbbdadabaacaacaaacdcacbbbbacbbaaacbac	FALSE
aabbbababadadaaaaaabacaddadaaccccaacacbcbacaab	FALSE
aadbdbdddacbbbbbbcaaabadddbbdbabbbdddaaddccacb	FALSE
abbabdddabbbdabdccaaccabacbbabbbacabddccbbbacb	FALSE
abdadddadbcbbcbbabacbbcbddbdaadadbccbcbbacbbab	FALSE
accbcbacbacabacaaabadbaaddadbbabdbdbdbadcbbccc	FALSE
adbbabadcbbcbacdbbaadbbbddbbdaaaadabdabbbadacb	FALSE
addaddbbdbccbbababbabccaccbaaabddadcabaacbbcbb	FALSE
baadbbadabbabbbadbaaaadadbcdbdbbdabdccbcacbcb	FALSE
bacbbbabcbcccbbaaadddadbdbddbbacacbccaaccacbca	FALSE
bbaadbabaadbbbdcbcabcccbdaddadababbdaddbdbadca	FALSE
bbbdbdbccaaacabcccbbbaacaacddbaaddaddbdabccba	FALSE
bcaaabbbabaacbaaaabacddabdacbaaaaccabbccbccbcc	FALSE
bdacaaacdaaadaaaaaadbbadbbbccbbacccbaacabcbcac	FALSE
bdbddadadadabbbbaaaaaadbadbbccbabcccbbbcaddbca	FALSE
bdddbdabdbadbbddbccdddabadadbbbbdbdadbadbdaccb	FALSE
cbaacacacbccccaabacabacaaccadaddaadbdaddabdadb	FALSE
ccccbcaacabdbdaaabdbbaddbbdabbabadbbbdadbadacb	FALSE
daaddaadaddcbaccbaccbaddddcbcccccaababcbcbbaca	FALSE
dadabddaccccbcbcddbbbabaabbdabacbbbbccbcabbcba	FALSE
dbabdbabcbcbbbacadadddbbbddadbbaaddbdadabdbbdc	FALSE
dbbddacaaacdaaababaaddbadadaadbddadbacabaabbcb	FALSE
dbdadababaabaabadddaadbbababcbaccadcaacbccabc	FALSE
ddabbadddbbaabbbaccabccabcaacbddbabddcbabbbbc	FALSE
ddbddbdaabdbaababddbbaabbbaadddccadbbbdadbdbad	FALSE
aaaaaababaaababddadaadbaccdcacbbbcbbaaaaaacbbbd	TRUE
aabbadbcdbdbddddcdbbaabbbbbbbbdcabbaacacccccccc	TRUE
aadbadcbdabdbddadbbdbbadabadaabbbcbcbdbacaaaaaa	TRUE
abaddabaaabdbaccdaabbccbacacaaababcccbccdccacca	TRUE
abdabddabbbabaaabbbbaadbcadabddbabadacccdaaacaa	TRUE
acbcabbcbbaccbcacdcbbbaadbabaaaabbbdacbbccabacc	TRUE
adaddccbabcbdaaddcdabdbbbbddaaadbdaaddddbadddab	TRUE
addacabbaadbbbadcaccaabcbbbaccbdadddbdbaaabbbbb	TRUE
baacbddaadbbdcaabbcabbbcabbdbbddaaaacbbaaacaabb	TRUE
babdbdcbbdbbbaaadaadaaabdabddbbbdcbacbbbbbbcdbb	TRUE
baddbacbbabbccacaaaddabbaaabacabbbcbbbadcabcbcc	TRUE
bbbabadaaaabbabdabdaaaaddcbddccbaccaabcdaabbcbb	TRUE
bbdabdaabdbdbdcacdaaabcabcbcbabddddabdbaadddaad	TRUE
bccbcbcbdaabaacccccbcadadbdadaadbdddddbbaadacbc	TRUE
bdbadcababcdccacdbdbcaabbbcbbbacccbacaabbbbbbcb	TRUE
bddbdbdbdbdababbacbbaaadaaaccabacbdbbaadaacacbc	TRUE
cacbbcbbbddbadddadbbaadbddbadcabaaaccaaaaadaccb	TRUE
ccbcbbadbdbdadbadadabbdbcbabbacabdcbabccccbaabb	TRUE
daadadadaddbdbbdddadaadbbbcadbabaddacadadaddabc	TRUE
daccccabbdabdadabaddbccbbabbaccbbacaabaacadcbac	TRUE
dbaadddaddccdbabbadcacbcacabaabbaaaacbccacbcdcb	TRUE
dbbbdaddbaabbbabddddaadcaccabbabdabaacadcbcaaaa	TRUE
dbddddbbaabbbbbbaaddbbbddacbddabaddcbadbdbdbdaa	TRUE
ddabdbabbddbabbdadddcbadadbdddbccdddadbbadabbdb	TRUE
ddbdddaaaacadabbaaaacaaabcacababbcaaabbdcbbbbaa	TRUE
aaaaaababaaababddadaadbaccdcacbbbcbbaaaaaacbbba	FALSE
aabbadbcdbdbdddddbbaabbbbbbbbdcabbaacacccccccc	FALSE
aadbadcbdabdbddadbbdbbadabadaabbbcbcbcbacaaaaaa	FALSE
abaddabaaabdbaccdaabbccbacacaaababcccbccaccacca	FALSE
abdabddabbbabaaabbbbaadbaadabddbabadacccdaaacaa	FALSE
acbcabbcbbaccbcacccbbbaadbabaaaabbbdacbbccabacc	FALSE
adaddccbabcbdaaddadabdbbbbddaaadbdaaddddbadddab	FALSE
addadabbaadbbbadcaccaabcbbbaccbdadddbdbaaabbbbb	FALSE
baabddaadbbdcaabbcabbbcabbdbbddaaaacbbaaacaabb	FALSE
babdbdcbbdbbbaaadaadaaabdabddbbbdcbacbbbbbbccbb	FALSE
baddbacbbabbccacaaaddabbaaabacabbbcbbbacabcbcc	FALSE
bbbabadaaaabbabdabdaaaadddbddccbaccaabcdaabbcbb	FALSE
bbdabdaabdbdbdcacbaaabcabcbcbabddddabdbaadddaad	FALSE
bccbcbcbaaabaacccccbcadadbdadaadbdddddbbaadacbc	FALSE
bdbadcababcaccacdbdbcaabbbcbbbacccbacaabbbbbbcb	FALSE
bddbdbdbdbdababbadbbaaadaaaccabacbdbbaadaacacbc	FALSE
cacbbcbbbddbadddadbbaadbddbadcabaaaccaaaaaaaccb	FALSE
ccbcbbadbdbdadbadadabbdbcbabbacabccbabccccbaabb	FALSE
daadadadaddbdbbdddadaadbbbcadbabaddaadadaddabc	FALSE
daccccabbdabdadabaddbccbbabbaccbbacaabaacaacbac	FALSE
dbaadddaddccdbabbadcacbcacabaabbaaaacbccacbccb	FALSE
dbbbdaddbaabbbabddddaadcaccabbabcabaacadcbcaaaa	FALSE
dbddddbbaabbbbbbaaddbbbddabddabaddcbadbdbdbdaa	FALSE
ddabdbabbddbabbdaddddbadadbdddbccdddadbbadabbdb	FALSE
ddbdddaaaacacabbaaaacaaabcacababbcaaabbdcbbbbaa	FALSE
aaaaaddbddbbaddcdaabaabbbdaaabdbdbbcbacccdcbacaa	TRUE
aabbbddadcccaaababaaaaacbbcbbadacbbcacccbaabcbda	TRUE
aadbbbbbbbdaaaadabbaabaaaaddcaaabcbacdbcaaacbbdc	TRUE
ababcabdabbbdcccbaaccabcbabcdcbbcbabacbabacaabac	TRUE
abbdbdbbddaddaacaaadbdbaaaddcaccaacdcabacbccabcc	TRUE
acdababddbbbbddcacabbcaacbbadadbbaababcacbacaccb	TRUE
adabdbdbcbbccaabbccabbbdacbacacbcbcabbbbdddaadca	TRUE
adbddbddcbbcdbbadbcaaadbabaacbacbbccccccccbcaaba	TRUE
baaaaabdbbdbccbccdbddccaaabbcbcabcccbbcbbcbadbaa	TRUE
babbcbaadddaddccbacbabcccbaaacbcabaacabacadbdddd	TRUE
baddaabaacbaadabaaadabdacaccbcaadabbbdadbabdadaa	TRUE
bbbaabdbdaaccbdabadbddaaaccbaaaaccbcbccaabaabbdc	TRUE
bbdadadabadaadadbdbdccabaabcbbdbbabdbccccaadacac	TRUE
bccbbbbadcabaabbaccccbbccabaacbabcdabcbbacbabacc	TRUE
bdbabadacccaaabcacbcbcadaabbbcbbababcaaaccaaaaad	TRUE
bddadadbdbabdabcacdbaddbdabbdbbdbabdacdbaabddbad	TRUE
caaaccabcbccaabaadbbcadbddabdaabadaadddbbcabaaba	TRUE
ccaababcbcbbabacbabbbcbdacabccdbaacaaaaaccccacac	TRUE
daabdcaaababdbaabbbbadddbdaabacababcbdcabbccacbc	TRUE
dabddbdadabdadbdccccdaddcdadaaabbddabadabdaaabba	TRUE
dbaadbaabcbbbccddddddbadcdddbbadaddbbdbbabacaabc	TRUE
dbbdbaadababbbbbacbabacabdbadbcabbbddababddcbbba	TRUE
dbddbbccaadabaaabbadbddbddaadabbccbccaacacacbadc	TRUE
ddaadabaaaaabdbbbaccabcabaaccabdbddbaaacabadacac	TRUE
ddbdbabdbdadacbadadaaddabcbabbbaddadadbbbbabcabb	TRUE
aaaaaddbddbbaddadaabaabbbdaaabdbdbbcbacccdcbacaa	FALSE
aabbbddadcccaaababaaaaacbbcbbaacbbcacccbaabcbda	FALSE
aadbbbbbbbdaaaadabbaabaaaaddcaaabcbacabcaaacbbdc	FALSE
ababcabdabbbdcccbaaccabcbabcbcbbcbabacbabacaabac	FALSE
abbdbdbbddaddaabaaadbdbaaaddcaccaacdcabacbccabcc	FALSE
aadababddbbbbddcacabbcaacbbadadbbaababcacbacaccb	FALSE
adabdbdbcbbccaabbccabbbbacbacacbcbcabbbbdddaadca	FALSE
adbddbddcbbcdbbadbaaaadbabaacbacbbccccccccbcaaba	FALSE
baaaaabdbbdbccbccdbddccaaabbcbcabcccbbcbbcbacbaa	FALSE
babbbbaadddaddccbacbabcccbaaacbcabaacabacadbdddd	FALSE
baddaabaabbaadabaaadabdacaccbcaadabbbdadbabdadaa	FALSE
bbbaabdbdaaccbdabadbddaaaccbaaaaccbcbccaabaabbcc	FALSE
bbdadadabadaadadbdbdccabaabcbbdbbabdbccccaabacac	FALSE
bccbbbbaacabaabbaccccbbccabaacbabcdabcbbacbabacc	FALSE
bdbabadacccaaabcacbcbcacaabbbcbbababcaaaccaaaaad	FALSE
bddadadbdbabdabcacdbaddbdabbdbbdbabdadbaabddbad	FALSE
caaaccabcbccaabaacbbcadbddabdaabadaadddbbcabaaba	FALSE
ccaababcbcbbabacbabbbcbdacabccabaacaaaaaccccacac	FALSE
daabdcaaababdbaabbbbadddbdaabacababcbbcabbccacbc	FALSE
dabddbdadabdadbdccccdaddbdadaaabbddabadabdaaabba	FALSE
dbaadbaabcbbbccddddddbadadddbbadaddbbdbbabacaabc	FALSE
dbbdbaadababbbbbacbabacabdbadbbabbbddababddcbbba	FALSE
dbddbbccaadabaaabbadbddbddaadabbccbccaacacacbac	FALSE
ddaadabaaaaabdbbbaccabcabaaccabdbddbaaadabadacac	FALSE
ddbdbabdbdadacbadadaaddabababbbaddadadbbbbabcabb	FALSE
aaaaaabdaaadaaccccbaaacbbacdadddbbadbdbaabcadacba	TRUE
aabbbbdbbdabababdbdbdaaadbaabdbcdbbdbadcaadabbddc	TRUE
aadbdacacaaadaacabbabbbacacbbccbdbbdddddaabdbdcac	TRUE
abadbbbbdababbddadddadabccddbdbdbdadabcacbdcccbbb	TRUE
abdaaaaadbdacabcacbabbcacacbdaabbcacbacbabcbddaca	TRUE
accabbbccbbccacddacbbaabbbbbacbaabaacaabcbcbdaaca	TRUE
adadadcaadadadcacccdbddbbbbbbadddbcbabaaabacbbcbb	TRUE
adccbaabccabbbccdbaacacbbaccabccdddbadadbbdbdcacb	TRUE
baaadddadaddaabbaddbdadadaacddbadacabcaabacbcbccd	TRUE
babcccaccaaadaaacbbbababcacbcbacdbabbabcaabbccbba	TRUE
baddbdcaacacccbbaccccaaaccaacdccacbccbdaaadbcacbb	TRUE
bbbaadbdcaaaaaacddbbbddabdbbdbdddcdaabdabaadabaab	TRUE
bbdbababcacabbbcaccbbbdbcbcbcbdddbddaadbadddbbbad	TRUE
bcdcabbcdaabdaaddadbdddbaadbbbaddabbaaadbdcccaaaa	TRUE
bdbbacddddaaddcbcdaabbbbadbdabadddbabbbcbbcbcbcab	TRUE
bddbdaaddaaddbcccddddadaddbacdadcbcbabbcbbabbaccc	TRUE
cababcaaacbaababababbdbabaacccababcadddbdaadbbaab	TRUE
ccbcbbaccaaabbdbcbabacdadadddaabccbbbbbbbacacbcca	TRUE
daadbadbddaadbddaabbddadbcaabddbbbbbacadaccbcccac	TRUE
dacaababacbbbdacccaabcabbaaccacbcbcacddddcbabccbc	TRUE
dbabbcbbaabcbcbacdaacddaabadddbbbdababdbdbcaccbab	TRUE
dbbdbdabbadbcbdbbbbbcacccbacbbcacadabcbcaabcabccb	TRUE
dbddbdadbdbaddbadbabddbdbbbabbdacabcabbddadddcaad	TRUE
ddabaabaddcdadcabbaabccbacbbbaaacabbbbddaddaabaac	TRUE
ddbdabbcaaccabbacdbaaabbbabacbbbcccbbcddbaadaaabd	TRUE
aaaaaabdaaadaaccccbaaacbbacdadddbbadbdbaabcaaacba	FALSE
aabbbbdbbdabababdbdbdaaadbaabdbbdbbdbadcaadabbddc	FALSE
aadbdacacaaaaacabbabbbacacbbccbdbbdddddaabdbdcac	FALSE
abadbbbbdababbddadddadabccddbdbdbdadabcacbcccbbb	FALSE
abdaaaaadbdacabcacbabbcacacbaaabbcacbacbabcbddaca	FALSE
accabbbccbbccacddacbbaabbbbbacbaabaacaabcbcbaaca	FALSE
adadadbaadadadcacccdbddbbbbbbadddbcbabaaabacbbcbb	FALSE
adccbaabccabbbcccbaacacbbaccabccdddbadadbbdbdcacb	FALSE
baaadddadaddaabbaddbdadadaaddbadacabcaabacbcbccd	FALSE
babcccaccaaadaaacbbbababcacbcbacababbabcaabbccbba	FALSE
baddbdcaacacccbbaccccaaaccaacaccacbccbdaaadbcacbb	FALSE
bbbaadbdcaaaaaacddbbbddabdbbdbddddaabdabaadabaab	FALSE
bbdbababcacabbbcaccbbbabcbcbcbdddbddaadbadddbbbad	FALSE
bccabbcdaabdaaddadbdddbaadbbbaddabbaaadbdcccaaaa	FALSE
bdbbaddddaaddcbcdaabbbbadbdabadddbabbbcbbcbcbcab	FALSE
bddbdaaddaaddbcccddddadaddbaadadcbcbabbcbbabbaccc	FALSE
cababcaaacbaababababbababaacccababcadddbdaadbbaab	FALSE
ccbcbbaccaaabbcbcbabacdadadddaabccbbbbbbbacacbcca	FALSE
daadbadbddaadbddaabbddadbaabddbbbbbacadaccbcccac	FALSE
dacaababacbbbbacccaabcabbaaccacbcbcacddddcbabccbc	FALSE
dbabbcbbaabcbcbaccaacddaabadddbbbdababdbdbcaccbab	FALSE
dbbdbdabbadbcbdbbbbbcacccbacbbcacababcbcaabcabccb	FALSE
dbddbdadbdbaddbadbabddbdbbbabbdacabcabbddadddbaad	FALSE
ddabaabaddbdadcabbaabccbacbbbaaacabbbbddaddaabaac	FALSE
ddbdabbcaaccabbacbbaaabbbabacbbbcccbbcddbaadaaabd	FALSE
aaaaaabaabdddddbbcadacbbbbdabbbdbdbbadbaaaaadccbba	TRUE
aabaddbbdadbbdbdbcbddaaabbddbabacccbdbabbcbabbbaba	TRUE
aadbaaaddadddbabaadddabbcbdababbddacaaccdaccabbaac	TRUE
abadbbaaabcdbdbddabdbbaabaaaaddbdddbbacaccdcacbcbc	TRUE
abcbbbabacbcbbbccaccbcaaaccbccbabbcabbbbdbbbacadda	TRUE
acbaddadbbaddbaddabddbdcacacaacdaabaaabacbaaabcbac	TRUE
adaddbbcbbdcabbcaccbccdadaadaabddaabbbcaabbaabbacb	TRUE
addaabaddabaadcbcbbbadbbdbdddabdadabddccacaccdabcc	TRUE
baaadacbbabccaddbbdabbbbaabbddbabbdacadababddbaccb	TRUE
babdaaacacccbaaccacccbcbbadbddbabdabdcbababdababdd	TRUE
bbaaababbabbcdabdaabcbbababcbacadabcacccbaccaabbaa	TRUE
bbbbcdabdbdbaabdbdabddacbccbbddbbdabaaaacacabaabca	TRUE
bbdbdbddcbdabbddddaddbcaaabacccbbaccadbbdcbabbabaa	TRUE
bdaabddbbdbddbdcbbbbacbcadbaacacbbbbccbabddabbbbbb	TRUE
bdbbddbbacbadaaabbcddddadaaaababdaddaaddbbaaaadbca	TRUE
cbbdbaababbddabababaaaaddacbaaaaaabbcbaaddcbbbbbac	TRUE
cbbaaadbdadbbadbdbddbababaddcaadddabdbddbdbdcaabac	TRUE
daaabbbabdddbaadbaadaaacaddbaddddaaddbadcbbadcbbbb	TRUE
dabbcabacaabcbdaadaaadbadadcdbdaabdbaadbdcccaccaca	TRUE
daddadabbaaaaadbcaaabbcababccdbbbccbdcbacacaacbccc	TRUE
dbbabdddbddadadabacdbbbbaaaadabdaacabbddaabababbbb	TRUE
dbdadaaaaddddcacdcabdbabbddaddbbaadccabbabbbabacbc	TRUE
dcbabbadddaddaadcdbaaaadbcaababbccabaaababcbbaaacb	TRUE
ddaccbcaacbccbadbdbdabdaabaddaabcddbaacacbaaccacac	TRUE
ddbdcddbddbbccbcbddbaadabbdbbaaddbaddbdbddaddbddac	TRUE
aaaaaabaabdddddbbadacbbbbdabbbdbdbbadbaaaaadccbba	FALSE
aabaddbbdadbbdbdbcbddaaabbddbabacccbbbabbcbabbbaba	FALSE
aadbaaaddadddbabaadddabbbdababbddacaaccdaccabbaac	FALSE
abadbbaaabadbdbddabdbbaabaaaaddbdddbbacaccdcacbcbc	FALSE
abcbbbabacbcbbbccaccbcaaaccbccbabbcabbbbabbbacadda	FALSE
acbaddadbbaddbaddabddbdcacacaacaaabaaabacbaaabcbac	FALSE
adaddbbcbbacabbcaccbccdadaadaabddaabbbcaabbaabbacb	FALSE
addaabaddabaadcbcbbbadbbdbdddabdadabddccacaccaabcc	FALSE
baaadacbbabccaddbbdabbbbaabbddbabbdabadababddbaccb	FALSE
babdaaacacccbaaccacccbcbbadbddbabdabdabababdababdd	FALSE
bbaaababbabbadabdaabcbbababcbacadabcacccbaccaabbaa	FALSE
bbbbddabdbdbaabdbdabddacbccbbddbbdabaaaacacabaabca	FALSE
bbdbdbddbbdabbddddaddbcaaabacccbbaccadbbdcbabbabaa	FALSE
bdaabddbbdbddbdcbbbbacbcabbaacacbbbbccbabddabbbbbb	FALSE
bdbbddbbacbadaaabbddddadaaaababdaddaaddbbaaaadbca	FALSE
bbdbaababbddabababaaaaddacbaaaaaabbcbaaddcbbbbbac	FALSE
cbbaaadbdadbbadbdbddbababaddaadddabdbddbdbdcaabac	FALSE
daaabbbabdddbaadbaadaaacaddbaddddaaddbadcbbabcbbbb	FALSE
dabbcabacaabcbdaadaaadbadadddbdaabdbaadbdcccaccaca	FALSE
daddadabbaaaaadbcaaabbcababccabbbccbdcbacacaacbccc	FALSE
dbbabdddbddadadabacdbbbbaaaadabdaaaabbddaabababbbb	FALSE
dbdadaaaaddddcacccabdbabbddaddbbaadccabbabbbabacbc	FALSE
dcbabbadddaddaadbdbaaaadbcaababbccabaaababcbbaaacb	FALSE
ddaccbcaacbccbadbdbdabdaabaddaabaddbaacacbaaccacac	FALSE
ddbdddbddbbccbcbddbaadabbdbbaaddbaddbdbddaddbddac	FALSE
