aaaacaadcccdbbcacdadacbcccccdaa	TRUE
abaccdcbacbdcbcacccacadbccdcacb	TRUE
acacbbdcaddaaaaccddcbcddcbddcac	TRUE
accbcbbbbbdcccddbcbdccddadccccc	TRUE
adbabdcdccdddddbabdcabadbcadbcb	TRUE
addbadbccacbddddacaddbddccbcdcb	TRUE
badbaccacbadccdbcaccbcbacabdacc	TRUE
bbdcdddbbdcdaaaaaaaaddacbbcddbc	TRUE
bccbbbbbbbcddcaaaaddaacccdacdbc	TRUE
bcddddacdbccdbddcaacbcdbcdcbdbd	TRUE
bdccdbddcbbdcccdcbbbccdacadccbb	TRUE
caacdaccccdddbddbcdaacdcadcaccb	TRUE
cadbccdbabccbddcbccbcdbddccacab	TRUE
cbcaddacbcbcddcddbcbcbdddddbdbb	TRUE
ccabcdcbddabcdbdcbacdcdaccdbcbd	TRUE
ccccbdccbacbaddbdadcccddbcacdbc	TRUE
cdaccccaaacccccbcdccbcaccacaaaa	TRUE
cdccdcacbddddbbcacbcdbcdaadcbdd	TRUE
dababcdbcadbcbdabadbaddbadcbdad	TRUE
dadcacccaddccdaccbabadcddbadbcc	TRUE
dbcbdccdcdcbcdcdaaacdcbcbccbddc	TRUE
dcacadaaadacaacbccaaaccbddbbcbc	TRUE
dccbcacddacaaaaacdcbcaddccaccda	TRUE
dcddbabdcabdccddcdbddcabcbadcdb	TRUE
ddcbabdccdacaddcddcaccbccdbcacc	TRUE
aaaacabadcccdbbcacdadacbcccccdaa	FALSE
bbaccdcbacbdcbcacccacadbccdcacb	FALSE
acabbbdcaddaaaaccddcbcddcbddcac	FALSE
accbcbbbbbdcccadbcbdccddadccccc	FALSE
adbabbcdccdddddbabdcabadbcadbcb	FALSE
addbadbccacbddddaaaddbddccbcdcb	FALSE
badbaccacbadccdbcaccbcbaabdacc	FALSE
bbdcdddbbdcdaaaaaaabddacbbcddbc	FALSE
bccbabbbbbbcddcaaaaddaacccdacdbc	FALSE
bcddddaddbccdbddcaacbcdbcdcbdbd	FALSE
bdccdbddcbbdcccdcbbbccdacadccbba	FALSE
caacdaccccdddbddbbdaacdcadcaccb	FALSE
cadbbcdbabccbddcbccbcdbddccacab	FALSE
cbcaddacbcbcddcddabcbcbdddddbdbb	FALSE
ccabcdcbbddabcdbdcbacdcdaccdbcbd	FALSE
ccccbdccbacbaddbdaadcccddbcacdbc	FALSE
cdaccccaaacccccbcdccbcaccacaaab	FALSE
cdccdcacbddadbbcacbcdbcdaadcbdd	FALSE
dababcdbcadbcbdabadbaddbadcbdaa	FALSE
dadcacccaddccdaccbabadcbddbadbcc	FALSE
dbcbdccdcdcbcdcdaaacdcbcbccbdda	FALSE
dcacadaaadacabacbccaaaccbddbbcbc	FALSE
dccbcacddbacaaaaacdcbcaddccaccda	FALSE
dbddbabdcabdccddcdbddcabcbadcdb	FALSE
ddcbabdccdacadacddcaccbccdbcacc	FALSE
aaaaaadaacbdcccbddcacdcbcdacdada	TRUE
abccbacccccacccdbadccabaddcddacb	TRUE
acbaddbadbabcbcababcabaddcbcdcbc	TRUE
acdbcacbcbdcdddaaaadcdddadcbcbbb	TRUE
adbdcbdabcccabcabcccdcadcdacdcbc	TRUE
bababcdabcdaccccdcbdabcbddddccdb	TRUE
badddcddcdaccbdccdcabacdbdcbadca	TRUE
bcadaadcbcdbccbdddbcccadacbbcbcb	TRUE
bcccbddcdcdcdbdbdbcbbddccdadaaac	TRUE
bdacbcacaccdccbadbcddaddddcdbcad	TRUE
bddbcacdccaddddcbcbbdcddaccbcbdb	TRUE
cacadbadbacbababdcbdcdbcadccadbd	TRUE
cadcddbacbccdbcdccdddbcaccbcddda	TRUE
cbcdaddccadcbcabcdacacbcbdccddad	TRUE
ccacccccdacacdbcaacdacadaddcdbca	TRUE
cccccabcdbcdcddbabacdddadddbcacb	TRUE
cdacbdcccccdadcadcacaacbbdbdcddb	TRUE
cdcdaccbdcadbcbabdccbdacbadcdbca	TRUE
daadadddcdcdccadcadddcbdbdddbcdb	TRUE
dadcacbcacddbadcbacbaccdbddcbcdc	TRUE
dbcbccdcddacccdbdcdccbdcacbababd	TRUE
dcabcbcaccbdccabddabaddcbdabaccb	TRUE
dccbdcdbdacacaccacbaccddcadcacca	TRUE
ddaccbccbbcaddadcdcddcccacaccaaa	TRUE
ddccacddaccadccdcacdaadddaaccdbd	TRUE
aaaaaadaacbdcccbddcacdcbcdacdbada	FALSE
abccbacccccacccdbadccabadadcddacb	FALSE
acbaddbadbabcbaababcabaddcbcdcbc	FALSE
abdbcacbcbdcdddaaaadcdddadcbcbbb	FALSE
adbdcbdaabcccabcabcccdcadcdacdcbc	FALSE
bababcdabcdaaccccdcbdabcbddddccdb	FALSE
badddcddcdaccbdccdcabacdbdcbaaca	FALSE
bcadaadcbcdbccbdddbcccadaabbcbcb	FALSE
bcccbddcdcdcdbdbdbcbbddccbdadaaac	FALSE
bdacbcacaccdccbadbcddaddaddcdbcad	FALSE
bddbcacdccadddddbcbbdcddaccbcbdb	FALSE
cadadbadbacbababdcbdcdbcadccadbd	FALSE
cadcddbacbccdbcdccddbbcaccbcddda	FALSE
cbcdaddccadcbbcabcdacacbcbdccddad	FALSE
cbacccccdacacdbcaacdacadaddcdbca	FALSE
cccccabcdbcdcddbabacdddaadddbcacb	FALSE
cdacbdcccccdadcadbacaacbbdbdcddb	FALSE
cdcdaccbdcadbcbabbdccbdacbadcdbca	FALSE
daadadddcdcdccadcadddcbdbadddbcdb	FALSE
dadcaacbcacddbadcbacbaccdbddcbcdc	FALSE
dbcbccdcddacccbbdcdccbdcacbababd	FALSE
dcaabcbcaccbdccabddabaddcbdabaccb	FALSE
dccbdcdbdacacaccaacbaccddcadcacca	FALSE
ddaccbccbbcadbadcdcddcccacaccaaa	FALSE
ddcbacddaccadccdcacdaadddaaccdbd	FALSE
aaaaaadccbdccaacbdcbddcbcadadccac	TRUE
abadddbddacacdabadbacdcdccccadcbd	TRUE
acaddcbcadcbadbdccadcccaddccdaccb	TRUE
accccddbdcdcbacccbaccbcdacbcacccd	TRUE
adaaddcbbbbdccdaacccacdbbbcaadada	TRUE
addaddcaddcbbddcacaaadacbddcccdbd	TRUE
baccccdddddbddabdcbcadcddbabcbacb	TRUE
bbdbddbbbccdadcbdccdbcccbcbbcacbc	TRUE
bcbdabaddbddcacbdccaccbabdcbadddc	TRUE
bcdbdbccbbbdcddcbccbcbcbbcccaddcd	TRUE
bdcadddbcbccdddcabcabcccddcaddbcb	TRUE
bdddcbcdaacdacdadddcadcdbbddbbddb	TRUE
caccdbabccbcbdacbcadbadbcdccbdcad	TRUE
cbbccdacbbdcdaadacddcbbdcbcdccaaa	TRUE
cbdccbcabdcbcdbdcacacdabcaddddcbc	TRUE
cccacccbdcdadccdcccddbccdbdcaacdd	TRUE
ccdcdabdcabdabaccabccabcbcdaddcbc	TRUE
cdcbcadcdaaacadaaacddcdacaacaccbc	TRUE
cddddacdcdbabcddddcbabcabccdacdba	TRUE
dacdacdbbcddccdcaaccccbcdcdaaaddc	TRUE
dbbdccbbcacdcdaacbbbbddcacacdacbd	TRUE
dbdddcdcdbcdacdaaccaaaccdaddcbbdc	TRUE
dccbcadbadddbcdbddccbdcabadbddaca	TRUE
ddacbbbbcaccccbccbcdadacaccdccbdc	TRUE
ddcbcbddcacdbcbddbdbdcddaacbbddbb	TRUE
aaaaaadccbdccaaabdcbddcbcadadccac	FALSE
abadddbddacacdaaadbacdcdccccadcbd	FALSE
acaddcbcadcbadbdccadcccaddaccdaccb	FALSE
accccddbdcdcbacccbbaccbcdacbcacccd	FALSE
adaaddcbbbbdccdaacccacdbbbcaadadba	FALSE
addaddcaddcbbddcacaaadacbaddcccdbd	FALSE
baccccdddddbddabdcbcadcddbabcbacbb	FALSE
bbdbdabbbccdadcbdccdbcccbcbbcacbc	FALSE
bcbdabadbbddcacbdccaccbabdcbadddc	FALSE
bcdbdbccbbbacddcbccbcbcbbcccaddcd	FALSE
bdcaadddbcbccdddcabcabcccddcaddbcb	FALSE
bdddcbcdaacdacdadddcadddbbddbbddb	FALSE
caccdbabccbcbdacbcadbbdbcdccbdcad	FALSE
cbbccdacbbdcdaadacddcbbacbcdccaaa	FALSE
cbdccbbcabdcbcdbdcacacdabcaddddcbc	FALSE
cccacccbdadadccdcccddbccdbdcaacdd	FALSE
ccdcdabdcabdabaccabccabcbcdaddcbbc	FALSE
cdcbcadcdaaacadaaacddcdacaacaccabc	FALSE
cdddaacdcdbabcddddcbabcabccdacdba	FALSE
dacdadbbcddccdcaaccccbcdcdaaaddc	FALSE
dbbdccbbcacdcdaaabbbbddcacacdacbd	FALSE
dbdadcdcdbcdacdaaccaaaccdaddcbbdc	FALSE
dccbcadbadbdbcdbddccbdcabadbddaca	FALSE
ddacbbbbcaccccbccbcdbadacaccdccbdc	FALSE
ddcbcbddcacdbcbdabdbdcddaacbbddbb	FALSE
aaaaaacddddadcdacdadaaccaadcdbdbcc	TRUE
abacddacabaddcdbabccdbdabaddccbcbc	TRUE
acaccaccccacbcaaccdaddccddaddacada	TRUE
acccabcdcbcdbddddcdcdccadbaddddcab	TRUE
adbacbcbcdacabaddccdcdbacadcbdcacb	TRUE
addcbcbcbddcaacaaddadcacacacdacbdb	TRUE
baddcddddbabaddddbcbabcdcddcacccad	TRUE
bcadbcdcdabdcddddbcdbacdccacbccccc	TRUE
bccbdbcdcdaccacaaccdcbcbbccddbbdcc	TRUE
bcdddbbbbcbcdcbddbcccadccaaacbbcdd	TRUE
bdcdbcbcddacddbcddccccccbabacccdcc	TRUE
cabccacbadcbddcbacdabcabddcadddbcb	TRUE
cadcdccbdaccabcdbabcbdccbdcaddcdba	TRUE
cbccccddaacbddbdddbcbdcdddbbbccbbc	TRUE
ccbabacddabcdbabcbacddccdccccaccad	TRUE
cccdddaccccbccaddcaacbcddcbbbbdcaa	TRUE
cdadddcdccccdbdadcadddbacdccdcdacd	TRUE
cdccdbdccccbcababcdacadbababadcabd	TRUE
dabadcacdabadcaddbdcdcbabacbcddcbc	TRUE
dadbcdbcdbcdacbabcabdccdbdcbacabdc	TRUE
dbcadccdbddabccdcadcddcbabddcbccad	TRUE
dcababdacdacdcccdadcacddddcacaccba	TRUE
dcccadbdccabacdcddacbaddbdcbaccccc	TRUE
ddabaccbacddbdcdcccdbdddabcddcaccb	TRUE
ddcbaccddbccccddbdcacdbdacdcdbcacc	TRUE
aaaaaacddddadcdacdadaaccaadadbdbcc	FALSE
abacddacabaddcdbabbcdbdabaddccbcbc	FALSE
acaccaccccacbcaacbdaddccddaddacada	FALSE
acccaacdcbcdbddddcdcdccadbaddddcab	FALSE
adbacbcbcdacabaddccdcdbacadcbdbcacb	FALSE
addcbcbcbdddaacaaddadcacacacdacbdb	FALSE
baaddcddddbabaddddbcbabcdcddcacccad	FALSE
bcadbcdcdabdcddbddbcdbacdccacbccccc	FALSE
bccbdbcdcdaccabaaccdcbcbbccddbbdcc	FALSE
bcdddbbbbcbcdcbddbcccadccaaadbbcdd	FALSE
bddbcbcddacddbcddccccccbabacccdcc	FALSE
cabccacbadacbddcbacdabcabddcadddbcb	FALSE
cadcdccbdaccabcdbabcbdccbdcaddcdbaa	FALSE
cbccccddaacbddbdddbcbdcdddbbbccabbc	FALSE
ccbabacddabcdbaabcbacddccdccccaccad	FALSE
cccdddaccccbccabddcaacbcddcbbbbdcaa	FALSE
cdadddcdccccdbbdadcadddbacdccdcdacd	FALSE
cdccdbdccccbcababcdacadbabaaadcabd	FALSE
dabadcacdabadcaddbbcdcbabacbcddcbc	FALSE
dadbcdbcdbcdacbabcabdbccdbdcbacabdc	FALSE
dbcadaccdbddabccdcadcddcbabddcbccad	FALSE
dcababdacdacdcccdadcacddddaacaccba	FALSE
dcccadbbdccabacdcddacbaddbdcbaccccc	FALSE
ddabaccbacddbdcdcccdbdddbabcddcaccb	FALSE
ddcbaccddbccccddbdcacdbdacdcdbcaacc	FALSE
aaaacaaaccbcccddbbbbcaccddaaacbbbcc	TRUE
abadcdacddadcbadddcccdacadcadccabcc	TRUE
acbbccdbcddbddcbbdbcdcccbbbdbbddcbd	TRUE
acdbccacdaccddccdcbddccdccaadccddcd	TRUE
adcbcdcdcadadcadacacaaacddbbbbccacc	TRUE
babccccbdcbcccdccbabacdabadcdcdabdd	TRUE
bbcbcdbcaddcdbdccbcadcddccdbcdbdcbd	TRUE
bcbcbcbadbadbdacddccbcdaddbcdbcdccb	TRUE
bcdbcdaaacaddcbbdcdbbbccdbbdccaacbc	TRUE
bdcbbbbdddccdcbdbcbcbbcadaaddccbdca	TRUE
caacbcbcbccccccadcccbbdbcbdbccacdbd	TRUE
cacdabaccacadcacdacdcacbcacddbabdca	TRUE
cbacccccddddbcabdddccccdabdcbcdbadc	TRUE
cbcddcdaddddcaccdbbccdbcddaacdbdcad	TRUE
ccbcadddbcbddadcbacdbdccdacbdcdcdcd	TRUE
cccddcbcacccacacaacbbccadacdadaaadd	TRUE
cdbaccdbcdcbcddaccdccacacbcbacabacd	TRUE
cddaacaacccacccbbcbcaaadcccdbbdbbdd	TRUE
dabcdbacbacbdcacbccbabdacbdcbadcadc	TRUE
dadcdaaddacaaddaacdbbcdacdbbdcdcbcb	TRUE
dbccacacacdbddcdbcabdadcddadccbabac	TRUE
dcaccabddddcbddddddcbcacacadcabccab	TRUE
dcccccbcdacacaddbacabcddddccbdcadbd	TRUE
ddabaddccbacdbdcabaccdbdccdadcbabcb	TRUE
ddcbacdbcbabccadcabababddabacabccbc	TRUE
aaaacaaaccbcccddbbbbcaccddaaacbbabcc	FALSE
abadcdacddadcbadddcccdaacadcadccabcc	FALSE
acbbccdbcddbddcbbdacdcccbbbdbbddcbd	FALSE
acabccacdaccddccdcbddccdccaadccddcd	FALSE
adbbcdcdcadadcadacacaaacddbbbbccacc	FALSE
babccccbdcbcccdccbabacdbbadcdcdabdd	FALSE
bbcbacdbcaddcdbdccbcadcddccdbcdbdcbd	FALSE
bcbcbcbadbbadbdacddccbcdaddbcdbcdccb	FALSE
bcdbacdaaacaddcbbdcdbbbccdbbdccaacbc	FALSE
bdcbbbbdddccdcbdbcbcbbcadaaddbccbdca	FALSE
cbaacbcbcbccccccadcccbbdbcbdbccacdbd	FALSE
cacdabaccacadcacdacdcacbbcacddbabdca	FALSE
bbacccccddddbcabdddccccdabdcbcdbadc	FALSE
cbcddcdabdddcaccdbbccdbcddaacdbdcad	FALSE
cbbcadddbcbddadcbacdbdccdacbdcdcdcd	FALSE
cccddcbcacccacacaacbbccadacbadaaadd	FALSE
cdbaacdbcdcbcddaccdccacacbcbacabacd	FALSE
cddaacabacccacccbbcbcaaadcccdbbdbbdd	FALSE
dabcdbacbacbdcacbccbabdacbdcaadcadc	FALSE
dadcdaaddabaaddaacdbbcdacdbbdcdcbcb	FALSE
dbccacacacdbddcdbcabdadcddadccaabac	FALSE
dcaccaabddddcbddddddcbcacacadcabccab	FALSE
dcccccbcdacacabdbacabcddddccbdcadbd	FALSE
ddabaddccbacdbdcabaccdbdccdadcbabbcb	FALSE
ddcbacdbcbabbccadcabababddabacabccbc	FALSE
aaaaaaadddadcdaadcaaccaadccbbdcddddb	TRUE
abacdbddabacadccbcacdcdcaccccdbcbcca	TRUE
acacdcbbccbbdcbbdbdcacbcbbccddadadaa	TRUE
accddacbcdcaccdcddccabcacdddccaddcac	TRUE
adbcbaccadddddcbcdccbcddbddcdccacbdc	TRUE
addcdacacdcdcdddaccdaaaccbccdccbdcdc	TRUE
baddcabaddcbdadbccccccadcbdabcdcbcca	TRUE
bcacaacccadaaacacacbbcaccccadddaccdb	TRUE
bcccacccddddbdcdbbcbcbbbcacddadcdbdb	TRUE
bcdddbcacdbadddcdcabcbdddcdbddcbcbab	TRUE
bdccccbaccaddddbabcbddabcccccccdbacb	TRUE
cabacdbacaccaddbabcdcbdadccccbaddcad	TRUE
cadcbccabadbcacdacddbcabddacacbabcab	TRUE
cbccababcacadccbdacdccabacdaccbdacba	TRUE
ccaccbbbcbdddcbcdcaaddacdbccdccbddcc	TRUE
ccccdbbcdbcaaaccdbddcbdcbccccbdcdadd	TRUE
cdacacbdcacacacadcaacccdbcaddddcccbc	TRUE
cdcbcddadcbadccdbdacadcddcddadcdbadc	TRUE
cdddddaddbaccbcbdccdbabdcdccadcdbcdc	TRUE
dacdbbddccbcadacdcdbddcccbbcdddddacb	TRUE
dbbdcaadacdadadcaccdbcacbdddcbcbccda	TRUE
dbddabcdbabddacbabccbcbdcdddbcdbdcac	TRUE
dccadaddaaaaddaacccacbccbddccdacaacb	TRUE
ddacaacbccddcaadaaccdadccccdccacbcbc	TRUE
ddcbadcbaccdacdcccdacbdcdddaccbabaca	TRUE
aaabaaadddadcdaadcaaccaadccbbdcddddb	FALSE
abacdbddabacadacbcacdcdcaccccdbcbcca	FALSE
acbacdcbbccbbdcbbdbdcacbcbbccddadadaa	FALSE
accddacbcdcaccdcddccaabcacdddccaddcac	FALSE
adbbcbaccadddddcbcdccbcddbddcdccacbdc	FALSE
addbdacacdcdcdddaccdaaaccbccdccbdcdc	FALSE
baddcabaddcbdadbccccccaadcbdabcdcbcca	FALSE
bcacaacccadaaacacbacbbcaccccadddaccdb	FALSE
bcccacccddddbdcdbbcbcbbbcacddadcdbda	FALSE
bcdddbcaadbadddcdcabcbdddcdbddcbcbab	FALSE
bdcccbbaccaddddbabcbddabcccccccdbacb	FALSE
cabacdbacaccadadbabcdcbdadccccbaddcad	FALSE
cadcbccabadbcacdacddbcabddacaababcab	FALSE
cbccababcacadccbdacdccabacdaccbdacbba	FALSE
ccaccbbbcbdddcbcdcaaddaddbccdccbddcc	FALSE
ccccdbbcdbbaaaccdbddcbdcbccccbdcdadd	FALSE
cdacacbdcacacacadcaacccdbcadddbcccbc	FALSE
cdcbbddadcbadccdbdacadcddcddadcdbadc	FALSE
cdddddadddaccbcbdccdbabdcdccadcdbcdc	FALSE
dacdbbddccbcadacdcdbddcccbbcdddddacba	FALSE
dbbdcaadacdadbdcaccdbcacbdddcbcbccda	FALSE
dbdaabcdbabddacbabccbcbdcdddbcdbdcac	FALSE
dccadaddaaaaddaacccacbccbddccdacaacab	FALSE
ddacaacbccddcaadaaccdbadccccdccacbcbc	FALSE
ddcbadcbaccdacdcccdaacbdcdddaccbabaca	FALSE
aaaaacdddcbddccadaccccccaccaddacbcdcc	TRUE
abcadcbacadbddababccbcdcdddccacbadcdc	TRUE
acaddacbdbbcacaacacacdbddccaddcddbbcd	TRUE
acccbbbddcdadcaaacdcacdcbddddccacbdbc	TRUE
adaccadccaacdcdacdcaaadcdcbbbddcdcaad	TRUE
adcddbadcdcbdacbcbcdccbacbdaddcddadbc	TRUE
badbcbacbdddaddbcadcddcabcbdabdacbcba	TRUE
bcabcdcddadbccdcabdcccccbcccababcddbd	TRUE
bcccacbabdccacbaddccacacccdadcabacdbc	TRUE
bdacdcbadbdcaccadddbcbdcbdadcccbcdcbc	TRUE
bddbcccaacaddddadcdaacbbdcdacccbdbbcb	TRUE
cacaddadadacdbddcddcbccadadcdccccacbc	TRUE
cbacbdabdadbadbdcdbaccddbdcabcddccaca	TRUE
cbdccdccdddcaddccabcbddaccddacadcdbca	TRUE
cccaadcadddaaadacdbccbdcacbbdbbdbcddd	TRUE
ccdccbccddaccbbcbdbbcbdcaddacbddbcbcb	TRUE
cdbddbdbcdaddccccccdcaddaaddcaaacaaac	TRUE
cddcaadccadcdbdcaccdcdbddbbbccadacccc	TRUE
dacadcacdcabcacccacabddcbcbdcbaccacac	TRUE
dbabcbdadbaddcdcccbabdacabcbacadcbaca	TRUE
dbdabacdabcdccaccccbcbdccdddbddcacbab	TRUE
dcbadbccbcccacacbdcddcaccbadbcccbadba	TRUE
dcdaacdbdbddcdbbccbccbbbccdacdcdcdacd	TRUE
ddacddddcbadbcdacadbaccccbadcdccababd	TRUE
ddcccadacbdbddbcdddddccbcdadcccaaacda	TRUE
aabaacdddcbddccadaccccccaccaddacbcdcc	FALSE
abcadcbacadbddababccbcdcdddccacaadcdc	FALSE
acaddacabdbbcacaacacacdbddccaddcddbbcd	FALSE
acccbbbddcdadcaaacdcacdcbddddccacbdbac	FALSE
adaccadccaacdcdabcdcaaadcdcbbbddcdcaad	FALSE
adcddbadcdcbdaabcbcdccbacbdaddcddadbc	FALSE
badbcbacbdddaaddbcadcddcabcbdabdacbcba	FALSE
bbcabcdcddadbccdcabdcccccbcccababcddbd	FALSE
bcccacbabdccacbaddccacacccaadcabacdbc	FALSE
bdacdcbadbdcaccadddbcbdcbdadcccbcdbbc	FALSE
bddbcccaacaddddadcdaacbbdcdacccbabbcb	FALSE
cacaddadadacdbdadcddcbccadadcdccccacbc	FALSE
cbacbdabdadbadbdcdbaccddbdcabbddccaca	FALSE
cbdccdccdddcaddccabcbdbaccddacadcdbca	FALSE
cccaadcadddaaadacdbccbdcacbbdabdbcddd	FALSE
ccdccbccddaccbbcbdbbcbadcaddacbddbcbcb	FALSE
cdbddbdbcdaddccccccdbaddaaddcaaacaaac	FALSE
cddcbadccadcdbdcaccdcdbddbbbccadacccc	FALSE
dacadcacdcabcacccacabddbcbcbdcbaccacac	FALSE
dbabcbdadbaddcdcccbabdaacabcbacadcbaca	FALSE
dbdabaacdabcdccaccccbcbdccdddbddcacbab	FALSE
dcbadbccbcccacacbdbddcaccbadbcccbadba	FALSE
dcdaacdbdbddcdbbccbccbbbccdabcdcdcdacd	FALSE
ddacddddcbaabcdacadbaccccbadcdccababd	FALSE
ddcccadacbadbddbcdddddccbcdadcccaaacda	FALSE
aaaaaaacbcdbdcdadcbbdcdccdbccdacddddca	TRUE
abcadcacccbdcdbdcccacdcabacbadcddbcabd	TRUE
acadbcacccccadcbcbadccccdbaccbadcddddc	TRUE
accdcccdddaaccacbdddbbcdacbcdacdbcadad	TRUE
adcaaadcaadccdacdddbdcdddaddccaccccaac	TRUE
adddbcccabcbacacbdadbacbcddcddbcdcacbd	TRUE
bbbbdccadaddcbcdddaddcbbddddbbccbbcddc	TRUE
bcacdbacccdabacdcbddcaddcaccbcbcdabdad	TRUE
bccdddbcbccaddcaaacdaaddcccddacbbbcacd	TRUE
bdbdbcacdadacdaccccddddcbbdbcddcdbdcca	TRUE
bddccbddacbadbcdadccccdbccacaccabcdbac	TRUE
caccdcbdbbbbbccddbcbccbcdbcdcdddadaddd	TRUE
cbadcdcbdcdccdccdabdcacdacabcbdababdac	TRUE
cbdccacbbcaccacdddcccbcdacadddcdacacac	TRUE
ccbdccbcadddbdccccbdcbcdbdcccbcacbcdcd	TRUE
ccdbdcaddcadbdddcabdcbcddbcadcdacacabc	TRUE
cdbcbcaacdcdccddbcbdccccadcaaddcacadda	TRUE
cddbcdabcccabadbdabdccacbadcddcbcdabac	TRUE
dacbddccbcaacccdcbddbddcdcadccdbccbbcb	TRUE
dadddccdbdccdcdddaaadccbdcacaaadcadaac	TRUE
dbcdccbdddcdcdddbddddcbabcdcdbacabccab	TRUE
dcacccacaacdbbbbccaaaadcddddbbddbcdcdd	TRUE
dccccbcbadcbabcddbcccdcdabdcbcddddccbc	TRUE
dcddcadbcccccaccacdadddddddcdadbccadba	TRUE
ddcabaccbadcbcdbdcbaccbdcccdddddddddcc	TRUE
aaaaaaacbcdbdcdadcbbdcdccdbccbacddddca	FALSE
abcadcacccbdcbbdcccacdcabacbadcddbcabd	FALSE
acadbcacccccadcbcbadccccbdbaccbadcddddc	FALSE
accdcccdddaaccacbdddbbcdadbcdacdbcadad	FALSE
adcaaadcaadccdacaddbdcdddaddccaccccaac	FALSE
adddbcccabcbacacbbadbacbcddcddbcdcacbd	FALSE
bbbbdccadbddcbcdddaddcbbddddbbccbbcddc	FALSE
bcacdbacccdabacdcbddcaddcaccbcbcdabbdad	FALSE
bccdddbcbccaddcaaacdabaddcccddacbbbcacd	FALSE
bdbdbcacdadbacdaccccddddcbbdbcddcdbdcca	FALSE
bddccbddaacbadbcdadccccdbccacaccabcdbac	FALSE
cbaccdcbdbbbbbccddbcbccbcdbcdcdddadaddd	FALSE
cbadcdcbdcdccdccaabdcacdacabcbdababdac	FALSE
cbdccadbbcaccacdddcccbcdacadddcdacacac	FALSE
ccbdccbcadddbdccccbdcbdbdcccbcacbcdcd	FALSE
ccdbdcaddcadbdddcabbcbcddbcadcdacacabc	FALSE
cdbcbaacdcdccddbcbdccccadcaaddcacadda	FALSE
cddbcdabcccabadbddbdccacbadcddcbcdabac	FALSE
dacbddccbcbaacccdcbddbddcdcadccdbccbbcb	FALSE
dadddccdbdccdcdddaaadccbdcacaaabdcadaac	FALSE
dbcdccbdddcdcdddbdddddbabcdcdbacabccab	FALSE
dcacccacaacdbbbbccabaaadcddddbbddbcdcdd	FALSE
dccccbcbadcbbcddbcccdcdabdcbcddddccbc	FALSE
dcddcadbcccccaccacdadddddddcdadbccaadba	FALSE
ddcabaccbadcbcdbbdcbaccbdcccdddddddddcc	FALSE
aaaaaaaddcddccdbbbcdccdddadaacaadcbcada	TRUE
abcaccabcabadbcacdacbdaddcdabccbacbcbca	TRUE
acbacabcdadcddcbacacddcccaddbdccacabcba	TRUE
accdccacbcbddccaacaaccaaadcbcaaccacbdbd	TRUE
adbabdadbacbcbcadccadcacbcbcccdacddddcb	TRUE
addcbcccacadadccdbcdccdbccaddcddaacdccd	TRUE
badccddbdaddbcbcdcdbdcacdddcdcdcdcccacd	TRUE
bcabcccbdacdccbacacbddcccbabacccbdacaca	TRUE
bccbaccdabcdcdcbdcbccbcbccbcbddcbacddbc	TRUE
bcddadcbabcdcbdacbadbdacbccbccaddcbcabc	TRUE
bdcbccdbcdcdcaccaccadddaddcdccaacdcdcbd	TRUE
caacdcbcddccadcbcccddacddddaccbcadacacd	TRUE
cadaaaaaaccdacbddcdcdcdcccccdacccadcbcd	TRUE
cbcacabcdcabadccbcabdabcacdacacbcddbcdc	TRUE
cbddbcaacaacdcbcdbddddcbdcddddaccddbcbc	TRUE
cccadadadcdcdbbbbbbdddbdbcacacdbddbdcbb	TRUE
ccdddcddcbcaddbabcadbdadbadcacacbcadccd	TRUE
cdccaccdacbdcccdddaddcccdccdbbcaaacdaca	TRUE
daadddaccbdbbbbdbdcccbbbcdadcacaaccbccb	TRUE
dadccbcdcadcccbcacbcababdabdccdabcacacd	TRUE
dbcccccabacdbacdbdcddadcacdddcaccadcbda	TRUE
dcaccdadbcadddddbcacacdadbadbddcdbccddb	TRUE
dccdccacadcbcbcdacccadacccdbccaaccddcda	TRUE
ddacccdddcadccbcacabacabacdccddcadddddd	TRUE
ddccdadccbcddcbcdbdacccbdcdacabddcbccbc	TRUE
aaaaaaaddcddccdbabbcdccdddadaacaadcbcada	FALSE
abcaccabcabadbcacdacbdaddcdabccbacbdbca	FALSE
acbacabcdadcddcbacacddcccadadbdccacabcba	FALSE
accdccacbcbddccaacaaccaaaddbcaaccacbdbd	FALSE
adbabdadbacbdbcadccadcacbcbcccdacddddcb	FALSE
addbcccacadadccdbcdccdbccaddcddaacdccd	FALSE
badccddbdaddbcbcdbdbdcacdddcdcdcdcccacd	FALSE
bcabcccbdacdccbacacbddcccbabbcccbdacaca	FALSE
bccbaccdabcdcdcbdcbccbcbccbcbddcbacdbdbc	FALSE
bcdadadcbabcdcbdacbadbdacbccbccaddcbcabc	FALSE
bdcbccdbcdcdcaccaccadddadbdcdccaacdcdcbd	FALSE
caacdcbcddccadcbcccddacddddaccabcadacacd	FALSE
cadaaaaaaccdacbddcdcdcdcccccdacccadbcbcd	FALSE
cbcacabcdcabadccbcabdabcacdacacbbddbcdc	FALSE
cbddbcaacaacdcbcdbaddddcbdcddddaccddbcbc	FALSE
cccadadadcdcdbbbbbbdddbdbcacacdbdadbdcbb	FALSE
ccdddcddcbcadbbabcadbdadbadcacacbcadccd	FALSE
cdccaccdacbdcccdddaddcccdccdbbdaaacdaca	FALSE
daadddaccbdbbbbdbdcccbbbcdadcacaaccbccba	FALSE
dadccbcdcadcccbcacbcababdabdccdaabcacacd	FALSE
dbcccccabacdbacdbdcddadcacdddcaccadcbada	FALSE
dcaccdadbcadddddbbcacacdadbadbddcdbccddb	FALSE
dccdccacadcbcbcdacccadabccdbccaaccddcda	FALSE
ddacccdddcadccbcaaabacabacdccddcadddddd	FALSE
ddcadadccbcddcbcdbdacccbdcdacabddcbccbc	FALSE
aaaacbdccdddadaacdbdbdddcacdbbbcbcaddacb	TRUE
abadbdacbacccacacadcdabcdbcbcddcddacbabd	TRUE
acadacddaaccaacbbdcdcaacccdaadddccdadadd	TRUE
accdaddcbbbbcbccccccdccbbcdaadcbbdccdbdd	TRUE
adbccccaccabdcdccccddababacdabadbadccaca	TRUE
addcdcdacaccdacddbccaaccbccbcadaaaaddcdd	TRUE
badcbcdaddddccadbccdacdcbdcacbadcdcdcadd	TRUE
bcacaccbcdcbcaddcabccccddddbabcabababcbd	TRUE
bcccbccbcabccbdccbdaccacacbabaddbddcdadc	TRUE
bdaccabadcccdcdabdcabddcdcadcbdccddabcbd	TRUE
bddaddddbdabcbabcbcddbcdcdbaccacbcbacacc	TRUE
cacacbdddacbcdcddabccacccbabdcddcdccbddc	TRUE
caddcdabababddacbcbcccdbcccccdcbdacdcacc	TRUE
cbcdbdbbddcbcccdcdbcddbccbbddbcdddddcada	TRUE
ccbbcbbcbdddddcdcbcccddbcaadcbccbdcbbbcd	TRUE
ccdbcdbcccdbccdaddbaddbcdbcccbabccdcdccd	TRUE
cdbbcbcaddcbdbccbcdadccdacdbbcacdcbccbbd	TRUE
cdcdddcdcbcdbccbcdddcacdbdccaacdbbdddcdd	TRUE
dabcaccdbcdbcbcccbcccbadcadcddcbdcbaccdb	TRUE
dadcdbddcddbddadcbccbcadcbddacbddababacd	TRUE
dbccaccaddcdcdcbcacddccdbdddcdbbccdbbdbb	TRUE
dcacadcbbccdcacbccccdccbbcdbdbdbdddbbdca	TRUE
dcccddcadbcdbabdaddcbdcbacbdaddbcdbcabcb	TRUE
ddabdddcbacdbcccbaccdbccddccbabccddbabda	TRUE
ddccbdbbdbcdddcbccacddbdccdacdaadccaaadd	TRUE
baaaacbdccdddadaacdbdbdddcacdbbbcbcaddacb	FALSE
abadbdacbacccacacadcdabcdbcbcddcddacbaabd	FALSE
acadacddaaccaacbbdcdcaacccdaabdddccdadadd	FALSE
accdaddcbbbbcbccccccdccbbcdaadcbbdccabdd	FALSE
adbccccaccbbdcdccccddababacdabadbadccaca	FALSE
addcdcdacaccdacddabccaaccbccbcadaaaaddcdd	FALSE
badcbcdaddddccadbccdacdcbdcacbadcdcdcadad	FALSE
bcacaccbcdcbcaddcabccccdbdddbabcabababcbd	FALSE
bcccbccbcabccbdccbdaaccacacbabaddbddcdadc	FALSE
bdbccabadcccdcdabdcabddcdcadcbdccddabcbd	FALSE
bddaddddbdabcbabcbcddbcdbdbaccacbcbacacc	FALSE
cacacbbdddacbcdcddabccacccbabdcddcdccbddc	FALSE
caddcdabaaabddacbcbcccdbcccccdcbdacdcacc	FALSE
cbcdbdbbddcbcccdcdbcddbccbbddacdddddcada	FALSE
ccbbcbbcbdddddcdcbcccddbcaadcbccbdcabbbcd	FALSE
ccbbcdbcccdbccdaddbaddbcdbcccbabccdcdccd	FALSE
cdbbcbcaddcadbccbcdadccdacdbbcacdcbccbbd	FALSE
cdcdddcdcbcdabccbcdddcacdbdccaacdbbdddcdd	FALSE
dabcaccdbcdbbcccbcccbadcadcddcbdcbaccdb	FALSE
dadcdbddcddbbddadcbccbcadcbddacbddababacd	FALSE
dbccaccaddcdcdcbcacddccdbdddcdbbccdbbdabb	FALSE
dcacabdcbbccdcacbccccdccbbcdbdbdbdddbbdca	FALSE
dcccddcadbcdbabdaddcbdcbacbdaddbcdbcaabcb	FALSE
ddabddddbacdbcccbaccdbccddccbabccddbabda	FALSE
ddcabdbbdbcdddcbccacddbdccdacdaadccaaadd	FALSE
aaaaaaccbdbdcbcbbbbdbbddbdcbddcdaacccccad	TRUE
abcadddbccdddbaddbdcddcdabddadcdabcdddabc	TRUE
acadcbddbdcddcbdcaccccaacadaccdccbcccacca	TRUE
accccdcacddacaddccccdcaccdcacbabacccdbcca	TRUE
adacaccaacbbccaaadacbdbcdddbdcdaddcccacaa	TRUE
addaccdbdbdbccddaccdacbdcbccbcacdddcdbbdb	TRUE
bacdbcbccbdacccdcabcadbabcadbddabcdbdcaca	TRUE
bcaacccdddddbcacdaaaddacddbbdbbbcdcbcddbd	TRUE
bccbabdabcadccdbddacabaccbccddbabacccdbda	TRUE
bcddadbcccccbcbcdbcccadcdcaccbabcddcbacad	TRUE
bdcdccddcacdccbdacddcaccddccdddcbdcdaccba	TRUE
cacadcccdcdacabdcdcbdacbdcadbacbdddabccba	TRUE
cbababddcbacacdcabcbacbdddcacdcbacdbadbac	TRUE
cbdbbcaddcdbbdccbcbbbcaddacdbbbcdcdbdbccc	TRUE
ccbcacbbbcdbdbcddcdcbccbbccacdcddcaccdaaa	TRUE
ccdacbaccdddacccbdacddacdadbaddddcdbacbad	TRUE
cdaddcadaaccccbdbcaaaadaacacdcddbcccacddc	TRUE
cdccddcbdddcccbbcbdccbddcaccddaddcacacaaa	TRUE
dabacabacddbddacabddadcdbabaddbadcbadbacb	TRUE
dadcadcacccaccdbcbcccbbcccbdcdddcbdcacbca	TRUE
dbccaccdcdcadcaaadddacadcdadacbbbdccdcaac	TRUE
dcaccabdadcabcadcdbabacaddcabcbcbabacdacb	TRUE
dccdabcbdcbadbabcbadbddacbcccaccdacdbcdad	TRUE
ddacaccbdccaaddcbcbddcddcccaadcaaacdddacb	TRUE
ddccadccddccdbdaccbdcdbcdcccbddacddadcdbc	TRUE
aaaaaaccbdbdcbcbbbbdbbddbdcbddddaacccccad	FALSE
abbadddbccdddbaddbdcddcdabddadcdabcdddabc	FALSE
acaddbddbdcddcbdcaccccaacadaccdccbcccacca	FALSE
accccdcacddacaddccccdcaccdcacbabbacccdbcca	FALSE
adbcaccaacbbccaaadacbdbcdddbdcdaddcccacaa	FALSE
adbdaccdbdbdbccddaccdacbdcbccbcacdddcdbbdb	FALSE
bacdbcbccbdacccdcabcadbabcadbddaabcdbdcaca	FALSE
bcaacccdddddbcacdaaaddacddbbdbbbcdcbcddbad	FALSE
bccbabdabbcadccdbddacabaccbccddbabacccdbda	FALSE
bcddaadbcccccbcbcdbcccadcdcaccbabcddcbacad	FALSE
bdcdccddcacdccbdacddcaccddccdddcbbcdaccba	FALSE
cacadcccdcdacabdcdcbbdacbdcadbacbdddabccba	FALSE
cbababddcbacacdcaacbacbdddcacdcbacdbadbac	FALSE
cbdbbcaddcdbbdccbcbbbcaddacadbbbcdcdbdbccc	FALSE
ccbcacbbacdbdbcddcdcbccbbccacdcddcaccdaaa	FALSE
ccdacbaccdddacccbbacddacdadbaddddcdbacbad	FALSE
cdaddcadaaccccbdbcabaadaacacdcddbcccacddc	FALSE
cdccddcbdddaccbbcbdccbddcaccddaddcacacaaa	FALSE
dabacabacddbddacbbddadcdbabaddbadcbadbacb	FALSE
dadcbadcacccaccdbcbcccbbcccbdcdddcbdcacbca	FALSE
dbccaccdcdcadcaaadddacadcdadacabbbdccdcaac	FALSE
dcaccabdadcabcaacdbabacaddcabcbcbabacdacb	FALSE
dccdabdbdcbadbabcbadbddacbcccaccdacdbcdad	FALSE
ddacaccbdccaaddbcbddcddcccaadcaaacdddacb	FALSE
ddccadccddccdbdaccbdcbdbcdcccbddacddadcdbc	FALSE
aaaaaacbdddcdbcacdccbdcdbddbdcbbcbdccddcac	TRUE
abcaccdcdcdacbdcdbcbdacddccccabdabcbdccabd	TRUE
acadadcacdcacbbdbcbcdbbddbbccccdbbbccccbdb	TRUE
acccdadcabcdcdbabdddccddccccbdaddbcdbdacdc	TRUE
adbabcbcccddbacbadcddacdcababdabccdddabdad	TRUE
addbcdccacaddcacadccddadbdcdacdbdabccddcdb	TRUE
badcacbacddcdadcbcdabdacbcbccccdcbdcbdcacb	TRUE
bcaccbdcacccaaaaadcddbbccbdbcaddddcacbcbdc	TRUE
bcccdcadacccdadaccbdbdcdbccbbbcbbcdbbdbbdd	TRUE
bdbbcacacdbdcbdbccacbcbcacaaadcbbccdaaddca	TRUE
bddcadcccccabccaccaccddabacdbacccbaccbddad	TRUE
cacccbdcbaccbcdddddbcdaddccdccdbdcddabcacb	TRUE
cbabccccbdcbcbacaccbdccabddadcbcbccdabdaba	TRUE
cbcddaccbccdddbbbdcbbcccacbcaacdaccdddcbdd	TRUE
ccbbcddccbbcacbdccccbdcdbdcccbcacdaacccbbc	TRUE
ccdbcbdcccbdabcbdacababdcddabaccabadcacddd	TRUE
cdaddcaccddcdabcccddacdcccabdcdbdcbaddbccb	TRUE
cdcddbaddcdbccbccbdccdccbcdbadbadddcbcdacc	TRUE
dabccbcbcddccdddccbccaddbccaddbdacddacdacc	TRUE
dadddcdbbcccdbccaccdaaaccacdbcbccbccbbbbcc	TRUE
dbcdddccdcdbdccdabcdacacabcadbdcabdccdbcad	TRUE
dcbbcdbdbcadcbbddbbccbdcdccdbdcbbccddcbddb	TRUE
dccddcdbbcdaddcdbdcaaccaccdbbcccdbccdadcbc	TRUE
ddacbccbccdddacdaddccaddbdccaccbdabacccddb	TRUE
ddcbcbddddcaccbbdddbdccdcddacdacaccdbdccdb	TRUE
aaaaaacbdddcdbcacdccbdcdbddbdcbbcbaccddcac	FALSE
bbcaccdcdcdacbdcdbcbdacddccccabdabcbdccabd	FALSE
acadadbcacdcacbbdbcbcdbbddbbccccdbbbccccbdb	FALSE
acccdadcabcdcdbabdddccddccccbdaddbcbbdacdc	FALSE
adbabcbbcccddbacbadcddacdcababdabccdddabdad	FALSE
addbcdccacadacacadccddadbdcdacdbdabccddcdb	FALSE
badcacbacddcdadcbcdabdacbcbccccdcbdcbdcacbb	FALSE
bcaccbdcacccaaaaadcddbbccbdbcadddbcacbcbdc	FALSE
bcccdcadacccdadaccbdbacdbccbbbcbbcdbbdbbdd	FALSE
bdbbdacacdbdcbdbccacbcbcacaaadcbbccdaaddca	FALSE
bddcadcccccabccaccaccddaabacdbacccbaccbddad	FALSE
caaccbdcbaccbcdddddbcdaddccdccdbdcddabcacb	FALSE
cbabccccbdcbdbacaccbdccabddadcbcbccdabdaba	FALSE
cbbddaccbccdddbbbdcbbcccacbcaacdaccdddcbdd	FALSE
ccbbaddccbbcacbdccccbdcdbdcccbcacdaacccbbc	FALSE
ccdbcbdccbbdabcbdacababdcddabaccabadcacddd	FALSE
cdaddcaccddcdaabcccddacdcccabdcdbdcbaddbccb	FALSE
cdcddbaddcdbccbccbdccdccbcdbaadbadddcbcdacc	FALSE
dabccbcbcddccdddccbccaddbccaddbbdacddacdacc	FALSE
dadddcdbbcccdbccaccdaaaccaddbcbccbccbbbbcc	FALSE
dbcdddccdcdbdccdabcdacacabcadbdcabbdccdbcad	FALSE
dcbbcdbdbcadcbbddbbccbdcdccdbdcbbacddcbddb	FALSE
dccddcdbbcdaddcdbdcaaccaccdbbcccadbccdadcbc	FALSE
ddacbccbccddadacdaddccaddbdccaccbdabacccddb	FALSE
ddcbcbddddaccbbdddbdccdcddacdacaccdbdccdb	FALSE
aaaaacaadcbbcdcaadcacbcaacacccaacbcaaadcddb	TRUE
abcccccabccabdcdddccdadcccbcababcacdddcbacb	TRUE
acbcacddbcaddaaccdccdbddbbbdddcdcaccddcaccd	TRUE
acdacccbbcbcddcddcdaaaddacbdddddbcbcbcccbdd	TRUE
adbdabadcbdcadbaddbccacdccccbacacaccacdddad	TRUE
babacacddddccacdbcdccbcdcbdddadbaccbdccbcba	TRUE
bbbddcbdcdadddacacbccbdcaddccdadacbdcaadddc	TRUE
bcbadccdcccbdccbdcbdacdbcadbccdabdababdaccd	TRUE
bccdccdaccacdaccbdabcbacbabcbddacccadbddcca	TRUE
bdbdcdddccacdaacdadcdaadadacbdcaaacddacdbdd	TRUE
bdddbcdacbccacddacdccbbccacacdbccdaacccdccc	TRUE
cacdbdbdbbcccaccdddcdcaaaccbdbbcdcccddaacbb	TRUE
cbadcdcbacbcbacbdcadccdacdbcacdcdcbcabcacba	TRUE
cbdcbbdddbcbbbcadadaaacddacdaacadacccddccdd	TRUE
ccbdccdcbcdddacdbdbbccacacddcbccbbddbbdcacd	TRUE
ccdbccbdabcdbccacddcdacbcdcdddacdacacccdcad	TRUE
cdbadccccacddbdabdddabcccbadbcabacabdcabcac	TRUE
cddabacddccadcbccbcddbacddccddbdcdabcddcbda	TRUE
dabdddabccabddcddbddacddddbddcbcbcbadcaddca	TRUE
daddcacddbdcdaccbdddddccaccccaaaacccccccbbc	TRUE
dbccddbadcdacbddacadddcbadbcdbddcbdaccbcadb	TRUE
dcaccacccccddacacddbbcaaaaddadccadcaccdadac	TRUE
dcccacdadcacaddbcbccddcaccddddabcabacbddcab	TRUE
ddaadcddbcbdccacacbcdacccddaacccdddaaadcbca	TRUE
ddcacdcccbcdabdabdcaddbddccabdcacdbdcddbacc	TRUE
aaaaacaadcbbcdcaadcacbacaacacccaacbcaaadcddb	FALSE
abcccccabccabdcdddccdadcccbaababcacdddcbacb	FALSE
acbcacddbcaddaaccdccdabddbbbdddcdcaccddcaccd	FALSE
acdacccbbcbcddcddcdaaaddacabdddddbcbcbcccbdd	FALSE
adbdabadcbdcabdbaddbccacdccccbacacaccacdddad	FALSE
babacacddddccacdbcdccbcdcbddddbaccbdccbcba	FALSE
bbbddacbdcdadddacacbccbdcaddccdadacbdcaadddc	FALSE
bcbadccdccbbdccbdcbdacdbcadbccdabdababdaccd	FALSE
bccdccdaccacdaccbdabcbacbabbcbddacccadbddcca	FALSE
bdbdcdddccbacdaacdadcdaadadacbdcaaacddacdbdd	FALSE
bdddbdacbccacddacdccbbccacacdbccdaacccdccc	FALSE
cacdbdbdbbcccaccdddcdcaaaccbdbacdcccddaacbb	FALSE
cbadcdcbacbcbacbdcadccdacdbcacdcdcbbabcacba	FALSE
cbdacbbdddbcbbbcadadaaacddacdaacadacccddccdd	FALSE
ccbdccdcbcdddacdbdbbccacacddcbccbbddbabdcacd	FALSE
ccdbccbdabcdbccacddcdacbcdadddacdacacccdcad	FALSE
cdbadccccacddbdabdddabcccbadbcaaacabdcabcac	FALSE
cddabbacddccadcbccbcddbacddccddbdcdabcddcbda	FALSE
dabdddaabccabddcddbddacddddbddcbcbcbadcaddca	FALSE
dabddcacddbdcdaccbdddddccaccccaaaacccccccbbc	FALSE
dbccddbadcdacbddacadddcbadbcdbddcadaccbcadb	FALSE
dcaccacccccddacacdadbbcaaaaddadccadcaccdadac	FALSE
dcccacdadcacaddbbcbccddcaccddddabcabacbddcab	FALSE
ddaadcddbcbdccacacbcdacccddaacccbdddaaadcbca	FALSE
ddcacdcccbcdabdabdcadbbddccabdcacdbdcddbacc	FALSE
aaaaaaadcdadcaccdbbdddbcbcccdbdbdbcbcdcbdcad	TRUE
abadbdcadbabccbacbcdadcdddabdccbccbdacabacca	TRUE
acaddddacbbdcbcddddbbdcaaacbbcadcccacacaccaa	TRUE
accdadbadddccdacacdcbcdddacdbacdadcadcacccbc	TRUE
adbabccabcddbdccbadbcddcbdaccddcbcaccadcddad	TRUE
addbdcdcdacdddbdabdcacddacaccccdcacbddacddcb	TRUE
bbbcdaddaddddddacbcdbddcbbcbbcdaaddacaacdbdb	TRUE
bcbcabdaccdadcddcabadbdcdccbdcdacdbddaccddad	TRUE
bcdbcacdcdcadcbccbccccddaacdbbdccdcacaaddcbb	TRUE
bdcadaacdbbbbbcacbdddddccaddadaacdacdccbccbc	TRUE
caaaacdaccdbccadacdbccacbcccdbdccccdddcdcdca	TRUE
cacdcacdacdbcddbdbdcddddadccaccdaacdcaccbcbb	TRUE
cbbbdbcdcdcddbdcdcdbddcaddacadcddacdbdccddbd	TRUE
cbddcacdddbdbcddcdddddcdaccbdcaadccaaccddbbd	TRUE
ccbcdcbdcbbdbcddaccddddacccccdddaddaaddddcac	TRUE
ccdbcdcabacacdddbacbadbcabccbdcabcddbabccdba	TRUE
cdbadcbcdcbdcbdadcbcacccbcdbccdadcdbcccbcadb	TRUE
cdcdccacccdbccbdccbcddbbdcadcaaaadccdaaadcbd	TRUE
dabcccadbcdaccabcdaccabadbadccdcdcdbabdcbdac	TRUE
dadcacddccccccdbbcdaddcbcbbcbccdbddbcbcbcbdd	TRUE
dbcaddadcaccdbcbbcccacbdcacbbbcaccdbcadccaaa	TRUE
dcacbdcdcaacacaddacdbdcadcadaddccacbcbdbcbcd	TRUE
dcccdbcbddcddcabacbdcbdcadbcddaccacdcdcdddab	TRUE
ddaccadcbcbdcddaaddadaccbbdcbbdccddcbcbcaddc	TRUE
ddcccdacdacbcabdddcdacdcddccabcddaddcabacacd	TRUE
aaaaaaadcdadbcaccdbbdddbcbcccdbdbdbcbcdcbdcad	FALSE
abadbdcadbabccbacbcdadcdddabdccbccbdaaabacca	FALSE
acaddddacbbdcbcddddbbdcaaacbabcadcccacacaccaa	FALSE
accdadbadddccdacacdcbcdddacdaacdadcadcacccbc	FALSE
adbabccabcddbdccbadbcddcbdaccddcbbcaccadcddad	FALSE
addbdcdcdaacdddbdabdcacddacaccccdcacbddacddcb	FALSE
bbbcdaddadddddbdacbcdbddcbbcbbcdaaddacaacdbdb	FALSE
bcbcabdaccdadcddcabadbdcdccbdcdacdbddaccdadad	FALSE
bcdbcacdcdcadabccbccccddaacdbbdccdcacaaddcbb	FALSE
bdcadaacdbbbbbcabcbdddddccaddadaacdacdccbccbc	FALSE
baaaacdaccdbccadacdbccacbcccdbdccccdddcdcdca	FALSE
cacdcacdacdbcddbdbdcddddadccaccdaacdcaccbcba	FALSE
cabbbdbcdcdcddbdcdcdbddcaddacadcddacdbdccddbd	FALSE
cbddcacdddbdbaddcdddddcdaccbdcaadccaaccddbbd	FALSE
ccbcdcbdcbbdbcddaccdddbacccccdddaddaaddddcac	FALSE
cbdbcdcabacacdddbacbadbcabccbdcabcddbabccdba	FALSE
cdbadcbcdcbdcbdadcbcacccbcdbccdadcdbcccbaadb	FALSE
cdcdccacccdbccbdccbcddbbdcadcaaaadccdaaadbbd	FALSE
dabcccadbcdaccabcdaccabadbadccdcdcdbabddbdac	FALSE
dadcabddccccccdbbcdaddcbcbbcbccdbddbcbcbcbdd	FALSE
dbcadbdadcaccdbcbbcccacbdcacbbbcaccdbcadccaaa	FALSE
dcacbdcdcaacacaddacdbdcadcbdaddccacbcbdbcbcd	FALSE
dcccdbbbddcddcabacbdcbdcadbcddaccacdcdcdddab	FALSE
ddabcadcbcbdcddaaddadaccbbdcbbdccddcbcbcaddc	FALSE
ddcccdacdacbcabdddcdacdcddccabcddaddcabbacacd	FALSE
aaaaaccaaacbbbdbcbbcbbcbdcdaacbccaadaccdbcdca	TRUE
ababdcccadcacdcdcdcbdcddcccabddcdbccbacbcbcdc	TRUE
acadbcdcbdcbccdcddccccdacbdadccdcbcbddadbcadd	TRUE
acccacacbcddadcdcdabacdcdbcaccdaddccddbcabcbc	TRUE
adacdcdcddadccddaddaadaddcddcddacaccbdddddccc	TRUE
addcbcbdddddcaccababcaccdcbcbaccbcababaccccdd	TRUE
bbbcaaccaaacddccddccdcddaaacddbddcaacbdbdbcaa	TRUE
bcadccdcadcacadbccdbdcbcddacaccdddddcacabcddb	TRUE
bccdbbddccdacacdacbdcbddcbccccdbccdaaacadacdd	TRUE
bdacdbaccbcddabcbadddbacacddcbcbccddadcbdacbc	TRUE
bdcdccacaaadcbcaaadddcdbbcccdbcdaccaaadacdaaa	TRUE
cacaccbcddabddadbdadcbcddccdcdbacddacddbacadd	TRUE
cbabddaccdddccabababaccddabccdbccadbcccccaccb	TRUE
cbdbddcdbbbdbddcdbbcbbdcdaadcdccdcdbcddacbdcc	TRUE
ccbccbcdbabaccdadbdcdbcabccbaccdbddcddddaccdc	TRUE
ccdaccdaacdbccdacaadccddccaadcacacbcdbdbbbbdc	TRUE
cdbbcaacdcadcadccccbddbccaddcdcbcddddaccaccda	TRUE
cdcdddbbccbcaacdbbdcbcadcbbdbcdaddacaaacbdcaa	TRUE
dacabccbccdbcbcdddccddacbdabcbdcadcacdaccabab	TRUE
dadddddcdacadcdccacabcdacaddbdcbcccddcacbacab	TRUE
dbcdcdadcabcdcdddadcbddaccbadccdabcdacdcacddb	TRUE
dcaddcacacddddaccbdddababadbccabccbacbddcddab	TRUE
dccccccaccbccadaacccdbdcadacbddccadcaadaacdbc	TRUE
ddacacdbddacbdccdddacbabadcbacdcccbcaddbcacda	TRUE
ddcbacddcbabdccabccddbdacbdcdcabdaddbaddcdadb	TRUE
aaabaaccaaacbbbdbcbbcbbcbdcdaacbccaadaccdbcdca	FALSE
ababdcccadcacdcdcdcbdcddcccabddcdbccbbacbcbcdc	FALSE
acadbcdcbdcbccdcddccccdaacbdadccdcbcbddadbcadd	FALSE
acccacacbcddadcdcdabacdcdbcaccdaddccddbcabcbbc	FALSE
adacdcdcddadccddaddaadadbdcddcddacaccbdddddccc	FALSE
addcbcbdddddcaccababcaccdcbcbbccbcababaccccdd	FALSE
bbbcaaccaaacddccddccdcddaaabcddbddcaacbdbdbcaa	FALSE
bcadccdcadcacadbccdbdcbcddacaccdddddcacabcddbb	FALSE
bccdbbddccdacacdabdcbddcbccccdbccdaaacadacdd	FALSE
bdacdbaccbcddabcbdddbacacddcbcbccddadcbdacbc	FALSE
bdcdccacaaadcbcaaadddcdbbcccdbcdaccaaadacbaaa	FALSE
cacaccbcddabddadbdadcbcddccdcdbacddacbdbacadd	FALSE
cbabddaaccdddccabababaccddabccdbccadbcccccaccb	FALSE
cbdbddcdbbbdbddcdbbcbbdcdaadcdccdcdbcddacabdcc	FALSE
ccbccbcdbabaccdadbdcdbcabccbaccdbddcaddddaccdc	FALSE
ccdaccdabacdbccdacaadccddccaadcacacbcdbdbbbbdc	FALSE
cdbbcaacdcadcadccccbdadbccaddcdcbcddddaccaccda	FALSE
cdcdddbbccbcaacdbbdcbcadcbbdbcdaddacaaacbdacaa	FALSE
dacabccbccdbcbcdddccddacbdabcbdcadcaacdaccabab	FALSE
dadddddcdacadcdccacabbcdacaddbdcbcccddcacbacab	FALSE
dbcdcdadcabcdcdaddadcbddaccbadccdabcdacdcacddb	FALSE
dcaddcacacddddaccbdddabaadbccabccbacbddcddab	FALSE
dccccccaccbccadaacccdbdcadacbddccadcaadabacdbc	FALSE
ddacacdbaddacbdccdddacbabadcbacdcccbcaddbcacda	FALSE
ddcbacddcbabdccabccbdbdacbdcdcabdaddbaddcdadb	FALSE
aaaaacaddcbdcdccbccbbcdcbcbcccdbddcbbbccbbbdcc	TRUE
abcadccdddacbccccdcaccacddbacdddadcadddbcacbda	TRUE
acbbbcaccdcdddbbcaaaddadcdaaacbdcbdbbccdacbbcd	TRUE
accdddcdbcabacacddabadddcbcdaccdabcbdcabccdadb	TRUE
adbcdcdcabccadcabdcbdaccadccdddccbccbdacdcdaba	TRUE
addcbdcbaccabdddabdacdacdbadcbdcacdcbabacbccab	TRUE
badbdddacbccdadbaddbcdcccacaccacbdcacbccbabadc	TRUE
bcacbdcccacbdcdddaadccccbcddadcdbdbbbbdddcdddc	TRUE
bcccdadacddbdbccccacbbccdbbccddbcbbbccddbcdcbb	TRUE
bcddddcbcdaaacdcacbdddccbcddbbbddcaacbcdaddccd	TRUE
bdcdcdccdcabdccacddaddbacadbdadbdcbcbdccdbacca	TRUE
cabddcddbdccabdabddcbacdddacaddcddcddbacacadbc	TRUE
cadcddbdacacabcdcbccabdacbcddcddbcdbcdadddccbd	TRUE
cbccdddbcbaddddbccccadbccabaddbcdcdacbcddacdcb	TRUE
ccacdcccacaddccdcacdccbdddcbddbcacddccdaddaaaa	TRUE
ccccdcbaddcdcbacccdbabdaddbcbabdacaddbacddccca	TRUE
cdabcacdadccbacdacbcacdcbacbdacdcdadcadcbddcbd	TRUE
cdccdccdcbabadddcacddcdbdacadbacacacdcbdcbacba	TRUE
dabadbdacadbababcddbcadcabcccbacddabcbccadbdac	TRUE
dadcbacdddaddcbdccdacdbdadcdcccadcccabcdbddcda	TRUE
dbcbdcbccacbdcbbddcdcddaacccacdbbcbbdccbbbdccc	TRUE
dcabccdadbabdacbcccddbccdddabcacacadcacdddcabc	TRUE
dccadcacddbccdbdcbddcbcacbddbcbcacddddacaadcbd	TRUE
dcddddaccacdbcbbdddbcaddddcdcbdccdaddddcbbbdbd	TRUE
ddcbdbdbbcaddaadcacdcaccdcadacdbbcbccbcdbcddcc	TRUE
aaaaacaddcbdcdccbccbbcdcbcbcccdbaddcbbbccbbbdcc	FALSE
abcadccdddacbccccdcaccacddbaacdddadcadddbcacbda	FALSE
aabbbcaccdcdddbbcaaaddadcdaaacbdcbdbbccdacbbcd	FALSE
accdddcdbcabaaacddabadddcbcdaccdabcbdcabccdadb	FALSE
aadbcdcdcabccadcabdcbdaccadccdddccbccbdacdcdaba	FALSE
addcbdcbaccabdddaddacdacdbadcbdcacdcbabacbccab	FALSE
badbdddacbccdadbadbdbcdcccacaccacbdcacbccbabadc	FALSE
bcacbdcccacbdcdddaadccccbcddadcdbdbbbbadddcdddc	FALSE
bcccdadacddabdbccccacbbccdbbccddbcbbbccddbcdcbb	FALSE
bcddddcbcdaabacdcacbdddccbcddbbbddcaacbcdaddccd	FALSE
bdcdcdccdcabbdccacddaddbacadbdadbdcbcbdccdbacca	FALSE
cabddcddbdccaddabddcbacdddacaddcddcddbacacadbc	FALSE
cadcddbdacacabcdcbccabdacbcddcddbcdbcdaddadccbd	FALSE
cbccdddbcbaddddbccccadbccabaddbcdcdacbcadacdcb	FALSE
ccacdcccacaddccdcacdccbdddcbddbcacddccdaddaaaab	FALSE
ccccdcbaddcdcbacccdbabdaddbcbaddacaddbacddccca	FALSE
cdabcacdadccbacdacbcacdcbacbdacdcdadcaacbddcbd	FALSE
cdccdccdcbabadddcacddcdbdacadacacacdcbdcbacba	FALSE
dabadbdacadbababcddbcadcabcccbacddabcbccaabdac	FALSE
dadcbacdddaddcbdccdacbbdadcdcccadcccabcdbddcda	FALSE
dbcbdcbccacbdcbbddcdcddabcccacdbbcbbdccbbbdccc	FALSE
dcabccdadbabdacbcccddbccdddabcadacadcacdddcabc	FALSE
dccadcacddbccdbdcbddcbcacbddbcbdacddddacaadcbd	FALSE
dcddddbaccacdbcbbdddbcaddddcdcbdccdaddddcbbbdbd	FALSE
ddcbdbdbbcaddaadcacdcaccdcadacdabcbccbcdbcddcc	FALSE
aaaaaaccaacadcadccccdccbdcbddccdbcddcddaccdbccd	TRUE
abadddbabdadbdacdbacccddbaccbdddabcddcbdadcaddb	TRUE
acbbbcbdcdbddbdcdcdcaaadccaaddaccacaacbdbbddcda	TRUE
accdcddaddadacadacadddaadacdddcbcbdccbcbbbcdbbd	TRUE
adbcbabcdcacdbabcbdddcacbcccdbcbdcadcdddccbccdc	TRUE
addcdbdcdbddddcddbccabccacdbddcbccddbcabdacadbd	TRUE
badbddaddcabababcadcbddcbccddddaccddcdbdabccabc	TRUE
bcabaccabcddbaddcdcdcdadcdcdcbdcdbcacadcacbcdab	TRUE
bccbaccccdcccbcdcbddadddccbcabccadbcddcadcdbdac	TRUE
bcddbdddcbbbbdcbddcddacbbdcadaddcdaccddcccdbddb	TRUE
bdcdcdcdcbdcabdacdcdbacddabdabacbcbaccadbdcabdd	TRUE
cacadacaadadadccaaacacadcbcdcddbbcbcccbcbcdbcca	TRUE
cadcddbbbdddcaaaccdcadccdcacddbdcbdccdbdbbcbcdc	TRUE
cbcdbdbcdacdaacdbbcacbcdbcdbcadccdbbdbcdcbbbcdb	TRUE
ccbbbcbcddcdcbddcdbcdbcbcadcdacdcbddcbcbdcdacaa	TRUE
ccdacbcadbccddccdccdcbaddcdacddcdccbddabcdbcbab	TRUE
cdadcbcddccdcaddadaddcdbdcaadccdbbcaccccccacdad	TRUE
cdccbbccddcdacadaaacddcdcaaadccbdddddcaaaaaacda	TRUE
daacadadacadcbbdccddacdccbbddcbdcaadccaadccdbcd	TRUE
dadcdacccdcddddccacacdcacabadcabababdacdcabdcbc	TRUE
dbcccbdbbbdcdcdbbbcdaacddaddaaaddacdcaaccadcbca	TRUE
dcaccacbcbbcbddcbdbddcccbccdacccbbdbbbcdcacbcdd	TRUE
dccccbddcbbccadcadddddddcddbcdcacdbcdbcbbdcddac	TRUE
dcdddddaccacdacabaddcabadccbddccdbadbcbabadbaba	TRUE
ddcbacbcbccbdcaccacdcccbcbcbacacbdabcadbcbabcba	TRUE
aaaaaaccaacadcadccccdccbdcbddccdbcddcdbaccdbccd	FALSE
abadddbabbdadbdacdbacccddbaccbdddabcddcbdadcaddb	FALSE
acbbbcbdcdbddadcdcdcaaadccaaddaccacaacbdbbddcda	FALSE
accdcddaddadacadacadddbadacdddcbcbdccbcbbbcdbbd	FALSE
adbcbabcdcacdbdbcbdddcacbcccdbcbdcadcdddccbccdc	FALSE
addcdbdcdbddddcddbccabccacdbddcbccddbcabdaacadbd	FALSE
badbddaddcaabababcadcbddcbccddddaccddcdbdabccabc	FALSE
bcabaccabcdbbaddcdcdcdadcdcdcbdcdbcacadcacbcdab	FALSE
bccbaccccdcccbcdcbddadddccbcabccadbcddcadadbdac	FALSE
bcddbdddcbbbbdcbddcbdacbbdcadaddcdaccddcccdbddb	FALSE
bdcdcdcdcbdcabdacdcdbacddabdabacbcbaccadbdcabbdd	FALSE
cacadacaadadadccaabcacadcbcdcddbbcbcccbcbcdbcca	FALSE
badcddbbbdddcaaaccdcadccdcacddbdcbdccdbdbbcbcdc	FALSE
cbcdbdbcdacdaacdbbcacbcdbcdbaadccdbbdbcdcbbbcdb	FALSE
ccbbbcbcddcdcbddcdbcdbcbcadcdbacdcbddcbcbdcdacaa	FALSE
ccdacbcadbccddccdccdcbaddcdacddcdccbddabbcdbcbab	FALSE
cdadcbcddccdcadbadaddcdbdcaadccdbbcaccccccacdad	FALSE
cdccbbccddcdacadaaacddcdcaabdccbdddddcaaaaaacda	FALSE
daacadadacadcbbdccddacdccbbddcabdcaadccaadccdbcd	FALSE
dadcdacccdcddddccacacdcacabaadcabababdacdcabdcbc	FALSE
dbcccbdbbabdcdcdbbbcdaacddaddaaaddacdcaaccadcbca	FALSE
dcaccacbcbbcbddcbdbddcccbccbdacccbbdbbbcdcacbcdd	FALSE
dccccbddcbbcbadcadddddddcddbcdcacdbcdbcbbdcddac	FALSE
dcdddddaccacdacabaddcabaaccbddccdbadbcbabadbaba	FALSE
ddcbacbcbccbdcaaccacdcccbcbcbacacbdabcadbcbabcba	FALSE
aaaaacccadcdadaaaddcbbbdcccadadddcbddbcdcdbddbbc	TRUE
abcaccccbacbcdcbcacbddabdadcbcddadccabcdaddccdad	TRUE
acacddcbddbcbcbbdcdbdcdcaccbbdcdcbdcccaccdcdddbb	TRUE
accccbadcbdcabadbabcccdacddbdabcdaccbacccdbadcad	TRUE
adacddcadcddbcdcaccccaddaaccaccbbcdacccdaddcbccb	TRUE
adddacddddacdbdbdbcadccbbdcaccaddacacaaacacddccc	TRUE
bbbcdcacdaacdbbcdbdddbcbccddbcdcdccdcccdaaacacca	TRUE
bcadcbdcdaadddadccdcdaddccaacacaacacdbbcadacbdcb	TRUE
bcccbbcbddccbbbccdcdbcadaccacdccdcdcccaaaaccaacb	TRUE
bdabccaddccdbdcbacabdccabdacbdabdadddcccbadcbcdc	TRUE
bdcdcddcaaadacccaaadddddddacddaddcdbbddcacadaccd	TRUE
cacabcaccdababcdcbacccbcacacbccaccbcdabadcccdcad	TRUE
caddcddccbccccdcacdacdbcbadcacbadcbdcdddacadbddc	TRUE
cbccddacbdddcdccacabcddacdccabadddbabaddcacabdad	TRUE
ccadcdcdcbacbaccadbdcddaccacdbcbadddbdcddcddcbab	TRUE
cccdadcdbccdbbdbdbcdaacbbcaccacbbccbcaccadacbbbb	TRUE
cdacccabdabdcbcacbacccdcccccadddcbabcacdddcbdccb	TRUE
cdcdbcacdabdacbcbccbadcdadbcacddaddcadcacaddcddd	TRUE
daaddadaddacaccdcbcbcdcaaaccdcadccbccdcacdccdbcc	TRUE
dadbcabddabcadbdcaccddbccccadcccadddddccbddabdda	TRUE
dbcacccdaacdaccbbccdacdcccbccbcbdbbccccccdcaccbd	TRUE
dcabadbadcacdbcaccbdcbcbabaddbaccbcbacdbddaccadd	TRUE
dccbcdcacabdddaddcdddabadbdcdcdcdcbcdccccaddcddd	TRUE
ddaadaccbcaccddccbbbbddbbbddcaccccbbbccdaddcbccd	TRUE
ddccaaacbdddbcbbcacdddcbbcdcdcaccdbccaccbcadcddb	TRUE
aaaaacccadcdadaaaddcbbbdcccadadddcbddbacdcdbddbbc	FALSE
abcaccccbacbcdcbcacbddabaadcbcddadccabcdaddccdad	FALSE
acacddcbddbcbcbbdcdbdcdcaccbbdadcbdcccaccdcdddbb	FALSE
accccbadcbdcabddbabcccdacddbdabcdaccbacccdbadcad	FALSE
adacddcadcddbcdcaccccaddaabcaccbbcdacccdaddcbccb	FALSE
adddacddddacdbdbdbcadccbbdcaccaddbacacaaacacddccc	FALSE
bbbcdcacdaacdbbcdbddabcbccddbcdcdccdcccdaaacacca	FALSE
bcadcbdcdaadddadccdcdaddccaacacaacacdbbcadacbdacb	FALSE
bcccbbcbddccbbbccdcdbcadaccacdccdcdcccaaaacbaacb	FALSE
bdabccaddccdbdcbbcabdccabdacbdabdadddcccbadcbcdc	FALSE
bdcdcddcaaadacccaaadddddddacddaddcdbbddcabadaccd	FALSE
aacabcaccdababcdcbacccbcacacbccaccbcdabadcccdcad	FALSE
caddcddccbccccdcacdacdbcbadcacbadcbdcdddacadabddc	FALSE
cbccddacbdddcdccacabcddacdccabadddbabaddcacadad	FALSE
ccadcdcdcbacbaccadbbdcddaccacdbcbadddbdcddcddcbab	FALSE
cccdadcdbccabbdbdbcdaacbbcaccacbbccbcaccadacbbbb	FALSE
cdacccabdabdcbcacaacccdcccccadddcbabcacdddcbdccb	FALSE
cdcdbcacdabdacbcbccbadcdadbcaacddaddcadcacaddcddd	FALSE
daaddadaddacaccdcbcbcdcabaaccdcadccbccdcacdccdbcc	FALSE
dadbcabddbabcadbdcaccddbccccadcccadddddccbddabdda	FALSE
dbcacccdaacdaccbbccdacdcccbccbcbdabccccccdcaccbd	FALSE
dcabadbadcacdbcaccbdcbcbabaddbaccbbcbacdbddaccadd	FALSE
dccbcdcacabdddaddcdddabadbdcdcdcdcbbcdccccaddcddd	FALSE
ddaadaccbcaccddcabbbbddbbbddcaccccbbbccdaddcbccd	FALSE
ddccaaacbdddbcbbcacdddcbacdcdcaccdbccaccbcadcddb	FALSE
aaaacaccadddddcdacdccdbcbcdccccdcbbcbccdbddbcbdbb	TRUE
abaddcacbcadcdacbdddaccdabcbcbcdabccbdddcdcccdccd	TRUE
acadcdaccadccddcdcddccaacbccccbbccdcddaddadacbddc	TRUE
accdadcddaccdaaaddcacdaacdbbbdcccbdcaccddbcbcaccb	TRUE
adbccacdccccbdabdaccbdadccdcdbcacbabdacccdaddbdcd	TRUE
addcbcadcbabcbccaddccaddbadbcacbadcadcbdcababadcb	TRUE
badcdcadcdcabaccdcbacabdacdbccacbacccdccbdcabcdcb	TRUE
bcaccadadddadcacaacbcdccaddcbdbccacdccddaaacddcad	TRUE
bcccbddcdddbcabccccbcacadbddcdbcacacccaccddccacda	TRUE
bdbbcacdcbcdbbcccaaaacbcbdbddcacadacdbcadaaddcaaa	TRUE
bddccacadcadddcadbdddddadcadcbdabccdacabcdadcddcc	TRUE
cacccbcdcdcbbbcacdcccbcdadcbdbcadddaaddcaaadcccaa	TRUE
cbacaddbcdacbcdbcabccacbdacbabcabaccadddbaddbacdb	TRUE
cbdacadcccbcadcccacabcddabacdddcdddacdabacbabcbab	TRUE
ccbabcacdbcdadcdcbadbccadbdabdacdbcaccbabacddcdab	TRUE
cccccdbcdcbcadccbdacccddcdccbcababddccbdcddadcacb	TRUE
cdacbcacadbcdbcbddddcbcccaccbadcadbcabdccbddcdcad	TRUE
cdccbcdadcabdacdcdadbdcdcbadcccdaccbdddacddbcccca	TRUE
daacccddcbbdbcdbbdcdcacbccdcdacbbdcbcbdbdcddaadcb	TRUE
dadcbdabacccbdabadcacbdacddcadcbabcacdcddddbdacca	TRUE
dbccbcccbdacadcbacbdcababcddddbdcccabcbccbddababa	TRUE
dcacccacccbcccbccbdcbdcdddaaaaccdadaaaacccdcccaca	TRUE
dcccccdbdcbccdbacdddbccddadccabdabdabcdbccabacddd	TRUE
ddacbadccbacdcdacccadddcbcbadbdcbdcadcdababcdbcdb	TRUE
ddccbbbddcdbdcaaccaaaddaaaadccccaddaacdbdddddccaa	TRUE
aaaacaccadddddbdacdccdbcbcdccccdcbbcbccdbddbcbdbb	FALSE
abaddcacbcadcdacbdddaccadabcbcbcdabccbdddcdcccdccd	FALSE
acadcdaccadccddcdcddccaacbccccbbccdcddaddadacbadc	FALSE
accdadcddaccdaaaddcacdaacdbbbdcccbdbaccddbcbcaccb	FALSE
adbccacdccccbdabdaccbbdadccdcdbcacbabdacccdaddbdcd	FALSE
addcbcadcbabcbccaddccaddbadbcacbadcadcbdcabbabadcb	FALSE
badcdcaadcdcabaccdcbacabdacdbccacbacccdccbdcabcdcb	FALSE
bcaccadadddadcacaacbcdccaddcbdbccacdccddaaacddcab	FALSE
bcccbddcdddbcabccccbcacadbddbdbcacacccaccddccacda	FALSE
bdbbcacdcbcdbbcccaaaacbcbdbddacacadacdbcadaaddcaaa	FALSE
bddccacadcaddacadbdddddadcadcbdabccdacabcdadcddcc	FALSE
cacccbcdcdcbbbcacdcccbcdaddbdbcadddaaddcaaadcccaa	FALSE
cbacaddbcdacbcdbcabccacbdacbabcabaccaddbdbaddbacdb	FALSE
cbdacadcccbcadcccacabcddabaacdddcdddacdabacbabcbab	FALSE
ccbabcacdbcdadcdcbadbccadbdabdaacdbcaccbabacddcdab	FALSE
cccccdbcdcbcaadccbdacccddcdccbcababddccbdcddadcacb	FALSE
cdacbcacadbcdbcbddddcbcccaccbadcaadbcabdccbddcdcad	FALSE
cdccbcdadcabdacdcdadbdcdcbadcccdaccbdddacdbdbcccca	FALSE
daacccddcbbdacdbbdcdcacbccdcdacbbdcbcbdbdcddaadcb	FALSE
dadcbdabacccbdabadcacbdacddcadcbabcacdcbdddbdacca	FALSE
dbccbccbbdacadcbacbdcababcddddbdcccabcbccbddababa	FALSE
dcacccacccbcccbacbdcbdcdddaaaaccdadaaaacccdcccaca	FALSE
dcccccdbdcbccdbacdddbccddadccabdaadabcdbccabacddd	FALSE
ddacbadccbacdcdaccaadddcbcbadbdcbdcadcdababcdbcdb	FALSE
ddccbbbddcdbdcaaccaaaddaaaadccccaddaabcdbdddddccaa	FALSE
aaaaacdbbbcdaaacbbcbddbcdddaccbcddcbbdcdddcdccaddc	TRUE
abccdcacdcdcbcdddddacbdadbaddcccbccabdddcdcadbccad	TRUE
acbadbaddcdcacdddccaccbddcdbcaddcacdccdbcabacdacbd	TRUE
acdacdcacaccddaacddaadddccdccbcdacdadadacccbcdaccd	TRUE
adcadccbcdbccadccddcccbcacbcbcdbcbbbcaacaccaddcdac	TRUE
addddccbcbcaaddacbcbcaccbdcaddadacdadadcccadaccddc	TRUE
bbcadadacdcddddcdcbbcdccaddaccaacbccaacddbbdbbccaa	TRUE
bcadcdcbdbccccbbcbcdcaddcccacccdcadccdbdcacbbbcdac	TRUE
bcccdacdacadcdcbdcbcababcdcabdadcabccbccabdacdbdcc	TRUE
bdacadbdaddcdababcbadcbdcdcacdbcbcbadcacddddabddda	TRUE
bdcdddbbddbcbcdcbcdcaddaccdbcacbcdbcdbbbdcdbbcdbca	TRUE
cacadcddcdbadddcacccbaccbcadbacddcacbdcdbdcababcda	TRUE
cbababdccbcdcbdabcddabacbadcabcbdabdadccaccccccbdd	TRUE
cbccdccbbbbbcdbccbcaddccbcbddbbbcdbcaacacddddbdcbb	TRUE
ccadcadaccadadaaacbcdbbdcbcdacaadccbdddcdbcadcddcd	TRUE
cccccaddcdabdcdcccabadbabccdddcacbaccdbddadcbacbac	TRUE
cdacdcdddbcbcdccccacabadccbcdacdcbdabccbccacababdc	TRUE
cdccdbaccdbdcacdadbaccbccbabcdddbcdbcbacadcccddbcb	TRUE
daacbdcbbdbbcdcddcccbbcdacdadddaccbcbbccdddcdbdddc	TRUE
dacdadbddddcdacbdadbdcbcdddaccbdccbcdccadbcadddcba	TRUE
dbcacddbcaadcaaadaaccaacccbccdbcdddadcdaacbbdcdcad	TRUE
dcacabcacadbdccbaccbaccdccadcccadddbacbdcadcdcbdca	TRUE
dcccdbcdccbddddabacbdccadbcbcbacbacabcddcdadbcdacb	TRUE
ddaaddaacadddaaadccccaccacddcbcccdddbddcdbbccbdddb	TRUE
ddcaddbdacccdadbaddcacadcdbcbdcbacdbdcdbccdbdccbcd	TRUE
aaaaacdbbbcdaaacbbcbddbcdddaccbcddcbbdadddcdccaddc	FALSE
abccdcacdcdcbcdddddabbdadbaddcccbccabdddcdcadbccad	FALSE
acbadbaddcdcacdddccaccbdbdcdbcaddcacdccdbcabacdacbd	FALSE
acdacdcacaccddaacddabdddccdccbcdacdadadacccbcdaccd	FALSE
adcadccbcdbccadccddcccbcacbcbcdbcbbbcaacaccadbcdac	FALSE
addddccbcbcaaddacbcbcaccbdcaddadacdadadcccadabccddc	FALSE
bbcadadacdcddddcdcbbacdccaddaccaacbccaacddbbdbbccaa	FALSE
bcadcdcbdbccccbacbcdcaddcccacccdcadccdbdcacbbbcdac	FALSE
bcccdacdacadcdcbdcbcababcdcabbdadcabccbccabdacdbdcc	FALSE
bdacadbdaddcdababcbadcbdcdcaadbcbcbadcacddddabddda	FALSE
bdcdddbbddbcbcdcbcdcaddaccdbcacabcdbcdbbbdcdbbcdbca	FALSE
cacadcddcdbadadcacccbaccbcadbacddcacbdcdbdcababcda	FALSE
cbababdccbcdcbdabcddababbadcabcbdabdadccaccccccbdd	FALSE
cbccdccbbbbbcdbccbcaddccbcbddbbbcdbcaacaaddddbdcbb	FALSE
ccadcadaccadadaaacbcdbbadcbcdacaadccbdddcdbcadcddcd	FALSE
cccccaddcdabdcdcccabadbabccdddcacbaccdaddadcbacbac	FALSE
cdacdcdddbcbcdccccacabadccbcdaacdcbdabccbccacababdc	FALSE
cdccdbaccdbdcaacdadbaccbccbabcdddbcdbcbacadcccddbcb	FALSE
daacbdcbbdbbcdcddcccbbcdacdadbdaccbcbbccdddcdbdddc	FALSE
dacdadbddddcadacbdadbdcbcdddaccbdccbcdccadbcadddcba	FALSE
dbcacddbcaadcaaadaaccaacccbccdbcdddadcdaadbbdcdcad	FALSE
dcacabcacadbdccbaccbaacdccadcccadddbacbdcadcdcbdca	FALSE
dcccdbcdccbddddabacbdccadbcbcbacaacabcddcdadbcdacb	FALSE
ddaaddbacadddaaadccccaccacddcbcccdddbddcdbbccbdddb	FALSE
ddcaadbdacccdadbaddcacadcdbcbdcbacdbdcdbccdbdccbcd	FALSE
