bcccccbdcbbcbbbaaaac	TRUE
aaadbacbdbbbddddacab	TRUE
aabcbbbdadaabdcadbbd	TRUE
aacbcbccddcddddcdaaa	TRUE
aadcbbdddbdddcdbdadd	TRUE
ababbcddbaabbabcddcc	TRUE
abbadddabaacaabcacbd	TRUE
abbddbaadacbdbaaacdd	TRUE
abdabbbaabababdcdbcb	TRUE
acbddbdbaaaaaccbaacb	TRUE
acbcaabbacbdbcbcdbcd	TRUE
acccdddbccdbdddadabc	TRUE
adacdcbabaddbdbabbdb	TRUE
adbaaaddcdbaaddadddc	TRUE
adcbccdbbabaaacbddbd	TRUE
addddcbbcbdcaaddddbb	TRUE
baaccabbbddcbaddabda	TRUE
babcbcdabcbdbabccbdb	TRUE
baccdbbdbbabbacdcbcb	TRUE
baddcbdbaaaadcdbdbad	TRUE
bbacbbbbddbadddaacaa	TRUE
bbbbdbcababdbdabdbbc	TRUE
bbccaabbababaacdabab	TRUE
bbdbdaabacaddcacbccb	TRUE
bcacbbbcbddacbcbddbd	TRUE
bccbadcadaddbddcbdbb	TRUE
bcadbbbcbbccbdabbbbb	TRUE
bdacbbbbddccabbacccc	TRUE
bdbdbaabdcbcdbbdacdb	TRUE
bddbdabbcadcbabbcbbd	TRUE
cacaacdcdbdbdbdbdbbb	TRUE
caabcbaaaadadaddaabc	TRUE
cbacdbdbaaddbdaadccc	TRUE
cbcbddddadabcddbddbc	TRUE
ccaadbbadaacdadbdbaa	TRUE
cccbadbddbadadabcacb	TRUE
ccdadcbdbddababadbda	TRUE
cdcdbdcabababadaabab	TRUE
caddbdaaabdbcbbccdab	TRUE
daaaabcbdadbdcdbbbba	TRUE
daaddadcddbdcdddbbda	TRUE
dacaadbbdbabbbabdbdc	TRUE
dadcddabdbaadbdcadba	TRUE
dbadaadaadbcdbdadcaa	TRUE
dbbddacbaaddacabacbc	TRUE
dbdbdacccbddbbabcbbd	TRUE
dcbabaaaadcdabdbbbab	TRUE
ddaabacbdbccddbadbba	TRUE
ddbbbbdddcdbcccdddaa	TRUE
ddcabcbbcbcbbbadbada	TRUE
abcccccbdcbbcbbbaaaac	FALSE
aaadbacbdbbbddddabab	FALSE
aabcbbbdadaabdadbbd	FALSE
aacbcbccddcddddddaaa	FALSE
aadabbdddbdddcdbdadd	FALSE
ababbcddbaabbabdddcc	FALSE
abbadddabaacaabacbd	FALSE
abbddbaadacbabaaacdd	FALSE
abdabbbaabababdcbbcb	FALSE
abddbdbaaaaaccbaacb	FALSE
acbcaabbacbbbcbcdbcd	FALSE
acccdddbccdbdddadab	FALSE
abacdcbabaddbdbabbdb	FALSE
adbaaaddcdbaaddadddb	FALSE
adcbccdbbabaaabbddbd	FALSE
addddcbbcbbcaaddddbb	FALSE
baaccabbbdddbaddabda	FALSE
babcbcdabbbdbabccbdb	FALSE
baccdbbdbbabbacccbcb	FALSE
baddcbdbaaaadddbdbad	FALSE
bbadbbbbddbadddaacaa	FALSE
bbbbcbcababdbdabdbbc	FALSE
bbccaabbababaabdabab	FALSE
bbdbdaabaaaddcacbccb	FALSE
bcacbbbcbddcbcbddbd	FALSE
bccbadaadaddbddcbdbb	FALSE
bcddbbbcbbccbdabbbbb	FALSE
bdadbbbbddccabbacccc	FALSE
bdbdbaabdcbcdbbdaddb	FALSE
bddbdabbadcbabbcbbd	FALSE
aacaacdcdbdbdbdbdbbb	FALSE
caababaaaadadaddaabc	FALSE
cbaadbdbaaddbdaadccc	FALSE
cbcbddddadabcddbddbb	FALSE
ccaadbbadaaadadbdbaa	FALSE
cccbadbddbadadabcccb	FALSE
ccdbdcbdbddababadbda	FALSE
cdbdbdcabababadaabab	FALSE
daddbdaaabdbcbbccdab	FALSE
daaaabdbdadbdcdbbbba	FALSE
daaddadddbdcdddbbda	FALSE
dabaadbbdbabbbabdbdc	FALSE
daddddabdbaadbdcadba	FALSE
dbadaadaadbddbdadcaa	FALSE
dbbddaabaaddacabacbc	FALSE
dbdbdacccbddbbababbd	FALSE
dcbabaaaadddabdbbbab	FALSE
ddaabacbbccddbadbba	FALSE
ddbbbbdddbdbcccdddaa	FALSE
dddabcbbcbcbbbadbada	FALSE
aaaaabcbbdaaddaacabbc	TRUE
aaacbdaaacaddccbbbdbb	TRUE
aabbbcbdbcbdadaadbbdc	TRUE
aacbcbbadacdbabbbbddc	TRUE
aadbaabaddbaacaddbccb	TRUE
abaacddabbabbdcbacbbd	TRUE
abaddbabadaadcdbaccad	TRUE
abbccbbbdbbabccddcdbd	TRUE
abcdabbcdcbcbccbbbddd	TRUE
abddabcbdadbabbdbbdcb	TRUE
acbbccbbcddcbdcaadaba	TRUE
accdacbbaadbababaddab	TRUE
adabcccccbcdbdaaacbbb	TRUE
adadddddabbaaaaacadbc	TRUE
adbdddadbabdacbabcddc	TRUE
adddbbbccabbdbcbaaadb	TRUE
baacaaaaccbcdbbabacdb	TRUE
babbbabcbbbdadbddccdc	TRUE
bacbbddbbdabcbcaacbcc	TRUE
badcdbbaaaaababaccbca	TRUE
bbabcbaadabbdbcbccdcd	TRUE
bbbabaabcdccadabbddcd	TRUE
bbbdaadabdacaaabbdddc	TRUE
bbcddbddcaabdbddbcbad	TRUE
bbddbdadbddaadccbadac	TRUE
bcbbcddcbbabcbdaaabaa	TRUE
bccccbdbcbddbaadbdaca	TRUE
bdbbabcbbbdbddbcbadda	TRUE
bdadcddadcddabbaabddb	TRUE
bdcbbabcabbbaaaabbaaa	TRUE
bddcbcabbbbaaaddbacbb	TRUE
cbbacaaaaddbdbaaacccc	TRUE
cabaddaabdbaadcaaaccd	TRUE
cbbbaaadabbaabcaadaad	TRUE
cbcdbbbcbbacdadddaaab	TRUE
ccbbabbbaabbdcbdbddbc	TRUE
cccbdbdddadddcabaccdb	TRUE
cdababdacdaadadabbbab	TRUE
cddbcdcbbbcaaadaaaaab	TRUE
dacccaaaaaaadddadadcc	TRUE
daabbbadbcbacdadabadd	TRUE
dabcbbaddaddadabddcdb	TRUE
dadbbbcbabbbdaacbbbba	TRUE
dbabbadadbdcbdadccdaa	TRUE
dbbbddadbcdabddbdbcaa	TRUE
dbdaddbacbcabccdbbadd	TRUE
dcbaadddbddaddadbcbdd	TRUE
ddaadbbbddaacbcacccca	TRUE
ddbadddbdbadccbdbacdb	TRUE
ddccbbcbaabcbbaababda	TRUE
aaaaabcbbdaaddaacbbc	FALSE
aaacbdaaaaddccbbbdbb	FALSE
aabbbcbdbcbdadaadbbdb	FALSE
aacbcbbadadbabbbbddc	FALSE
aadbaabaddbaadaddbccb	FALSE
abaacddabbabbdcbcbbd	FALSE
abaddbabadaadadbaccad	FALSE
abbccbbbdbbabccdddbd	FALSE
abcdabbcccbcbccbbbddd	FALSE
abddabcbdadbabbdbbdbb	FALSE
acbbccbbcddcbdaaadaba	FALSE
accdaabbaadbababaddab	FALSE
ababcccccbcdbdaaacbbb	FALSE
adadddddabbaaaaabadbc	FALSE
adbdddadbabdacbabcdd	FALSE
adddbbbccabbdbbbaaadb	FALSE
baaaaaaccbcdbbabacdb	FALSE
babbbabcbbbdadbddccc	FALSE
bacbbddbbdcbcbcaacbcc	FALSE
badadbbaaaaababaccbca	FALSE
bbabcbaadabbdbcbcccd	FALSE
bbbabaabcdccadabbddad	FALSE
bbbdaadabdacaaabbdddd	FALSE
bbcddbddcaabdbddbabad	FALSE
bbddbdadbddaadccbaaac	FALSE
bcbbcddcbbababdaaabaa	FALSE
bccccbdbcbddbaadbdaa	FALSE
bbbabcbbbdbddbcbadda	FALSE
bdadcddaddddabbaabddb	FALSE
bdbbabcabbbaaaabbaaa	FALSE
bddcbcabbbbaaaddbabbb	FALSE
abbacaaaaddbdbaaacccc	FALSE
cabaddaabdbaadaaaccd	FALSE
cbbbaaadabbaabaadaad	FALSE
cbcdbbbcbbadadddaaab	FALSE
ccbbabbbaabbdbbdbddbc	FALSE
cccbdbdddadddbabaccdb	FALSE
cdababdabdaadadabbbab	FALSE
cddbdcbbbcaaadaaaaab	FALSE
acccaaaaaaadddadadcc	FALSE
daabbbadbcbaddadabadd	FALSE
dababbaddaddadabddcdb	FALSE
dadbbbcbabbbdaaabbbba	FALSE
dbabbadadbdabdadccdaa	FALSE
dbbbddadbcdabddbdbaa	FALSE
dbdaddbacbcbbccdbbadd	FALSE
dabaadddbddaddadbcbdd	FALSE
ddaadbbbddaacbccccca	FALSE
ddbadddbdbadccbabacdb	FALSE
ddccbbcbaabbbbaababda	FALSE
aaaaaaacbcddbcdbdbdcdb	TRUE
aaadabbcccbbcabdbababc	TRUE
aabbbdbaabcbccbbbcabdc	TRUE
aacaddacaaadababbcbddd	TRUE
aadbbaabbbdbcababccbab	TRUE
abababaaadacdcbaabbddd	TRUE
abbaacadaddbbcadbdabbb	TRUE
abbdaaddabddacbbabcacb	TRUE
abcdcccbbbcbaddacdaddb	TRUE
abddbbdbdcbcbacdbaddaa	TRUE
acbbcaddbddcdbababadaa	TRUE
accddbabbddabadacbdaac	TRUE
adababbbbcddcbbdbbaada	TRUE
adbbbdaaabcddddacacccb	TRUE
addacdacccbbbaadbbbada	TRUE
baaabcababdbccdadadbad	TRUE
baaddaabcdbdbcadaabdab	TRUE
babcaaddbbbddbbcdbbbbc	TRUE
baccbddadbdaadcddaabba	TRUE
badcdcaabddabdaaaddbdd	TRUE
bbabbaaabaddcbbbdcadab	TRUE
bbbababdbdcdbccccbbbbc	TRUE
bbbdbddcaadcabdddaadab	TRUE
bbdcdbabbdddddabbaacbb	TRUE
bbdddadadbbbadcddabbbc	TRUE
bcbbbcaccccbbabbdbbbaa	TRUE
bcccccacbbabbdbabaccbc	TRUE
bdaaaaacbcdcaaaacbccbd	TRUE
bdadbbdccbcacbbccddbdc	TRUE
bdbdacccacdbadbbbddbab	TRUE
bddbacbddbbbdbbababcdb	TRUE
cddadaacdaddbadddbdbba	TRUE
caadbbddacbaaaababbdba	TRUE
cbbbcbbccacbddaddababb	TRUE
cbcdddaabdbdadcdddaadc	TRUE
ccbbaabadabcabbdaadcbb	TRUE
cccccbccacddbbbbbbdcda	TRUE
cdabbabcdddbddcbcbcbcc	TRUE
cddbbdababdddadbdbdcad	TRUE
dcccbdbdddccbccbccbabd	TRUE
daabcddaddbaacacbbccdb	TRUE
dabbbcabcddddabdabddda	TRUE
dadababcdcaaadaaaabadd	TRUE
dbabaaabdddabdbdcdadcd	TRUE
dbbbbcadbddbdbaaacaaab	TRUE
dbdaaaddbbabdbbcacabcb	TRUE
dcabdbbbddabadbacbddaa	TRUE
dcdaddabdaddbcbbcaaccc	TRUE
ddaddbccdcccdaabdadaba	TRUE
ddcdbadabcbbdbdbadddbd	TRUE
aaaaaaacbcddbddbdbdcdb	FALSE
aaaabbcccbbcabdbababc	FALSE
aabbbdbaabcbccbbbcabac	FALSE
aacaddaaaaadababbcbddd	FALSE
aadbbaabbbdbababccbab	FALSE
abababaaadacdbaabbddd	FALSE
abbaaadaddbbcadbdabbb	FALSE
abbdaaddabddaabbabcacb	FALSE
abcdcccbbbcbaddaddaddb	FALSE
abddbbdbdcbcbadbaddaa	FALSE
acbbcaddbdddbababadaa	FALSE
accddbabbddabadadbdaac	FALSE
adababbbbcddbbdbbaada	FALSE
adbbbdaaabaddddacacccb	FALSE
addaddacccbbbaadbbbada	FALSE
baaabaababdbccdadadbad	FALSE
baaddaabadbdbcadaabdab	FALSE
babcaaddbbbddbbddbbbbc	FALSE
baccbddadbdaadddaabba	FALSE
badccaabddabdaaaddbdd	FALSE
bbabbaaabaddabbbdcadab	FALSE
bbbababdbdccbccccbbbbc	FALSE
bbbdbddcaaddabdddaadab	FALSE
bbcdbabbdddddabbaacbb	FALSE
bbdddadadbbbadbddabbbc	FALSE
bcbbbcccccbbabbdbbbaa	FALSE
bccccccbbabbdbabaccbc	FALSE
bdaaaaacbcccaaaacbccbd	FALSE
bdadbbdccbcacbbccddbd	FALSE
bdbdacccaadbadbbbddbab	FALSE
bddbadbddbbbdbbababcdb	FALSE
ddadaacdaddbadddbdbba	FALSE
caadbbddadbaaaababbdba	FALSE
cbbbcbbccabbddaddababb	FALSE
cbcdddaabdbdadddddaadc	FALSE
ccbbaabadabbabbdaadcbb	FALSE
cccccbccbcddbbbbbbdcda	FALSE
ccabbabcdddbddcbcbcbcc	FALSE
cddbbdababdddadbdbdcd	FALSE
cccbdbdddccbccbccbabd	FALSE
daabaddaddbaacacbbccdb	FALSE
dabbbcabaddddabdabddda	FALSE
dadababdcaaadaaaabadd	FALSE
dbabaaabdddabdbdadadcd	FALSE
dbbbbadbddbdbaaacaaab	FALSE
dbdaaaddbbabdbbdacabcb	FALSE
dabdbbbddabadbacbddaa	FALSE
dddaddabdaddbcbbcaaccc	FALSE
ddaddbccbcccdaabdadaba	FALSE
dddbadabcbbdbdbadddbd	FALSE
aaaaaaacbadbdabcbabdccc	TRUE
aaacbbcbbaccbbbcacbdbdd	TRUE
aabbacdbabbbdabadddcabb	TRUE
aabdddcaadcbbccaabaabda	TRUE
aadcccddbddcadababadbba	TRUE
abaaabdcabdadcdddbaabaa	TRUE
abadbdbaaacdddcbadaabaa	TRUE
abbccbcabbdaadaadcaacdd	TRUE
abcdbbbbdabdbbbaaacdcdb	TRUE
abddccbbccdadacadbaabda	TRUE
acbbcbbcbbaaacbddbaadaa	TRUE
accdbbabaadddaaabbabdca	TRUE
adaabdddbcadbabababbbcd	TRUE
adbabdbcccbbabcdbdbdbda	TRUE
adcabccbbccbdaddbabdbad	TRUE
adddbddaadccdbccaaabadd	TRUE
baabcbcadbcbadadbbbadac	TRUE
babadabdacbbdcbcaccddbd	TRUE
babdcbdaaddadadccbcbcbd	TRUE
badcbdabddaadaaacdddddd	TRUE
bbaabddbbcaddbbabadadca	TRUE
bbadaddbadadbcbbaadacca	TRUE
bbbbcdbabdbbdaabaacbdcc	TRUE
bbccaaaaaacccdabbbdcbcc	TRUE
bbdcbbadabbadcbdaadadbd	TRUE
bcbaddabdbcddabaabadaac	TRUE
bccdcccbccabbbcddaddbbb	TRUE
bdaabaddddbdcdcbbcbbddb	TRUE
bdbadbdddbadbcdbbcacbbd	TRUE
bdcbdbaaaddbbdbddcdadbd	TRUE
cabaacbdababbaabdbadcdd	TRUE
cdaaaccabdbdaabbabdbaad	TRUE
cbabdbbaabaabdbabbdbdca	TRUE
cbcbbbbcabbccddbbcdcddb	TRUE
cbdddbacabaaaaaaddabcbb	TRUE
ccbdccccccbbacadbdbdaaa	TRUE
ccdddbdbbbbdbccadbabdcd	TRUE
cddaadaddacbddddaacbcbc	TRUE
dbcdddddbbbcbccdddabbbd	TRUE
daabbdadabdabacaccaadda	TRUE
dabbbabbdbdcdbdcadaabbd	TRUE
dadabacdbcbaadadbbabbaa	TRUE
daddddddbdcdabbbbdcddba	TRUE
dbaddbcbbaabbacdcbcbbbc	TRUE
dbbddadacdddbdbcbddddbd	TRUE
dbdcbbbccbacbaadaddddda	TRUE
dccbabbbbbbcbbcdcdbbddb	TRUE
ddabddadbbbdbcdbbbacccc	TRUE
ddbbbdbdbabdcacaadbadbd	TRUE
dddaacacbaaabaaaaaddabd	TRUE
aaaaaaacbadbdabababdccc	FALSE
aaacbbcbbaccbbbcbcbdbdd	FALSE
aabbacdbabbbdabadddcdbb	FALSE
aabddddaadcbbccaabaabda	FALSE
aaccccddbddcadababadbba	FALSE
abaaabdaabdadcdddbaabaa	FALSE
abadbdbaaadddcbadaabaa	FALSE
abbccbcabbdaadaaddaacdd	FALSE
abcdbbbbdabdbbbaaacddb	FALSE
abddccbbccdadabadbaabda	FALSE
acbbcbbcbbaaabbddbaadaa	FALSE
accdbbabaadddaaabbabdda	FALSE
adaabdddbcadbabababbbdd	FALSE
adbabdbcccbbabcdbdbdbd	FALSE
adcbccbbccbdaddbabdbad	FALSE
adddbddaadcccbccaaabadd	FALSE
baabcbcadbabadadbbbadac	FALSE
babadabdabbdcbcaccddbd	FALSE
babdabdaaddadadccbcbcbd	FALSE
baccbdabddaadaaacdddddd	FALSE
bbaabddbbcaddbbabadada	FALSE
bbadaddbadadbbbbaadacca	FALSE
bbbbcdbabdbbdaabaabdcc	FALSE
bbccaaaaaacccddbbbdcbcc	FALSE
bbdabbadabbadcbdaadadbd	FALSE
bcbaddabdbddabaabadaac	FALSE
bccdcccbccabbbbddaddbbb	FALSE
bdaabaddddbddcbbcbbddb	FALSE
bdbadbdddbadbcbbbcacbbd	FALSE
bdcbdbaaaddbbdbddddadbd	FALSE
abaacbdababbaabdbadcdd	FALSE
bdaaaccabdbdaabbabdbaad	FALSE
cbabdbbaabaabdbabbdbdcb	FALSE
cbcbbbbcabbccddbbddcddb	FALSE
cbdddbadabaaaaaaddabcbb	FALSE
ccbdccccccbbaadbdbdaaa	FALSE
ccdddbdbbbbdbccadbabdad	FALSE
cddaadaddabddddaacbcbc	FALSE
bcdddddbbbcbccdddabbbd	FALSE
daabbdadabdabacbccaadda	FALSE
dabbbabbdbdcdbdbadaabbd	FALSE
dadabacdbabaadadbbabbaa	FALSE
daddddddbdcdabbbbdaddba	FALSE
dbaddbcbbaabbaccbcbbbc	FALSE
dbbddadadddbdbcbddddbd	FALSE
dbdcbbbccbadbaadaddddda	FALSE
dccbabbbbbbcbbcdddbbddb	FALSE
ddabddadbbbdbadbbbacccc	FALSE
ddbbbdbdbabdcadaadbadbd	FALSE
dddaacccbaaabaaaaaddabd	FALSE
aaaaaadbabdaddabacacbadb	TRUE
aaacdcddbccddbdabddabaaa	TRUE
aabbbadcabbcabaaaacbdddd	TRUE
aacbbcacabaacbccccbbdccc	TRUE
aadaddbbcdcbdabaadbdaada	TRUE
abaacdbbaadaadcbdbcdbbbd	TRUE
abadbbdacaabaaadddddddcb	TRUE
abbbccdcadddbcbbbcbcdbbd	TRUE
abcbcccbbcbdbddbaacbadad	TRUE
abdbbcbdbddabdcabbddbaaa	TRUE
acaabaadbabacbbaadabaaaa	TRUE
accbbdbdbddcbbacbcdcbbbd	TRUE
acdddacddaddbbbbbbdbdaba	TRUE
adabdddabbbbdcadacdbadda	TRUE
adbbdadbddbdbaacbbdcaada	TRUE
addaadbbddddaaccbdcabccb	TRUE
baaaabaaabdbbccbcadababc	TRUE
baaccbacdbbbdddbbbaaddda	TRUE
babbbdaaacdddcdabadbbadd	TRUE
bacabbbadddaadacdbbdacbc	TRUE
badadadacbbcbdbcddbbddba	TRUE
bbaabbabbbadcacbdcbbdbbb	TRUE
bbadabaadaadabddcacabadb	TRUE
bbbbccaccccddabadabbabbd	TRUE
bbccbbccbbccdddcaccbccca	TRUE
bbdbdbaabccdacdabbaddbdb	TRUE
bcbbbbaddddaaaddcadcbbdb	TRUE
bcccdccbcaadcddabdadadda	TRUE
bdaaabcbdadabaaacaddbadd	TRUE
bdaddcbcbcadbbddcddbbadd	TRUE
bdbddbdaddbabcbddaccddba	TRUE
bddcdaabbbcabbdbddbaaaab	TRUE
cabbbabdaddacbabdbbaddaa	TRUE
cadbdbbddcababbbdddabdaa	TRUE
cbcbaaddcbbdbaadadabaada	TRUE
ccaaadaaddaadbccbdcbbbbb	TRUE
ccccaadabaacadaddbaadbdd	TRUE
cdabbbdbdbacdbabdbbbdccb	TRUE
cddddaddddabaadbabcaabdc	TRUE
dbccdcaaabaaadaadadbdbdd	TRUE
daaddddbdbbaddacaadbccbc	TRUE
dabdcbbcccbbcbccdcdaddda	TRUE
daddaadbbacbbcdaacabbabb	TRUE
dbabdadadbdadaacdbacbbdb	TRUE
dbbbdbcbccbadbbcdddabbad	TRUE
dbdadbaaabddbcccccdcbdbd	TRUE
dcbbddaddbdbdcbbbbabcddd	TRUE
ddabaabaddabddabdacbdacd	TRUE
ddbacddddbaadbadbcbdbdda	TRUE
ddcddbddbbabdbbaddbcbbaa	TRUE
aaaaaadbabdaddabacbcbadb	FALSE
aaaccddbccddbdabddabaaa	FALSE
aabbbadaabbcabaaaacbdddd	FALSE
aacbbcccabaacbccccbbdccc	FALSE
aadaddbbccbdabaadbdaada	FALSE
abaacdbbaadaadbbdbcdbbbd	FALSE
abadbbdacaabaaadddddddbb	FALSE
abbbccddadddbcbbbcbcdbbd	FALSE
abcbcccbbcbdbddbaadbadad	FALSE
abdbbdbdbddabdcabbddbaaa	FALSE
acaabaadbabaabbaadabaaaa	FALSE
accbbdbdbddcbbacbcddbbbd	FALSE
acdddadddaddbbbbbbdbdaba	FALSE
adabdddabbbbdcadaddbadda	FALSE
adbbdadbddbdbaacbbbcaada	FALSE
addaadbbddddaaccbcabccb	FALSE
baaaabaaabdbbccbcadabab	FALSE
baaccbaddbbbdddbbbaaddda	FALSE
babbbdaaacdddddabadbbadd	FALSE
bacabbbadddaadadbbdacbc	FALSE
badadadacbbcbdbaddbbddba	FALSE
bbaabbabbbadcacbddbbdbbb	FALSE
bbadabaadaadabddacabadb	FALSE
bbbbccdccccddabadabbabbd	FALSE
bbccbbccbbccdddcaccbccc	FALSE
bbdbdbaabccdadabbaddbdb	FALSE
bcbbbbaddddaaaddadcbbdb	FALSE
bcccdccbcaadddabdadadda	FALSE
bdaaabbbdadabaaacaddbadd	FALSE
bdaddcbcbcadbbdddddbbadd	FALSE
bdbddbdaddbabbbddaccddba	FALSE
bddcdaabbbbabbdbddbaaaab	FALSE
babbbabdaddacbabdbbaddaa	FALSE
cadbdbbddababbbdddabdaa	FALSE
cbcbaaddabbdbaadadabaada	FALSE
ccaaadaaddaadbccbbcbbbbb	FALSE
ccccaadabaadadaddbaadbdd	FALSE
cdabbbdbdbaddbabdbbbdccb	FALSE
cddddaddddabaadbabaabdc	FALSE
cbccdcaaabaaadaadadbdbdd	FALSE
daaddddbdbbaddacaacbccbc	FALSE
dabdcbbcccbbcbccbcdaddda	FALSE
daddaadbbacbbcdaaabbabb	FALSE
dbabdadadbdadaacbacbbdb	FALSE
dbbbdbcbccbadbbdddabbad	FALSE
dbdadbaaabddbcccccbcbdbd	FALSE
dbbbddaddbdbdcbbbbabcddd	FALSE
ddabaabaddabddabdadbdacd	FALSE
ddbacddddbaadbadbbdbdda	FALSE
ddcddbddbbabdbbaddbdbbaa	FALSE
aaaaaabaaccbbdbcaababdcda	TRUE
aaacbdbcbcccbbacdbadaddda	TRUE
aabbaabadccccbccbabccabcd	TRUE
aabddaaadacabddadcbadbabd	TRUE
aadadbbbcadbbabbbbcbaabbd	TRUE
abaababaddbadacbbcbacdaad	TRUE
abadaaaadbbbabbadcccacdba	TRUE
abbbbcaaabcdbdbdabddddaba	TRUE
abcbbadbbdbaddbbaadbbbcdc	TRUE
abdadbabbbbacdbcbddabbdad	TRUE
acbbbaabbbdbaadadaadcaaac	TRUE
acbdabbbbbadabbaaacabaaab	TRUE
acadddbcccabbbbbbaacbbbdb	TRUE
adabdbbcbaddaddbaadaddbcd	TRUE
adbbbdaabdacbbcaacabbbcbd	TRUE
addacbabbabaddaaadbdcbdbb	TRUE
baaabbbbababbacaadcabbabc	TRUE
baacdaadbabadbadbaabcabdc	TRUE
babbcdaddaccbbcccbaabddbd	TRUE
bacabaabdacabbbdbddaadabd	TRUE
badacbdbaaabdbddddbccccad	TRUE
bbaabcbdadbbbccacbcbcbdbd	TRUE
bbadaabbbabaabdabcbdaccab	TRUE
bbbbbbbbbbdcbacbbccccaccd	TRUE
bbcbaacdcaaddadaaaaaddbda	TRUE
bbdabcbcccabbddddbdbbcddd	TRUE
bcdabadabbbaacbacdbbbbbbb	TRUE
bcbddcccbababaaadacdaabdb	TRUE
bcddaccbadbddabdbdabdabbb	TRUE
bdadbabdbdddacaadcbdbadbd	TRUE
bdbdbbbadbabbbaacacccaabc	TRUE
bddbabdaaccbabccbccbbaddd	TRUE
cdaddddbadaadaaabacccaaba	TRUE
cabacddabdddadaaabbbbdccc	TRUE
cbbccddbdcddadadbdddacabd	TRUE
cbdcbbbcddabdabbadbadbdac	TRUE
ccbdcabdadbbdbdbdaddddcdd	TRUE
ccabdccccbbbdadaabbbdbdba	TRUE
cddbaadabdbbadbadabcdbadd	TRUE
dccbcabbbddaabbadbabdccdb	TRUE
daabdbabaaddbbaacdaccbcca	TRUE
dabbdaabcacccbbbbdabdbaab	TRUE
dadaddbcbabcabdaabababaad	TRUE
dbabaabdaddbbcacadaabbabd	TRUE
dbbbaabadcbcdaacdbbaadddb	TRUE
dbcabbabdbbaddddbdadcaddd	TRUE
dbddbdbaaddbbbdbaacdbcbcb	TRUE
ddaabbbcabdbaccdadaddaaaa	TRUE
ddbabdcbcbcbccabccaabbcdb	TRUE
ddcdddbdadbbcbdaddabdabbd	TRUE
aaaaaabaaccbbdbcaababddda	FALSE
aaacbdbcbcccbbccdbadaddda	FALSE
aabbaabadccccbccbbccabcd	FALSE
aabddaaadaaabddadcbadbabd	FALSE
aadadbbbdadbbabbbbcbaabbd	FALSE
abaababaddbadacbbcbbcdaad	FALSE
abadaaaadbbbabbadcccaddba	FALSE
abbbbcaaabbdbdbdabddddaba	FALSE
abcbbadbbdbaddbbaadbbbccc	FALSE
abdadbabbbbadbcbddabbdad	FALSE
aabbbaabbbdbaadadaadcaaac	FALSE
acbdabbbbbadabbaaaabaaab	FALSE
acddddbcccabbbbbbaacbbbdb	FALSE
adabdbbcbaddaddbaadaddbad	FALSE
adbbbdaabdacbbcaaabbbcbd	FALSE
addacbabbabaddaaadbdabdbb	FALSE
baaabbbbababbacaaddabbabc	FALSE
baacdaadbabadbadbaababdc	FALSE
babbadaddaccbbcccbaabddbd	FALSE
bacabaabdaabbbdbddaadabd	FALSE
badadbdbaaabdbddddbccccad	FALSE
bbaabcbdbdbbbccacbcbcbdbd	FALSE
bbadaabbbabaabdababdaccab	FALSE
bbbbbbbbbbdabacbbccccaccd	FALSE
bbbaacdcaaddadaaaaaddbda	FALSE
bbdabcbcccabbddddbdbbdddd	FALSE
bdabadabbbaacbacdbbbbbbb	FALSE
bcbddcccbababaaadadaabdb	FALSE
bcddbccbadbddabdbdabdabbb	FALSE
bdadbabdbdddacaadbbdbadbd	FALSE
bdbdbbbadbabbbaacbcccaabc	FALSE
bddbabdaaccbabccbccbbdddd	FALSE
daddddbadaadaaabacccaaba	FALSE
cabaddabdddadaaabbbbdccc	FALSE
cbbccddbdcddadadbdddadabd	FALSE
cbdcbbbcddabdabbadbadbdab	FALSE
ccbdaabdadbbdbdbdaddddcdd	FALSE
ccbdccccbbbdadaabbbdbdba	FALSE
cddbaadabdbbadbadabddbadd	FALSE
ccbcabbbddaabbadbabdccdb	FALSE
daabdbabaaddbbaabdaccbcca	FALSE
dabbdaabccccbbbbdabdbaab	FALSE
dadaddbcbabdabdaabababaad	FALSE
dbabaabdaddbbbacadaabbabd	FALSE
dbbbaabadcbcdaabdbbaadddb	FALSE
dbdabbabdbbaddddbdadcaddd	FALSE
dbddbdbaaddbbbdbaadbcbcb	FALSE
ddaabbbabdbaccdadaddaaaa	FALSE
ddbabdcbcbcbccbccaabbcdb	FALSE
ddcdddbdadbbbbdaddabdabbd	FALSE
aaaaadaddbadbabcdbccabbabb	TRUE
aaacddcbddaabadcdddbadadda	TRUE
aabbbabccccccbdadadabcacbb	TRUE
aabddcbdddbcdaaddaabaadadd	TRUE
aadabdabcaddaabacbaadbdbda	TRUE
abaaaaabaaaabddabacaacaadd	TRUE
abacbbccadaaaddbbdbbcabbbd	TRUE
abbbbbbabccaaacdaaabadcbbc	TRUE
abcabdbbbbdabbcbbbbcdaabaa	TRUE
abdbaaadcbacddbabddabdbaab	TRUE
acbaddaabbaabadcbcbbabdbaa	TRUE
accbaddbbdbbaabdacbdccccdb	TRUE
adcbbddbcbaaabdadddddaddbd	TRUE
adadadbacdbadbdadcbbcdbaba	TRUE
adbdabbddbaacbddaabdbaaccd	TRUE
addbadcbbadbbbdcbbdaddadaa	TRUE
baaacddabddabcdabdaadadabb	TRUE
baadbdadbdabcdbabbcaaababd	TRUE
babcbbcbdcbbcbdcaddddbaadd	TRUE
bacddddbdbadacddaabadaaaab	TRUE
baddadadddcccaaaacadbaddbb	TRUE
bbabbcadbdaabaacbbaddadaad	TRUE
bbbabaaccbbaababbbaaddacdc	TRUE
bbbcddbcccbcddaacaaddabbad	TRUE
bbcdcbaaabaadaaadabbadcddb	TRUE
bbddaaacdbadaddabbccdabbdb	TRUE
bcbcbadaaabababdaaaabcbaaa	TRUE
bcdcbcbbaadbaaaabaadadcbbb	TRUE
bdabddcdaddaddbaadbbababcd	TRUE
bdbbccbbababcaadbbbbadbadb	TRUE
bddabaabacdabbbbbbbdbdbcdd	TRUE
caaaadddcaabaddabaadadddba	TRUE
cddadbbaacbabbaddbbdbabddb	TRUE
cbacbddbddbadddbabdbaddabd	TRUE
cbcbdbbdbabbdbbdaaadcbdbac	TRUE
ccaddaabbaaadbdbbcbadbcbbc	TRUE
ccccbbccabaaaadaddddbcdbcd	TRUE
cdbaadabbdbbbcaadbbadaddba	TRUE
cbbbaabddbdbbdaddbbdccbaad	TRUE
daaaddaadcdadbdaddbcabdddd	TRUE
dababcdaaaabdadddaddabccdd	TRUE
dacdbaaacadbbbbaadddabadbb	TRUE
daddbddacabbbadcbaabbbdadd	TRUE
dbadabdaaaadbbacdbdbdbcdaa	TRUE
dbbcadbbdcbbcbcbaddadbddbd	TRUE
dbdadaddddcaadbbbbbadcdbab	TRUE
dcaabddbbbadbcaddadbdabaab	TRUE
ddaadcbbbcabacaabbdbadaada	TRUE
ddbaddaaddabddcaccaacbcccb	TRUE
ddcbbddddbbdcbbddbdaaaabbd	TRUE
aaaaadaddbadbabbdbccabbabb	FALSE
aaacddcbddaabadbdddbadadda	FALSE
aabbbabccccccbdadadabaacbb	FALSE
aabddcbdddbbdaaddaabaadadd	FALSE
aadabdabcaddaababbaadbdbda	FALSE
abaaaaabaaaabddabacaadaadd	FALSE
abacbbccadaaaddbbdbbccbbbd	FALSE
abbbbbbabccaaaadaaabadcbbc	FALSE
abbabdbbbbdabbcbbbbcdaabaa	FALSE
abdbaaadbbacddbabddabdbaab	FALSE
aabaddaabbaabadcbcbbabdbaa	FALSE
accbaddbbdbbaabdacbccccdb	FALSE
acbbddbcbaaabdadddddaddbd	FALSE
adadadbadbadbdadcbbcdbaba	FALSE
adbdabbddbaabddaabdbaaccd	FALSE
addbaddbbadbbbdcbbdaddadaa	FALSE
baaacddabddabddabdaadadabb	FALSE
baadbdadbdabcdbabbaaababd	FALSE
babcbbcbdcbbcbdbaddddbaadd	FALSE
bacddddbdbadadddaabadaaaab	FALSE
baddadadddcccaaaaaadbaddbb	FALSE
bbabbcadbdaabaabbbaddadaad	FALSE
bbbabaaccbbaababbbaaddabdc	FALSE
bbbcddbcccbcddaabaaddabbad	FALSE
bbcddbaaabaadaaadabbadcddb	FALSE
bbddaaaddbadaddabbccdabbdb	FALSE
bcbcbadaaabababdaaaabbbaaa	FALSE
bcdcbcbbaadbaaaabaadadabbb	FALSE
bdabddadaddaddbaadbbababcd	FALSE
bdbbccbbababdaadbbbbadbadb	FALSE
bddabaabacdabbbbbbbdbdbadd	FALSE
aaaadddcaabaddabaadadddba	FALSE
bddadbbaacbabbaddbbdbabddb	FALSE
cbadbddbddbadddbabdbaddabd	FALSE
cbcbdbbdbabbdbbdaaaddbdbac	FALSE
ccaddaabbaaadbdbbbadbcbbc	FALSE
ccccbbccabaaaadaddddbbdbcd	FALSE
cdbaadabbdbbbaadbbadaddba	FALSE
dbbbaabddbdbbdaddbbdccbaad	FALSE
daaaddaaddadbdaddbcabdddd	FALSE
dababdaaaabdadddaddabccdd	FALSE
dacdbaaabadbbbbaadddabadbb	FALSE
daddbddaaabbbadcbaabbbdadd	FALSE
dbadabdaaaadbbaddbdbdbcdaa	FALSE
dbbaadbbdcbbcbcbaddadbddbd	FALSE
dbdadaddddbaadbbbbbadcdbab	FALSE
dcaabddbbbadbdaddadbdabaab	FALSE
ddaadcbbbcababaabbdbadaada	FALSE
ddbaddaaddabddccccaacbcccb	FALSE
ddbbbddddbbdcbbddbdaaaabbd	FALSE
aaaaaabbbaabddcdadaabbdcdbd	TRUE
aaacbbcdbdbbdddcbadbdadadcd	TRUE
aabbbaccbaabddbbdbbcbaddbbb	TRUE
aacadabbcadaaaddadababdbddc	TRUE
aadbbbdaaadbdbdbbcaabbacdaa	TRUE
abaadadbaaacabadbdabbdbbdcd	TRUE
abadbacaaaabaabdaacacbbccbc	TRUE
abbbcbcccddbdcabdccbccbdbbb	TRUE
abcbdccaabaabdaaababddbbcbd	TRUE
abdbadbdabacdcdbaaddbdbbbbd	TRUE
acdbddddbababbbaabddadaccac	TRUE
accbabbdaaddcdddabbbdbadabb	TRUE
adbacbcdddadbabbbdaaaabdccc	TRUE
adadbadbcaddaaaadbdcbababda	TRUE
adbdbabadcbabdaddcadaababbb	TRUE
addbadaabccbbcbbbaaaabdccbd	TRUE
baaacbbaabccccdddbbaddccbbd	TRUE
baaddcdddadbaaabdbbcbcbbdbb	TRUE
babcbcaccaabaabdaaddbdadddc	TRUE
baccadbadddbdddbddaabdcabcb	TRUE
badbcdddabbccbbbaadbbdabbbd	TRUE
bbaaddcabdbddddbadacbaababb	TRUE
bbaddabababacadddaaadbabccc	TRUE
bbbcabdababddabbbadbdabdcab	TRUE
bbccdaabbaacbccbcbbbbcdbdcc	TRUE
bbdcdaaaabdbaabbdddddbcbdba	TRUE
bcbaaddaabbadaabbccbabbccdd	TRUE
bccdcbcccdaabadaaaadcddddab	TRUE
bdabadbaacbbdaccccbbdddbbaa	TRUE
bdbbadaacbbcabcdadbdabddbdd	TRUE
bdcbccdaaaddabbadacdbbabddd	TRUE
bdddabdbabbbdabbabcaabccbad	TRUE
cddacccaabbabdbddbbbbbdbddb	TRUE
cbbbcbbdcbdcbaaabdaaadbdddd	TRUE
cbdababdbddcdbadabdbbdaaabd	TRUE
ccbcdadbaadddabbdcdbdadbbaa	TRUE
ccdcdbdbbbddddbbcddadadaabb	TRUE
cddaaaadbabacdbbacbbbbbbddd	TRUE
dbaccdccaaddabdbdddadaaadbb	TRUE
daacadabdadaabcbcddbbdabdba	TRUE
dabbddbddbdddbcdbcbbcababbb	TRUE
dadadbadcbcbbdbbdaaadcbbdab	TRUE
dbaabbabcbaaabdbbdbacaaaada	TRUE
dbadcbbaacbbaadadadaaaababd	TRUE
dbbdbbdaadadadbcdddcbaadbbd	TRUE
dbdbbbdabddababaadcbcbbdacb	TRUE
dcaaabddbaabbaddadddddabdac	TRUE
ddabbdddbdbbbdbaabbccbabcda	TRUE
ddbbdaaabaabbbbbcbdccccaadd	TRUE
dddaabadaaacdadabdbbdaaacbb	TRUE
aaaaaabbbaabddcdadaabbdadbd	FALSE
aaacbbcdbdbbdddbadbdadadcd	FALSE
aabbbaccbaabddbbdbbcbcddbbb	FALSE
aacadabbbadaaaddadababdbddc	FALSE
aadbbbdaaadbdbdbbbaabbacdaa	FALSE
abaadadbaaacabadbdabbdbbdbd	FALSE
abadbabaaaabaabdaacacbbccbc	FALSE
abbbcbcccddbdcabaccbccbdbbb	FALSE
abcbccaabaabdaaababddbbcbd	FALSE
abdbadbdabacddbaaddbdbbbbd	FALSE
aadbddddbababbbaabddadaccac	FALSE
accbabbdaaddddddabbbdbadabb	FALSE
abacbcdddadbabbbdaaaabdccc	FALSE
adadbadbbaddaaaadbdcbababda	FALSE
adbdbabadcbabdaddaadaababbb	FALSE
addbadaabccbbcbbbaaaabcccbd	FALSE
baaabbbaabccccdddbbaddccbbd	FALSE
baaddadddadbaaabdbbcbcbbdbb	FALSE
babcbccccaabaabdaaddbdadddc	FALSE
baccadbadddbdddbddaabdcbcb	FALSE
badbddddabbccbbbaadbbdabbbd	FALSE
bbaaddcabdbddddbadadbaababb	FALSE
bbaddabababaadddaaadbabccc	FALSE
bbbcabdababddabbbadbdabddab	FALSE
bbcccaabbaacbccbcbbbbcdbdcc	FALSE
bbdcdaaaabdbaabbdddddbbdba	FALSE
bcbaaddaabbadaabbccbbbbccdd	FALSE
bccdcbcccdaabadaaaadddddab	FALSE
bdabadbaaabbdaccccbbdddbbaa	FALSE
bdbbadaacbbccbcdadbdabddbdd	FALSE
bdcbccdaaaddabbadabdbbabddd	FALSE
bdddabdbabbbdabbabaaabccbad	FALSE
bddacccaabbabdbddbbbbbdbddb	FALSE
cbbbcbbdcbdbbaaabdaaadbdddd	FALSE
cbdababdbddddbadabdbbdaaabd	FALSE
ccbcdadbaadddabbddbdadbbaa	FALSE
ccdcdbdbbbddddbbbddadadaabb	FALSE
cddaaaadbababdbbacbbbbbbddd	FALSE
abaccdccaaddabdbdddadaaadbb	FALSE
daabadabdadaabcbcddbbdabdba	FALSE
dabbddbddbdddbcbbcbbcababbb	FALSE
dadadbadcbcbbdbbdaaadabbdab	FALSE
dbaabbabcbaaabdbbdbabaaaada	FALSE
dbadbbaacbbaadadadaaaababd	FALSE
dbbdbbdaadadadbbdddcbaadbbd	FALSE
dbdbbbdabddababaadcbcbbdadb	FALSE
dcaaabddbaabbaddadddddabdab	FALSE
ddabbdddbdbbbdbaabbccbabada	FALSE
ddbbdaaabaabbbbbbdccccaadd	FALSE
dddaabadaaaadadabdbbdaaacbb	FALSE
aaaaaaadabcbdbdabdbbbddabadc	TRUE
aaacbcccacbaabdddbdbbbcbdbdb	TRUE
aabadaaabdcdbadbdbdbbaccbbda	TRUE
aabdbdcddbadadaccddbdaddadad	TRUE
aadabbacadabddcdbaadadbdbddb	TRUE
abaabbabdbaaadbbddaacacbbadd	TRUE
abadaaacabbbbdbdcadbbbbdabda	TRUE
abbbbbdbbadcdbbddbadaddacaba	TRUE
abcbacbbddaaddbdbadddbabbaba	TRUE
abdbaabcddbdbbdbbbdbaacbacbb	TRUE
acbacdbdddbddbdbbaabadddcccb	TRUE
accbcbcccbaaabdaddbdaadbcdba	TRUE
adbabacbdccbcadbbdaadaaaabbb	TRUE
adadbbabbadaabadccdbbccdbdbd	TRUE
adbdabbacbbbaabbbddabddbcbcc	TRUE
addadcbddaabaaccbcabcccbcbbc	TRUE
baaaadddbabbddbdaddaccbcbdac	TRUE
baadbbbbddddbacdbdbdbaadabbc	TRUE
babbbdcdadaaadbcccbcabaabdba	TRUE
bacabbabbaacbaabaadbaaaaccdd	TRUE
badacacbbabaddbbdbddbbaddbad	TRUE
badddbaacddbdddababbababbcdd	TRUE
bbabddbbbbacdbddabbcdaaddbda	TRUE
bbbbadacdbddabbbaabdddababac	TRUE
bbbdcdcabbbbabbdaaddabadbadb	TRUE
bbdaabbaabacbbbcadabcbbccbdb	TRUE
bbddaddaddbbdabddbdacdabdaca	TRUE
bcbcbcbccdbbbcbdbbbdabddacab	TRUE
bcddcbaaadbbdbabaacabbaadbbd	TRUE
bdacbaabddddbdaddacbaaaabbbd	TRUE
bdbdabddddcaadddcbcccbcccaac	TRUE
bddadcddadddaddbbddbaacbcdba	TRUE
cbdadaddaaadbbdbdbabaccadaad	TRUE
caaddddbabbabdabcbbddbbabaad	TRUE
cbbccdddddbbbaddacbbbdccdddd	TRUE
cbdbcccdddacdbabdbadbadbdbdd	TRUE
ccbdaddbbbcadbdadddddaaadcdb	TRUE
ccddbccadabbdbbddabbdbcadaba	TRUE
cddadaadbbbaabbaabdaaabaadca	TRUE
dbcdaabdddbababaabbbbdddcddb	TRUE
daadbdddbcbdaabdbbbadbbbdcad	TRUE
dabdbbddbaadaadbbadadabcacba	TRUE
dadbcbbdabaddabbadbaaaaddcbc	TRUE
dbacbbdbbdaacbbbbabbbadddabd	TRUE
dbbbcdbbccaaadbdbdaddaaabbad	TRUE
dbdacacabdbabaadbaaddadaabad	TRUE
dcadadbcbbadbdaaaadbbdadabdd	TRUE
ddaadcaabdbbdbaadadddacccaac	TRUE
ddbbaadbdaabaabbaccadbcdbbad	TRUE
dddaababaddadcdadcbdbbadbbaa	TRUE
aaaaaaadabcbdbdabdbbbddabada	FALSE
aaacbcccaabaabdddbdbbbcbdbdb	FALSE
aabadaaabdddbadbdbdbbaccbbda	FALSE
aabdbdbddbadadaccddbdaddadad	FALSE
aadabbacadabddadbaadadbdbddb	FALSE
abaabbabdbaaadbbddaaacbbadd	FALSE
abadaaaabbbbdbdcadbbbbdabda	FALSE
abbbbbdbbadcdbbddbadaddaaba	FALSE
abcbaabbddaaddbdbadddbabbaba	FALSE
abdbaabdddbdbbdbbbdbaacbacbb	FALSE
abbacdbdddbddbdbbaabadddcccb	FALSE
accbcbcccbaaabdaddbdaadbadba	FALSE
aababacbdccbcadbbdaadaaaabbb	FALSE
adadbbabbadaabadccbbccdbdbd	FALSE
adbdabbabbbbaabbbddabddbcbcc	FALSE
addaddbddaabaaccbcabcccbcbbc	FALSE
baaaadddbabbddbdaddaccbcbac	FALSE
baadbbbbddddbacdbdbdbaadabbb	FALSE
babbbdbdadaaadbcccbcabaabdba	FALSE
bacabbabbaabaabaadbaaaaccdd	FALSE
badacabbbabaddbbdbddbbaddbad	FALSE
badddbaacddbdddababbababbddd	FALSE
bbabddbbbbacdbddabbdaaddbda	FALSE
bbbbadaddbddabbbaabdddababac	FALSE
bbbdcdaabbbbabbdaaddabadbadb	FALSE
bbdaabbaabacbbbcaaabcbbccbdb	FALSE
bbddaddaddbbdabddbdacdabdaaa	FALSE
bcbcbcbccdbbbcbdbbbdabddadab	FALSE
bcddcbaaadbbdbabaadabbaadbbd	FALSE
bdacbaabddddbdaddadbaaaabbbd	FALSE
bdbdabddddaadddcbcccbcccaac	FALSE
bddaddddadddaddbbddbaacbcdba	FALSE
bdadaddaaadbbdbdbabaccadaad	FALSE
caaddddbabbabdababbddbbabaad	FALSE
cbbccdddddbbbaddacbbbbccdddd	FALSE
cbdbcccdddaddbabdbadbadbdbdd	FALSE
ccbdaddbbbbadbdadddddaaadcdb	FALSE
ccddbccadabbdbbddabbdbdadaba	FALSE
cddadaadbbbaabbaabdaaabaadcc	FALSE
cbcdaabdddbababaabbbbdddcddb	FALSE
daadbdddbbbdaabdbbbadbbbdcad	FALSE
dabdbbddbaadaadbbadadabacba	FALSE
dadbbbdabaddabbadbaaaaddcbc	FALSE
dbabbbdbbdaacbbbbabbbadddabd	FALSE
dbbbdbbccaaadbdbdaddaaabbad	FALSE
dbdacaabdbabaadbaaddadaabad	FALSE
daadadbcbbadbdaaaadbbdadabdd	FALSE
ddaaddaabdbbdbaadadddacccaac	FALSE
ddbbaadbdaabaabbaccadbddbbad	FALSE
dddaababaddadcdadbdbbadbbaa	FALSE
aaaaaabbabbababaadbadaaccdccc	TRUE
aaadbaccbbdaddaabdddcbbcbcbdb	TRUE
aabbabadbcabaddbbdddbadaccacb	TRUE
aabddadadbdddbabbbbbbcbcbbcdc	TRUE
aadabaccabbcadbdbdabbabaddaab	TRUE
abaaabdddbaaaadabbbbccaadcbbd	TRUE
abadbaabbdbaaadddaddcdbdadcac	TRUE
abbbbbbdaaaacbbcbbabbbcdbdcdd	TRUE
abcbbbccabdddaaaddbbaaadbbaca	TRUE
abdbdbbadccdbcddbbbbbbdaaaadb	TRUE
acadbaacaaabbaddbbbbdbddaaddb	TRUE
accdababbdbdabbaddaabcaccdddd	TRUE
adaadddbddaaabbacdbdbabcccadb	TRUE
adbabbcaddbbdbaadaabbdbcbbdaa	TRUE
adcbbcadaadaabbdadbbadbddcdaa	TRUE
adddadbbbacdadbabbbbdadbabdcb	TRUE
baabbccbabbbbcabdbaddaaacccdb	TRUE
bababddddcabaaabdacdbdaaadbda	TRUE
babdbcacccdbddbaddddbbabaabdb	TRUE
bacadabdaabbabccadaadbbbabdaa	TRUE
baddbadcbbaaadbdaadaacbcabccb	TRUE
bbabbccbcbdccbaabcddbdbbadbdd	TRUE
bbbababbdcccbabbabbdaaadcaaad	TRUE
bbbccdbddaabaadaadaaaaaddcdbc	TRUE
bbdaabbcbcabacdbbababbbaaaadb	TRUE
bbddaddaddaabbdbacaddbddbbbcc	TRUE
bcbcccbdbcbaadaddadaddaddbcbd	TRUE
bcddacaddddddabbddabaccbbcbdd	TRUE
bdabdddddbccaadabadaabbcbbbaa	TRUE
bdbbdcbddbdabbaaccbccdbddadbd	TRUE
bddabccbabbadbbdcbdabadadabba	TRUE
caaccccbccbaddbdbbbabacbbbccc	TRUE
cdbaadbddabdbaaadccdddbbbbdaa	TRUE
cbadabbdabbbbaddacbbaadaadccd	TRUE
cbcdabbadaaaddababaacdbadbbab	TRUE
ccbcadbaddabbbcaabdaaddbbadcb	TRUE
ccdaacdabddbacdbdbbdbbddbdbdb	TRUE
cdcdbdcdbaadabbabbaaddabadaaa	TRUE
daaaaabbdbbadabbdcbaabdccabbc	TRUE
daadddadbdcabacadbdbdbdbdbdba	TRUE
dabdabbcbddddccbbdabbbabdaaab	TRUE
dadbbbbdccabddbbcbddaddbadbbb	TRUE
dbababaaddaabdadadacdadddddcb	TRUE
dbbacaabbacadadbbabdaababbaba	TRUE
dbcbcddaaacdbaabbbbbbdaabaaaa	TRUE
dbdcbaadacdbddbbddabdbadadabd	TRUE
dcccbccadadbaddbadbaabdbdbacb	TRUE
ddabdbadcbcbbbbbbcddadadbcdaa	TRUE
ddbbabbcbaadbaadaddbacaaddbbb	TRUE
dddabcbabdbdabaadcbcbcbbcddaa	TRUE
aaaaaabbabbababaadbadaacccccc	FALSE
aaabaccbbdaddaabdddcbbcbcbdb	FALSE
aabbabadbdabaddbbdddbadaccacb	FALSE
aabddadadbdddbabbbbbbcbcbbcd	FALSE
aadabacccbbcadbdbdabbabaddaab	FALSE
abaaabdddbaaaadabbbbccaadbbd	FALSE
abadbaabbdbaaadddadddbdadcac	FALSE
abbbbbbdaaaacbbcbbabbbcdbddd	FALSE
abcbbbccabdddaaaddbbaaadbbac	FALSE
abdbdbbadccdbaddbbbbbbdaaaadb	FALSE
acadbaadaaabbaddbbbbdbddaaddb	FALSE
accdababbdbdabbaddaabaaccdddd	FALSE
adaadddbddaaabbaadbdbabcccadb	FALSE
adbabbbaddbbdbaadaabbdbcbbdaa	FALSE
adcbbcadaadaabbdadbbadbddddaa	FALSE
adddadbbbacdadbabbbbdadbabddb	FALSE
baabbccbbbbbcabdbaddaaacccdb	FALSE
bababddddbabaaabdacdbdaaadbda	FALSE
babdbdacccdbddbaddddbbabaabdb	FALSE
badadabdaabbabccadaadbbbabdaa	FALSE
baddbadabbaaadbdaadaacbcabccb	FALSE
bbabbccbcbdccbaabcddbdbbdbdd	FALSE
bbbababbdcccbabbabbdaaadaaad	FALSE
bbbccdbddaabaadaadaaaaaddcbc	FALSE
bbdaabbcbcabaadbbababbbaaaadb	FALSE
bbddaddaddaabbdbaaddbddbbbcc	FALSE
bcbcccbbbcbaadaddadaddaddbcbd	FALSE
bcddaaddddddabbddabaccbbcbdd	FALSE
bdabdddddbccaadabadaabbdbbbaa	FALSE
bdbbdbddbdabbaaccbccdbddadbd	FALSE
bddabccbabbadbbdbbdabadadabba	FALSE
aaccccbccbaddbdbbbabacbbbccc	FALSE
bdbaadbddabdbaaadccdddbbbbdaa	FALSE
cbadabbdabbbbaddadbbaadaadccd	FALSE
cbcdabbadaaaddababaaddbadbbab	FALSE
ccbcadbaddabbbaaabdaaddbbadcb	FALSE
ccdaabdabddbacdbdbbdbbddbdbdb	FALSE
cdcdbdadbaadabbabbaaddabadaaa	FALSE
daaaaabbdbbadabbddbaabdccabbc	FALSE
daadddadbdcababadbdbdbdbdbdba	FALSE
dabdabbabddddccbbdabbbabdaaab	FALSE
dadbbbbdccabddbbbddaddbadbbb	FALSE
dbababaaddaabdadadabdadddddcb	FALSE
dbbacaabbaaadadbbabdaababbaba	FALSE
dbcbcddaaadbaabbbbbbdaabaaaa	FALSE
dbddbaadacdbddbbddabdbadadabd	FALSE
dcccbccadadbaddbadbaabdbdbabb	FALSE
ddabdbadcbcbbbbbbcddadadbddaa	FALSE
ddbbabbabaadbaadaddbacaaddbbb	FALSE
dddabdbabdbdabaadcbcbcbbcddaa	FALSE
