aaaaaabadacccbbddcdd	FALSE
aabbbaddaccdadabbdcb	FALSE
aacbddacccaacccdabda	FALSE
aaddbadacaacabcaabda	FALSE
abbadbdaccaadacbdcac	FALSE
abcbcdadddadbccdbdbb	FALSE
abddbcdddaaaaddcbbdb	FALSE
acbaabbcdbbbdaaccbca	FALSE
accabdbacbcccabddada	FALSE
acdbcbabbbbadbdbbbbd	FALSE
adacbdcbbbadbacddbbc	FALSE
adbddcbadbcccddddadb	FALSE
addabaaccdbccdbccdac	FALSE
baabcaaadcbcbdaabbcc	FALSE
babbdddadcbccddcccbd	FALSE
baccdbccbbaddbbdcccd	FALSE
bbaaaabbacdbdbbdbdbb	FALSE
bbbacccacdbbddabbcaa	FALSE
bbcbdccbdacabaaddaad	FALSE
bbdcdbdbdaabbadcccbb	FALSE
bcadabddddcdaadbdada	FALSE
bcbdcacbcdddacabcdad	FALSE
bcdbaadccadbacdadbda	FALSE
bdacabbbdccdbbcadbba	FALSE
bdbdcdbdabacdbcdbada	FALSE
bddabaabdcbbdacaaccb	FALSE
caabbcaccbcdcccccacd	FALSE
cabddddcccbdbccadbdb	FALSE
cadbcbaaaddabcccbacd	FALSE
cbaccdccdcdbdbacbcaa	FALSE
cbcaaadbdcbbccbccbba	FALSE
cbdacabadcbcddbcdcdb	FALSE
ccabdbbaaadabbadbaac	FALSE
ccbcbbdcadcaacaabcca	FALSE
ccdaaddcacacdaacdbaa	FALSE
cdaadaacdddacddaaaca	FALSE
cdbcabbdddacddadadcd	FALSE
cdccdcaacbddbbdaacdd	FALSE
daaaadcaabdbacdddbbd	FALSE
dabbadbcbcabbbdcacab	FALSE
daccdccdacdbdaddbbaa	FALSE
dbaacdadcddabbaadada	FALSE
dbbbbbaaaccacbacadad	FALSE
dbccdabdbbdaddccbabb	FALSE
dcaabdacddaabbcccddb	FALSE
dcbcaccdbbbbdcdcdbbb	FALSE
dccdbadaacdaddaabacd	FALSE
dcddcdbcadddadccadba	FALSE
ddbadddbbcdbbcddcaaa	FALSE
ddcccdabbddaccbddbdc	FALSE
aaaaaaccabababbdbccb	TRUE
aaadcccacbbacacbabab	TRUE
aabddabbdbddbdbcbaad	TRUE
aadcbddadbbcacdadbab	TRUE
ababbadbaddaccbcabab	TRUE
ababdccabccbacddcaba	TRUE
abbadaabdababbdaabad	TRUE
abccdccaddbadbdcacbb	TRUE
abdcdbcbabadbabaabca	TRUE
acadacababbcdccccdbc	TRUE
accacadbadbbbdbcaddd	TRUE
acddababdaadcadddadb	TRUE
adbabacdcaddbbaddacc	TRUE
adbdabdbdaadadbabbab	TRUE
addbabbdaaddcabbdbcb	TRUE
baabdbbacbcbbabaddbc	TRUE
babbbaddababdbcdcbca	TRUE
bacbddacbaddacdaabab	TRUE
badcccbbcacaabdaddbc	TRUE
bbadcaaabadbbcabcada	TRUE
bbcbbbcbdcbdadabadbd	TRUE
bbdcdaccaabadbbcdcda	TRUE
bcadbdabaabcbbdadaba	TRUE
bcccdadddaadbadbaadc	TRUE
bdaadddbadddbbbacddb	TRUE
bdbbababbbcacddbdbbb	TRUE
bddacabdabbdccbaccbd	TRUE
caabcbcdbdbccabadddb	TRUE
cabadbddccacddbcabac	TRUE
caccabcaadbabbcdbadc	TRUE
cadddcbcaddbdabcbcad	TRUE
cbbacbcccababbaadacc	TRUE
cbcdcbbbccabadbaccac	TRUE
ccabbbdbdcbdbabababc	TRUE
ccbdabdadbaaccbbcaac	TRUE
ccdcaacdababbccddbca	TRUE
cdbaababbbbdbbcddcbd	TRUE
cdcbdbddadbacabadbdc	TRUE
daaaabababbaccbbabaa	TRUE
dababbcddcdbdcdbbdcb	TRUE
dabddcababdcddcadaab	TRUE
dadbddaddbbcccbcabbd	TRUE
dbacbadbabcdcbabcccd	TRUE
dbcababcbbdacbcdabbc	TRUE
dbdcacccaccdcdadbaba	TRUE
dcadcdcdabaabbbababb	TRUE
dccabcddabadbbbaadac	TRUE
dcdcdcbdabcdcdadbadb	TRUE
ddaddacdaacababaddbc	TRUE
ddcbadababbbabccddac	TRUE
aaaaaadabdacadbbcaaca	FALSE
aabbdccaaccbbabbbdcbb	FALSE
aacdaaacdbbbcadbbbdcd	FALSE
abaaddcdbcacaadcacaac	FALSE
abbdddbaaaadcacddcbdd	FALSE
abdaabbdbbaaacddabcab	FALSE
acabcbcabcbbaacbcdacc	FALSE
acbcaaaaccddcdddabcda	FALSE
accdaccdbaaccbaacddab	FALSE
adaacdbbdadcdbddddcbc	FALSE
adbcacbadcdbdbcacbdda	FALSE
adcdbcabcabbdcdbdacac	FALSE
baabbbdbbdbdadddccbcd	FALSE
babcadacbbdbbccadaccc	FALSE
bacdccdbaabacbcdacdcc	FALSE
bbacbbacbcdacbcabbdcd	FALSE
bbbdbbccabcdbdbccdabd	FALSE
bbcddccaaabdadcaaacda	FALSE
bcabbcbddcdabcccbddcc	FALSE
bcbbbbddddcdacbccccab	FALSE
bccccabccdaccccbbacdd	FALSE
bcdddcdaaacacacbacaac	FALSE
bdbaddcdaadcaddbbccaa	FALSE
bdcbdbdaccaacddadacdb	FALSE
bddcddcbcabcbddbabdbc	FALSE
caaddaadbcdcdabbbcbbd	FALSE
cacbacbcaabcdbabdbdad	FALSE
cadbdbcddddabbcbbbbdb	FALSE
cbacdadbbdaccdddbdbdc	FALSE
cbbdbdbbccacabcdabbcc	FALSE
cbdaabbddcbddcdabaaab	FALSE
ccabdaacadcaaabddccdc	FALSE
ccbcdacbaabbcdaaabaca	FALSE
cccdcaaabbadbdbddcbdd	FALSE
cdaaacaabbbacdbbdcbac	FALSE
cdbbcbdcbdbdadbacdadd	FALSE
cdccbddacdaddacacabdc	FALSE
cdddbbabaaccbccbbadbd	FALSE
dabaabcaadabdbdbcbdaa	FALSE
dacadbdbbcdccddacbbcb	FALSE
dadccdbddbddadcadccda	FALSE
dbaddaacadcdddddcaacd	FALSE
dbcacdbadccdbdaaaabba	FALSE
dbdbdaabdccdaadddacdc	FALSE
dcaccdabacdabccbbdcdd	FALSE
dcbdadadadbadaaabbbcb	FALSE
dccdddcbccdbbdddbbcba	FALSE
ddaadbbabdcccbcaadabd	FALSE
ddbbdccaadcbddcbaacbd	FALSE
ddcdaaaadccdbbacaacbd	FALSE
aaaaaacbadbcbaababadc	TRUE
aababcabadaaacdabaddd	TRUE
aacbababaacdbdacadabb	TRUE
aadbdabbddccddcabbcdd	TRUE
ababbbdccdbabaabcdbcb	TRUE
ababddccdacdcbbbcadca	TRUE
abbabdadbcdaaabddaddb	TRUE
abcccbbadadccaccdabab	TRUE
abdaddacccbadababbaca	TRUE
acabccbadbbdadababbaa	TRUE
acbdcccabcabdabcaabbd	TRUE
acdbcbadddbccdaddbaba	TRUE
adbaaaccbaabdadbaddbb	TRUE
adbddadbcacbaddaacabb	TRUE
addbabbddcbdaabdadcba	TRUE
baabbbbaccbabbabdadba	TRUE
babadbccccabcbbbaddcd	TRUE
bacbcbdbcaabaddbbacdc	TRUE
badcdbcaabcabadbbcdcc	TRUE
bbbabcabadbadbbdcbdcc	TRUE
bbccababaddcdbdbcddbc	TRUE
bbddbbadbdaddbcbacccb	TRUE
bcbaacbacccabcbdadbab	TRUE
bccccadcbdaadbabcbbdc	TRUE
bdabacaddbabadccbbdcb	TRUE
bdbdacacdbbaaacbabdab	TRUE
bdddbdbcadbabacdbdcab	TRUE
caadddbabcbaabcbbabda	TRUE
cabdabaddbbbcaadcccdc	TRUE
cadacadabcababbbdadbd	TRUE
cbaadccdcbddbabbababb	TRUE
cbbbcbdbabbabccababbd	TRUE
cbcdcababcaabddbbabac	TRUE
ccababbdcabbaabacadcd	TRUE
ccbcabadcdabaddbaabbc	TRUE
ccdacbababcbdaaccdadd	TRUE
cdacdccabadbaacdccccd	TRUE
cdcadababbcddbccdaacb	TRUE
cdddbababdbbdbadacadc	TRUE
daadccdbdadbdabaccdbd	TRUE
dabdabdabdbacdabacadd	TRUE
dacdddcdbcababbadbabb	TRUE
dbababdddbcdbbadcaccb	TRUE
dbbdabdbaacabadbbccba	TRUE
dbdadbabbbbcbbbccddbb	TRUE
dcadaabdabdcddddbbcab	TRUE
dccaddaabbabddabadbdc	TRUE
dcdcbddbabdabbddaacac	TRUE
ddadccddabddabbcbdbcd	TRUE
ddcbabdabaadadadbcbab	TRUE
aaaaaccabbbdccabaadabb	FALSE
aabbadcbbbadcbcddbbddc	FALSE
aacbdbcbadabdbaaccbdbb	FALSE
aaddaddddcbccaacddacdb	FALSE
abbbdcbddacdbabcdbabda	FALSE
abcbdadadacbcdbacacbcd	FALSE
abdcdddbaccccadcbbbdbb	FALSE
acbabaccbcdbcabbbddbad	FALSE
accbaccbdbddcbbbddcccc	FALSE
acdbcbcbcddcdaccdbacbd	FALSE
adacdbdbcbbcadaacddcdb	FALSE
adcaaaddabdcacacdddbad	FALSE
addbbdacdbccdbadbaaaca	FALSE
baacbadaabdaadbbdacdab	FALSE
babddcbaadaacbcbddcacd	FALSE
badacdcdbbadacabddccdc	FALSE
bbaccdcabbdaaddaaacbbd	FALSE
bbbddbabcddbdcbcadadad	FALSE
bbdabcbdccdadaacaabdbd	FALSE
bcacccadddabdddbacbdda	FALSE
bcbcdbcdbccbdcdcdccccc	FALSE
bccdccaabaabcbbdcabddb	FALSE
bdaaccbdbdcdaaacbbaaaa	FALSE
bdbbdaccddbdbdbdaaccad	FALSE
bdccdbdddaadbdcabaccba	FALSE
bddddcdadbcdcadadcbcbc	FALSE
cabbbdccaaaadcbddcaacd	FALSE
cacdbbabddbbddaaadbadd	FALSE
cbaaccaddabaadcdbcddac	FALSE
cbbbbbbcdbaadccbdbbadb	FALSE
cbcbdddbadccbddaccbddd	FALSE
cbddccbdacccdbcbddcdca	FALSE
ccbbaddbacdccadcdbdada	FALSE
cccccdabaaabbbcadcdaaa	FALSE
cdaabbaacdbacbcdcdbabd	FALSE
cdbaddacadcbadcdaadbdc	FALSE
cdcbbaccadccdbaabadabc	FALSE
cddcabdcaddaddacdcccda	FALSE
daadcadcaddadcadcdbcbb	FALSE
dacbcbadbadcadabbadccb	FALSE
dadbddddacbcbdabdadcba	FALSE
dbacdbcbcadbdbbdbdadab	FALSE
dbcaaabcaacddcddccacda	FALSE
dbdabdaabbaaacccbdcadb	FALSE
dcacbaddbbcaacacccbcba	FALSE
dcbdadbcbdbcddddcbdddb	FALSE
dcdaaaddbdaadadaadcdbb	FALSE
ddabcbbaddabadacbbdabd	FALSE
ddbdabddbdbacbabdddcbd	FALSE
ddcdacdcacacdcabdbccbb	FALSE
aaaaaaababadddbabbcbdc	TRUE
aaadcddcacdadadbabdadc	TRUE
aabdaddddbdbbdcaadabdc	TRUE
aadadabbaaababddcbacac	TRUE
abababcbaccdcddbdbccda	TRUE
ababdcaadccbbbbbddbcbc	TRUE
abbadbabcdbbdbabddccba	TRUE
abccdcbaadcabaddbdddcc	TRUE
abddabbcadaaddbdbbbbbd	TRUE
acadcabdadbcadadbdbdbc	TRUE
accacabddabaabcddabbcb	TRUE
adaababbadcbdbaabbccba	TRUE
adbabaccdbcbaabadcbdac	TRUE
adbdadbabbdacccccacdca	TRUE
addaabdabcdbbbbbaabddb	TRUE
baabaddbaabdcaabccaaca	TRUE
babbadcabdaddbdddccabb	TRUE
baccdccaaabddaadbabbca	TRUE
bbaaabcbcbcabdadadbabb	TRUE
bbbabccbbadbdaddbbdabd	TRUE
bbccbaabdccadbdadbcbdc	TRUE
bcaadbccababdaaabcccab	TRUE
bcbbddabdabbdddbbcaadd	TRUE
bcdaadddbbdabdabdaacaa	TRUE
bdabbccaababcdbbdcddda	TRUE
bdbdcabdaddbdccacbddad	TRUE
bddbbacacdccbbdadbabca	TRUE
caaccbdaddbdabbacbdaad	TRUE
cabccaacdbdababcadbdcd	TRUE
cacdcbadcdcaadbadddbda	TRUE
cbaabaddaddbdabbabcacc	TRUE
cbbdaaccdcaccaabaddbbd	TRUE
cbdabadabdabcaaddcabcd	TRUE
ccaccababdcdcbbabcdcab	TRUE
cccabadbaccddadccdcdcc	TRUE
ccdccdccbaddabdabbbcaa	TRUE
cdadcddccacdaadbadbbac	TRUE
cdcbbaccacbccacababcad	TRUE
daaaaaddcbccabdadbdbcb	TRUE
dababcacccbccdbbadcdbb	TRUE
dabdddbbdababcbbaabbbb	TRUE
dadbaababcaadaaaacdcbc	TRUE
dbabdadddbbabddcbabcdb	TRUE
dbcabdbabdabbbacdabdba	TRUE
dbdcacabcbadccdcccabab	TRUE
dcadbabbacabcccadcdddd	TRUE
dccbaadcdcbbaaadbabcca	TRUE
dcdcdcccdddbaacadbabdb	TRUE
ddbaababcccaaccaabaaad	TRUE
ddccbcaaccaabcbdabdaba	TRUE
aaaaacdbdacbcadaaabddba	FALSE
aabbacdcabdddbdaaadacac	FALSE
aacbcbdaaddcccdbdcacacd	FALSE
aadcadddbadddabbbddbbab	FALSE
abbacdbcbccaadabaddcdca	FALSE
abcbdadbcaadcddddccddaa	FALSE
abdcdbbccaaaddbbacabaca	FALSE
acadcbcdadadabdcccbaccd	FALSE
acbddbddbbadaaaacbaccba	FALSE
acdaccdbacbbbbbddbbdbcb	FALSE
adacbbabbddbaadabcacbda	FALSE
adcaacdcccbbaddbcdcacaa	FALSE
addbdcddccdcdadbbbbbcaa	FALSE
baaccdaccbdbabcaccaabbb	FALSE
babddcbbabbccbbcadcddcd	FALSE
badacbbbddbacbddacddbca	FALSE
bbabcdbcabbbcdcccaabaac	FALSE
bbbdbcdacdcdbdcdadaccbc	FALSE
bbdabddcbccbccbcbddbbba	FALSE
bcacccccbbdbdaaccabbcba	FALSE
bccadacbddacccadddcdccb	FALSE
bcdcabdbacadbadaabdadca	FALSE
bdadbaacccabbcbabadacbb	FALSE
bdbdcbbcdacaaacbdacddaa	FALSE
bddacddbdbcacbbcdaaccaa	FALSE
caabdddbcdabcdcbaddcdca	FALSE
cabcdcddcbbcaaadbaaddcb	FALSE
cacdaddcdadbccadcddddad	FALSE
cbabacccbccadbdbdbcbbaa	FALSE
cbbcbaaddacbbbdcbcdcbba	FALSE
cbcdadadbdccdcdadbdbcab	FALSE
cbddddbaaacddcaadaccdcb	FALSE
ccbabbbaadaaaabccbdacca	FALSE
cccbbccabdadabdbbabdbad	FALSE
ccdcaccdccdbbbcbbccacdb	FALSE
cdacccdcabcbdabacabcdaa	FALSE
cdbdcaccbcacaacdbbdcccd	FALSE
cddacbcbcbabdcaaccacccc	FALSE
daacaadcdcacccbcaccdbad	FALSE
dabddbbdbdbaabddccbbdaa	FALSE
dadbcccccbbadbaaaccbacb	FALSE
dbacacadabddcabbbcaadda	FALSE
dbbdaacbbaccddbcabcaccb	FALSE
dbdaadabbcdcccaddabbaab	FALSE
dcabdbbabbdcdcbdbbdccda	FALSE
dcbdadddaaccacbccabcbdd	FALSE
dccdccccccbdcbbdbcdacba	FALSE
ddaaddaadbdbadcdabccbcb	FALSE
ddbcbbdcbccccbabddacddd	FALSE
ddccddddcadbaccaabcaddd	FALSE
aaaaacaababdacdcdcbbcbb	TRUE
aabaabddabdbdcccacccdda	TRUE
aabdabdcbdcddabbcbcccac	TRUE
aadbabacadbadbaadbaadda	TRUE
ababadacadddabaadacdbcc	TRUE
ababdcaabdddccdabcaaddc	TRUE
abbabadbaaabbcacadbbcaa	TRUE
abcbacbcabdbcabaddbcdab	TRUE
abdbbdbcadaabddabbabbcc	TRUE
acabdddadbccddcbdbcdbac	TRUE
accaadcaadddbdcbababbbc	TRUE
acdbadcdbdbabadddddddbc	TRUE
adacdcacbbddadcaacdabab	TRUE
adbdabaaaabacbbaaabdacb	TRUE
addaabbaadababdbdcbcddc	TRUE
baaaccdbcbbcbbaadbddabb	TRUE
bababdccbdbbddbabacbdbc	TRUE
bacbdaccdaabacddaaababd	TRUE
badddaddbabbdddcdddabad	TRUE
bbbbbcddbddaadcabadbacd	TRUE
bbdaaabcdbbbcbbbadbddab	TRUE
bcabdabbdbcabadaababbcd	TRUE
bcbdcacbaacaabaababaaab	TRUE
bcdacacbaaadababdaabacd	TRUE
bdacbdbbabdabcbaaccbadc	TRUE
bdbddbddcadbbadaababbba	TRUE
bddbdabaddbabccdbddbdac	TRUE
caadbcdababaaaaadcacdbb	TRUE
cabcdaacabbcdaacadbdabc	TRUE
cacdcaababcddacacdcdbac	TRUE
caddcbacabccbacbabdabad	TRUE
cbbaaabddabbabadaccdcbd	TRUE
cbccaccababbbbcddccbabb	TRUE
cbddadaacdcacdabaddbaac	TRUE
ccbaadbabbbbdbdabacabbc	TRUE
cccdadcadaababadbaacacb	TRUE
cdaadbabbbcccaaddbdabdd	TRUE
cdbcdadcdcadcbbbaababcc	TRUE
cddadbabbcbbacbccccbbaa	TRUE
daaccbbbdadadcadabdabaa	TRUE
dabcbdaacadbabdabdccaaa	TRUE
dacdbbcababbddcbdabddab	TRUE
dbababbcccbccbacdbccaaa	TRUE
dbbcdbdadccdcbababbdabb	TRUE
dbdbdbababbbcbddbaadcac	TRUE
dcacbaababcddbadcabadac	TRUE
dcbdcacbddaccbddabdabcb	TRUE
dcdcbbbbddcbabadbbabbdb	TRUE
ddbaaabcdabdaaaddbddadb	TRUE
ddcbcabdabacdbcdbbbacbb	TRUE
aaaaaabddcdacacbccbcabbb	FALSE
aabaccdbcbcccdccbdbcbbab	FALSE
aacccbbbaadaabdacadaddac	FALSE
aaddcddacaadbbcdcabdbbbd	FALSE
abbbbcadabcdbbacbbcddcbc	FALSE
abccbbadddcbbaacddcbaadd	FALSE
acaaabdacbbdbccaabadcbaa	FALSE
acbbbccacddbaabcbbbccdda	FALSE
accbdcbcccaddabaabcadccd	FALSE
acdcdcbadbaacdacabaddcdc	FALSE
adadccdaaaaabadcdaccccbc	FALSE
adcacddccbcdbbcabdbaaada	FALSE
addbbabaacbdabadcbcbbbac	FALSE
baabccdbbcdbcddcbabccdcb	FALSE
babccdabcdcdcbdbbdcdcbcd	FALSE
baccddcaacdabcbaacabccbd	FALSE
bbaabcbaaabdaabcdcccadaa	FALSE
bbbcbbbdcdbadcbadbddddca	FALSE
bbcdadcbbcbcdaccbdbdccdd	FALSE
bbdcdbbccbabbdaacbccbdad	FALSE
bcbacbccdaddbbbdbccdaaba	FALSE
bccbbabcbadccbcccbbbbacb	FALSE
bcdcaccdccccdbcacdbbbabd	FALSE
bdadbccbdaacbbabcbacaacc	FALSE
bdcadcdbacdbaabbcaddcadd	FALSE
bddbcbbcbccbbcbdbdccdabd	FALSE
caadbdbdccbdbcaadcdcddbc	FALSE
cacaabcbcadadadaabbadbcb	FALSE
cadbcbcbaaaabcacaccddcbc	FALSE
cbadabbbdaabdddbddaddbba	FALSE
cbbdcccdabdbbbbabbdaacdb	FALSE
cbdbaadbbdbdcbabbabddaca	FALSE
ccaccdcabaddaaccccbcccba	FALSE
ccbdcbdacdadbcdabbadaacc	FALSE
ccdbaabcdabdcbdbaadcdcca	FALSE
cdacbacccdaabacbdbcbbbbc	FALSE
cdbcdccccbaaabcacbdcbabd	FALSE
cdcdaccdccaacadcadbcbdcc	FALSE
cdddbdbaabccaabdacaccadc	FALSE
dabacccaccccbbdcdbccddbc	FALSE
daccbbcddcdcdbacbadacddc	FALSE
dbaacbacabdcdcdddbaccdbc	FALSE
dbbbcddacbccbbbaacbaacbd	FALSE
dbcdaddcaaaaadbddbbdabdb	FALSE
dcaabaacbbbaaabccbbdbbca	FALSE
dcbbcdaabdadddaaccddbacc	FALSE
dccdbbabacabacbacdabccba	FALSE
ddaaccadcdaaddcadaccaddc	FALSE
ddbcadcaaaaaaccadddbaacd	FALSE
ddcdbcdcccbaacdbdbcaaddd	FALSE
aaaaaaabcbaacbaababbbada	TRUE
aababdbbcbbacabbcaadbadc	TRUE
aacacbadbbaccbbabababbbb	TRUE
aadbbaadababacbacbacabac	TRUE
ababbbaccbabdcadaccbabca	TRUE
abadbbbcdbabbcabcadbbddc	TRUE
abbdbcbbababacbdbbcdacba	TRUE
abdabdbdcadbccdcbccaddbb	TRUE
acaaababdccbcacbcddbaadc	TRUE
acbbbdcaabadbbbbcaadcbab	TRUE
accdcabdddabbbdddbdcbdda	TRUE
adaabadbbcbaadadbcbadacc	TRUE
adbacabbadddababbabcbbbd	TRUE
adcadccccbcabdbbcdadbabb	TRUE
addbdabbcaccdcacaadbbcbb	TRUE
baacbbaadcbdbbacdcdcabab	TRUE
babbdddccadcdadabdabccaa	TRUE
bacdbcabdabbcbaacdddbccc	TRUE
bbaaaababaacdbbcdaaaaaab	TRUE
bbbadcdabcabcabcababdddc	TRUE
bbcdaaccdcadabadddbcbcbc	TRUE
bcabacdddbcabcabdabbddaa	TRUE
bcbbdbcacaabcdaacababaac	TRUE
bccdaabbbbccadababadaccd	TRUE
bdaaddadadbcabdabacbcacd	TRUE
bdbdaacdabdabcbddcbbbbaa	TRUE
bddbdcababdbaddbcbacdbac	TRUE
caacddbcdbbababbaaadadbd	TRUE
cabbcbdaababccbcabdbabcb	TRUE
caccabaadbabcabccdaadcbc	TRUE
caddbbdadbabbaacacabcbdb	TRUE
cbbcababbadcccbcdabaaabc	TRUE
cbcddbbdbdbcadbcccacabab	TRUE
ccabcaaacddbccddaadddbab	TRUE
ccbdbcbdaadbadacaadbadba	TRUE
ccdadbddadddbddadadaccdb	TRUE
cdacaadaccbddcadcababbcd	TRUE
cdcacbadcbddbbbabaddbdad	TRUE
cddcddbabababdbaacbdaccd	TRUE
dababadadaacbccabadcacda	TRUE
dabdbbcdbadbcabadbaacadc	TRUE
dadbadbdbcbabcccaadcbcaa	TRUE
dbabddabbcabddcccbbbcbbb	TRUE
dbcaaaabdadbbacabddacbcb	TRUE
dbdbddabdabbacaabbaddabc	TRUE
dcadcdacdbacababcbbbcaca	TRUE
dcccbababcacccdcbbdbcdcd	TRUE
ddaaabacbabbabddadbcddcc	TRUE
ddbaddadddbcadbabccddacc	TRUE
ddccccabcdcbbdbbbdaddbab	TRUE
aaaaaadbbcbcaabbcabcddbaa	FALSE
aabbdaabccccdcddbbdbdbcdc	FALSE
aaccadadcbaabbabccddabcbd	FALSE
aadcdcdccbadaabbccabcbbdc	FALSE
abbbbaacacdddacccbaaacddd	FALSE
abcbbddbbdaccdcccaacdccbd	FALSE
abdcbbaaabaaacbccccbcbbcc	FALSE
acadcdccaaacbcddbaadadaaa	FALSE
accabdbaccacdcabadabbbdcb	FALSE
acdbbcccdccbbbcdbccccbdcc	FALSE
adacbcdadadacdaddbcccaacb	FALSE
adcaabcbbaccdacabacbadcbb	FALSE
addaddbdcdcbbdadbbbbcdbcd	FALSE
baabdbaabbdccaddbacdcbcab	FALSE
babccdbbbcacdbbacbacdadaa	FALSE
badaaacbccdbacdcadacbadcd	FALSE
bbabbccbacddbccacaaadcdbc	FALSE
bbbcbdabbcbdbdabacbdabcba	FALSE
bbcdbdcbddabbdabcadadbcdc	FALSE
bcaaccccadcccadacbadbbbbd	FALSE
bcbbcaabcdabadaccdabddcbc	FALSE
bcccbcddcbddbddabacccbabc	FALSE
bcdddcacccbccccccbadbaadc	FALSE
bdbbbcddacdaadbdccbdaacad	FALSE
bdcccbbaacdcacbabccbdcddd	FALSE
bdddaacbadabdcdcbaaacddbd	FALSE
caadddbbaaacbbdacccdcbbda	FALSE
cacbbddccbadabcbddcdabcaa	FALSE
cadcbbdcbcabcbcdbacaadaba	FALSE
cbadaacaabcbdacbccbddcacc	FALSE
cbcabcbcbbdcabcabbaddaddd	FALSE
cbdcacdccbaddddacbdbdddcd	FALSE
ccadbcdaadcbbbadcbaacdccd	FALSE
cccbabdbbabccdabdbbccbadd	FALSE
ccdcdbbcacabccdcdbddbdcac	FALSE
cdbabbddacdaccbbcdbabaaaa	FALSE
cdcacadcbccdadbbdddbcbcac	FALSE
cddbcadacaccbccbdabbbbdbd	FALSE
daacdcabdaacbdbddbccacabd	FALSE
dacacdcbcadcadcdccdaadbaa	FALSE
dadbbdcbdcaacbadaddcdacca	FALSE
dbacacabaaddbdadcaaddddad	FALSE
dbbdcdcbaccbadadbdcbcaacc	FALSE
dbdbcccddccbacdacabbbbcdb	FALSE
dcacbdbabadaabdacbcacadbc	FALSE
dcbcccbbcdaaccdcacdcacdab	FALSE
dccdcdaadabacbacbdbccaaba	FALSE
ddabaadcbdddbbaabacadaabd	FALSE
ddbcbabaaddcdbaabcbddbbac	FALSE
ddcdaacbbbcaadddbdbdcadda	FALSE
aaaaaababacdaaadbdabcbdba	TRUE
aababdadccaccddbabbcbdccb	TRUE
aacababdaccbcadccbbacaabb	TRUE
aadbcabaabdabcdcccdcccdad	TRUE
ababadbaabddbbdddaaaacbdd	TRUE
abadbadaddddabbdacabbbcca	TRUE
abbcddcabcdabababdcdbdadc	TRUE
abdabbadacaacbcdabbaddcaa	TRUE
abddadbabdbcabaababdabbbb	TRUE
acbadacabadbbcbaaaadbcacc	TRUE
acccbbbacaababcbaadacdcbb	TRUE
acddcbacbdcacaababdcdcaca	TRUE
adbabccabccdaccaccbabaadb	TRUE
adbdddddbcdababacabddddbd	TRUE
addbabcdccbbdaccdcaaadacd	TRUE
baabbddbadaddcccadbadbbac	TRUE
babbcaababacacbbdaadbbdcb	TRUE
baccddaaababcbbdcbbbdbacd	TRUE
bbaaaddbcbcdbbbccdababcab	TRUE
bbbbdbbbabcadaadbbabcabab	TRUE
bbdaabadaddaddbbabdabacbc	TRUE
bcabdabdbcbbadbcdbcbdbbbd	TRUE
bcbdcdbdddabbadcbdacababc	TRUE
bcdbdbbcbbdabadbbacacacaa	TRUE
bdadadcdcbddaabababbbbbac	TRUE
bdcbbbcccccadcdbaacababdb	TRUE
caaababcabcdabbbadbaabada	TRUE
cababcaaabcabaddcddcabdab	TRUE
cabddcaababbdaddbadddcada	TRUE
cadbabaabccbabbcdbcdbdbba	TRUE
cbabdabbcaddbbdcdbbcadbcc	TRUE
cbbdababbbcabacdbcaadcbbd	TRUE
cbdbdabdabacdcccabcccbdab	TRUE
ccacdddaadabdaadbabcbacab	TRUE
cccbbcabddabcccdbbbaddbbb	TRUE
ccddaabdbacbcccbababdaccb	TRUE
cdbaadbabcccdcaaddccbadad	TRUE
cdcbacdcdbbbcbcbababbccbc	TRUE
cddcdabdabccabbcdaccddaab	TRUE
daadccccabccacaadadbadbcd	TRUE
dabdbdcadaccbbabbdadbdabd	TRUE
dadadddadadbababcccbacaba	TRUE
dbabddcddaddabadbdabaccac	TRUE
dbbdbdcadbabcdcdacbaadbcd	TRUE
dbdadccccabbabcababdbbdbb	TRUE
dcabdddabadaabbbddabbcaca	TRUE
dccacdcadabbaabadbdbddbcd	TRUE
dcdcbabdabbdbdddcbcdaabda	TRUE
ddbabadbcbddbbbcbbdbabbbc	TRUE
ddcbdddbdcbacbbabadbaaccc	TRUE
aaaaaadacdcaccdcacccbaccbb	FALSE
aabbdbdaaaaabdcccbacbccbab	FALSE
aadacabbaacacabdbaddbddbcb	FALSE
abaccdcdaddbddbbcddccaaada	FALSE
abcaacadabbaaddabbdddbdbdc	FALSE
abdbaaccdadabbabcccadaaaab	FALSE
acacadabbadccbacbcbcadbcbc	FALSE
acbdaddccbaaabbadddbcbbdcb	FALSE
accdddcbcbabdbcadddacbcaca	FALSE
adabbcbbcdaadcdcdbcacdbada	FALSE
adbccdbdccccbaacdccabaaaab	FALSE
adcdbddcdcdadacabaabbcbaac	FALSE
baabbabcaacacdddbcabcbdbcb	FALSE
babcbbaddccdbabadaddcdbddd	FALSE
bacddabbbbbbbddbcdbaccabaa	FALSE
bbabccbbacacbcacbdcdaccbdc	FALSE
bbbcdadadacbbcadccbacbcbcb	FALSE
bbcdddbdacddacbbcaddcdddda	FALSE
bcaaddaaccacaccdbddaddbcdc	FALSE
bcbcadaabddbcaddaacbbdbaac	FALSE
bcccbdcbcccddabadddcabaada	FALSE
bcddbbbccbbcccbdddadbcccda	FALSE
bdadbdcbdacdadcaddbbaccddc	FALSE
bdcacdaddaddadadccdcdcbaac	FALSE
bddcbbbabdddbacbccbaabacaa	FALSE
caacdcadcbbadbcbcbaccbcbda	FALSE
cabdcbbbbdbdcbbccadcdadadc	FALSE
cadacacadcdccccbdcbacbbacd	FALSE
cbacbacbdcddcbadcbabdaccab	FALSE
cbbcbbdaacddabcbcadccddddd	FALSE
cbcccdbadbbadccaacdddccbac	FALSE
cbddcdabbaaaaaccccbdbbddcc	FALSE
ccbbccbdadbcbbccaddadacdab	FALSE
ccccbcbacccdbbbdbcbaabbacc	FALSE
cdaaaddcadddadcdddccccbbba	FALSE
cdbadbbcabdbcbdacabdacadad	FALSE
cdcadbbcadbbcbcbcaabbbdbbc	FALSE
cddbbcddcadbaaabcacacbacda	FALSE
daabdcccacbdcddaccdaabcbcd	FALSE
dabdbdcbabadabadabcdcdddda	FALSE
dadadacdaccdadacaccccbccaa	FALSE
dbabdaabbbcbddbbdcbbbdddbb	FALSE
dbbdbdcccbaccccbdcacbbacdb	FALSE
dbdabbabcdbccbdccabbdabdbb	FALSE
dcabbccccdbaccdccccddbbbad	FALSE
dcbccbdabddaaabadaddaddbbc	FALSE
dcdaabdbdbabcbbabacaadcbad	FALSE
ddaacccddbcaccbddaaabbaddd	FALSE
ddbbdccdbaaccadaabddddbadb	FALSE
ddcccdbbbaacbadbbcdccaabbd	FALSE
aaaaabccaababccdccdaababbc	TRUE
aababcababbcdacadcadccaaba	TRUE
aacadcbabcbdbbcdbababadadc	TRUE
aadbbcabaabdaddbccacacacda	TRUE
ababadbcdabbdddaabdccdcaab	TRUE
abadbbcbacbbabaccccddbacdd	TRUE
abcacddcababcbccaddcdccacd	TRUE
abdacbcdacdcadadcdbddabadb	TRUE
acabddbcddcdcddabadbbccbcd	TRUE
acbdabdaddbdacbcadbadacadd	TRUE
acdbcdaaabadbbddbcdcddbcbb	TRUE
adacbbdcaababddccddcddccbd	TRUE
adbbcdbcdbccbdbbcaabdabbdd	TRUE
adcccdbadbdbabdddaddddbbaa	TRUE
adddbcabdbccadbaabdabcbacb	TRUE
bababaabbbaddbdcbdbbaaaaaa	TRUE
bacaacacdcaabadbadaabddbcc	TRUE
badbddcdaabdabcbaabadccccc	TRUE
bbadbbbbcabbacbddababccdcd	TRUE
bbcbadbabadcacacdabbadcbdb	TRUE
bbdcdcbdbdbaabdadbdbcaaccb	TRUE
bcadcbddbbdccbaadddbdabcaa	TRUE
bccaccbabaacaccaacabadabab	TRUE
bcdcbddbdabdacbabcbaabddab	TRUE
bdadbcacaababacadcdadcdbca	TRUE
bdcaabababaadacbdbdabcdccc	TRUE
bddbcabddabcddcbbaabdaaccc	TRUE
caacacababbadbddbdcbacdcda	TRUE
cabcccbdbababbbdcaadcaaacd	TRUE
cacdbabcbadcbdbbbdacababcb	TRUE
cbaacbdbbddaababccadbddbda	TRUE
cbbcbcabddabdabddacbacddac	TRUE
cbdbaabaabbdcbdccadbdddaba	TRUE
ccabcadbddadbbdbbabaadcbad	TRUE
ccbdcbdbadbabdddccdadbdcaa	TRUE
ccdbaddabbddababdbadaabddd	TRUE
cdacdbbdddbcdacaaccbaadbab	TRUE
cdcbccdbdabdadddacaadbadba	TRUE
daaaabaabbbdcabacdabababbb	TRUE
dabbabaababbbbcbabdbadccdc	TRUE
dacdbdacbaacaaabaacbaabadb	TRUE
dbaabadddbbcccbcddcabbdcad	TRUE
dbbbdccbacabdccccbddcababb	TRUE
dbcdabdddabddacabbccdcccba	TRUE
dcaadbccbacccbbcddbdabadbc	TRUE
dcbbaacaaadbababbbbaadcddc	TRUE
dcccbdabccddabaddbcaadbcdb	TRUE
dcdddbaabcbababdbabcccdadb	TRUE
ddbadddcccaddabddcababccca	TRUE
ddcdabbbaacbabadbcbacdbbad	TRUE
aaaaaadcdaadcacbddccbdcbcab	FALSE
aabbaaddacabdcacaccaccdadad	FALSE
aacbbbddccbaabaaadbaaacbabb	FALSE
aadcbbdcaabcddbbbbbbaaacbdd	FALSE
abadddcabadacdcaccddadaadbb	FALSE
abbdcdacbdbacaaaabcccadadbd	FALSE
abdbcacbacccabbdbcaadaccbad	FALSE
acadbbdcdcddaadccdbadccdcac	FALSE
acbdcbcadddaddaddbbdbcadbdd	FALSE
acdbaddddcdccddcbbcbaccabba	FALSE
adacccdaabdaccbbaabbabcbacb	FALSE
adcaaccdcccaaacbddccdbacccc	FALSE
addaccbbaadadaaccabbbaabdad	FALSE
baaccccaddbbbcaccdacdabadad	FALSE
bacadddcdacabadcbabdacdcbaa	FALSE
baddadcdabcdcaccacbabaacdac	FALSE
bbadddbdadaaacacdacacbdbbca	FALSE
bbcaddcacddbadccbcbaddbdaca	FALSE
bbdbddadbbacccddacaabcccacc	FALSE
bcaddccdcabbadccbcbbabddcab	FALSE
bccbbbbcbbdaabbccdaccdaddbd	FALSE
bcdcdbaacabcacadddcacaadcdd	FALSE
bdadcdccdcabcaabbbadabcbcdc	FALSE
bdcbcdcacaaacaddaaccdaccabb	FALSE
bddcdcbdbcdcccdadbddbbbbbca	FALSE
caadbbcddbbdbbabbcacdadcdad	FALSE
cacadaccacaabccbbadbcdabbdb	FALSE
cadcacbbabcbbcdbaabcacbbacc	FALSE
cbacdcdabddbddbcdbabbbaacad	FALSE
cbcadadbcdadbbbddaacabbaacb	FALSE
cbdcbdbbacddddbdcbddbddcbaa	FALSE
ccbaddbcacbccacccdbdcbcaacb	FALSE
cccbbbdaddbbcbacccadccdacdb	FALSE
ccdcbdbdbdcdcddcbacadbbcdda	FALSE
cdadabcdabcccdcaccadaddcbcb	FALSE
cdcaadbdcdccdcccbcdacdbbcbd	FALSE
cddadcccdcacabaaadbadccaacc	FALSE
daabdcabccccdadabcdbdccdbba	FALSE
dabccdadbbadcccdbcadacbbdbd	FALSE
daccdddbaaabaccbccdccacabdd	FALSE
daddcabcabbccbdcdddcadcccaa	FALSE
dbaddbbdcdcdcdccabdbbcbbccd	FALSE
dbcaccadbdaccadbbacdcbbcdda	FALSE
dbdbadacbbcaadadbbaabcbadcb	FALSE
dcacadddbdbaccadbaaddcdddba	FALSE
dcbdccabbbaabbdacddbabbdcab	FALSE
dcdbabddbaabcbdabbcbaabdbca	FALSE
ddaccacaddaacccbcdcdaacdaaa	FALSE
ddbdcbbaabbddbcccbabdcbadad	FALSE
dddaacddcbcacbcaddadcddccca	FALSE
aaaaaacbacaaaccdcaadbadbcdc	TRUE
aababacbaddbadbdaabaaaddbba	TRUE
aabddabcddcbcdcbcaababdbaba	TRUE
aadbbaaaacacccbcadcbdabadbb	TRUE
ababadcbbcacacccabcadaccadb	TRUE
abadaaccadcaadbadbacddadbbc	TRUE
abbddabdadbdbccdddbbdbcdcbd	TRUE
abdabbbbaadcdcddaccddabbbbd	TRUE
acaadbdddddabbdaadbbbdacccd	TRUE
acbbcaadccaabdcbcbcaaaababb	TRUE
acdaacbdaababdbcabaacacbaca	TRUE
adabddabddcccaadcdcbbbddabd	TRUE
adbcbaddcdabcdababcccbabbba	TRUE
adcddbbadabdcdcabababbdbbac	TRUE
baababcbaabddcbccdcdbbabdcc	TRUE
babbacbabadbbabadaaabdbbadc	TRUE
baccccccdbdcadcaacbcbdababa	TRUE
bbaabaaacdaababcdcbbcacddac	TRUE
bbbabadcabccababddcbcddabbb	TRUE
bbcbdddbccbdcbabdbcdadddbab	TRUE
bbdcdcdbcbcbdabababdcbbddcb	TRUE
bcadbbbccacccababdaaacbdbdb	TRUE
bccbbadaabbcbcbbadbdabddcab	TRUE
bcdcddddaacbbaddbabcaacdccd	TRUE
bdaddddbaacadccbbcbcbababca	TRUE
bdccaaddbcdcbbcbcbacababcda	TRUE
bddddadaddadcbccdccdcbabadb	TRUE
cababbdbcdccdaabdbadacbbbab	TRUE
cabdddddddabbbaacddaadacdba	TRUE
cadbabdcddccccacddaccbdbaca	TRUE
cbacdabbcaababacbaacbcccdda	TRUE
cbbddddbdcabdabacacddbcdbdb	TRUE
cbdbadbcccaabbddaadbabbbcbc	TRUE
ccabbcabdddabdddcccadabbbcc	TRUE
ccbcdaabbaaacbddcababbdbddc	TRUE
ccdabdcddbadcbdbdddbbaddbab	TRUE
cdabdbdcaaabdabacdcdadbabdb	TRUE
cdbddadddddaababbbcdcdacbcc	TRUE
cddcaaadbdbbababaabacbcbcad	TRUE
daadcadbadbadcadbabdcbbbaaa	TRUE
dabccabdaadddacbbbaadcabadb	TRUE
dacddacccdababdddddacaacabd	TRUE
dbaaaabbacababcdcaabadcddcb	TRUE
dbbbdadbabddcdaacaabdbabdcd	TRUE
dbcdbdcdbadbddaddbcacbcddcd	TRUE
dcabdaddbddddadbaddddbdbbba	TRUE
dccaadddbdbcabddbadabcabadb	TRUE
dcdbdccaababdabadadaadbadad	TRUE
ddbaabcababacbacdcdbcadddbb	TRUE
ddcbdadbadbdddbbbdadaaaabdb	TRUE
aaaaaaadbbaaaadccbbaadbbcbbc	FALSE
aabbabcadddbbddcdcbcbdacbdcd	FALSE
aacbdbccbccaddccbcdcdaddaaca	FALSE
aadcdaadbcccccdaccacacddcdbd	FALSE
abbbcabcbbadccbcddcbbaadcbca	FALSE
abcbdbcabaacddbaaacdddbdcbbc	FALSE
abdcddbacdbcaddabbcbcddacdad	FALSE
acbabbacdcbadcbadbdbaacdbcac	FALSE
accbaaaabbacdbcdadcbddadacca	FALSE
acdcbcaacaddbadcacccabbadcba	FALSE
adaddaabcabcabdbccbabcbbdcaa	FALSE
adcbbdcccbccdcbcadccdcdabcab	FALSE
addbcbabdddbbdbadbccacddcddd	FALSE
baacdccbcbbcccbdbadcddbcbbbb	FALSE
bacaaadcaddcccdcbbbccbaddbdd	FALSE
bacddcdccaaacddaabcbdabdcacc	FALSE
bbaacbaddbdaadbcacabdcdbddbd	FALSE
bbbbbabcacccdacbadbdacadcada	FALSE
bbccbdbabcacddddadaaaccbbccd	FALSE
bbddbbadcdbaabccddbbbdcdbaab	FALSE
bcbaaddddcddbacdcddacbcccadc	FALSE
bccadcbbdddcbbadddabdbdacbda	FALSE
bcdcbabcdbcacccabcbaddadaaac	FALSE
bdaddaaadcaacccbdcbcbbadcabd	FALSE
bdcabdbabaaacacbdbabbcabadad	FALSE
bddcaabcbddaccccbddccbacdcac	FALSE
caadbcadabcddaadbcdaacbabddb	FALSE
cacbbcddcbcacdacbbbbbddadaba	FALSE
cadcadbcdadbcdbbdcdcbdabbdca	FALSE
cbbabadaaacdbbaabacbdbabccda	FALSE
cbcabcaacbbbbacdcddbdcbdccdd	FALSE
cbdcaacbdaabaaddaacdcbabddbb	FALSE
ccadcacbbdccaacabbcadabbdada	FALSE
cccabcbbdacccbdccdcccbacbaba	FALSE
ccdbdcacaacabdccbaddcccdbdba	FALSE
cdbaaadacbacccacddaacdbadddd	FALSE
cdcbccacabccadbbcacddbadddaa	FALSE
cddcbcbbdbacdbccadaddbccbdbc	FALSE
daaddadbacdbddbabcbaddccacdd	FALSE
dacbbcabcccdbbcbdbdacadbbdcc	FALSE
dadcccabadaccccdcdbccbbbabdc	FALSE
dbbabcccdcdcccaacbabdcbadbdb	FALSE
dbcadcaacccadcbaaaaabcddaddb	FALSE
dbdbdbdccdcccbbaacddadcbdaab	FALSE
dcadbcadddbaabccbdbcbdabbdda	FALSE
dccabddcdabbdbbbcbdbcabddcdb	FALSE
dcdbcbccdbbacbbcbcbcddcdbacb	FALSE
ddabcadcacaacbcbcdaaaabccabd	FALSE
ddbdaddadabcadaadaabccadcacb	FALSE
ddcddbcbcabacabccbadbccdbbdb	FALSE
aaaaabaabadadcabdadbbbababbd	TRUE
aababcdccdcbddddccdccbdabcdd	TRUE
aacbdddcdbdcdbbdcdcabddabcab	TRUE
aadcccbadcdaaaddabccbababdbb	TRUE
ababcbabaadcdbcacbcadbbbddba	TRUE
abadcabcddcababacccbacacaaad	TRUE
abcabcdddabdbcccacababbdbadc	TRUE
abdbaadcababcabdbabdccccdddb	TRUE
acabcbbbdbbadbabcaadbabdacac	TRUE
acbcccbbaabcdbabdbaababdacdd	TRUE
acdababdbbbbadabdcabcaaabdaa	TRUE
adabbdccadbabdccbacbccdaadcc	TRUE
adbbbdababbccadccbbbbccaccbb	TRUE
adcccaaaacddaddaaadbabbdacaa	TRUE
addddbaadaabadcaadddddddbaba	TRUE
bababccbcdababbadaccadccaddc	TRUE
bacabbacbaaccbbaddbcbababddc	TRUE
badbdbabadbbdadbdadbcbbddbcd	TRUE
bbadbabdcccddbdddddbdddbddcc	TRUE
bbcbbbdbaabdbcbababaccdbddcd	TRUE
bbddadbbcbacaabccbdabddabdab	TRUE
bcaddcdabaaadbabdbbcaabcbbdd	TRUE
bccbdbababbddbdaacabadbabbba	TRUE
bcdcccabbdccadacababbacaacbd	TRUE
bdadbadbdcbbbbacdcbdaaadcddb	TRUE
bdcacdabdbaaababbabaabdbdbbc	TRUE
bddbcaccbdacdbccbccdababcbba	TRUE
caabdcdaabccacaaaaadbdddabaa	TRUE
cabcaabcbbdbaadcddddccababbc	TRUE
cadaaaadbabaabacadccadcaaaab	TRUE
cbaabdcbcdccdaacaabdaddbcdbd	TRUE
cbbbccbacbabadbbcdddcbbcbdcd	TRUE
cbdabddadbabbbddaadcccadccdb	TRUE
ccabcddccbdacdccababdbcbacaa	TRUE
ccbcacdbbcdabadbddadadacdbcd	TRUE
cccdccdccbcbcbabadbabbbcabcb	TRUE
cdabcabaddbdadbdcbdcdacbccbb	TRUE
cdbddbcadbabcbdcadcacbbabadc	TRUE
cddbaacdbabaddddbdbddabacdcb	TRUE
daacababbccabbbaabbabbbcbbaa	TRUE
dabcabddadbacdcdbbaabaaccbcb	TRUE
dacdcacdaddcababdaddbbadcdaa	TRUE
dbabababcbadcbdddaddcadaabbc	TRUE
dbbcbdcaadabdabbcdcdadccabca	TRUE
dbdaabaccadaabdabbddbbdacdac	TRUE
dcabccbdadbbabcababdcbbabbbb	TRUE
dcbdabbdababdbaaaaaadbbdaccb	TRUE
dcdbbdbcaababbadccdcddbbaacc	TRUE
ddadbabddabcaacbdccbdddadbbc	TRUE
ddcbbababdcadabadcabcacabbdd	TRUE
aaaaabcaccdabbabaccbdadabcaac	FALSE
aabbdaadddaabdcadddaadcacdcad	FALSE
aacdadabddaccddbbcccdacadadba	FALSE
abaaaccadcbaadadcccbdadbcccba	FALSE
abbdabcbddaddacdcadbcddbdbaac	FALSE
abdaaacacacabdaacdbbadbdaccad	FALSE
acacabdbbbbaadcdcaadabccbbaca	FALSE
acbdbddbacbcabcabbaaddcaadadd	FALSE
acdaacbdbacdacdbddbbabaddabbc	FALSE
adabacbdbaaaccbcaaaacccdacdbb	FALSE
adbcdbcdbadacbcbbcddbcdabbbab	FALSE
adcdcdccadacdacccbacdbaadddbd	FALSE
baaabcdabcacaccdcadccbbbbadbd	FALSE
babbbddcdccbabbcbacaddacddbbb	FALSE
baccbdbdaddbccaaaadaaadbbbcdd	FALSE
baddaacacbacccbabacabaacacdca	FALSE
bbbaaccdddaddbdcdcbcbddcbaccd	FALSE
bbcbacabcdddddddcbaabcdcdabbd	FALSE
bbdcaccaaaccacbbcadcaaadadbdc	FALSE
bcadabccaacbbdbcddcdacdbbdbdd	FALSE
bcbdbddcbaddacaacadabdbabbdba	FALSE
bcdaadabddacbdcbcdacadbcacadd	FALSE
bdabbdacdbacadabbaaddddccdcbb	FALSE
bdbccddcbccabccdcbddcddcaacda	FALSE
bdcdcdacdaddacdadbcddcdabcbaa	FALSE
caaabccabaccabcdccdcbaadccadd	FALSE
cabbbbccdbdaadcdabcbacddbdcaa	FALSE
cacdaabbacadcabaaacaddabdbaad	FALSE
caddcbcadbdcbdacdabdbadbaccdb	FALSE
cbbbadcbabbccabbcdbcbbaaaabbc	FALSE
cbccaadadcddacbadabcdbccbdccd	FALSE
cbdcbcdcadcbabccdabbcaabdcbac	FALSE
ccadbbccbadccbdccbcacdadddbcb	FALSE
cccaaabcbadccdbbaadcadcbdcbca	FALSE
ccdaddccadbcadacbdcaadadbddcd	FALSE
cdacaccbdddabdadcadcdaacbdadb	FALSE
cdbdcbbccddbdacddaaaaaccaaaac	FALSE
cddbcbdcdacdbaaccddddcabaadca	FALSE
daadaccdaacbbcdbcaadadbbbdadc	FALSE
dacadaabcbccacacacaaabcdcdbcb	FALSE
dadcacbacbdadcdbbbaadcbbdcbca	FALSE
dbadcbcbbbdbaacccdaacdbccbdba	FALSE
dbcaadabaacaddcdcbbddcddbdaab	FALSE
dbdacbbabdacacbbcaadbbddcbbca	FALSE
dcacbcbccddccbaacdddddcbacbad	FALSE
dcbccaddabadcdcbbcaccdabbdbab	FALSE
dccdaacbbabaadcdabbabcaaaaabb	FALSE
ddaaadccaccdcdaadcadcaddcaddb	FALSE
ddbbdabcdbcabcbdbaccbcdbdadbc	FALSE
ddccccacbadcdadbbbdabadcaccbc	FALSE
aaaaaaaaaabdabdbdadadcddbacad	TRUE
aababbdcdcabacbdaddadabadcaaa	TRUE
aacbaabaabddbdadacccdbababdca	TRUE
aadccdbbdbbdbabdddbcababbbdbd	TRUE
ababbdbbadaadbbcdabcbadbadcaa	TRUE
abadccabdbdbcabdabaadcbdccaba	TRUE
abcabcbcdabadcabadbdcbcbccacb	TRUE
abdadbcaadcaddddcdacbcdccaccc	TRUE
acacabbbdbcbdcaccadbadababbac	TRUE
accaabadbbaaadaadcdaacbaccdaa	TRUE
acdcacabcbcdbdababbdbababaccc	TRUE
adadbcacdbdaacbabaddbbadacdbd	TRUE
adbdabaacbadcdbabcbccccbabbac	TRUE
addaaccbccddacacadbabdaaccaaa	TRUE
baabadaababbcdaccdacbabdabdbc	TRUE
babadbddbaddaabaacaddccddccba	TRUE
bacbaaadaaddbabddbcbdbadabcbb	TRUE
badbdccacdccdadddbbbaababadab	TRUE
bbbababdbdddbaabacbadbcadbbac	TRUE
bbccaaaadabddabbdacdbaabdcbaa	TRUE
bcaaabadaababbdaddcdabdacdbad	TRUE
bcbbcddabdabbdcccccbacbaabcdc	TRUE
bcdababbacddcbdcbcacbcaccdaba	TRUE
bdabbdccadccdaddadbbaaaddbadb	TRUE
bdbcadacbbcdacdcbbababbabbacd	TRUE
bddbacbdbcbabdaddbccbdaaadcdd	TRUE
caacbababacdddccbcadcdabbbbac	TRUE
cabddaababdccdddbdbacabbdddcc	TRUE
cadaaababacdbcbddabcbbadcadad	TRUE
cadddcabcabadcccdbadddacabadb	TRUE
cbbbaabbaabaaabddabbaaddbccaa	TRUE
cbcccaadbdbadadbbbdaabaddbaca	TRUE
ccaadbaadccabcdababdaccbbdbba	TRUE
ccbcccbbbbaaddbabbccbbbcbcbac	TRUE
ccdabddccdabadbcaadbcdcaddcdc	TRUE
cdabbcdccccaaddadccdbadbdabdd	TRUE
cdbccccccaaddbabcdadbddccdabd	TRUE
cdcdcaabababcdbcdcdacddbcdddb	TRUE
daabacababbbbadabdccdacbdabda	TRUE
dabadbaddcbabcdcabacabbbaaaab	TRUE
dacbcabcdaaababcbdbcdddabbadb	TRUE
daddbadacddaabaddddbabdbacbdb	TRUE
dbbbcdcacddadcbadbaabddabcdca	TRUE
dbcdcdcaadbdbdabcababaacbccba	TRUE
dcabbcabadbbacdccdcdbdbcbaaca	TRUE
dcbccdaadbabcacaadccdbbbbcadb	TRUE
dccdbdcccbbdababdcbbdacabdddb	TRUE
ddaacccccdabbbccdacacdababdaa	TRUE
ddbadbababdaaacacbcadabbcacad	TRUE
ddcccdcababddbbbbcadddcdbadcb	TRUE
