aaaaaabbacbcbdadbddb	TRUE
aabacaaaddabdbcdbcac	TRUE
aacbbcaccaadbddadbba	TRUE
aadcabcccacadaacbacc	TRUE
abaddcbcbdbdddbbbabc	TRUE
abcacabbaabcaaadaaab	TRUE
abdadbaadcbccabbcada	TRUE
acaacdbdbadcddacddcd	TRUE
acbbdccadbaadacddbaa	TRUE
accdcadbabcabddcccad	TRUE
adabbcbdaabdaddddcdc	TRUE
adbcdcddcabdadddcaab	TRUE
adcdddcaacddadbcacdb	TRUE
baabdcbbbbdcdabcabbb	TRUE
babdcabbcddcaccaacaa	TRUE
badbaccaddcbcbbcbdda	TRUE
bbacbbadbbbdcbabacab	TRUE
bbbdbbdbabbbdddccbca	TRUE
bbcddbbccadbbdcbcaaa	TRUE
bbdddbcdccacbdbddaab	TRUE
bcbbacbdccaadcaababa	TRUE
bcccbdccacddabbaadbd	TRUE
bcddacacbdcddacadbdc	TRUE
bdbaacbbbabccadcadaa	TRUE
bdcbaadbdadbdbdabadc	TRUE
bddcbbddcdacbcbaabcc	TRUE
caadbddbbcdbaddabbcd	TRUE
cacbaccaaaadabcadada	TRUE
cadcaddbabcaccaccbaa	TRUE
cbaccbbabcdabccddbbd	TRUE
cbbdbbaaaaacdbdcbacd	TRUE
cbdacbdacacddaacabdb	TRUE
ccabbacccbbbdadcabaa	TRUE
ccbdacbddabaaabcdacb	TRUE
ccdabacabdadcaccbbcd	TRUE
cdabcbcbabbcddadcada	TRUE
cdbccacbcaddccdccdcd	TRUE
cddaaabbcbccadcadcdb	TRUE
daabacccdaabcaadccaa	TRUE
dabbdaaabcbdaadbbaab	TRUE
dacdaabccdcadddaacdc	TRUE
dbaaccddddcabccaaaac	TRUE
dbbbddddbabaadbdbcdc	TRUE
dbccdddaabacaacbbabd	TRUE
dcaaabbadadaccbabcba	TRUE
dcbbabccdadcbdbdcaaa	TRUE
dcccbabdcacadbdcbaca	TRUE
ddaabcddabcabadabdcd	TRUE
ddbbabbddddbdacdcdcb	TRUE
ddccddbbaaddadacdcdb	TRUE
aaaaacbdbdabbabdadba	FALSE
aabababccdbaaacabcac	FALSE
aacaababdabacbbcbbbd	FALSE
aadbabdadbdacadaaddd	FALSE
abababccaddabdcbbdcc	FALSE
abadbabaccbbacabaacb	FALSE
abbcdccaaaddacbababa	FALSE
abdababbcdbdcaddcadb	FALSE
abddaddaadacacababab	FALSE
acbbadbabaddadbbdcdb	FALSE
acdaccdbadbabdaaadcb	FALSE
adabcaadbddabdabcbad	FALSE
adbbbdcaabdababddacd	FALSE
addaadbabcdbbdbababa	FALSE
baabdddbbababacccabc	FALSE
bababadaaddacbcbaddd	FALSE
babdabdaadaacbbccdad	FALSE
bacddbababddaddbaaaa	FALSE
bbaaacbababaabbdcccc	FALSE
bbaddcccbbdbadbabdaa	FALSE
bbcbccbcbdaababadbdb	FALSE
bbddaadbbbababadaaaa	FALSE
bcbababadbdddccbbaab	FALSE
bccbdbbbcadbadbadbba	FALSE
bdaabababadcdbcacdbb	FALSE
bdaddbaddddbdacdbcdc	FALSE
bdcbabddabacabaabddc	FALSE
bdddababacdbcaacdcda	FALSE
cabababbcbdcabccbddb	FALSE
cacadddbababddbcbaad	FALSE
caddacaabbabadbaaadd	FALSE
cbacdcdcadbababdcdcb	FALSE
cbcaccbcaaaddbadbabd	FALSE
cbdcbcbadbababdbabbb	FALSE
ccbadbabdababbaadaca	FALSE
cccdbababdaadcdacdcc	FALSE
cdabaaaddcbbadbdabac	FALSE
cdbbccabadbabbdcbaab	FALSE
cddababadbbbbaabacaa	FALSE
daabcbdababaaadcbbab	FALSE
dabbbbbabdabdacdccab	FALSE
dacddabddcccadbdabab	FALSE
dbababacaabddcbcadad	FALSE
dbbaddbabaaaaccbdbad	FALSE
dbdaaccdcbcbabdabaad	FALSE
dcabcbcdaccabaddbabb	FALSE
dcbcddababdabbdcbcba	FALSE
dcdaacababdabbcbdacc	FALSE
ddacababadbccbbcbaad	FALSE
ddcadabababdbacacabb	FALSE
aaaaaacdaddbacbccdacd	TRUE
aabaabadbdadacadcdaad	TRUE
aacbdccdaabccadcbdcbb	TRUE
aaddabcdadcaccabdbccb	TRUE
abbaacbbdbddcdccaaaca	TRUE
abcbcbcdbddcddacacacc	TRUE
abdcabcbaacabacdcbcdd	TRUE
acadabcacddcdaccdbbcb	TRUE
accaaddacdcabccbabbbb	TRUE
acdbcbbdcdddccdccbbcd	TRUE
adacdaccaddbacddbccba	TRUE
adcacbcbdbcdbbdcdccdc	TRUE
addbdacaaababdcdbaccd	TRUE
baacccbcadacdbbcaacdb	TRUE
babddddcddccacbcabdab	TRUE
badbcbbabcddbabbddcbc	TRUE
bbabcddabdabaacbadcda	TRUE
bbbcddcddbccccbdabddc	TRUE
bbcdcadabdbdcdaccdbca	TRUE
bcaacaaadccbcbbcaabac	TRUE
bcbbbddcdaaadcdcbcaab	TRUE
bcccbabcccbccccbdbbdd	TRUE
bcddbdbcdbcabdcbacdba	TRUE
bdbaccaadddbabcdbaacc	TRUE
bdcacaddccabdbbddabdc	TRUE
bddbaaaabaabaccadbaad	TRUE
caacaaaadbcbccdcdadbc	TRUE
cabccbbdcdcdacdbaabab	TRUE
cacddcccdcacdcbaccacc	TRUE
cbabadbccadaadcaadcac	TRUE
cbbcacaaccadccbbccdcb	TRUE
cbccdcaadccbbddddcbbc	TRUE
ccaabccdbdaabbbbabdab	TRUE
ccbbdccccdaccbcbcbddc	TRUE
ccccbdbdbbdabcdbcaabb	TRUE
ccdcddcbaccaccbcaadda	TRUE
cdbbabbaacabaaabddcbb	TRUE
cdcbddbccdbbcdcabbcdd	TRUE
daaabbcdaabaaccdccbba	TRUE
dabbaaabaacddaaddcbbd	TRUE
daccbdccacdcbabcdcabd	TRUE
dbaacbaaadbbcbabdaaac	TRUE
dbbbbaacdcadbdccdbdad	TRUE
dbccacbabdddbaaabcdba	TRUE
dcaaabbaabacdcaabacaa	TRUE
dcbbbacdcbcadcbadaaab	TRUE
dccdcadaacddadddbcbdc	TRUE
ddaaccabbccabbbcbcbcd	TRUE
ddbbbddaccbbddddbdaaa	TRUE
ddcbdddacddaccbadaabc	TRUE
aaaaaaddacdccdabadbab	FALSE
aababdaddbcdbddbbcdbc	FALSE
aacbdadabaaccaababadb	FALSE
aadddcacdaacababababd	FALSE
ababadbddadbcadacadba	FALSE
abbaacacccdcadcbababa	FALSE
abccbaabababcbbabacba	FALSE
abddabdadbccaccdbddcd	FALSE
acaddddaddbdddababdac	FALSE
accbbdadbadbadbbdbccc	FALSE
adaabdaaadbdababdabac	FALSE
adbacacadbdabdabdbbcb	FALSE
adcbabdababdccdbaccda	FALSE
addcdcaddcbadbababaac	FALSE
bababaabaaccbbacabaac	FALSE
babadcbababacdcdabbcc	FALSE
bacadcadddabadbdabaaa	FALSE
badbdaabadbabddbabacb	FALSE
bbabdabacdbcaaabdcdbc	FALSE
bbbcddaccbccadbadbabd	FALSE
bbdababadccddccabdabb	FALSE
bcababaddbcadbadadbcd	FALSE
bcbdaabaaacaddbababcc	FALSE
bcdbbabdabadacaadaada	FALSE
bdabadddbacbbddbacaaa	FALSE
bdbbcbdbccbabadbaddbc	FALSE
bdcdacaddbbbababadabc	FALSE
caaadabbababaacaddcdd	FALSE
cababdabdcbdabdcadaca	FALSE
caccabababbbbbbbcbcbd	FALSE
cbaabababbccbaaaaaadc	FALSE
cbaddbbadbabacbddabad	FALSE
cbccabadbdabcaadcdbbb	FALSE
ccabaabababbddaddcdad	FALSE
ccbcbadbabddadcabdabd	FALSE
ccdaadbbabaddbaababbc	FALSE
cdaccbbdcdaaababdabab	FALSE
cdbdcbcbaabbcdabababa	FALSE
cddbabadbadcdddbbcabb	FALSE
dabababaadbabbbdccccb	FALSE
dacaacaadbbabadbababb	FALSE
dadbbacdabadbbababada	FALSE
dbabdabaaaadadbdadbbc	FALSE
dbbcbddababacabaacabd	FALSE
dbcdddadabababcabcaba	FALSE
dcacacbadbabababacadb	FALSE
dccabbdadcdcbbcbababa	FALSE
dcddababdabbbdaccdcba	FALSE
ddbabdadbdacaadaacbda	FALSE
ddcbcbbababaddbdddabd	FALSE
aaaaabdadddadbbbbdbbda	TRUE
aabbcbaabaddccdbcabaad	TRUE
aaccdadddbacbddcccacbb	TRUE
aadddbdbaaabbccbaccdcd	TRUE
abbacbaaadbbbcbddcdbab	TRUE
abcccccbcdddaddcbcaadb	TRUE
acaaaccdbdccccacbdcdcd	TRUE
acbbbdbbddaacdbdbdacdd	TRUE
accdaacbbacbbadcbbcdcb	TRUE
acdddcbcacaadaadddcabb	TRUE
adbacbbbcdadccddabbddb	TRUE
adcbdadbacadbccccaabca	TRUE
addbcbaddadbcabcbacaaa	TRUE
baacbbddcdbbabcadcdaba	TRUE
bacabbabadabbaadbaadba	TRUE
badbccccadaacadddccdda	TRUE
bbadcbddacdbbbbddaabdb	TRUE
bbcaaadcaaabcbdbcdbacb	TRUE
bbdadcaacbccbadacdbbbb	TRUE
bcaccacdbcdcdbbcdbdada	TRUE
bcbddbdccacbcddddaacca	TRUE
bcdaddacccbbccaddabacb	TRUE
bdacaadbbdacdbbccddaac	TRUE
bdbdccddadcbcaadbdccab	TRUE
bddababcabddadbbcbbccd	TRUE
caabdbacabbcdbadacccbb	TRUE
cabcdcabdcaabcdbdbdcbc	TRUE
cadaacbbbadaaccbdaaddb	TRUE
cbabccdbdbabddaabacccc	TRUE
cbbdaabcbabddabcacdcad	TRUE
cbdaaabcbdddbdaabcdaaa	TRUE
ccaacdaacbbccabbacabab	TRUE
ccbcbbbadcaaaaaacabcbb	TRUE
cccdbdacacbdbdabbbbddd	TRUE
cdaabadddbccaabbcccbdc	TRUE
cdbbcacddcadcabbaddadb	TRUE
cdccdbbacaacbcdbbaabcc	TRUE
cddddadacdddabbdbdbbcb	TRUE
dabacdbcdaabcadbdbdbdc	TRUE
dacbbaabbaaaddbdbcadab	TRUE
dadcbabccbcbcddacacbbb	TRUE
dbadcbacbdcdbcdcdacaad	TRUE
dbcaaadcaacbadddbddbab	TRUE
dbdaccdacdbbdddbbdbdbc	TRUE
dcabbbdbcdbdcbcdddccba	TRUE
dcbcbaacaccbadbbdbbcad	TRUE
dcccdcccbdcdcaacdbdddb	TRUE
ddaacaddaccdddddbcbabb	TRUE
ddbcccbddacabddadbdbca	TRUE
ddcdbcbcdcadbcbbddddbc	TRUE
aaaaabaddacabdddababcb	FALSE
aababdabaadbacbadadcad	FALSE
aacbbbbdaacaabdababdaa	FALSE
aadccadbbadbdabddabbdb	FALSE
ababadbabccdccacbcacca	FALSE
abadccbaabababacbbcada	FALSE
abcaddbabdaddbabbbcbaa	FALSE
abdbcadcdcababdababaca	FALSE
acacdabdaddacadbaddbab	FALSE
accaadcaabccdbababdacd	FALSE
acdbcacbaabababddbacbc	FALSE
adaddcabababaccbcaabba	FALSE
adbdcacabbddabdabacdbd	FALSE
addadbdabdabcdcdccbccb	FALSE
baabcccbccadbdaddbabcd	FALSE
bababdabbabbaacdccacdd	FALSE
babddaddbabbbdaaccaaaa	FALSE
badbabaacaaddddcaddabb	FALSE
bbababdacbaaababdaccba	FALSE
bbbcbcadbadbabcaabcbaa	FALSE
bbdabadbdbdcaabababbca	FALSE
bcacaaddcbccbdabdadbab	FALSE
bccadaaababcccbababaac	FALSE
bcdcbcbaaaddaabababdba	FALSE
bdadbabacdadbbbbdabadc	FALSE
bdcabbdcbabadbacdadadc	FALSE
bddcbbddabdababcaddbbc	FALSE
cabababbacdbbbbbadbcba	FALSE
cacaaccabdababaccdaacb	FALSE
cadbcbcadbaddbabbdadca	FALSE
cbacbdadabbabdabacacac	FALSE
cbbdbdcadaadbadbdabcad	FALSE
cbdbaaaaadbacacadbabab	FALSE
ccacaadddccddcababdadb	FALSE
cccabcdddcdadbdababacc	FALSE
ccdcdbabcbcabbadbabaca	FALSE
cdbabbabddaddbdabaaaac	FALSE
cdcdcdcbdddababdadcccb	FALSE
daabaddbadbadadbadbadb	FALSE
dabadabababadaadadbabd	FALSE
dacbaddbababcbadabccac	FALSE
dadcababadbbccaabcbbac	FALSE
dbacccbbcadbababbacabc	FALSE
dbcacdcaacabaddbadbbaa	FALSE
dbdcdadcbababaadccaaac	FALSE
dcbaadbabdddabadacaaab	FALSE
dccbbddadbadbabaadddda	FALSE
ddaacdcdbabdabadcdadcd	FALSE
ddbbadbcbdcababdababdc	FALSE
ddccbccbcbababdaaaaacb	FALSE
aaaaaaacdcaaadbdcddbabc	TRUE
aabbaabacacbccaacddcbba	TRUE
aacbddbccdacdaadcccaadd	TRUE
aaddcacddadabdccaaabadd	TRUE
abbbacaddadddcbbcabaaaa	TRUE
abcbccdbcccabadadbddcba	TRUE
abddcddccacdbdcdacbacbb	TRUE
acbabccdbdbdcdadabdccaa	TRUE
acccaaaaacbcdbccdcdddaa	TRUE
acddaacbbddbcbcbcbcbccb	TRUE
adbabcacacdccacbdcbabcd	TRUE
adcbddbcadbbbbbbbccbdcd	TRUE
addccacbcccdddbbcdcdaaa	TRUE
baacdddbdccdabcbccbbbbb	TRUE
babddbbadbadddadccaddbc	TRUE
badbabbabdbdadbcadabaaa	TRUE
bbacbbcdcacccbbcadccbcc	TRUE
bbcaabbdbbdacabaacdabdb	TRUE
bbdadadbddcbddcaaddcbcb	TRUE
bcacbcdcbddcbdabadbcbba	TRUE
bcbcdbdcdcbaccdbdccadbc	TRUE
bcdabacccbbacccabdbaada	TRUE
bdabcccbcddaaaaccaadcba	TRUE
bdbcdadbcbadaacdadcbdda	TRUE
bdcdcdabadbbdaccbababbb	TRUE
caabbddcbcbdbddcdacbbdd	TRUE
cabcdadcdbadaccbbcbadcc	TRUE
caccddcaaadbdbaaaaacabb	TRUE
cbaabadaacdcabccccbdabb	TRUE
cbbbbaacbdaadccbdcddbab	TRUE
cbcbdcdddbbaddbcbaadbcc	TRUE
cbddcdadcdbbaabdadcdbad	TRUE
ccbadbdadddbbbcbabaddca	TRUE
cccacbacadacbbcdabdbcbb	TRUE
ccdadbbacdbaadadcddcacd	TRUE
cdacbbbdbccaddcabdbaccb	TRUE
cdcacdadadaddbaabbccdab	TRUE
cddbbccbdbcbccddababbcc	TRUE
daaccaddabccadbdaabaaac	TRUE
dacacacaccacadadbbdbdca	TRUE
dadadbcbbacaaaccbbbcaab	TRUE
dbabaddaadaaacdadabacca	TRUE
dbbcdbaadbbcbabdcbaacbc	TRUE
dbcdcdddbcbcdcbcadbbdbd	TRUE
dcabbbababcdbbacbdadcbb	TRUE
dcbdbbadcdaacbbbcaaabab	TRUE
dccdddcdacacacacabdacdd	TRUE
ddaacaddccdadcddddabaab	TRUE
ddbbacccddccadaccccddaa	TRUE
ddcdaddbdcccbbbbbbaabbb	TRUE
aaaaabadbaddbdddcdbdcbb	FALSE
aababddaaaccddabababbda	FALSE
aacbcaddbbababadbdcadcc	FALSE
aaddadbdababaadbcbadaba	FALSE
ababadbcdcdbdbcddbaacda	FALSE
abbabdabaadaaabcaddddca	FALSE
abcbdaccddacabababddabd	FALSE
abddabadbbdccabacbdbbca	FALSE
acbadabcaaabcbbdabababa	FALSE
acccbadcdcbababdaddbadb	FALSE
acdddcccaabdabdabbcbaaa	FALSE
adbadbabccdbdbccdaadbca	FALSE
adcbbcdbabddabadaddaccd	FALSE
adddcbabadbaddacbddbbad	FALSE
bababaacaddadbabbcccbdb	FALSE
babcdbaddcdbbddababacba	FALSE
bacddddcbcbcacdbabababa	FALSE
bbaaababadbabbaddccaaab	FALSE
bbaddcaacacbbbddbababac	FALSE
bbcabbbbabbdaddbabadbba	FALSE
bbdbababadbddadbbcdbcbd	FALSE
bcbaaccaadbbdababdaaaca	FALSE
bcccbacaadabdddadbababa	FALSE
bdaaadcabdabdddabdddaca	FALSE
bdaddbdabdaaacccbbdadad	FALSE
bdcbaabcdadabdddaddbadb	FALSE
bddcbabacabccabadbabcdc	FALSE
caadddacbdbabbdabadbada	FALSE
cabddabadbababccdcdbcdb	FALSE
cadbdabdaddbbcbcaadaada	FALSE
cbacaabababdddacbbdbaac	FALSE
cbbddbbabbababaccbdcaab	FALSE
cbdbdccbcbaddbdadbabcda	FALSE
ccaddcbacbabbabadbabdca	FALSE
cccacbcbbccbddaadbababb	FALSE
ccdbbcbabcdadcabadbddab	FALSE
cdadbacdaadbdadbdabbbdd	FALSE
cdcacbbbdccadacabadbdab	FALSE
cdddcbcbababacbcbbadbcd	FALSE
dababdddabcccacdbabaacd	FALSE
dacbdaabadbabaaccabdcbd	FALSE
daddbdabdabdadbbabddaaa	FALSE
dbadbabaddccbaddccdabbc	FALSE
dbcacbaacbbcbdbbababacb	FALSE
dbdbdbbbabbcdabbadbdaba	FALSE
dcaddbdababccaaccadbbdb	FALSE
dccbcdababdadbaadcadbbb	FALSE
dcddccccdbaaabababcadbc	FALSE
ddbaaadddddbcbabdabadad	FALSE
ddcbadbddabaaddccdadaba	FALSE
aaaaadaacacaadbddcbcbcda	TRUE
aabbbbadaccabdbacddabdad	TRUE
aaccbcbdabcddadbaaddddbb	TRUE
aaddddcddbadabbccabaccdc	TRUE
abbbabcddacddbccbaaaabab	TRUE
abccaacbbbbaacdcabddcdbd	TRUE
abddcdcddbbabaaccccbadbb	TRUE
acbadabcdcdacbdbcadccdcb	TRUE
accdabcccddacccbbcddcabd	TRUE
acddaccacccaadabacabccdb	TRUE
adaddcaccacbdadbdbbddbab	TRUE
adcadadadaabadbbcbadbbdb	TRUE
addcbadcdbdbaadcaaacbcab	TRUE
baadbdcdababbcccbbbbacdb	TRUE
bacaccbcaababaaacabdbdaa	TRUE
badbabbdcbdcadcaabbdadcc	TRUE
bbabcccbdbcacdaaacbccbbb	TRUE
bbbccdacccadadbbadcbdbdd	TRUE
bbcdcadaacbdacbccdcddcbc	TRUE
bcabbbcaadddbacacaaaacac	TRUE
bcbdcabdaddcacccaacbcbdc	TRUE
bcdaacbbdbdbbcbacbabbcac	TRUE
bdabbbabdcccdadcbcdadaba	TRUE
bdbccbbddababcdbcaabacdc	TRUE
bdcdddcccabddccbbabcbcdb	TRUE
caabcbcbbdccbdcbdcbaabab	TRUE
cabdabdbacbccaacdbcdaabc	TRUE
cacdccbddbacdccaaacbccbd	TRUE
cbaacddadabdbbbcbabaccdb	TRUE
cbbbcaddaacacdcccacddadd	TRUE
cbccabcabccdcababaabacbd	TRUE
ccaaacbabdadcccbaddddbbd	TRUE
ccbbbdccdbbcbdcadcabbbbb	TRUE
ccccbbccbbcaccacbaabbbaa	TRUE
ccdddbbabbdbadcbadbbabcc	TRUE
cdbacddddbbcdaacaabbddab	TRUE
cdcbdcadaacadddddcadabbd	TRUE
cdddbbaddbbbacbbacabbcdb	TRUE
dabaaaaabcdcabccccbddddd	TRUE
daccaabdbbcdaacaaacbcdaa	TRUE
daddbacbbccacdbbdbbbccbc	TRUE
dbaddcddbbddcdadcabdbddb	TRUE
dbcbdadcdcccdabcaacdadbc	TRUE
dbddacaabdcbccdcadabbdda	TRUE
dcaddbbabdddacbddbdcdcdb	TRUE
dccabaababadabadaccaaacc	TRUE
dcdacddbdbccbacddaadadcd	TRUE
ddabbbbbacadbdcaadbcdaca	TRUE
ddbcabaadadbcaacadacadcd	TRUE
ddcdabbadaabdbcbbdaabaca	TRUE
aaaaaabcbabddadbdaaccdda	FALSE
aabadaaaccdccbdababacdcc	FALSE
aacdaddbdabddadbaabcddac	FALSE
abaacaaadabdadbaddbcbbab	FALSE
ababddabbacbcacdcbdccdcc	FALSE
abbbccacaddbdbcdabababcc	FALSE
abdabababbbabbadbbbabbdc	FALSE
abddcbdddccddcdadabababa	FALSE
acbadcdcdcbadbadbacbbbdb	FALSE
accccdaabadbabdacbdbbdca	FALSE
adabababbacdaabcacdddacc	FALSE
adbadddbabadaacdbbcbdbcc	FALSE
adccdabbdaddbdabdacccabd	FALSE
baababddadbdbddcadddadcd	FALSE
bababadadacbccdddddccbcb	FALSE
babdabaabbadcbcbbabbdbba	FALSE
baccdacbddabdabaabddddbc	FALSE
baddacacbdcaacddbabdabaa	FALSE
bbadccbbbadbabaccaabaacb	FALSE
bbcabaddcdadabababccacac	FALSE
bbdbbcbaabdabdabbdcacaac	FALSE
bcaccbadbdbadbabadabcacc	FALSE
bccadbadbdadcacabababddb	FALSE
bcddbbdadbabaccdbbcdcbcb	FALSE
bdadaabababdaabbbccbdabc	FALSE
bdbdddabbbcadacdbdabadba	FALSE
bddbbdabdabdddaacccbdcbd	FALSE
caadbddababcddbccbdbccbc	FALSE
cacaccdbbdbdabaabddabadb	FALSE
cadbdddabadbcaaaadacbddb	FALSE
cbacbddbcaacbababadaddcd	FALSE
cbbcdcabadbabdbabddabccd	FALSE
cbdabdabdaddbcadabaddbca	FALSE
ccabcdcddbcdadbdabddabbb	FALSE
ccbcbbdccbbcabddabdadbaa	FALSE
ccdbbccbdadbdabacbcdddbb	FALSE
cdadaadadabdababacadacad	FALSE
cdcbcabdadddbababbbacaac	FALSE
cdddabbdadbddabdaabdccaa	FALSE
daaddabbaaadbdabddabdacd	FALSE
dacaacdacdababbdadbabacc	FALSE
dadbdababaabdabaddcabbaa	FALSE
dbadabababadcacadadcbada	FALSE
dbbdadcacbbabababdbdddcd	FALSE
dbdbdadbababdddbdcabadba	FALSE
dcadabdabadbcacacdbdadaa	FALSE
dccaabababbdcabcabaadacb	FALSE
dcdcbdbbddaddcdbabddabaa	FALSE
ddadcbbaabadbdadbccdcbbb	FALSE
ddcbbccbaadbdaabddababba	FALSE
aaaaaacbaaddacccaabbccdda	TRUE
aabbbcadcaddaaabbcbbacaab	TRUE
aacdaccbbadbadbbccdddcddc	TRUE
abaaacdcaaadcdbadaaccddab	TRUE
abbbdabcaacacccdcbbccdbbb	TRUE
abccccbcadbddcddcdcbdbcbb	TRUE
abddbdaaccbbcabdcdabcdbbd	TRUE
acadbccccdacbcccdbaadccdb	TRUE
accbacddcddacdccbcbbdcacb	TRUE
acddcdbbdbadddbbadccbcbac	TRUE
adbaddadaaaaacdaabbbcacba	TRUE
adcbcabaccaabdbbcdddbcdcc	TRUE
addcccdbbcdbddbaaddbdcdaa	TRUE
baadccddbdacdcdbdbcadcabb	TRUE
bacbacddddbdcbabdaaaaccca	TRUE
badbcdbbaacbdbcadcbbccccb	TRUE
bbacbdabcdaabbbbbcdbaaadd	TRUE
bbbdaaccdcbdcdcbdcddcadba	TRUE
bbdaaaccbddbbdbbdaacacdcb	TRUE
bcababdcadcdacbabcdbdbadd	TRUE
bcbcbaccddbacbdabbaaacaca	TRUE
bcccdbbbbdcaabbdbcdadbddb	TRUE
bcddbabacbadadcacadcaacdb	TRUE
bdbaccaacacacdbaacdbdbbba	TRUE
bdccbbaaadbcbdbbcbadbabbc	TRUE
bdddbacccbabccdbbcaabadab	TRUE
caaddbbdabcaadcccbddaaaba	TRUE
cacbbaacdddbadccbabaaddcc	TRUE
cadbbadabbccdbddabcbbbcaa	TRUE
cbacabbccbbdddcaacaaabbbd	TRUE
cbbdcabbaacdaddbabcaaaada	TRUE
cbdacacadabbbddcbbcacdacb	TRUE
ccabddbcacabdbcdbbaaccdcd	TRUE
ccbddbcadadccbdabdccaadba	TRUE
ccdbaacbdcdbddcdbbdcdaacb	TRUE
cdaccadccdbccaaaabdaaccbd	TRUE
cdbddcaaadacaadddddcbcdab	TRUE
cddbbdabcadccbaabadddbbdb	TRUE
daacdbdbcbdbdbcadacdddacc	TRUE
dabddaadbbdbccbdddcaccdcb	TRUE
dadbcabacdadbbbabbdacadab	TRUE
dbabdaddbcbababcadbabacaa	TRUE
dbbcdccbadacdccbacbbcccaa	TRUE
dbdadaddababdcbdaabddbccb	TRUE
dcabddccdcddaaacdcabcaadb	TRUE
dcbdacdaaaccddacccbbadbad	TRUE
dcdacdbccacbdddbadbdbaddd	TRUE
ddaadaddaadabcabbabaabcbd	TRUE
ddbbddbcabadccdcdaccbadcc	TRUE
ddcdbabbbbcddcadddcbccbbb	TRUE
aaaaaaabdabdabbbbccbbdadb	FALSE
aabadbabaccccadbaacbdccaa	FALSE
aaccabcccadabdababdcdccad	FALSE
aadcddddadaadabdcabababab	FALSE
ababdadbcacbadbacccbaaabb	FALSE
abbadbdabadaaadaadcaddcab	FALSE
abccdbabbbcadbdaddbabcddb	FALSE
abdddbbcbcaadbadbabdaaabd	FALSE
acbadcdcbcdcbaaabbabdabaa	FALSE
acccbddaabcdabdbbcabababb	FALSE
adaabbababaacbdbacbaacacd	FALSE
adbabddddabbdaacdbababcdc	FALSE
adcbdabababbbcacbdddbdaab	FALSE
adddacbdbbdababaccadaccaa	FALSE
baadcbbccaddadabababbabad	FALSE
babaddbdabbbdcabadbacbaca	FALSE
bacadcdadacdadabdababdbaa	FALSE
badbdaddbabbddcadbcaaabca	FALSE
bbabdcbbbababaadabdabaabd	FALSE
bbbcccdbabdabadbaddbcdadb	FALSE
bbdbababadbdbdbdbdbcabbda	FALSE
bcabddababacccacaabdbcbaa	FALSE
bcbdccdbbccbabababbcddbac	FALSE
bcdacdbdbadbadbcabababddb	FALSE
bdabdbdabababdadcbaabdbcd	FALSE
bdbcdcbdbbbbbbababaddbadc	FALSE
bddbcbdcbcbdabadbdaddbdbc	FALSE
caadbabdddabbdbbaabaddcbb	FALSE
cabdababadacbcdbacbaddcad	FALSE
cadacbcabababababdccddbbc	FALSE
cbababcbdbcdcbadbdabacabb	FALSE
cbbbdbcdabababbabdbcbaccb	FALSE
cbdaacccbdbcdaabdababcdad	FALSE
ccababdadbcbabbbddabccbcd	FALSE
ccbcdacbcbabadbaaacbbdabd	FALSE
ccdbaabaabdbccabbabadbada	FALSE
cdacaacadbaadabababbdbcdc	FALSE
cdcaddaaddbccadabbababdab	FALSE
cdddabababaccbcdbcbcadbca	FALSE
dabababdcaababcbdbabbdabc	FALSE
dacbababdddabacddabaacdcc	FALSE
daddaaabababbadbccdbaccdc	FALSE
dbadbabaaabdacdcdcdabaaaa	FALSE
dbcaacbacbabababaddbbbcad	FALSE
dbdcacdbccacabababbbabdcc	FALSE
dcbaabccaadaababadbbadaac	FALSE
dccbcdbbababaadacdbbbbcdb	FALSE
dcddddaabadbadbcbddaccbbd	FALSE
ddbacddacabbbcabababccbac	FALSE
ddccddacbaddaabbdccbababa	FALSE
aaaaaaddcacdbddcacabcabbbc	TRUE
aabacbdbcdcdcdbabaadabcabc	TRUE
aacccaaddcdcbddbbdbbadcbcd	TRUE
abaaadadcdabcbbcdcabbddcab	TRUE
abbbabbdcbaaaddccabaaaacca	TRUE
abcbdbcbbacccdbcbcaacbabbc	TRUE
abddbcdaabbadadbddbdddcbcb	TRUE
acbabcbbcdcbdbabbbdccdcddd	TRUE
accbcddcdaaaaadadbddaadacb	TRUE
acdcaaadcdabdcacaaddacbbda	TRUE
adacdcbacacaadcccabcbadbcd	TRUE
adbdcbaaabaaabdacdcbddaaac	TRUE
addabbcbcddabbabaadbbcbcca	TRUE
baabdbcdaaadacdaaacbadbabd	TRUE
babcddabdbdadbcadacccbdacb	TRUE
badaadccaacaccdccddcccabcb	TRUE
bbababbcbccdbacdadaacdcacd	TRUE
bbbadddcadcadddddbdbbbdcac	TRUE
bbcbcadcacdbababcdcdaaadbb	TRUE
bbdcdbaddbaccadaddcacaabcb	TRUE
bcbaacdaaacabbbbadbcbcadbb	TRUE
bccbccaababcaddaccccddbabc	TRUE
bcdcdbcbccbabdcdcccbdbdada	TRUE
bdadabcaacbcabcacdccaaacbd	TRUE
bdbdaabddbbcbbbacbdccbacac	TRUE
bddabbcaabbcdddcbbbcadbaac	TRUE
caacaaaacdabdccdbacbdddcba	TRUE
cabdaddaaaddcaddbdaacbdcac	TRUE
cadaabddabcdbccadbbcacbbac	TRUE
cbabcacbbddabaaacddcdbdccb	TRUE
cbbccddcdaadddcbbbcdacbcad	TRUE
cbcdcdddbcdcbcccdcbacbdabd	TRUE
ccabaddbcbcccdbbcabbcbabdc	TRUE
ccbbdbdcccdccacdddddbabcbd	TRUE
cccdabacaaaabdacdbadbbcada	TRUE
cdaaaacbcaccddadbddaaabdda	TRUE
cdbaddabcaddabbbbdddcacbcd	TRUE
cdccadbbcbcbacadaababcdbaa	TRUE
daaacdbccdadabdcbacdacabda	TRUE
dabbaccbcbddcdcdbdccdcbbba	TRUE
daccbabbacbbdaaaadacccdbba	TRUE
daddbccbdabcbabbcbbddcadca	TRUE
dbbbabbdbcddaddddadcbbcdbc	TRUE
dbccacdadcccdacbbcacccddbd	TRUE
dbdcdddadcccabaacdbbdcaccd	TRUE
dcadbdccddaaddadaaaccaaddd	TRUE
dccadcacbbcaaddabadcadcbdd	TRUE
dcdcdbcbacdcaabdddcdcdddca	TRUE
ddbacdbbcddbdadbdbaddcbcba	TRUE
ddcbdbbccbcbdbaabacccbcbac	TRUE
aaaaabdababaaddcabacbadddd	FALSE
aababcbaaabcddaaadbdababad	FALSE
aacaadcabadbabdbdddacdddbc	FALSE
aaddcbbcbbdbaddbdabdabdacd	FALSE
ababcccacbbcadabababababba	FALSE
abadddbabacdbbbbbdbcbccabc	FALSE
abcaccbabadbacbdadddbaaccc	FALSE
abdcaaadddadadcbababdaccda	FALSE
acbababddaaaacddbdbbbcbccd	FALSE
acccaababadbdbcdcccaaacadd	FALSE
adaabccbaaaddbababbdbcadcb	FALSE
adbaddddbadbbdbccbcabdcbba	FALSE
adcdacbddcddadabadbadbcccc	FALSE
baaabcaaddacbaabadbadbdabb	FALSE
bababacddbaddcabcdbdcbcdab	FALSE
babdabaaabcbdccbddbaadcbbb	FALSE
baccddddadaacaccbababdacbb	FALSE
baddbabdadbddacacacbccdbcd	FALSE
bbadbabdaacbddcdaadabaabcc	FALSE
bbcaddabababcdcacacbdbadbc	FALSE
bbdcdadbdbbbbbdaadccbababa	FALSE
bcadcbbadcabababcbacbbbdca	FALSE
bccadbbdabddcadbbdadbabaab	FALSE
bcdbcddbadbaddccddaabababb	FALSE
bdaccccbbcbbbababaacabcdbc	FALSE
bdcaababdabbccaabccdbacccc	FALSE
bddbabcbdcbabadbaacdadbbda	FALSE
caacaddcabbcbabababbbdccac	FALSE
cabdababdccbbaacccbbdadadc	FALSE
cadabddccdbbdbacadbbababab	FALSE
cbabadbdddacbddabbcdbbdddd	FALSE
cbbbdabdadbdabbbbbcdcbddcb	FALSE
cbdaabcddbadbcccbcbadbadba	FALSE
ccabddababdbacbdcdbadbccdd	FALSE
ccbcdbbdbdcdcdbbdbababdaad	FALSE
ccdadabbbcbacbaddddbdabdac	FALSE
cdacaacdadbadbabadcdcbcddd	FALSE
cdbddaadbcbaddddddbabaacaa	FALSE
cddaddaaabbdadcccadbababab	FALSE
daacdaababddadbcacddcdaddc	FALSE
dabddababbbddcabacdbdaccdd	FALSE
dadbbdcbababddabcccababbba	FALSE
dbacaabadbabddbaabcaaaabba	FALSE
dbbdbadcacdadadccabdadbdab	FALSE
dbdadaacdbdaddbbababadccdc	FALSE
dcacbdbababaddaddccaacccbd	FALSE
dccaadabababdcbadaddbcbdad	FALSE
dcdccccbccccbbabdabaccdcba	FALSE
ddbabababbcdddaddabcdccbcb	FALSE
ddccaabababdccddcdbadbbdaa	FALSE
aaaaaabccdcddbbcdddcdbcabab	TRUE
aabbcbcddbacbcaacbbcabbaadb	TRUE
aacdcadacbcdbaaddbacdcbbddc	TRUE
abaacdaaacaadabcbacccbadaab	TRUE
abbadccdbbdadbaddbcccdbdbda	TRUE
abccbadccbbaadcdadaabcddcdd	TRUE
abddccdadcbcadbdcdacbbadaba	TRUE
acbadacaaaadcbcbcbcbddadacd	TRUE
accbcdbacacaadcdcaddaaabaab	TRUE
acdccabdaacacadcaadcbaaadaa	TRUE
adadbdbcdcdaabccdacacabbdcb	TRUE
adcababdcbaccabcacbcadbdabd	TRUE
addbbaddaaaacbbdcbdaccddbcb	TRUE
baadaccaabdaccbacbbabccdaac	TRUE
babddaaccaddaaaabdddaacaadc	TRUE
badbabcdbdcddadcabdbdcdcdca	TRUE
bbabccabbbdcdaadddbccaacbbc	TRUE
bbbdbbcbaabadaaabcadcbdbcdb	TRUE
bbdabdbddaaabbbadcdbadcddbc	TRUE
bcaaddccbbabcddbbbadabdaddb	TRUE
bcbbddbbddcdcabadacdddcbcdc	TRUE
bcccdbbadcdbacdcdcdcbbccbdd	TRUE
bdaaaadccbdddcdacddabdbdcaa	TRUE
bdbabcddaacdcabdcaaacbaabdd	TRUE
bdcbccadcbcdadaaacbcbaccdda	TRUE
bddcacadccdadcbddcbbcdcbcac	TRUE
caadacabbccccccdcbcbacaaabc	TRUE
cacaabdbbcdbaadbbacccdcaddd	TRUE
cadbacadccaccddddadbcbdabdd	TRUE
cbacacddcdadabdabdacbddabdc	TRUE
cbbdbcabacbdcdadcaccbaddcdc	TRUE
cbdacbacbdcbabddacabbdddbca	TRUE
ccabcbbcadccbaabddccddacdcd	TRUE
ccbcbdccadddaaadcdcbacaaaac	TRUE
ccdaaabbcdbcbacbbdccaabdccc	TRUE
cdabbcdbacbbcbccbbaacabbdda	TRUE
cdbdccdaabadaacdcdbacdabcdd	TRUE
cddabdbdbaabbcccbbbabbabaaa	TRUE
daabcadacbbbaadbbbbbabddcbb	TRUE
dabdacbdddaadcddbaabcddbdcd	TRUE
dadaccccbabaacdbdabaabcaddb	TRUE
dbabacdbbbccddbbcdcbbaccdad	TRUE
dbbdabcddabbcddcddbbbacaaac	TRUE
dbcdaddabbdaabbccdadbbcbbdb	TRUE
dcaabcaccbbbcbdbccaaddabbad	TRUE
dcbbcdcccadddccadcdbcdcdbbc	TRUE
dcccdcacbbcddbcdadacccdcbdc	TRUE
dcddcbbdbccaddbbadaabcaacac	TRUE
ddbbbbccbbccdbbabcabaccbadb	TRUE
ddccacccadbdcbbccdbccadbaac	TRUE
aaaaabababccbadabcadcabdddb	FALSE
aabacbbcabbaccacdddddababab	FALSE
aacbdabdaadadcccabababaccad	FALSE
aaddcbababadcbbabdccdcacabd	FALSE
ababdabdcbcadadbbbbcbdccaac	FALSE
abbcaababdabdbbbbcbbcbaaaab	FALSE
abcdbdbbcabcbbcbababdadbbca	FALSE
abddddbababadabdbdddbcadbac	FALSE
acbacdbbbcbdadbabdaacdcddbc	FALSE
acccaabddababdbdcdcaacbabad	FALSE
adaabadbabbbcdcdbccdbbdadcc	FALSE
adbacaacbcdacdccabdadbabcbb	FALSE
adccabdabbddacdaccdbababdac	FALSE
baaaaddddabccddacabadbdabcb	FALSE
bababadacbccacbcadcbbadbcbc	FALSE
babddcbaadbaabdabdadbdbdabb	FALSE
badbadbababaccbcbcbdccadada	FALSE
bbabaddccbcaabcabadaabababb	FALSE
bbbbdadaddacbddcadaddbababc	FALSE
bbcdadcbaabbaadbabadbdadbbd	FALSE
bcaadabadbabcbdddbbcdbbbcdb	FALSE
bcbcbbabcccabababcdcbccaacb	FALSE
bcdaddcdcababdabacddacddbca	FALSE
bdabdaabababdbccbcdccabacdb	FALSE
bdbdabddabadbcccaccbbacbabc	FALSE
bddacbdcdabababcaddbccccddd	FALSE
caaccbabadddbabadcccddddaba	FALSE
cabccbcbdaddabcabadbdabdcdb	FALSE
cacdcdbaaadbcdccdaddbdababd	FALSE
cbaabababbacdcddbaaaaaddabd	FALSE
cbbadbcdcabcaaababdabddacbd	FALSE
cbccbababdaaacdbabddbdcabdd	FALSE
cbddadbadbaccdbcdbdacddbbda	FALSE
ccaddacacbabdabaadaaaddccac	FALSE
cccadaccccbabadbdabbbadbdcb	FALSE
ccdbdabdabdabbabcacdabccaaa	FALSE
cdaddbaadabdbaddbabacbabcba	FALSE
cdcababdabccabcaaabbdccccba	FALSE
cddbcbaacdcddbaddbaddbaddbb	FALSE
daadbaddbdabcaaacadbbcaadad	FALSE
dacaabdbdababdabacdcdccccad	FALSE
dadbadcadaccbababdabacbacaa	FALSE
dbacbababdabccbccacaabdbcba	FALSE
dbbcdabdbcbacbabddabaabbcdc	FALSE
dbdabdababbddccddbabcabdaca	FALSE
dcabcdaacbddacacdabadbabbaa	FALSE
dccaaabababbdcaadaaaaadabda	FALSE
dcdbdbcacaccbabdabaddcbccba	FALSE
ddadbbcbacbcdacbcdaddbababb	FALSE
ddcbabdcabdababaadabbcacbdc	FALSE
aaaaaaaabdabbdcacdcddacaabac	TRUE
aabbdbbdcdbcbcccbcbcacaaaabd	TRUE
aacdaacccdddadabddddcbdcbdaa	TRUE
aadddbdacdddbdabdddcbcbdbaac	TRUE
abbacccbcbabdcadadadcccaddca	TRUE
abcbacdccdbbddcbbbccaccddaab	TRUE
abdbbcbadbdaddbdbdabaccddbdd	TRUE
acadcadbdacdcdaabadbbddbcadc	TRUE
accbcaaacddabcaabbaadbdbacba	TRUE
acdcbbcababdcadbdbdacbabadaa	TRUE
adbaacbabbdcddabacaacdacbcad	TRUE
adcbabdadbcaaccdcaaadcdcadcc	TRUE
addcacacbdcddacdbadcdbcdbbab	TRUE
baaccbbaabaacdbbcacdaaddddbd	TRUE
babddcbadddcbddbccdbacbdacda	TRUE
badbaccbbcbddbcdbbcbbbaccada	TRUE
bbacadbbaabcddaacbcbdddbddac	TRUE
bbbdbcdcbadabaabcdcdddadcaab	TRUE
bbdabccbadaacbcdaaaaaccaddcc	TRUE
bcabacdabcaccdcdbdacdcdabdcb	TRUE
bcbcdaccdabdbbbaacdcabbcdadd	TRUE
bccdcadcabbcdbaacbbacdcbcccc	TRUE
bdaabdadbbdacbaaacadacddbbab	TRUE
bdbbcdbbbabbccadcabaabbbbbcb	TRUE
bdcccddacbbbbccddcdbacddddcb	TRUE
bdddcddcadcadcdcadbbaddcdaca	TRUE
cabaccaccabdddbddccacdccbadd	TRUE
cacbdaadcbccddcbbcbdcbcdacdd	TRUE
cbaaacadcbdbccdabdcdcdabbbcb	TRUE
cbbabcdbbbdbaccbbcdbddaccccd	TRUE
cbcbacdccdcccdcbddaaaacccdbb	TRUE
cbddabdaacadcacacbacddbdcdba	TRUE
ccbabbacdcbcbcaddaadcbddadda	TRUE
ccccbcbaacccbbdaaaacdcdbbccd	TRUE
cdaaaabacbabdaababbbddbabbad	TRUE
cdbbabbdbddbccbddadcaccacddc	TRUE
cdccadadcbbdadcbaaddddcacccd	TRUE
cddccacdbadbdcddbadddadbcbbc	TRUE
dabaaadbbabdcddbbdccdbbaccab	TRUE
dacbbbbcdcaaacacbcaabaacddbb	TRUE
dadcdadbdaccbdcbcabdbcdbbaab	TRUE
dbbadcccabccdddddbcbcaabcbbb	TRUE
dbccbbbcaaccbaaaabcddcacdcca	TRUE
dbdcdcabdccaddaacabccbbacdac	TRUE
dcbbadcaadaacaadbdddbacacbdc	TRUE
dcccbabdaacdadcdccbcabdddadb	TRUE
dcddcacdcadacdcabcdaddbccccb	TRUE
ddbaacdbbdacdaadbdbbcbabbdcd	TRUE
ddcabdcabacbcababddbbccabadb	TRUE
dddaabbaabbacdddcabaaaddcbcd	TRUE
aaaaaacbcdbccddbcadbadbdabbd	FALSE
aabbadbadbdacaddbcaaddbadbbd	FALSE
aacdbabbbdccbaacbbdbababaada	FALSE
abababbcacadccccccdabdacadcb	FALSE
abadbabaccbbdcbbdccdacabbbcc	FALSE
abcaaabababadadcbcacdbbdabbd	FALSE
abdacbcbabaacabdaabaabadbabd	FALSE
acabaddbbdabddabdabdcddbcbbb	FALSE
acbdaabddbbcacbbddabadbabbdd	FALSE
acdadcbddacbbcaabababacaddcb	FALSE
adadacbacbabdabaabacbacdabdd	FALSE
adbdcabddaacbabababdaaacabac	FALSE
addcbdadbdabadbddcdaabcddcca	FALSE
baaddabcddcacadbcbdadbabacac	FALSE
babaddcababdabbabdcbbdadcdad	FALSE
bacbaadaabcbaddabdababcbbccd	FALSE
badcacbadcdbbacdbabaddbacdac	FALSE
bbaccaabdaabadbabcbabcabacaa	FALSE
bbbdbacbddaabababccadcdacbcb	FALSE
bbdbcdbbbabdadbacaabbcbbaddb	FALSE
bcaddbcbababaadcdadccdacdbbb	FALSE
bccadabccbabdadbdacbaddddcad	FALSE
bcdccaababcccdacbbababdaccbd	FALSE
bdacdbaacbdddbabadbadacbcaad	FALSE
bdcaccbacabbddadbcaacbababad	FALSE
bddbbcdbccbbaadaaadababdabad	FALSE
caadaddbbbddababdaadbadbaabd	FALSE
cabdabadbaccaacacbbbcbbddbab	FALSE
cadabacdccbabddacdcabdabdaba	FALSE
cbabababdaccabacabdadbbbbbab	FALSE
cbbabcacbdcaacdbbbdabdadbabd	FALSE
cbcbddbbddbcdbbacadcabadbabd	FALSE
cbdcdbbdcdbadabaddbabddaccad	FALSE
ccbabddabaacbadbbbbadddccacd	FALSE
ccccbcaaddaaaaadabbdbababdab	FALSE
cdaaaddddaccdcbababaadcccbac	FALSE
cdbadbdabdddabdadbdbbdcbaaad	FALSE
cdcccbdbcaabbcbabdddababdddb	FALSE
daaaaabacdcaddcaabababdddaca	FALSE
dabbadbabddaabacccbccaacdbba	FALSE
daccabdcdcbdacbadbabaaccaddb	FALSE
dadddadcccababadbdcaacccbabc	FALSE
dbbaabdababcccdcaacdcaccabcb	FALSE
dbcaacccbccbadbabadbdaccdbcc	FALSE
dbdbdadcdababddabbcaacbccdba	FALSE
dcaddbaccbbbbababadcbbdaaaca	FALSE
dccbadadaddbabdadbbabababbcd	FALSE
dcddabababcabbadbbacbcddddab	FALSE
ddadccacadadbddabdabdbcbbccc	FALSE
ddccaabdaabaddbadbdccacbdbab	FALSE
aaaaaadacaaaddbccbddcababaadb	TRUE
aabbbaccbdacccdbaccccbdbacacd	TRUE
aaccaccdbcabccacbcdcbacdccdcc	TRUE
aaddaabbbdcbadbbcbaacbdcaadac	TRUE
abbabcccadaabcacadbbdacdcabbc	TRUE
abcacbcbacbabaadcdbacbbbdcabd	TRUE
abdbdadddbaaadaacdbdbabacadbb	TRUE
acacbccabdbdadccaadacbdbcbdda	TRUE
acbddcbabbdabddcddbdddabbdabd	TRUE
acdacdbbdddadabacdcddccddabaa	TRUE
adabdcacbdddddcadddddacabbdbc	TRUE
adbccabbcaddccdbcbdcddbcddcaa	TRUE
addabadbbacaaacdaacdabbdbcdcb	TRUE
baabdadccdddcacbacdacdcadadaa	TRUE
babccccbbbcadbaccaddabdbaccba	TRUE
badaacdcaadbddaacacaaacbcdaad	TRUE
bbabcadbaccbbccdbabacaccbcaab	TRUE
bbbccdcdcbbcccccdabbadadcdddb	TRUE
bbdaddacdbdaabbdbdbdddcacacdd	TRUE
bcabbcbbacbbbaddbabbbddbbdcda	TRUE
bcbcbabccddbdaccdbdddcdaccada	TRUE
bcccddadccbaabdddabbbdabddcbc	TRUE
bdaaabdacccbbcbccdcbdbbddcdbd	TRUE
bdbbacaabaacbdbbdccdcccccccdd	TRUE
bdccbdbccacaddbccdabbdbbbbdda	TRUE
caaacddaccbdcabcbdbaacaccdddc	TRUE
cabcadbcbcdcdbcddacaaabcabcbd	TRUE
cacddaabbbccccababadcdcacccca	TRUE
cbabadaccdbbbcacdbbdacbadccca	TRUE
cbbcaddbbadacaacdaccabacccabd	TRUE
cbccddbdbdabdaacaaddaaacaadcc	TRUE
ccaaacbccaaacdadcccdaddbbcaac	TRUE
ccbbbaccaadaddaadbbaddbcaccab	TRUE
cccbccdadbbbccdccdaacdbabaada	TRUE
ccdcbdabcdccdccbaddcbddabdacd	TRUE
cdadcbdccaacaaadbacaadccadbac	TRUE
cdcacdadacacbdadadbadbacccddb	TRUE
cddbdbdcddabdddbbcbbbcbacadbd	TRUE
daadbaccaadaaabbcbcbbbccdccbc	TRUE
dacaacdbbabaccdabacdbbcaddacb	TRUE
dadbcdabdadadbcdddabadadaadba	TRUE
dbadacabdabbcbcdaaccdcdacbacc	TRUE
dbcaaacdbccbdcbdcbddabbbbabca	TRUE
dbdaddddabbcccadbbbdbcdacddba	TRUE
dcacdbbbcbaabcbbbaaabbdbdbdab	TRUE
dcbddbabaadaadabdadcbbbbbbbcd	TRUE
dcdaaadacbcbaaacaabcaabccdccc	TRUE
ddaaddaacddcbadadbcdaacbbbbad	TRUE
ddbccbdccaaacccdddbbdcbdacaaa	TRUE
ddcdbdddcddbbabcbdccbcbabdaac	TRUE
aaaaaabdddababbcadbcccadcdaba	FALSE
aabababccabdccacbacaabcdbadcc	FALSE
aacbabadbaacdcaaddadadaddbbcb	FALSE
aadbddbbababddacbadcadbbdabac	FALSE
abababdbbaababbccdbcabddddada	FALSE
abbaabaadcdbbababaababbdaccac	FALSE
abccababadbcadadaacaadaddacca	FALSE
abddabcbbcbddabaddbdacddabdad	FALSE
acbababaabbbaadccdcddabbcccdc	FALSE
acccaaabababaabdabbcddcddddca	FALSE
acddbcbbaccaabababcbdacdbccdc	FALSE
adbababdcaababaacbababbadbdcb	FALSE
adcbababddaccdcbbbbabdabadaba	FALSE
adddbababcaadacaadccbdbccaabb	FALSE
bababaaacbcddadbbbcaabcbacdbd	FALSE
babbdcadabdababdcadbcaaccbaac	FALSE
bacccabdcacbababacbbdbdaaccbc	FALSE
baddbabadaabaacdacbdcbbbbddcb	FALSE
bbadaacabcbddababadbbbdabbddc	FALSE
bbcaddcbbabacccddbcdbbabadbad	FALSE
bbdcacaababddabbdccadbbacbdbd	FALSE
bcadbbbbababdaccababdadaddbba	FALSE
bccbabababcbbcddabdccaacdbbda	FALSE
bcddababddddabccbddaadbacbbbc	FALSE
bdadadbddaadbccbadaacbbabdaba	FALSE
bdcaaabcddacaccbaadbababbcccd	FALSE
bddbabcadbdcbcacbabdabaadbdac	FALSE
caadabbaadaabadbddabacbdcdabc	FALSE
cabdbcdabbbdbdbdbabadbaacdddb	FALSE
cadadbababaadccacaadabcabbbba	FALSE
cbabdddabacabccdcbcdaacbcccad	FALSE
cbcaadababdadbaddbdacabcaabca	FALSE
cbdcadbdbddccdbabdababacccdca	FALSE
ccadbababadcddbadbbbcbbcbcdda	FALSE
cccbbbaccabbcacddbacccadbabab	FALSE
ccddabbdbababadbacdbbabacaabd	FALSE
cdbababaadccaaaacbcbaddacdcda	FALSE
cdcbabadcadcabdadacdbcbababab	FALSE
cdddcadcabababacadcccacbbaabc	FALSE
dabacadababddadbcddbaadacdacb	FALSE
dacadbcccddcaadbabdabbcaacbdd	FALSE
daddbaaaddbabcccbaaacababdaba	FALSE
dbaddcdabccabdabadddbaccabcab	FALSE
dbcabcdacbbaddbddadbaadcbaaab	FALSE
dbdbdbabddaddbaddcdbbdacbcdcc	FALSE
dcadbaadddaddbdababaacbdbbacb	FALSE
dccababdabccbccddcbbddcaadccd	FALSE
dcddabdadbabadccbcdbbaddcbabb	FALSE
ddbababacabdbdcbabdabbcadacda	FALSE
ddcbbcdabaaddbabdabbcadadabbb	FALSE
