aaaaabaaacabbbdaccbbccdcbcdbbdb	TRUE
aacbbccaabaadccbbdbcbdddbccccbb	TRUE
abacddbacacddaacbabddabacacacbb	TRUE
abdbaacdcacdcabacccaaadadcabccb	TRUE
acbbbcacadddddbaddaccdcbbcadbcb	TRUE
adaccaabcccadcbabcabcadcbbdddda	TRUE
addbabdcccdbcdbbcaaadbdaaadabaa	TRUE
bababdccacdbaabccbaddccacdcbcaa	TRUE
badbbdddbdadabacbadcbdcccdbdbad	TRUE
bbbcadbadbbdbbcaaabbddcdbdbdadd	TRUE
bbddbcddcaaccdadcdbdaaabcabbcca	TRUE
bccccbaacddbadcddbadbdabdddbcda	TRUE
bdbbcaabdcabababaddbabbacadccba	TRUE
bddcdaadabbacbbcdabaaccaaaaabda	TRUE
caacbcabbdcbcabbadbddbdcdaaccbc	TRUE
cbaccdccbdbddbacdbabdbdaaddbbdb	TRUE
ccaabdbdbccbbdbbdbbddcbadcabaca	TRUE
ccddbbdaabbbcdcbbcbbccddadbbabc	TRUE
cddcacacadaacabbcdbaabddbbbdabc	TRUE
dacadbcbdaacbccaccadaadbbbaadab	TRUE
dbadcbcdbbbdacadaaaddcccadabbbc	TRUE
dbdaaabdbadacdddcdacbbabacdbddd	TRUE
dcacabacdacbbcbcadbbadabadcbbbd	TRUE
dcdbbddaaaabdbcadddccbbcabdccaa	TRUE
ddbcababddddbabaaabbbdcdaccdbac	TRUE
aaaaabaaacabbbbaccbbccdcbcdbbdb	FALSE
aacbbccaabaadccbbdbbdddbccccbb	FALSE
abadddbacacddaacbabddabacacacbb	FALSE
abdbaabdcacdcabacccaaadadcabccb	FALSE
acbbbcacadddddbaddaccbcbbcadbcb	FALSE
adaccaabcccadcbabcabcaccbbdddda	FALSE
addbabdcccdbcbbcaaadbdaaadabaa	FALSE
bababdccacdbaabccbaddccacacbcaa	FALSE
badbbdddbdadababbadcbdcccdbdbad	FALSE
bbbcadbadbbdbbaaaabbddcdbdbdadd	FALSE
bbddbcddcaaccdaddbdaaabcabbcca	FALSE
bccccbaacddbaddddbadbdabdddbcda	FALSE
bdbbcaabacabababaddbabbacadccba	FALSE
bddcdaadabbacbbcbabaaccaaaaabda	FALSE
caacbcabbcbcabbadbddbdcdaaccbc	FALSE
cbaccaccbdbddbacdbabdbdaaddbbdb	FALSE
ccaabdbdbccbbdbbdbbddabadcabaca	FALSE
ccddbbdaabbbadcbbcbbccddadbbabc	FALSE
dddcacacadaacabbcdbaabddbbbdabc	FALSE
dacadbbbdaacbccaccadaadbbbaadab	FALSE
dbadcbcdbbbdabadaaaddcccadabbbc	FALSE
dbdaaabdbadadddcdacbbabacdbddd	FALSE
dcacabacbacbbcbcadbbadabadcbbbd	FALSE
dcdbbddaaaabdbbadddccbbcabdccaa	FALSE
ddbcababddddbabaaabbbdadaccdbac	FALSE
dbdbdddddddddbccbacccdacddadaadd	TRUE
aabdcccaaadadacbadccbadbdddbcaca	TRUE
abaadaacdbdbacabbbbadbddadcbdbbd	TRUE
abbddddcaaacdbcdacdbababbdacbcaa	TRUE
acddcadbbaacccbaaadacbccacacccba	TRUE
acdcbacbcbdadbadddbdaddcbdbaccba	TRUE
adcadaddbcccabbadcbaaddddbccacac	TRUE
baabacabccacbaaabccdabbabdcabdcd	TRUE
bacbcccdbcbbbdbabbadddbddccabbda	TRUE
bbadbdbddbcdadcdbaaccdaaacbabccc	TRUE
bbdbcdbcbbdabbadbcbbbbaacadabccc	TRUE
bccaadaacdcccbbbaabbcbabbacccdcc	TRUE
bdbbabdbabbdcdaaacdabbbacbacddda	TRUE
bddbbacaadbaddbcbaaadbcbcadcaccb	TRUE
caaacdaaabcbadddbabdaadbadddabcd	TRUE
cadcbdaabbcdaabddddaaaadbdbcbaac	TRUE
cbdabdbdcccacdbbdaaaddbdabcdaabc	TRUE
cccdcbcaccadbcbaccbaacacbaaddbbd	TRUE
cdbdacddadbdaaadabccbacadadaaddd	TRUE
dacbdabccddcdddaaaadbbaddbabbbdc	TRUE
dbaaccccbbcbcaacdcbdadbddabcdaaa	TRUE
dbcaccaabcdadaabbdbcadaadadccddc	TRUE
dcdadaaccbcddabaddbbaddddddccccd	TRUE
dcbdabbcabcbbdabbcacaaccccbcabda	TRUE
ddbcabdaacdcaabcbabcbacbdbbaddac	TRUE
adbdbdddddddddbccbacccdacddadaadd	FALSE
aabdcccaaadadabadccbadbdddbcaca	FALSE
abaadaacdbdbadabbbbadbddadcbdbbd	FALSE
abbddddcaaaccbcdacdbababbdacbcaa	FALSE
abddcadbbaacccbaaadacbccacacccba	FALSE
acdcbacbcbdadbadddbdaddbdbaccba	FALSE
adcadaddbcccabbacbaaddddbccacac	FALSE
baabacabccacbaaabccdabbabdcabbcd	FALSE
bacbcccdbcbbbdbabbadddbddccabbaa	FALSE
bbadbdbddbbdadcdbaaccdaaacbabccc	FALSE
bbdbddbcbbdabbadbcbbbbaacadabccc	FALSE
bccaadaaddcccbbbaabbcbabbacccdcc	FALSE
bdbbabdbabbdcdaaacaabbbacbacddda	FALSE
bddbbacaadbaddbbbaaadbcbcadcaccb	FALSE
caaacaaabcbadddbabdaadbadddabcd	FALSE
cadcbdaabbbdaabddddaaaadbdbcbaac	FALSE
cbdabdbdcccacdbbdaaaddbdabcaaabc	FALSE
ccccbcaccadbcbaccbaacacbaaddbbd	FALSE
ddbdacddadbdaaadabccbacadadaaddd	FALSE
daabdabccddcdddaaaadbbaddbabbbdc	FALSE
dbaaccccbbcbcaacdcbdadbddabdaaa	FALSE
dbcaccaabcdadaabbdbadaadadccddc	FALSE
dbdadaaccbcddabaddbbaddddddccccd	FALSE
ddbdabbcabcbbdabbcacaaccccbcabda	FALSE
ddbcabdaaddcaabcbabcbacbdbbaddac	FALSE
aaaabadcadbdbbbacdbacbcccadadadad	TRUE
aacaadbabcaaaabdbbcdabdbcbabcabcb	TRUE
abaabcabbccbdbbcbacddbbccabcadbbd	TRUE
abcaaccbbbacbbdccaababadbcbabdbbd	TRUE
acabbaadbacdcabcbadaabbdbddaaabac	TRUE
acadcccbbbcbbccbdadccbcabcbabbdcc	TRUE
adbdccdacdaabbdbbdbadabdcacbcadca	TRUE
baaadcaaabbcadcacddcacbbbccbccbdc	TRUE
bacbcdbbadabddcbdcdbbaddadababddb	TRUE
bbabbdadadadabacdcaabccdcccccadca	TRUE
bbccbcdbcabddacbacccbacaddddbaabb	TRUE
bcaccbdbbbddaddbcabadacccdbabddad	TRUE
bdaadddadadcdcbbaabccdbaacaddcaba	TRUE
bdbddadaaabbabcbccccdcadbcdcccacc	TRUE
cdbaabcacdabbbbadddaccbcacadacbab	TRUE
cabddbadabdddbacbcdccdaaadadddbbb	TRUE
cbbdbdcdabababcdbbdaabbdabdaababc	TRUE
ccbabacabdbcbbbcdcbbacbadbbdaaddb	TRUE
cddabadabdacbcaabcbddbcabcbccdbca	TRUE
dabbbdbbbdbcdbdbccdbbdacbbacadbcb	TRUE
dadcabccbbdddddcddbbdccacaaaacdca	TRUE
dbbbdbbbdbcaaaabdacdbaacbbdacabab	TRUE
dbdddaadbaaadccbacbddcabcacdcbdba	TRUE
dcdacadbbdbddbbdccacdbbbddbbbdbdb	TRUE
ddbbdbaadabdbbcdcbbcdcbacaacabadb	TRUE
aaaabadcadbdbbbacbacbcccadadadad	FALSE
aacaadbabaaaaabdbbcdabdbcbabcabcb	FALSE
abaabcabbccbbbcbacddbbccabcadbbd	FALSE
abcaaccbbbacbbcccaababadbcbabdbbd	FALSE
acabbaadbacacabcbadaabbdbddaaabac	FALSE
adadcccbbbcbbccbdadccbcabcbabbdcc	FALSE
adbdccdaddaabbdbbdbadabdcacbcadca	FALSE
baaadcaaabbcacacddcacbbbccbccbdc	FALSE
bacbcdbbadabddcbacdbbaddadababddb	FALSE
bbabbdadadadabacccaabccdcccccadca	FALSE
bbccbcabcabddacbacccbacaddddbaabb	FALSE
bcaccbdbbbddaddbcabacacccdbabddad	FALSE
bdaadddadadbdcbbaabccdbaacaddcaba	FALSE
bdbddadaaabbabcbccccdbadbcdcccacc	FALSE
dbaabcacdabbbbadddaccbcacadacbab	FALSE
cabddbadabdddbacbcccdaaadadddbbb	FALSE
cbbdbdcdabababbdbbdaabbdabdaababc	FALSE
ccbabacabdbcbbbccbbacbadbbdaaddb	FALSE
cddabadabdacbcaabcbddbcabcbccbbca	FALSE
dabbbdbbbdbcdbdbccdbbdacbbacabcb	FALSE
dadcabccbbdddddcddbbdccacaaaacaca	FALSE
dbbbdbbbdbcaaaabdacdbaabbdacabab	FALSE
dbdddaadbaaadccbacbddcabcacdcbba	FALSE
dcdabadbbdbddbbdccacdbbbddbbbdbdb	FALSE
ddbbdbaadabdbbcdcbbccbacaacabadb	FALSE
aaaaaaadbcacbabbbacdbcddadbbcaccdd	TRUE
aacaadaddcaaadbacccaddabbbdadbdbdd	TRUE
abaadcbbcadcdddadabacbabadadbcbcbb	TRUE
abcbdbadaacababdaabaaddaccaddaaabd	TRUE
acadacaccbccbabbcaccbbadcdccccaaac	TRUE
acabdacbbbbcdabaadadcabcaddabaddab	TRUE
adbdadbbdcdbbccdacabacbbbcddbadabd	TRUE
adddcdadcbcbdcacbcbdddadbadbdacaba	TRUE
bacdbdbaaacbbccbdabadbcaccaacbaadc	TRUE
bbaacddaddddddcdacaaabcbdbdbdacccb	TRUE
bbcbccaacddbdaaadcdcadbaccbacaccbb	TRUE
bcabbdcccabadbdabbadbababdbcddddcc	TRUE
bdaacdddbbcaccdddabaacabaaddbaabac	TRUE
bdccadbabbbcaaadcaaaadbbbbabcbacac	TRUE
cdbdaddcaabaadaccddabbadbdddbdbdaa	TRUE
cacbcccbcabdbdbdddbddcbdbbcbccdbbd	TRUE
cbcbddbbaabdadabdcdbddadcddccacbcb	TRUE
cccacbcadbddaaacabcdcccdbadaababba	TRUE
cddabdbdaacaccccabdbdbadcbcaadddaa	TRUE
dabcaaabcacdbcaccaccdcaccdabcccbaa	TRUE
daddddcacdaccbadacbdababbaddaabbcc	TRUE
dbcabcaacbcbdbbdbbdadccdaaddbdcadb	TRUE
dcababdcdabadbbcdccbcbababcabcbcac	TRUE
dcdabdbdbbbcadcccacbdbddbaadcaabaa	TRUE
ddbcbabbdacbdbcaaabacbdabbbcbacccb	TRUE
aaaaaaadbcacbabbbacdbdddadbbcaccdd	FALSE
aabaadaddcaaadbacccaddabbbdadbdbdd	FALSE
abaadcbbcadcdddadabababadadbcbcbb	FALSE
abbbdbadaacababdaabaaddaccaddaaabd	FALSE
abadacaccbccbabbcaccbbadcdccccaaac	FALSE
adabdacbbbbcdabaadadcabcaddabaddab	FALSE
adbdadbbdcdbbccbacabacbbbcddbadabd	FALSE
adddcdadcbcbccacbcbdddadbadbdacaba	FALSE
badbdbaaacbbccbdabadbcaccaacbaadc	FALSE
bbaadddaddddddcdacaaabcbdbdbdacccb	FALSE
bbcbccaacddbdaaadcdcaabaccbacaccbb	FALSE
bcabbdcccabadbdabbadbababdbddddcc	FALSE
bdaaadddbbcaccdddabaacabaaddbaabac	FALSE
bdccadbabbbcaaadcaaaabbbbabcbacac	FALSE
adbdaddcaabaadaccddabbadbdddbdbdaa	FALSE
cacbcccbcabdbdbdddbddcbbbcbccdbbd	FALSE
cbcbddbbaabdadabdcdbddaddddccacbcb	FALSE
cccacbcadbddaaacabccccdbadaababba	FALSE
dddabdbdaacaccccabdbdbadcbcaadddaa	FALSE
dabcaaabcacdbcaccaccacaccdabcccbaa	FALSE
daddddcacdaccbadadbdababbaddaabbcc	FALSE
dbcabcaacbcbdbbdbbdadccdaaddbdcaab	FALSE
dcababdcdabadbbadccbcbababcabcbcac	FALSE
dcdabdbdbbbcacccacbdbddbaadcaabaa	FALSE
ddbcbabbaacbdbcaaabacbdabbbcbacccb	FALSE
aaaaacbbdcbdbaabbbcccdbabbadbdccaba	TRUE
aabdcabbbabcaaababdabaccbdbdbadcadd	TRUE
abaaabccccbbbabaadcbcbcabccccbdcdbb	TRUE
abbdcdbcdbdbaaacaacbdabbaabadbdabab	TRUE
acdadbccdbdbdadbdabdbacbcaaacdbaadc	TRUE
adaadaaababbcacdcaddbcacaabbccdbdcb	TRUE
adcbbadaabdbcadaaddddbdaacdddabccca	TRUE
baacbaccadddadbbbaabdccdabdbacadaaa	TRUE
badadbadbacabacdcddbccccabacaabddad	TRUE
bbbaaaabbababbdbcdccccaccdacabdadbd	TRUE
bbdaaccdcadddbccbbacbdadbdddaaabaaa	TRUE
bcbacdaccccdcbdacaccacbcbabccaaabcb	TRUE
bdacddbbadcabacdacadaadabadbcacccac	TRUE
bdccacbcabccadcdacacbcbccdddbbadcab	TRUE
cdaadadadaccabbbddbccabadacaaabbccb	TRUE
cacbbbbbdacdbdcbcbcaaabbccabcbbdaba	TRUE
cbcaccacddbdddadbdabaccbaaadbccadcc	TRUE
ccbdbdcbabdabdbaababcbcacbbcddbaddb	TRUE
caaddaaaddcbcabccbdadbabcaaadaaddbb	TRUE
dabcdbdbbbcdbbbaadadbdbaabccbdabbab	TRUE
dbaaabadbdcbbacadbcdabcbbccabcacdda	TRUE
dbbdbdabdcdcbdddcdbddaadaadabccbabb	TRUE
dbdddddbccabadcddabcbaccacacddccaaa	TRUE
dcdcbbabcbbacaaaaddababbdccdaacccca	TRUE
ddbcbbabdcbdddadaabaaaddcbadcaabcca	TRUE
aaaaacbbacbdbaabbbcccdbabbadbdccaba	FALSE
aabdcabbbabcaaababdabaccbdbdbadadd	FALSE
abaaabccccbbbabaadcbcbcabccccbdcbbb	FALSE
abbdcdbdbdbaaacaacbdabbaabadbdabab	FALSE
aadadbccdbdbdadbdabdbacbcaaacdbaadc	FALSE
adaadaaababbcacccaddbcacaabbccdbdcb	FALSE
adcbbadaabdbcadaaddddbdaabdddabccca	FALSE
baacbaccadddadbbbaabdccdabdbacacaaa	FALSE
badadbadbacabaccddbccccabacaabddad	FALSE
bbbaaaabbababbdbcdccccaccdababdadbd	FALSE
bbdaaccccadddbccbbacbdadbdddaaabaaa	FALSE
bcbacdaccccdabdacaccacbcbabccaaabcb	FALSE
bdacddbbadcabacaacadaadabadbcacccac	FALSE
bdccacbcabccacdacacbcbccdddbbadcab	FALSE
adaadadadaccabbbddbccabadacaaabbccb	FALSE
cacbbbbbaacdbdcbcbcaaabbccabcbbdaba	FALSE
cbcaccacddbdddadbdabaccbaaaabccadcc	FALSE
ccbdbddbabdabdbaababcbcacbbcddbaddb	FALSE
daaddaaaddcbcabccbdadbabcaaadaaddbb	FALSE
dabcdbdbbbdbbbaadadbdbaabccbdabbab	FALSE
dbaaabadbdcbbacadbddabcbbccabcacdda	FALSE
dbbdbdabdcdcbddddbddaadaadabccbabb	FALSE
dbdddddbccabaacddabcbaccacacddccaaa	FALSE
dcdcbbabcbbacaaaaddababbdccaaacccca	FALSE
ddbcbbabdcbdddadaabaaaddbadcaabcca	FALSE
aaaaaaddbadbcabbbcaacdbccdbbbadacbdb	TRUE
aabdbbdaaddbdcaabbdadbcccdcdbbdbaddd	TRUE
ababbaabbbdcbabdcbdacbdaabaacaaaaccb	TRUE
abcbcabbadcbbcbccacdbababacdabaccabc	TRUE
acadcadaaadaabdddadaacbabbabaaacdabd	TRUE
adacabdcbdaadabdabdababacabbbaadbdcb	TRUE
adccacdcbcdcbabbcbcbbbccbcbcddbadaab	TRUE
baadabcacbdadddcdcacaaccbabbbbbbadca	TRUE
baccadcaaaadcbbdbaaaccbcbbaababbabcc	TRUE
bbacababccdbadaaacaccacdcdbbadaabaab	TRUE
bbcccaacccabbadcabdbbdabdcdaacaccbbb	TRUE
bcabbbacacaacccdcbdabcabacaaacdadcab	TRUE
bdaaddadbdbcabcddbabddacbaddcdabccab	TRUE
bdcdbbbbddbccddabdcaacbddbadadcbbbcb	TRUE
caddaddaddcbacbcdbaababccdbdadabcbaa	TRUE
cacbaabccabdaadabbcdbccccdddadbbdbbb	TRUE
cbccdbdcbaadccabacbccabadaabcabcacab	TRUE
ccbdabababbabdcbdabcbaccbcababccdbab	TRUE
cbaddadaaddbabbcaadabccbacaacddabccc	TRUE
dabddbbbdbcbabdddcbbaaabadabbccbbdbc	TRUE
dbabadbddbcdbbdcdadadbcabcaccdaaadbd	TRUE
dbcadddbbddaddadaccaccddaabdacdbbdda	TRUE
dcaadadddabcccdcbabdbcaaccbaaabcbccc	TRUE
dcdbccbabcacabdbbccaacababcccccdcbac	TRUE
ddbcacbadcadaaabbbcaccbccccacbdaddab	TRUE
aaaaaaddbadbcabbbcaacdbccdbbbadadbdb	FALSE
aabdbbdaaddbdcaabbdadbcccdadbbdbaddd	FALSE
ababbaabbbdcbabdbbdacbdaabaacaaaaccb	FALSE
abcbcabbadcbbcbccacdbababaddabaccabc	FALSE
acadadaaadaabdddadaacbabbabaaacdabd	FALSE
adacabdcbdaadabdabdababadabbbaadbdcb	FALSE
adccacacbcdcbabbcbcbbbccbcbcddbadaab	FALSE
baadabcacbdadddcbcacaaccbabbbbbbadca	FALSE
baccacaaaadcbbdbaaaccbcbbaababbabcc	FALSE
bbacababccdbadaaacaccacdbdbbadaabaab	FALSE
bbcccaacccabbadaabdbbdabdcdaacaccbbb	FALSE
bcabbbacacaacccacbdabcabacaaacdadcab	FALSE
bdaaddadbdbcabcddbabddacbaddcabccab	FALSE
bdadbbbbddbccddabdcaacbddbadadcbbbcb	FALSE
addaddaddcbacbcdbaababccdbdadabcbaa	FALSE
cacbaabccabdaadabbadbccccdddadbbdbbb	FALSE
cbccdbdcbaadccabacbccabacaabcabcacab	FALSE
ccbdabababbabdbbdabcbaccbcababccdbab	FALSE
dbaddadaaddbabbcaadabccbacaacddabccc	FALSE
dabddbbbdbcbabdddcbbaaabadabbccbbbbc	FALSE
dbabadbddbddbbdcdadadbcabcaccdaaadbd	FALSE
dbcadddbbddaddadaccaccddaabdaadbbdda	FALSE
dcaadadddabcccbcbabdbcaaccbaaabcbccc	FALSE
dddbccbabcacabdbbccaacababcccccdcbac	FALSE
ddbcacbadaadaaabbbcaccbccccacbdaddab	FALSE
aaaaaddadcaaaaacbdddacddddbbcadaaabcc	TRUE
aabddbabddddabbacbbdbbdadaacacddccdcb	TRUE
ababacbaacaabdadcbbaccaaaaadbcbbcacbd	TRUE
abcacacaacacdddbcbdbbdaaabdbdbbdcbdcb	TRUE
acaabcacbccdddcbbbccccbcdaacdbdabbacb	TRUE
adaaabcbcbaabdbaaccbadadddddaddccccdc	TRUE
adbdcddbbdbabbbcaacbbbabddbddabbcdbba	TRUE
addddbabbabbcbcacacaaadcacdcbabbddaab	TRUE
babdabcdcabccbabdbdaccabcacbaadbddbdc	TRUE
baddaabbbdcbdabacbcdcabadbadabacaaacc	TRUE
bbbbdcbdcaadabcaaccabdbbcaabcbccabbbc	TRUE
bbdddcbdaabcdaacbcbcacacbaccacaddbdab	TRUE
bcdbdabdcbdddccaaacabcbbcabacbaabdbdb	TRUE
bdbcdcaaaddcabcbbccccaddddcabaacacbac	TRUE
bdddbccbbbddadbaabdddbddaccdbcbbbdaac	TRUE
cabccddbabbcbaaaddbddbaabddbbacdbbdca	TRUE
cbbcddbdaabababdddcbcbbaabddcaadadabd	TRUE
cccbbbaaaaababdccccccdbadbadbcaabdddd	TRUE
daaacddaddcddadddaccdacabaacbacbcbaca	TRUE
dabcadbdbcadbbaccdaaddddbddcabcaabcca	TRUE
dadddbcbbabddbcbadcdaadaaabbdaabdabdd	TRUE
dbbcdabbcacbacccccccccbcabbdcddababbb	TRUE
dcaaaabdbaacbcccbdadcbabddabaaabacbcc	TRUE
dcccdccbaabbcaacaaacdcacdcbbabbcabaaa	TRUE
ddbdcdddcbbddbdccaabbbbaaccabacdababc	TRUE
aaaaaddadcaaaaacbdddabddddbbcadaaabcc	FALSE
aabddbabddddabbadbbdbbdadaacacddccdcb	FALSE
ababacbaacaabdadcbbaccaaaaaabcbbcacbd	FALSE
abcacacaacacdddbbdbbdaaabdbdbbdcbdcb	FALSE
acaabcacbccdddcbbbccccbcaaacdbdabbacb	FALSE
adaaabcbcbaabdbaaccbadadddddaddccccc	FALSE
adbdcddbbdbabbbcaacbbbabddbddabbadbba	FALSE
addddbabbabbcbcacacaaadcacddbabbddaab	FALSE
babdabddcabccbabdbdaccabcacbaadbddbdc	FALSE
baddaabbbdcbaabacbcdcabadbadabacaaacc	FALSE
bbbbdcbddaadabcaaccabdbbcaabcbccabbbc	FALSE
bbdddcbdaabcaacbcbcacacbaccacaddbdab	FALSE
bcdbdabdabdddccaaacabcbbcabacbaabdbdb	FALSE
bdbcacaaaddcabcbbccccaddddcabaacacbac	FALSE
bdddbccbbbddadbaabdddbddaccdbabbbdaac	FALSE
cabccddbabbabaaaddbddbaabddbbacdbbdca	FALSE
cbbcddbdaabababdddcbcbbaabddaaadadabd	FALSE
cccbbbaaaaababdccccccdbadbadbdaabdddd	FALSE
daaabddaddcddadddaccdacabaacbacbcbaca	FALSE
dabcadbdbcacbbaccdaaddddbddcabcaabcca	FALSE
dadddbcbbabddbcbabcdaadaaabbdaabdabdd	FALSE
dbbccabbcacbacccccccccbcabbdcddababbb	FALSE
daaaabdbaacbcccbdadcbabddabaaabacbcc	FALSE
dcccdccbaabbcaacaaacdcacbcbbabbcabaaa	FALSE
ddbdcdddcbbddbdccaabbbbaaccabacaababc	FALSE
aaaaaacbdcadaabddacccadcabacacbabcaccb	TRUE
aabdbdbcaacbaccacadbcdbbaaabacbcbccbcd	TRUE
abaadbbddbadcbbdaacbbcabcabadcdbbdbdcb	TRUE
abbdaadabbbcdcaababababdbbaddacbbaadbc	TRUE
abddccbaaccccabcaaadabdcdddacdbbababdb	TRUE
acdabdcddddaddadaabddaacdccbaacccacccb	TRUE
adbbddaacaccaabdacdbadadcabcacbacdbabc	TRUE
addcdadbbacbdcbcacbbaaabcbdaddaabdcacb	TRUE
babccccbcadbbcdadbbbddabcdbbacacbbccac	TRUE
baddcacdaabddadbdbdabcdbbcacccaddbddad	TRUE
bbbccccbdbbaaacdaabdcacaabbbaaacabbdbb	TRUE
bbddbcacbdaddacbaacacbdadbcbdbbbcababb	TRUE
bccdabbdabacbbbcbacbcbcdabdaacccabbcbd	TRUE
bdbcaaccbbacdabadbcbddcccacacdbbdadcba	TRUE
bdddabcbdcacdcbbcacccbbaacaaaaddbabdbc	TRUE
cabbabccbbdaabcaddcbabcbbbabccccbdaddd	TRUE
cbbcbbaacbaccbcdaabacddcdbdbaddccaacac	TRUE
ccbdbdbaabdaaabdabaabbaadddadcaabdacbd	TRUE
cdaaabbcabcccbbbaaccdbcacabbadaddddcaa	TRUE
dabcdbcbacaccaddbadbcbcbcbbacabccdaacc	TRUE
dadcaabddbbaaddcaccccabdbbbbcdbddaccac	TRUE
dbbbddcbabadcbaabbbcabcdccbbdbdbdaabbb	TRUE
dbddaadadbaabbaddabbcdbbbdaccbcdcbdabc	TRUE
dccdacdacbbcaaccdbdabbbcbcbbbabacacccb	TRUE
ddbbdbdcbabccaadbdaabcabccdddbacdbdaab	TRUE
aaaaaaabdcadaabddacccadcabacacbabcaccb	FALSE
aabdbdbcaacbaccacadbddbbaaabacbcbccbcd	FALSE
abaadbbddbadbbdaacbbcabcabadcdbbdbdcb	FALSE
abbdaadabbbcacaababababdbbaddacbbaadbc	FALSE
abddccbaaccccabcaaadabdcdddaadbbababdb	FALSE
acdabddddddaddadaabddaacdccbaacccacccb	FALSE
adbbddaacaccaabdaadbadadcabcacbacdbabc	FALSE
addcdadbbacbbcbcacbbaaabcbdaddaabdcacb	FALSE
babccccbcabbcdadbbbddabcdbbacacbbccac	FALSE
baddcacdaabddadbdbdabddbbcacccaddbddad	FALSE
bbbccccbdbbaaaddaabdcacaabbbaaacabbdbb	FALSE
bbddbcacbdaddacbaacacbdadbcbbbbbcababb	FALSE
bccdabbdabacbbbcbacbcbcdabdaacccabbcb	FALSE
bdbcaaccbbacdabadbabddcccacacdbbdadcba	FALSE
bdddabcbcacdcbbcacccbbaacaaaaddbabdbc	FALSE
cabbabccbbdaabaaddcbabcbbbabccccbdaddd	FALSE
cbbcbbaacbaccbcdaabacddbdbdbaddccaacac	FALSE
ccbdbdbaabdaaabdabaabbaadddadcaabacbd	FALSE
cbaaabbcabcccbbbaaccdbcacabbadaddddcaa	FALSE
dabcdbcbacaccaddbadbcbcbcbbacabcccaacc	FALSE
dadcaabddbbaaddcaccccabbbbbcdbddaccac	FALSE
dbbbddcbabadcbaabbbcabcaccbbdbdbdaabbb	FALSE
dbddaadadbaabbaddabbcdbbbdaccbcdcbbabc	FALSE
dccdadacbbcaaccdbdabbbcbcbbbabacacccb	FALSE
ddbbdbdcbabccaadbdaabcabccdddbadbdaab	FALSE
aaaaaaadbabcdcabcbbacaaccccaacdabdccdda	TRUE
aabddbdddadcbdddbabcbbbcddbabaabdadcbad	TRUE
abababcadaccaacbabdbabaccaabcacacdbdbbc	TRUE
abcdbacabbabbbacbdabbdddbadbccbbaccaadd	TRUE
acdddaacbdbaadbbadddbdddbbcccbccbcacdaa	TRUE
adaadcbdbcbccabcdadbbdcadaaaaddbdbbccaa	TRUE
adbddaacaccaabddabbaacdbdbbdcbccaacbbdb	TRUE
addddaaddbcabdbbcdabddcbabdaddaadabdbbd	TRUE
babdabcadbccbccdabababacbcaaacbcdaabcbb	TRUE
baddabccbcaabbbacacbadbcabdccabdddbbbcb	TRUE
bbbbdabacaabbcbdcabbdbcbcabdbdbdaddcbaa	TRUE
bbddbcbbabbabadddbccccaaccbadcbbddabbaa	TRUE
bcdabdabdcbbadcaccabbbbbbbadcccaaccabac	TRUE
bdbabdbbdaacbccaccddbbddcdbbcbaabddaccc	TRUE
bddadaabcaabcaadbbbdbdddbadbbacdcdcabcc	TRUE
caaabcbaaccdacddbaddbaddabdadccadadbada	TRUE
cbacdacaaccbadacabaaaabccbdaddaccbacbcb	TRUE
ccbabbaccabcdcbcdadbbabaadcaadbccaccccb	TRUE
cadaabbbabddbdabbdcbddaadbddbdaddacdbac	TRUE
dabdadaddabaddbdcdcbcdbdbacaacadbabaaad	TRUE
dadddcabccabcdbccbabcbbbbabcbbcccacbdcd	TRUE
dbbdacbcbaddaaddadaaadcdbddbccccabbbbad	TRUE
dbdddacdadaabbaadddbddbcadbdbabdcacccad	TRUE
ddaadbbabdddacaccbabdbddcdbcbcbcabdaaac	TRUE
ddbdccabaaddcdcbbbccacadbabdabadcbccbcc	TRUE
aaaaaaadbabadcabcbbacaaccccaacdabdccdda	FALSE
aabddbdddadcbdddbabcbbbcddbabaabdadbbad	FALSE
abababcaaccaacbabdbabaccaabcacacdbdbbc	FALSE
abbdbacabbabbbacbdabbdddbadbccbbaccaadd	FALSE
adddaacbdbaadbbadddbdddbbcccbccbcacdaa	FALSE
adaadcbbbcbccabcdadbbdcadaaaaddbdbbccaa	FALSE
adbddaacaccaabddabbaacdbdbbdcbccaacbbbb	FALSE
addddaaddbcabdbbcdabddbbabdaddaadabdbbd	FALSE
babdabcadbccbccdabababacbcaaacbcaaabcbb	FALSE
baddabccbcaabbbacacbabbcabdccabdddbbbcb	FALSE
bbbbdabacaabbcbacabbdbcbcabdbdbdaddcbaa	FALSE
bbddbcbbabbabadddbccccaaccbaccbbddabbaa	FALSE
bcdabdabdcbbadcaccabbbbbbbacccaaccabac	FALSE
bdbabdbbdaacbccaccddbbddcbbbcbaabddaccc	FALSE
bddadaabcaabcaadbbbdbdddbadbbabdcdcabcc	FALSE
caaabcbaacccacddbaddbaddabdadccadadbada	FALSE
cbaccacaaccbadacabaaaabccbdaddaccbacbcb	FALSE
ccbabbaccabcdcbcdadbbabaaddaadbccaccccb	FALSE
dadaabbbabddbdabbdcbddaadbddbdaddacdbac	FALSE
dabdadaddabaddbdcbcbcdbdbacaacadbabaaad	FALSE
dadddcabccabcbccbabcbbbbabcbbcccacbdcd	FALSE
dbbdacbcbaddaaddadaaadcdbddbccccabbbbaa	FALSE
dbdddacdadaabbaadddbddbbadbdbabdcacccad	FALSE
ddaadbbabdddacaccbabdbddbdbcbcbcabdaaac	FALSE
ddbdccabaaddddcbbbccacadbabdabadcbccbcc	FALSE
aaaaaacdbbcadadaacbdabdbbaabadbbdadbbcca	TRUE
aabdddddcadcabcdddabbcabbbccccacabcccdab	TRUE
abaadddaddabaddbaadbaaacabadcabbadaaccbd	TRUE
abbdadddadcbadccaddaaddabdacdababbbdbdad	TRUE
acbbbdbcadbabdbbbdbbbadabcaddddaadcccacc	TRUE
adaaaacdbabacdbcaccbcabaaacbcbcababdbaab	TRUE
adbdabbbcdaddabbadbdbcbadacdadaababaabdd	TRUE
baaabccbadbddcccbbaaacabbadaabbcaabddcbb	TRUE
babdbbdaacadbbcccbbbdaddddbdcbddcbbaaacc	TRUE
bbaaacdccaacabdbbbaadccbbcdaaadcbbacaccc	TRUE
bbbdbcbddabbccbabdbdbddbbbadacaaaccdbdcc	TRUE
bcddcabcacdabbbbabdbcaacbaaabcabbccadada	TRUE
bdaabdadadcadcacabccbcdcbdbddcbcbaccaabb	TRUE
bdcddbaaaadcbcbbcbcbdabadaccabaacdbdacaa	TRUE
cbbddabdbadbabadaabccbacadaaaadaaddcddda	TRUE
cacacaddbbbdaababdcdbbdddabdacaddddaddbb	TRUE
cbcdbbaabdcbaadbddddaacaababadbddddabaad	TRUE
ccdbbdaacbaaaabdbcbbabaccababcbddbcaccbb	TRUE
daabdaaabdddabcddabcbaaabccabadabcacacdd	TRUE
dacdbabbbddbbadaccaadabbaccaddddacbbcaaa	TRUE
dbabadadabdddbcddbbacbcbdadcadbbadaadabc	TRUE
dbcabadabbababdccbbbbaddbbdabacaabcbbddd	TRUE
dcaacadbcdaadadabcbaabbccbbabaddbbddaadd	TRUE
ddaabbbcadabdbbdcdadddbbddbddbbaabaacddc	TRUE
ddbdbaccbbbaddaadaadcccaacaabadbcbdbbcaa	TRUE
aaaaaacdbbaadadaacbdabdbbaabadbbdadbbcca	FALSE
aabdddddcaacabcdddabbcabbbccccacabcccdab	FALSE
abaadddaddabaddbaadbaaacabadcabbaaaaccbd	FALSE
abbdadddadcbaaccaddaaddabdacdababbbdbdad	FALSE
aabbbdbcadbabdbbbdbbbadabcaddddaadcccacc	FALSE
adaaaacdbabacdbcaccbcabaaacbcbcababbaab	FALSE
adbdabbbcdaddabbadbdbcbaacdadaababaabdd	FALSE
baaabccbadbddcccbbaaacabbaaabbcaabddcbb	FALSE
babdbbdaacaabbcccbbbdaddddbdcbddcbbaaacc	FALSE
bbaaadccaacabdbbbaadccbbcdaaadcbbacaccc	FALSE
bbbdbabddabbccbabdbdbddbbbadacaaaccdbdcc	FALSE
bddcabcacdabbbbabdbcaacbaaabcabbccadada	FALSE
bdaabdadadcadcacabccbcdbdbddcbcbaccaabb	FALSE
bdbddbaaaadcbcbbcbcbdabadaccabaacdbdacaa	FALSE
bbddabdbadbabadaabccbacadaaaadaaddcddda	FALSE
cacacaddbbbdaababdbdbbdddabdacaddddaddbb	FALSE
cbcdbbaabdcbaadbddddaaaababadbddddabaad	FALSE
ccdbbdaabbaaaabdbcbbabaccababcbddbcaccbb	FALSE
daabdaaabdddabcddabcbaaabccabaabcacacdd	FALSE
dadbabbbddbbadaccaadabbaccaddddacbbcaaa	FALSE
dbabadadabdddbcddbbacbcbdadadbbadaadabc	FALSE
dbabadabbababdccbbbbaddbbdabacaabcbbddd	FALSE
dcaacadbddaadadabcbaabbccbbabaddbbddaadd	FALSE
ddaabbbdadabdbbdcdadddbbddbddbbaabaacddc	FALSE
ddbdbaccbbbaddaadaadcccaacaabadbcbcbbcaa	FALSE
aaaaaacdbaabacbabbbbbabbbbaabcdaadbacabbd	TRUE
aabdbcbbbdadcaadbcccbcbabdaabdacbbcbccabc	TRUE
aadddcaccbcbabbdaadbdacaabadcaacccbcabbad	TRUE
abbccbadadbbaaddacaacabacdaacdabdcbbaabcc	TRUE
abddcbccaabbbabaaabcaccdcbaabdaacaabcadca	TRUE
acddaccbdabdabaaadacaccbbbbcbbbacbcaabbda	TRUE
adcbbdaaaddbdadaadacbbbacaaddbdabdcdaddab	TRUE
baababaadacdddbaabddacddaaddcababdaabdaab	TRUE
babddccbbacdddadaaaacabddbbbcaccbbcbbdccb	TRUE
badddcadabdbabcbabacaacbdccccbaaacbaccadc	TRUE
bbbdcbadacacbccaacbabcbadaaccbcbddadbdbdd	TRUE
bcdadabbdddabbdaacabadcbabcaadbdaadbbadaa	TRUE
bdaaaaccbbcbaddbacacdbccbccabacbaabaddaad	TRUE
bdbdbadbaaadaaacadbadacbdadcaacbcbbddacac	TRUE
cbaabadbdcbbdacaddaaddbabbababacaabbbccab	TRUE
cacaaabcdcacbddababccbdbbbddddadaccabaabc	TRUE
cbccdcabcacbcaddacbcdadabbdddbbbcbabaaacb	TRUE
cccccabccddabdbbabcbddbbbccabbcbacbdbccaa	TRUE
daabaccadbcbcaccccabccabaadbacddbabdbcacb	TRUE
dacacbadacadbdbacdbadbadabbdaaabdadbdabcc	TRUE
dbaadbcddddcccabcccbadddbdbddadbaadddcadd	TRUE
dbcbaaaaaacbccadbddbdbadbcaabdcaaccbbbccd	TRUE
dcdbddcabccbbbcabcbabbbabbabdbacdbdbddbad	TRUE
ddaacaccacaaddadaabadbdacabacdabcaccdcbcb	TRUE
ddbdbbdcdcbcbcdabcbcbbbccbcbaccbacadaacbc	TRUE
aaaaaacdbaabacbabbbbbabbbbaabcdaadbacabb	FALSE
aabdbcbbbdadcaacbcccbcbabdaabdacbbcbccabc	FALSE
aadddcaccbcbabbdaadbdaaabadcaacccbcabbad	FALSE
abbccbadadbbaaddacaacabaccaacdabdcbbaabcc	FALSE
abddcbccaabbbabaaabcaccdcbaabcaacaabcadca	FALSE
acddaccbdabdabaaadacaccbbbbcbbbacbcaabbba	FALSE
adabbdaaaddbdadaadacbbbacaaddbdabdcdaddab	FALSE
baababaadacdddbaabddacddaaddaababdaabdaab	FALSE
babddccbbacdddadaaaababddbbbcaccbbcbbdccb	FALSE
badddcadabdbabcbabacaacbbccccbaaacbaccadc	FALSE
bbbdcbadacacbccaacbabcbaaaaccbcbddadbdbdd	FALSE
bdadabbdddabbdaacabadcbabcaadbdaadbbadaa	FALSE
bdaaaaccbbcbaddbacaccbccbccabacbaabaddaad	FALSE
bdbdbadbaaadaaacadbadabbdadcaacbcbbddacac	FALSE
baabadbdcbbdacaddaaddbabbababacaabbbccab	FALSE
cacaaabcbcacbddababccbdbbbddddadaccabaabc	FALSE
cbccacabcacbcaddacbcdadabbdddbbbcbabaaacb	FALSE
cccccabccddabdbbabcbddbbbccabbcbacbabccaa	FALSE
daabaccadbcbcaccccabccabaadbabddbabdbcacb	FALSE
dacacbadacadbdbaddbadbadabbdaaabdadbdabcc	FALSE
dbaadbcddddcccabcccbadddbdbddadbaadddadd	FALSE
dbcbaaaaaacbccadbddbdbadbcaabcaaccbbbccd	FALSE
dbdbddcabccbbbcabcbabbbabbabdbacdbdbddbad	FALSE
ddaacaccacaaddadaabadbdacabacabcaccdcbcb	FALSE
ddbdbbdccbcbcdabcbcbbbccbcbaccbacadaacbc	FALSE
aaaaaaaaccbcbcbcabdbaccbaccdabbacabbddbbbc	TRUE
aabdbddccccdadbacbbcdddcbabbaabacbcaadbaaa	TRUE
abaaacaaaabbabcacccabdddbaaccbcdcbbccddddd	TRUE
abbddcabcbabaabbccdacbbbbbdbbadcbddbddbacb	TRUE
acbbdbbdbddcbdbbbbadadacddbadbcaacbabccaac	TRUE
acdcddbcabcbbbcbacbacbabbaddddbaadbadddbca	TRUE
adbbdccabbddcccbcaacbbcbadbdddabccbdbbcabb	TRUE
adddbbbcccaadbcbacaaaaacbcbdbdbcccddaabccc	TRUE
babdbadabadadacabbdcbaabaaccadabccccddddbd	TRUE
baddbddcabbabbbababcaadabdcdddaacdcbaaabca	TRUE
bbbdabdbaacabccbcdcdbbcdaadabbadddddabdacb	TRUE
bbddabbabcacacbddcbbdcdadddababababdddbcac	TRUE
bcccbcccabbdbcadadbaddabdccaaaabcbcbbdadca	TRUE
bdbabbacbcaabdcbbbbbadbaaabcabcdbdabddaaca	TRUE
bddabbaaabacdbaaddcbbbaaadcaddbdddddacbabb	TRUE
cdbcbcbbcdddbbdbdaaddadddacdabdababbabddab	TRUE
cbabbcccccbdacccbbaccaacccbacaddbbbaccbcdc	TRUE
ccbaaccacbcaabbdacbccacbacdddabbdbdcdbacca	TRUE
daaaaabdbbdbddbbcbbcdadabdcddbdcadddaababc	TRUE
dabcbbcadbabdacbaabdadddbbcdbdbbdbdcaccbba	TRUE
dadddcddabccccabbdbaaabbdadbabbbcdddddbdac	TRUE
dbbdadadaaadddcddddbcaabbcccccdacabbaabdad	TRUE
dcbdddadbdbbbaaacbddbbcdaaaddabbcbbcaabbca	TRUE
ddabbaabacbabcccbbacbadaaddabacdbbcdbabdcc	TRUE
ddbdddbdcbacbbacddccbbcccdacddaddbaacabccc	TRUE
aaaaaaaaccbcbcbcabcbaccbaccdabbacabbddbbbc	FALSE
aabdbddccccdadbacbbcdddcbabbaabacbcaabbaaa	FALSE
abaaacaaaabbabcacccabdddbaaccbcccbbccddddd	FALSE
abbddcabcbabaabbccdadbbbbbdbbadcbddbddbacb	FALSE
aabbdbbdbddcbdbbbbadadacddbadbcaacbabccaac	FALSE
accddbcabcbbbcbacbacbabbaddddbaadbadddbca	FALSE
adbbdccabbddcccbcaacbbcbadbdddabccbcbbcabb	FALSE
adddbbbcccaabbcbacaaaaacbcbdbdbcccddaabccc	FALSE
babdbadabadadacabbacbaabaaccadabccccddddbd	FALSE
baddbddcabbabbbababcaadabddddaacdcbaaabca	FALSE
bbbdabdbaacabccbcccdbbcdaadabbadddddabdacb	FALSE
bbddabbabcacacbddcbbddadddababababdddbcac	FALSE
bcccbcccabbdbadadbaddabdccaaaabcbcbbdadca	FALSE
bdbabbacbcaabcbbbbbadbaaabcabcdbdabddaaca	FALSE
bddabbaaabacdbaaddcbbbaaadbaddbdddddacbabb	FALSE
bdbcbcbbcdddbbdbdaaddadddacdabdababbabddab	FALSE
cbabbcccccbdacccbbaccaacccbacaddbbbaccbcac	FALSE
ccbaaccacbcaabbaacbccacbacdddabbdbdcdbacca	FALSE
daaaaabdbbdbddbbcbbcdadabdcddbddadddaababc	FALSE
dabcbbcadbabdabbaabdadddbbcdbdbbdbdcaccbba	FALSE
dadddcddabccccabbdbaaabbdadbabbbadddddbdac	FALSE
dbbdadadaaadddcddddbcaabbcccccdaaabbaabdad	FALSE
dabdddadbdbbbaaacbddbbcdaaaddabbcbbcaabbca	FALSE
ddabbaabacbabcccbbacbadaaddabacbbcdbabdcc	FALSE
ddbdddbdcbacbbacddccbbcccdaddaddbaacabccc	FALSE
aaaaabdbabccbddabdcdbaccbaacbbacdbbbaaaccbb	TRUE
aabbddaacdcababacabbdadddadbabcdabcabaabcbb	TRUE
aadcccbccacbbacdadadbccbcacbccaddaabaadcbdc	TRUE
abbbaadcccacdcbbabcbbcbdabadbbadaadabcdbddd	TRUE
abdcdddbdbaaaabcbcddcabbbaccdddbbaaaaaadcbb	TRUE
accbabcbcbbbbdbaaddbadbaaadcacaacdbcaadbdcc	TRUE
adbaddadcdbaaadaaabbbdbaacacdcadacbbbcaaabb	TRUE
addddbbbccdbcccccbbbdaaabccaacbddcabcccccac	TRUE
babdaaaabdbdcabcccbbcacbccbbbbdcabcacdccadd	TRUE
baddbddbadadaadbacbabdcccdabbddcacdaaabbaac	TRUE
bbbbcacccadbbccccbddbbdaacdabadadccaacbccaa	TRUE
bbdcbcaaacdccbaabbdbdaadacaccabdbadabadaacb	TRUE
bccabdbadaadbbbacbcbabccabcadccabcdaadabccb	TRUE
bdadabbbdcbdacbdaddabddbbdabaadaadccacdcbbb	TRUE
bdcdadbdbaaabdbdcbadbbbadccbaadbdaaadccabcb	TRUE
cadbabbbdbddccdddabbbaaadbcaccacdbddaabadba	TRUE
cbabaaaddacccdbdddbadacabbcbcccacbccabcdbac	TRUE
ccbbbcacccbababdabbddbacadbcdbadadaadbccccc	TRUE
daaacccabccbaadbcaaadacbdbbbddbddaddddababa	TRUE
dabdbcacbccbcaaadccdbbbaabccacacabccdbbdbbd	TRUE
dbaabababbbcaddbbbbdddabaabbcadcbbabcccbdaa	TRUE
dbbdaccbbcccbcbbadccdabcbaabdddddbabbabbaad	TRUE
dbddddbbbaaacbbcbabdcddaadbbbbadbdcaccadcaa	TRUE
dcddbcaccaabdcbcaabbbbccabcbbccbaaadbadaadd	TRUE
ddbbbabadbabdcbcbacbccaddddccbdccacbccbbadc	TRUE
aaaaabdbabccbddabdddbaccbaacbbacdbbbaaaccbb	FALSE
aabbddaacdcababacabbdadddadbabadabcabaabcbb	FALSE
aadcccbccacbbacdadadbccbcacbccaddaabaadcbac	FALSE
abbbaadcccacdcbbabcbbcbdabadbbadaadabadbddd	FALSE
abdbdddbdbaaaabcbcddcabbbaccdddbbaaaaaadcbb	FALSE
accbabcbcbbbbdbaaddbadbaaadcacaacdbbaadbdcc	FALSE
adbaddadddbaaadaaabbbdbaacacdcadacbbbcaaabb	FALSE
addddbbbcccbcccccbbbdaaabccaacbddcabcccccac	FALSE
babdaaaabdbdcabcccbbcacbccbbbbdcabcacbccadd	FALSE
baddbddbadadaadbadbabdcccdabbddcacdaaabbaac	FALSE
bbbbcacccadbbccccbddbbdaadabadadccaacbccaa	FALSE
bbdcbcaaacbccbaabbdbdaadacaccabdbadabadaacb	FALSE
bccabdbadaadbbbacbcbabccabcaaccabcdaadabccb	FALSE
bdadabbbdcbcacbdaddabddbbdabaadaadccacdcbbb	FALSE
bdddadbdbaaabdbdcbadbbbadccbaadbdaaadccabcb	FALSE
badbabbbdbddccdddabbbaaadbcaccacdbddaabadba	FALSE
cbabaaaddacccdbdddbadacabbcbcccacbccabcabac	FALSE
ccbbbcacccbababdabbddbacadbddbadadaadbccccc	FALSE
daaacccabccbaadbcaaadaabdbbbddbddaddddababa	FALSE
dabdbcacbccbcaaacccdbbbaabccacacabccdbbdbbd	FALSE
dbaabababbbcaddbbbbdddabaabbcadcbbabcccbcaa	FALSE
dbbdaccbbcccbcbbabccdabcbaabdddddbabbabbaad	FALSE
dbddddbbbaaacbbcbabdcddaadbbbbadbdcaccaccaa	FALSE
dcddbcaccaabacbcaabbbbccabcbbccbaaadbadaadd	FALSE
ddbbbabadbabdcbcbacbccaddddccbdccacbccbbacc	FALSE
aaaaaaadcbabacbdbacadbadbacccdadabcbaaaabcaa	TRUE
aabdabdbbcacadabbcaaacbccabbacabaabdbacadbbb	TRUE
aaddaaabdbddddbdaacdcccbaccabbadddbccaccbccd	TRUE
abbbcbdbdbaadcbbabacaacacbddbdacaadbacbbabac	TRUE
abddaaabdbacbbbcabcbdcccbccaaddaadabacddabdb	TRUE
accddddbdbdacddabddbddbbbbbbcacbaabacbadbddc	TRUE
adbbdcaaacccbabddadbabbdbcdaddcbbbaacbbdbcac	TRUE
adddbaddcddbbbcbbadbdababddccacdaabcbbbccacc	TRUE
babbbbcaabacdbbdaadccacbcadddbdabbbbacabadab	TRUE
badbdaaddabacdaddcbaaabcbccaabbabccdaaabdcbd	TRUE
bbbbbbddacaaccabbbbcdbabccdddbdabbacbaadbabd	TRUE
bbddabbabaddcdbdbbbcbacbbacbdbbcacabdbbcbcaa	TRUE
bccbcaadadaababbabbdabddacdbabbacbaadaaaddcb	TRUE
bdbacacccdcabbcabcbabaabbbabacccadaabaacaddb	TRUE
bddbababbaaabcababdabcabdabdbdcaaccbcbadbabb	TRUE
caaccabbcccddbbabbababdadbbbaccbacdbbbdbabcd	TRUE
cbbcbccacababbabbccbadabaacadbddccbaccadaccc	TRUE
cccbccaaaadbbddbbbcbcadcaccccbdabbddbccbcbcc	TRUE
daabacacbcbcacdabcdbbcbbbccdbadbbaddabaadbca	TRUE
dabdcbabacaaadccaddbcaaacddabddbabdcbbaabcca	TRUE
dbaaddbdbabadaadddbcdababcdadbdadaacbbdaaddb	TRUE
dbbddcaddabbabbbddaaccdadbcbdcaacaabcbbbacbb	TRUE
dcddddaabbadbbcbbdadcaccccbadadbbdaddbadcbcb	TRUE
ddabaaabaacdcbcaccacbbdddbbdbadbdacccaccdbab	TRUE
ddbdddabddabdcccdddbbddbabbadcbbbdbaaddbdcad	TRUE
aaaaaaadcbabacbdbadadbadbacccdadabcbaaaabcaa	FALSE
aabdabdbbcacababbcaaacbccabbacabaabdbacadbbb	FALSE
aaddaaabdbddddbdaacdcccbaccabbadddbccaccbcc	FALSE
abbbcbdbdbaadcbbabacaacacbddbdaaaadbacbbabac	FALSE
abddaaabdbacbbbcabcbdcccbccaaddaadabaaddabdb	FALSE
accddddbdbdaddabddbddbbbbbbcacbaabacbadbddc	FALSE
adbbdcaaacccbabddadbabbdbcdaddcbbbaacbbbbcac	FALSE
adddbaddcddbbbcbbadbdababddccaccaabcbbbccacc	FALSE
babbbbcaabacdbbdaadccacbcadddbdabbbbacababab	FALSE
badbdaaddabacdaddcbaaabcbccaabbabccdaaabddbd	FALSE
bbbbbbddacaaccabbbbcbbabccdddbdabbacbaadbabd	FALSE
bbddabbabaddcdbdbbbcbacbbacbbbbcacabdbbcbcaa	FALSE
bccbcaadadaababbabbdabddadbabbacbaadaaaddcb	FALSE
bdbacacccdcabbcabcbabaabbbabacccadaabaaaddb	FALSE
bddbababbaaabbababdabcabdabdbdcaaccbcbadbabb	FALSE
caaccabbcccddbbabbababdadbbbaccbacdbbbdbabbd	FALSE
cbbcbccacababbabbccbadabaaaadbddccbaccadaccc	FALSE
cccbccaaaadbbddbbbcbcacaccccbdabbddbccbcbcc	FALSE
daabacacbcbcacdabcbbbcbbbccdbadbbaddabaadbca	FALSE
dabdcbabacaaabccaddbcaaacddabddbabdcbbaabcca	FALSE
dbaaddbdbabadaadddbcdababdadbdadaacbbdaaddb	FALSE
dbbddcaddabbabbbddaaccdadbbbdcaacaabcbbbacbb	FALSE
daddddaabbadbbcbbdadcaccccbadadbbdaddbadcbcb	FALSE
ddabaaabaacacbcaccacbbdddbbdbadbdacccaccdbab	FALSE
ddbdddabddabdcccdddbbddbabbadcbbbdbaaddbdca	FALSE
aaaaabdaaaccacbcaaaacddbcbbcabadbbaacacbcbddc	TRUE
aabbddbadabbbcdbbaadccbabcdbccacbbabdbaabcbca	TRUE
aadcdaddcbcbabbbccacaaadabadadabbcabcaaabcdaa	TRUE
abbbbcbbdbbbbadbcacbaacccccbdbacbccaddaaddabc	TRUE
abdbcbaddddcccbcaabbcabcaaccacacbddbbbacddbda	TRUE
accaaaacbdbcdaabaabbbbbddbdddabcdddbabdaabdbb	TRUE
adbadcbcaabddadcbbccbaadbacababbbabddbbddaaad	TRUE
addbdaadadbcdaabcabbacbbabbccbaccbdcbcbacdacc	TRUE
baadcbcccbbbabbbcdbbdddaaccbaabdabbaddbcdabdb	TRUE
badacbbcbcccabbbdadcacccbbbcaabcdbacbdccbcccb	TRUE
bbadcbacbddadbddadbddbdcdcaaacbbbcdabcbcbbcbb	TRUE
bbdbbbbabcbabdbccdcbcacbbacbbcdabcaacbabbaacb	TRUE
bcccbbbcccaccdbdadbcabcddcaacccbabbadbcaaabaa	TRUE
bdbcaaaacbccabcbadcaabcbbcacbcddbadccabcdbcba	TRUE
bdddadaaabaacdcccaccabbbdadcbabbaabbddabbcccb	TRUE
cabcacabccacaccacdcbaabddcccbdaddbbdbddabdbcc	TRUE
cbdaaccacbcbbaadbdddbdaabbabdbabdbdadbddcdddd	TRUE
cabdacaaabcbbacaabcacaaabdbdddccacbacbcacdabc	TRUE
dabadabacdcbcacbbacbcabbaaddbdadccbccbcdddddb	TRUE
dadacbcbddccaddaaabbabbadadddddbbaaddacbaadca	TRUE
dbaccabcbbcababbbbcacddbbddddaacdcabadbbbabad	TRUE
dbcddddbbbbcadbbddbbabacacbcaabbcaacbaacbddcb	TRUE
dcacbbddadbbdccddbdaaaaddadadaababbbdcbbdaaad	TRUE
ddacabbdaababbaaaccccbaabaadaaabaadbdcbbddbdb	TRUE
ddcbbbbacccacbacaaabaaccddbaaaadbadcdcdaddaad	TRUE
aaaaabdaaaccacbcaaaacddbcbbcabacbbaacacbcbddc	FALSE
aabbddbadabbbcdbbaadccbabcabccacbbabdbaabcbca	FALSE
aadddaddcbcbabbbccacaaadabadadabbcabcaaabcdaa	FALSE
abbbbcbbdbbbbadbcacbaacccccbabacbccaddaaddabc	FALSE
abdbcbaddddcccbcaabbcabcaaccacacbddbbbaddbda	FALSE
accaaaacbcbcdaabaabbbbbddbdddabcdddbabdaabdbb	FALSE
adbadcbcaabddadcbbccbaabbacababbbabddbbddaaad	FALSE
addbdaadadbbdaabcabbacbbabbccbaccbdcbcbacdacc	FALSE
baadcbcccbbbabbbcdbbdddaaccbaabdabbaddbbdabdb	FALSE
badacbbcbcccabbbdadcacccbbbcaabccbacbdccbcccb	FALSE
bbadcbacbddadbddadbddbdcacaaacbbbcdabcbcbbcbb	FALSE
bbdbbbbabcbabbbccdcbcacbbacbbcdabcaacbabbaacb	FALSE
bcccbbbcccaccdbdadbcabcddcaacccbabbacbcaaabaa	FALSE
bdbcaaaacbccabcbadcaabcbbcacbcddbadccabcbbcba	FALSE
bdddadaaabaadcccaccabbbdadcbabbaabbddabbcccb	FALSE
cabcacabccacaccacdbaabddcccbdaddbbdbddabdbcc	FALSE
cbdaaccacbcbbaadbdddbdaabbabdbabdbdadbdddddd	FALSE
dabdacaaabcbbacaabcacaaabdbdddccacbacbcacdabc	FALSE
dabadabaadcbcacbbacbcabbaaddbdadccbccbcdddddb	FALSE
dadacbcbddccaddaaabbabbadadddddbbaaddacbaabca	FALSE
dbaccabcbbcababbbbcacddbbddddaabdcabadbbbabad	FALSE
dbcddddbbbbdadbbddbbabacacbcaabbcaacbaacbddcb	FALSE
dcacbbddadbbdccddbdaaaaddadadaababbbddbbdaaad	FALSE
ddaaabbdaababbaaaccccbaabaadaaabaadbdcbbddbdb	FALSE
ddcbbbbacccacbacaaabaaccddbaaaadbadcdbdaddaad	FALSE
aaaaaaadbdcdbbaabccbdabdadadbdcccabcbcbddaaacb	TRUE
aabdacacbadadaabccabcbaaccddbbbacbcdacbabaaaab	TRUE
abaadddaaadaadcacbcaadadaddaaacbcbdcaacbcdccaa	TRUE
abbdcbaaaacdcabcbcccacddcabaaaabcababdabbcbacb	TRUE
acaaaabbddbdbcccbacacbccccbcdaacdcccacbbaaacca	TRUE
adabdabdbdbcbcacacccdaccdcccccbaadabbaddbabcbc	TRUE
adcaaaacbcacaacababddaccdbdabbcbdbabbadbaadbad	TRUE
baaadddacaccccadabdcaacbbadbaccbccaccadbadbabc	TRUE
babdcdbcacaabcabaadbacadabddbdadddaababbdbaaba	TRUE
bbaaddccdacbaaccccaabdbbcaacbbcbbaacccbabbbdab	TRUE
bbbdaaaaacadbdbbdcbbccdbbbdbdabddaabdcacbdacac	TRUE
bcddadaabbabadccbddbbbbabadcbdbcbaaaabcbcbcbbc	TRUE
bcbadbbbadbaddbdddaabaccddaadbbcdbbddabaddbbcc	TRUE
bdbbbcccbaaccbaacabadacaaaaabadbcababcabbadccc	TRUE
bddcbaaadbddbbdcccbbacbbddccbbbacbdbabcabcabbc	TRUE
cabbdbbdbdbddddabbbbdbcbccbbbccdbbaadddcddacbc	TRUE
cbcaccaabcdcacddddabababbccccdadadcacbacbbccba	TRUE
ccdbdabbadaabadadadbadbccbcaaadbcdacabcbcaccac	TRUE
daadddaddbddddbababbcdbdaabbccbabadbbdbdccddca	TRUE
daccccdaabddabacdbdbbaccacaababcbcabdbaabdbdaa	TRUE
dbabbcdccbaaabbbccabccbadcacccdadaaababdaccccb	TRUE
dbcbaadbbaaabbaddbbdaadabacbbcbdbcacacabbccddd	TRUE
dcdaaadbdcaaaddabddaddddadbbdaccbbabdbbbccccbc	TRUE
ddaababcababaadaaddbddbabdcabbbbbdbdcdbbbdabbb	TRUE
ddbdcbacccaabdcacacaddaadadabadaddddcabdaaccaa	TRUE
aaaaaaadbdbdbbaabccbdabdadadbdcccabcbcbddaaacb	FALSE
aabdacacbadadaabccabcbaaccddbbbacbccacbabaaaab	FALSE
abaadddaaadaadcacbcaadadaddaaacbcbbcaacbcdccaa	FALSE
abbdcbaaaacdcabcbcccacddcabaaaabcababcabbcbacb	FALSE
acaaaabbddbdbcccbacacbccccbcdaaadcccacbbaaacca	FALSE
adabdabdbdbcbcacacccdacccccccbaadabbaddbabcbc	FALSE
adcaaaacbcacaacababddaccdbdabbbdbabbadbaadbad	FALSE
baaadddacaccccadabdcaacbbaabaccbccaccadbadbabc	FALSE
babdcdbcacaabcabaabbacadabddbdadddaababbdbaaba	FALSE
bbaaddccdacbaaccccaabbbbcaacbbcbbaacccbabbbdab	FALSE
bbbdaaaaabadbdbbdcbbccdbbbdbdabddaabdcacbdacac	FALSE
bddadaabbabadccbddbbbbabadcbdbcbaaaabcbcbcbbc	FALSE
bdbadbbbadbaddbdddaabaccddaadbbcdbbddabaddbbcc	FALSE
bdbbbcccbaaccbaacabadabaaaaabadbcababcabbadccc	FALSE
bddbbaaadbddbbdcccbbacbbddccbbbacbdbabcabcabbc	FALSE
cabbdbbdbdbddddabbbbdbcbccbbbccdbbaaddddddacbc	FALSE
cbcaccaabcbcacddddabababbccccdadadcacbacbbccba	FALSE
ccdbdabbadaabadadadbadbccbcaaadbcacabcbcaccac	FALSE
daadddaddbddddbababbdbdaabbccbabadbbdbdccddca	FALSE
daccccdaabddabaddbdbbaccacaababcbcabdbaabdbdaa	FALSE
dbabbcdccbaaabbbccabccbaacacccdadaaababdaccccb	FALSE
dbbbaadbbaaabbaddbbdaadabacbbcbdbcacacabbccddd	FALSE
dadaaadbdcaaaddabddaddddadbbdaccbbabdbbbccccbc	FALSE
ddaababcababaadaaddbddbabdcabbbbbdbddbbbdabbb	FALSE
ddbdcbacccaabacacacaddaadadabadaddddcabdaaccaa	FALSE
aaaaacbcadcaddddbccbbaabaaaccbccdbbdaababdbcbca	TRUE
aabcabadabdabadabbdadbcdabcadbbadaddbaadccbbcca	TRUE
aadbdcabacaccbbaabbbccacddcddbcaabbbcbadabbdccc	TRUE
abbababaacbbbcbbcccbaccdbcaacdadabcababcccbddbc	TRUE
abdbaddcacbbaadddbbddcacacbddabccaabaacabbcabda	TRUE
accbcacbbcbcbabdaacbcaacacddbbccccbacbdadbdaaad	TRUE
adbbadcabcbdbddcacabbbcadbabbadaabcccabccbdcaac	TRUE
addadaaaacccbbcdaaabbdadadadbbbdcaadcdbbaabdaca	TRUE
babaabbabbabaaabdbdabadbcdbbdacabaaababdcaddabc	TRUE
badbabbcdaaadbabddcbdbabdadbdabcaaaaacaccadacbc	TRUE
bbbabbaadbcbbcdbababdaacbadccdabdaabbcaccccccac	TRUE
bbdabdaabdadddbcdbcadcacbbbaabaaaacccdbddabbdbd	TRUE
bcbccaaccaddbadabbcdbacbacbcbcaaabcbdddddabadda	TRUE
bdbaadcacdbadbabcbcababcabcbdacdbaaaabdbbbdadbc	TRUE
bddaabbdadccacbdbaddbdabddbbccbbcccbddabcbbaccd	TRUE
caabbbacdbababdacaabaadaaabcadbddaddbbddbbccccc	TRUE
cbbaabcadddcddbabaaaccacaccbcabdbdabdddadddccab	TRUE
ccbdbacbbbdabddbdbaaaadbccbaacabbcaadabaccbbbca	TRUE
daabbbbccbdcbccabbccccbcbabacccadbaaddbbcdbbcac	TRUE
dacabbbbaabaabdaadadddcdbcaaacdbadbddbdadcbabcb	TRUE
dbabbbbdccabcaaacdbccacbbbaabaacbdadcaaadaddaba	TRUE
dbbddbcbdddadacdbdbaaccbdacabbccabbcccccbcbabca	TRUE
dcabbcbbaddbcacaacbbdcbcacabcaddcbbabcbbcabaacc	TRUE
ddaadbcdbcacbcacaaaadddddcbcbacbbccbbbbabdababb	TRUE
ddbddbaadcddabaddadaddaaddcaccabbbcdccacaaddbbd	TRUE
aaaaacbcadaaddddbccbbaabaaaccbccdbbdaababdbcbca	FALSE
aababadabdabadabbdadbcdabcadbbadaddbaadccbbcca	FALSE
aadbdcabacaccbbaabbbccacdddddbcaabbbcbadabbdccc	FALSE
abbababaacbbbcbbcccbaccbbcaacdadabcababcccbddbc	FALSE
abdbaddcacbbaadddbbddcacacbddabccaabaacabbcabaa	FALSE
accbcacbbcbcbabaacbcaacacddbbccccbacbdadbdaaad	FALSE
adbbadcabcbdbddcacabbbcadbabbadaabcccabccbcaac	FALSE
addadaaaacccbbcdaaabbdadadadbbbdcaaddbbaabdaca	FALSE
babaabbabbabaaabdbdabadbcdbbdacabaaababacaddabc	FALSE
badbabbcdaaadbabdddbdbabdadbdabcaaaaacaccadacbc	FALSE
bbbabbaadbcbbcdbababdaacbaccdabdaabbcaccccccac	FALSE
bbdabdaabdadddbcdbbadcacbbbaabaaaacccdbddabbdbd	FALSE
bcbccaaccaddbadabbadbacbacbcbcaaabcbdddddabadda	FALSE
bdbaadcacdbadbabcbcababcabcbaacdbaaaabdbbbdadbc	FALSE
bddaabbdadccacbdbaddbdabddbbccbbcccbddabcbbaccc	FALSE
caabbbacdbababdabaabaadaaabcadbddaddbbddbbccccc	FALSE
cbbaabcadddaddbabaaaccacaccbcabdbdabdddadddccab	FALSE
ccbbbacbbbdabddbdbaaaadbccbaacabbcaadabaccbbbca	FALSE
daabbbbccbdcbccabbccccbcbabacccadbaaddbbadbbcac	FALSE
dacabbbbaabaabdaadadddddbcaaacdbadbddbdadcbabcb	FALSE
dbabbbbdccabcaaacdbccacbbbaabaacbdadbaaadaddaba	FALSE
dbbddbcbdddadaadbdbaaccbdacabbccabbcccccbcbabca	FALSE
dcabbcbbaddbcacaacbbacbcacabcaddcbbabcbbcabaacc	FALSE
ddaadbcbcacbcacaaaadddddcbcbacbbccbbbbabdababb	FALSE
ddbddbaadddabaddadaddaaddcaccabbbcdccacaaddbbd	FALSE
aaaaabadadaadbaccccbcacabcacddcaaabddbddbaddacbd	TRUE
aabcdbdbbdddbbbdbcbbabdcabcabacccbbcbabdcccbaaba	TRUE
aaddbddadccaabdabbbddbadbddddcaacbaaacabdbcbbccd	TRUE
abbbdcaaabbaaaacabbdaabaabbabdbaaaabdcdbcbcaacdd	TRUE
abddcabbacbbabbdaddabcbcaacabcabbdacadadaaabdcbb	TRUE
acdabadcdadddadbbaddaababbccbdabadddbdababaddada	TRUE
adbbaaabdccddbcbcbabbacbdabaccacaabbdbdbbadaabbb	TRUE
addbacacdadadddbabaadddadcbaaabaabcddadcbaccbcda	TRUE
baadbaddaabacaaaccadbdcbabdaabdddadcadabacaabcac	TRUE
bacdaadbbbbdbbacabbddbdbdcbbaccaacbadabbdaabbdab	TRUE
bbabaaddbccaaadcbaabacbaaaacabbabaccabdcbacdacaa	TRUE
bbbdaccbbcbbcdcacaabaaaaaddbbaabcbccadcbcbababaa	TRUE
bcdbddcbaddadbaabbddbcaacdababbdbabbbddbdadcaabb	TRUE
bdababddbbacccdbddbbadbdccccdddbcdcabbccbcbbcbba	TRUE
bdbddabdddbadbdabadddccaccadaddbbbcccbbacdcbdcbb	TRUE
cdcadaadadbdddabbadabbdcbbbbbdbddaadadadcbacaaab	TRUE
cbaacabaaccacbccccaabbabcbcadacbbbdcbbcdabaacbcc	TRUE
ccbbbbccbccabbaabbadaabbbbaaaaadcbacdcabbbddbbaa	TRUE
daaabcbaabdcbaadaabadbaabddacbdddbadddacbbcbbaac	TRUE
dabdaacaccaadcbbbcbbabbccadbdcddcbbcbbbbccabbaba	TRUE
dbaaaabaccbbdaadbabbadbbbabadbaadacccaacacdccddd	TRUE
dbbdbbbacaaddaddbddbadcaddbcbbaaaabbabcaccddaddd	TRUE
dcadbcaabdabbddbdcddbddbddddaadabbdbbdabbcbababc	TRUE
ddaaddabcabcbddcdbabdddbaaccaddbbdbddbbddbbdcaca	TRUE
ddbccbbdabbbbdaddbabbbdcbadcaccbccbcadadddaadada	TRUE
aaaaabadadaadbaccccbcacabcacddcaaabddbddbaddacb	FALSE
aabcdbdbbdddbbbdbcbbabdcabcabacccbbcbabcccbaaba	FALSE
aaddbddadccaabdabbbddbadbddddcaacbaaacabdbcbbcc	FALSE
abbbdcaaabbaaaacabbdaabaabbabdbaaaabdddbcbcaacdd	FALSE
abddcabbacbbabbdaddabcbcaacabcabbdadadadaaabdcbb	FALSE
acdabadbdadddadbbaddaababbccbdabadddbdababaddada	FALSE
adbbaaabdccddbcbcbabbacbcabaccacaabbdbdbbadaabbb	FALSE
addbacacdadadddbabaadddadcbaaabaabcddadcbaccbcba	FALSE
baadbaddaabacaaaccadbdcbabdaabdddadcababacaabcac	FALSE
bacdaadbbbbdbbaabbddbdbdcbbaccaacbadabbdaabbdab	FALSE
bbabaaddbccaaadcbaabacbaaaacabbabaccabdcbacacaa	FALSE
bbbdaccbbcbbcdcacaabaaaaaddbbaabcbccacbcbababaa	FALSE
bbdbddcbaddadbaabbddbcaacdababbdbabbbddbdadcaabb	FALSE
bdababddbbacccdbddbbadbdccccdddbadcabbccbcbbcbba	FALSE
bdbddabdddbadbdabadddccaccadaddbbbcccbbacbcbdcbb	FALSE
adcadaadadbdddabbadabbdcbbbbbdbddaadadadcbacaaab	FALSE
cbaacabaaccacbccccaabbabcbcadadbbbdcbbcdabaacbcc	FALSE
ccbbbbccbccabbaabbadaabbbbaaaaadcbacbcabbbddbbaa	FALSE
daaabcbaabddbaadaabadbaabddacbdddbadddacbbcbbaac	FALSE
dabdaacaccaadcbbbcbbabbccadbdaddcbbcbbbbccabbaba	FALSE
dbaaaabaccbbdaadbabbadbbbabadbaadacccaacacbccddd	FALSE
dbbdbbbacaaddaddbddbadbaddbcbbaaaabbabcaccddaddd	FALSE
daadbcaabdabbddbdcddbddbddddaadabbdbbdabbcbababc	FALSE
ddaaddabcabcbdddbabdddbaaccaddbbdbddbbddbbdcaca	FALSE
ddbccbbdabbbbdaddbabbbdcbaacaccbccbcadadddaadada	FALSE
aaaaadbcabbbabaaacdbbbdcacbabacdbdbbbaaaddbddcbdb	TRUE
aabbcbcaaadbdadddddcbbabacdbaaabbdbcbbbccaabdabbc	TRUE
aaddadcbaababcacabbcdccbadbbadabddaccbbddbdccbbca	TRUE
abbbabadbbbcacdddccaabbaabdabdbbbdadbddcdaaabdacc	TRUE
abdbababadddacbadaddabacddbdbbadaadbaabaaadaaacda	TRUE
acbcbdbbaadbaadbabadaacacabbaaacbdcddddbadcacaacb	TRUE
adbaacacccbbcccbbbbbbcddddddddcadaccaaabadadaddba	TRUE
addbabcdbcbbbccbbdacaccbacbdaacacacbacbabacabbcaa	TRUE
baadcaabdbcabcabacbccababbabbcabdaacaacbddbccbbac	TRUE
badbadadbbccbbcccdaccacbdcbccaabacacadacccbcacaba	TRUE
bbbabbabbdbdbaadbbaddbddbcdbbaaaabbcaabbdcadbbdcb	TRUE
bbdadcabccbabdbddbaadbdbbddbbbbcbddbabbbbbcaadabb	TRUE
bcbcababdbddcbbbcaadcbbbabcbcbdbabbbddababddaaadc	TRUE
bdadbcdbaccaaacaabaaaaaabbcccbabdbacccbddbddacbcc	TRUE
bddabbbbddabadddbbbbbbcbdbadcbdddacadababacaaacbc	TRUE
cdddadbddadbddadbabdabdbcbadaadbaddddabccbcdbcaba	TRUE
cbbbbcccbaccabdbddababbabadadcdaabdbcbaaaaacadbad	TRUE
ccccdbbdddbdbdaadaabaddbabcdbdaabccbaacbabaaadaaa	TRUE
daacacbbaabcccbabcaccccbdaaadbcbdadbddccbbcacadba	TRUE
dacbcaadcccabcbbabbddadddaadddaddaacdbaddadcbcbac	TRUE
dbaadbbbdbabdaabcccaccdadcabbdacdbdabadbadbbdcaab	TRUE
dbbddbaacbaaaccbdaddbbaadbadddcaacbdbcadccabbbaab	TRUE
dcbaabbabdaaddbbdddbdaaaaaccaacbbdbbdaacbcccbdbbd	TRUE
ddaaccbaabdbbacbdadcccabababaaaabcbadcaaabbbaacca	TRUE
ddbdcdbcbddadbdadabdbbdbdcddbadddbadaabaababdaadd	TRUE
aaaaadbcabbbabaaacdbbbdcacbabacdbdbbbaaaddbddbbdb	FALSE
aabbcbcaaadbdadddddcbbabacdbaaabbdbcbbbccaabbabbc	FALSE
aaddadcbaababcacabbcccbadbbadabddaccbbddbdccbbca	FALSE
abbbabadbbbcacdddccaabbaabdabdbbbdadbddddaaabdacc	FALSE
abdbababadddacbadaddabaddbdbbadaadbaabaaadaaacda	FALSE
acbcbdbbaadbaadbabadaacacabbaaacbdddddbadcacaacb	FALSE
adbaacacccbbcccbbbbbbcddddddddaadaccaaabadadaddba	FALSE
addbabccbcbbbccbbdacaccbacbdaacacacbacbabacabbcaa	FALSE
baaddaabdbcabcabacbccababbabbcabdaacaacbddbccbbac	FALSE
badbadadbbccbbccccaccacbdcbccaabacacadacccbcacaba	FALSE
bbbabbabbdbdbaadbbaddbddbddbbaaaabbcaabbdcadbbdcb	FALSE
bbdadcabccbabdbddbaadbdbbddbbbbcbddbabbbbbaadabb	FALSE
bcbcababdbddcbbbcaaccbbbabcbcbdbabbbddababddaaadc	FALSE
bdadbcbbaccaaacaabaaaaaabbcccbabdbacccbddbddacbcc	FALSE
bddabbbbddabadddbbbbbbcbdbadcbdddadadababacaaacbc	FALSE
adddadbddadbddadbabdabdbcbadaadbaddddabccbcdbcaba	FALSE
cbbbbcccbaccabdbddababbabadadddaabdbcbaaaaacadbad	FALSE
ccccdbbdddbdbdaadaabaddbabcdbdaabccbaacbabaaaaaa	FALSE
daacacbbaabcccbabcaccccbdaaadbcbdadbddccbbcacaaba	FALSE
dacbcaadcccabcbbabbddadddaadddaddaaadbaddadcbcbac	FALSE
dbaadbbbdbabdaabcccaccdadcabbdaadbdabadbadbbdcaab	FALSE
dbbddbaacbaaaccbdaddbbaadbadddcaacbbbcadccabbbaab	FALSE
dabaabbabdaaddbbdddbdaaaaaccaacbbdbbdaacbcccbdbbd	FALSE
ddaaccbaabdbbacbdadcccabababaaaabcbaccaaabbbaacca	FALSE
ddbdcbbcbddadbdadabdbbdbdcddbadddbadaabaababdaadd	FALSE
aaaaaabbdbbddbaabcdcabcabcacbcaacacdaaaaabbcaadcac	TRUE
aabbbdbcccaccaabbcacabacbdabacbccddcbabddaadaccbba	TRUE
aadcbdabbbdddbbaadddbdcdaddddcabdaabbbbdcbbcbaaabc	TRUE
abadbbdadbbadadcbbddaadbbbbdcabdcccbbaacaccddaaacb	TRUE
abcbaadcaaaabadccbcabbbacccdbaabdaaabcbcacbbbbccac	TRUE
acaccadababbbaddadcababcbacbaababadcaddabcaabaacac	TRUE
adacccaaacaadddbdbdcdaaabaccaccaacdabccacabcbbcbcc	TRUE
adccaacaabbcbcdbbbbaacdacaabcaccdaddbaddbdbbdaccba	TRUE
baabbadddcaacbbabacbbbcdabbabcdadaaadaaddcdbcacaab	TRUE
bacabccabbbbcdbcdddacbccaaababdbbdadbddddbbaaddadc	TRUE
bbabdaaabcdbcccbabddbbabbcccbcbcaccabbccdaadcbcbab	TRUE
bbcabcbdaabdbdbbdaaaddbadbdadcbdaabccabbaaacbdabbc	TRUE
bcabccbdadbabcbacacababdbbabccbcaaacccbdccbcaaaacb	TRUE
bdabdcadcacbccbcbccaadcccabbbabaabbadcabaababababc	TRUE
bdcaacbbcbbdbaacbcabacbcccdabbbbddcaccacaaabbabcbd	TRUE
cdaababdccbababbbcddcabcacddbabaddddddddccbcccacab	TRUE
cbabaacccaccaaadbaabccbaccabcadddabccbcaabcbddddbb	TRUE
ccadbddbbbbbdabcdabacaaabadbbbabbaaaccabaacaaabcbb	TRUE
daaabbaacdbabccdbbaacbabcbcbcaaadaabdbadaddaabccac	TRUE
dacaacaccdcacbcaaabbabcccabcdabbcdbaddbbabababccaa	TRUE
dbaabaacdddddadddcbaabbdbdbaddccbcddaadbbabacbbbab	TRUE
dbbbdbabbcababbdbddabbdcdaadddbddbbbcccbddbccbbabb	TRUE
dbdccaccccbaaadcbbcabacabaabccbcdbcbcabababcbaabdc	TRUE
ddaabddaaabadabbbddbccdaabcddaadbbadbdbdbbcaaadbaa	TRUE
ddbdbaaddadddbbcaccaacbdabbddbcbdabdbbadbddcdaacba	TRUE
aaaaaabbdbbddbaabcdcabcabcacbcaacaccaaaaabbcaadcac	FALSE
aabbbdbcccaccaabbcacabacbaabacbccddcbabddaadaccbba	FALSE
aadbbdabbbdddbbaadddbdcdaddddcabdaabbbbdcbbcbaaabc	FALSE
abadbbdadbbadadcbbddaadbbbbdaabdcccbbaacaccddaaacb	FALSE
abdbaadcaaaabadccbcabbbacccdbaabdaaabcbcacbbbbccac	FALSE
acaccadababbbaddadcababcbacbaababaddaddabcaabaacac	FALSE
adacccaaacaadddbdbddaaabaccaccaacdabccacabcbbcbcc	FALSE
adccaacaabbcbcbbbbaacdacaabcaccdaddbaddbdbbdaccba	FALSE
baabbadddcaacbbabacbbbcdabbabcdadaaadaadddbcacaab	FALSE
bacabccabbbbcabcdddacbccaaababdbbdadbddddbbaaddadc	FALSE
bbabdaaabcabcccbabddbbabbcccbcbcaccabbccdaadcbcbab	FALSE
bbcabcbdaabdbdbbdaaaddbadbdadcbdaabccabbaaacbaabbc	FALSE
bcabccbdadbabcbacacababbbabccbcaaacccbdccbcaaaacb	FALSE
bdabdcadcacbccbcbccaabcccabbbabaabbadcabaababababc	FALSE
bdcaacbbcbbdbaacbcabacbcccdabbbbddcaccacaaabbabcba	FALSE
adaababdccbababbbcddcabcacddbabaddddddddccbcccacab	FALSE
cbabaacccaccaaacbaabccbaccabcadddabccbcaabcbddddbb	FALSE
ccadbddbbbbbdabcdabacaaababbbbabbaaaccabaacaaabcbb	FALSE
daaabbaacababccdbbaacbabcbcbcaaadaabdbadaddaabccac	FALSE
dacaacaccdcacbcaaabbabcccabcdabbdbaddbbabababccaa	FALSE
dbaabaacdddddadddbaabbdbdbaddccbcddaadbbabacbbbab	FALSE
dbbbdbabbcababbdbddabbdbdaadddbddbbbcccbddbccbbabb	FALSE
dbdccaccccbaaadcbbcabacabaabccbccbcbcabababcbaabdc	FALSE
ddaabddaaabadabbbddbccdaabcddaadbbadbdbdbbcaaaabaa	FALSE
ddbdbaaddadddbbcaccaacbdabbddbbbdabdbbadbddcdaacba	FALSE
