aaaaaabdadbbdcacbabcadbbbdbdbcb	TRUE
aaadcaacdddadbdbadcbdbdddabccab	TRUE
aaabdbcaaababbadbbbabcabdbccbbb	TRUE
aaabbbbdcccbdddcdcddadcadcbcdac	TRUE
aaadaadbbabadbbdccccbbabdbadcbc	TRUE
aaabbadaaadbbbdccddbdaacacdbddd	TRUE
aaaadabdacdcdcdbcbcaacdaaaabcca	TRUE
aaaccdbbbcbadbaabcdaaaaacacccda	TRUE
aaacccccadccbdbadbcbdddbabdaadd	TRUE
aaaaabdabccccbbcbdbbabdacdbaddd	TRUE
aaaccdcdacdadbddcacbcbcabaddbdc	TRUE
aaacdbccaadddbdaabbdbababddacbd	TRUE
aaaddbdaaacdbadbcbaacddbabdbabc	TRUE
aaaddbdbacacabcaadabcdbddabdbbb	TRUE
aaaadddddbbcdbdbadacadccccddbac	TRUE
aaacccbbaccdaddacccccbaaacddada	TRUE
aaadccbcaacaddbcaccbaaacbcdadba	TRUE
aaadbdbaccbdaacbcadadbacabbabad	TRUE
aaabbbabaacabcadcabdbaaacaaacab	TRUE
aaaacbacacdbbacbbdcbbabbabbbbdc	TRUE
aaaccdcdcabaadcbcdcaaccbdbbdbdd	TRUE
aaacaadccabdacdcdaaabcbccabbcba	TRUE
aaaddadabbdabbbdddbdccadcbcaccb	TRUE
aaabdcacadcdbcadcdddadbdcdbcbdd	TRUE
aaabaaaabccbbcbcaaccdcdabdacdaa	TRUE
baaaaaabdadbbdcacbabcadbbbdbdbcb	FALSE
baaadcaacdddadbdbadcbdbdddabccab	FALSE
caaabdbcaaababbadbbbabcabdbccbbb	FALSE
daaabbbbdcccbdddcdcddadcadcbcdac	FALSE
aadaadbbabadbbdccccbbabdbadcbc	FALSE
abaabbadaaadbbbdccddbdaacacdbddd	FALSE
acaaadabdacdcdcdbcbcaacdaaaabcca	FALSE
acaaccdbbbcbadbaabcdaaaaacacccda	FALSE
adaacccccadccbdbadbcbdddbabdaadd	FALSE
aabaaabdabccccbbcbdbbabdacdbaddd	FALSE
aabaccdcdacdadbddcacbcbcabaddbdc	FALSE
aacacdbccaadddbdaabbdbababddacbd	FALSE
aadaddbdaaacdbadbcbaacddbabdbabc	FALSE
aaddbdbacacabcaadabcdbddabdbbb	FALSE
aabadddddbbcdbdbadacadccccddbac	FALSE
aabcccbbaccdaddacccccbaaacddada	FALSE
aacdccbcaacaddbcaccbaaacbcdadba	FALSE
aaddbdbaccbdaacbcadadbacabbabad	FALSE
ababbbabaacabcadcabdbaaacaaacab	FALSE
acaacbacacdbbacbbdcbbabbabbbbdc	FALSE
acaccdcdcabaadcbcdcaaccbdbbdbdd	FALSE
adacaadccabdacdcdaaabcbccabbcba	FALSE
baaddadabbdabbbdddbdccadcbcaccb	FALSE
caabdcacadcdbcadcdddadbdcdbcbdd	FALSE
daabaaaabccbbcbcaaccdcdabdacdaa	FALSE
aaaaaaabdbcbdcbddbaccabbabacacdc	TRUE
aaacbaaccdabcdbaacbcadcabcdcaaab	TRUE
aaaddaddbbccabcbcdabccaddbdcbaab	TRUE
aaabdaabccacdadaaaaaabcacbcbbacc	TRUE
aaabbddacabcccadcccdbdadbdcccadc	TRUE
aaabddbccabcbbbbddbacbdaaacdaadd	TRUE
aaabaccdbcadcabbacdcacaacbccdabc	TRUE
aaaacbdcdaddbbbaccbadadcdccdbccb	TRUE
aaabdabcdddbcacabdddcbcbcbcbcbad	TRUE
aaaacbaabcbcdbacddbcdddddbdabdca	TRUE
aaaaadbbacbddcdacbbddaddabcacddc	TRUE
aaacbaccabbbdbdbdcbdcdacdcacbcbd	TRUE
aaadddcbbbddcdabcdaacbabbacccaad	TRUE
aaadcdbcabbaabcdabddadaccdacaccd	TRUE
aaaadddccdabbaaccaacbdaacabbaaaa	TRUE
aaaaabcbcaacbdbbcddacabcdcccbacb	TRUE
aaacdbbbddbcdbddacbdaabbbbabbaaa	TRUE
aaadcacbcabaacaacbaddccdddcdbdac	TRUE
aaabcdadabcacddabcaabbdacbcadabc	TRUE
aaaadaabbddbddcababcabdbcacdaccb	TRUE
aaaccbcaddcbacaaabcaabcbbddaddab	TRUE
aaacabbdbcabdcadbccdcccddbbcdaaa	TRUE
aaadbbdbdbcaaccbaddbbadcdcdbdaaa	TRUE
aaadadccbbaabddadaadacbaacbaddcd	TRUE
aaaadaabbbbbdbbadcdbcdbaabcbcdab	TRUE
baaaaaaabdbcbdcbddbaccabbabacacdc	FALSE
baaacbaaccdabcdbaacbcadcabcdcaaab	FALSE
caaaddaddbbccabcbcdabccaddbdcbaab	FALSE
daaabdaabccacdadaaaaaabcacbcbbacc	FALSE
aabbddacabcccadcccdbdadbdcccadc	FALSE
abaabddbccabcbbbbddbacbdaaacdaadd	FALSE
acaabaccdbcadcabbacdcacaacbccdabc	FALSE
adaaacbdcdaddbbbaccbadadcdccdbccb	FALSE
aabdabcdddbcacabdddcbcbcbcbcbad	FALSE
aabaacbaabcbcdbacddbcdddddbdabdca	FALSE
aacaaadbbacbddcdacbbddaddabcacddc	FALSE
aacacbaccabbbdbdbdcbdcdacdcacbcbd	FALSE
aadadddcbbbddcdabcdaacbabbacccaad	FALSE
aadcdbcabbaabcdabddadaccdacaccd	FALSE
aabadddccdabbaaccaacbdaacabbaaaa	FALSE
aacaabcbcaacbdbbcddacabcdcccbacb	FALSE
aaccdbbbddbcdbddacbdaabbbbabbaaa	FALSE
aaddcacbcabaacaacbaddccdddcdbdac	FALSE
ababcdadabcacddabcaabbdacbcadabc	FALSE
acaadaabbddbddcababcabdbcacdaccb	FALSE
acaccbcaddcbacaaabcaabcbbddaddab	FALSE
adacabbdbcabdcadbccdcccddbbcdaaa	FALSE
baadbbdbdbcaaccbaddbbadcdcdbdaaa	FALSE
caadadccbbaabddadaadacbaacbaddcd	FALSE
daaadaabbbbbdbbadcdbcdbaabcbcdab	FALSE
aaaaabbcddbbbbbaddcbcdbcdcdbdbcdd	TRUE
aaaddbcbbcdcbdbcbdddcdbbabbaaacda	TRUE
aaadabbaaaadccacadbbadcdccabcbabb	TRUE
aaacacddbdbdaacbcdadddbbabbcdcaac	TRUE
aaacaaadbbdadcccadcddcbcddbbabccb	TRUE
aaabdbdabbdcaccbddaacbaccbaaddbcc	TRUE
aaaacdddbbcbcdbabdcaacbaacaccaadb	TRUE
aaaddcccadabcdcccbdbaddcbddaadbca	TRUE
aaacdcadbacdbcbaccabbcdaddaadaddd	TRUE
aaacddbaddbdabcaabacbbccaabddadaa	TRUE
aaaccbdacabddddccdccdabccdbcbadcc	TRUE
aaacbbacdbbbcdbaabacdadbbaacddaad	TRUE
aaabadbdcdcccddcddabbcaaabdcabdcc	TRUE
aaabadadbbbadaccabaaaabcccbbddbbc	TRUE
aaaabbbdaacddcacbaababaabadaccadb	TRUE
aaacdabaaadabddacbdddcddacbcbbcba	TRUE
aaaccbcccaadcdcdcdcababdcdddbacbb	TRUE
aaabdaadaadcdcbbacdbbabaabccbaadb	TRUE
aaabbdabbbbaaabbadbdbdcbabbdaddca	TRUE
aaabaaabdbbbdacddcbabbcbbbbbbabbb	TRUE
aaadddcaddababcabbcdcadcaccddadcd	TRUE
aaacdcdcaacbabbbabdacccdbccdcabab	TRUE
aaabdcbcdadaccaddccbdcadbdcabbada	TRUE
aaabaabadbadbcbcdccbddbdabdabadda	TRUE
aaaacbdcadaabbbddcbbacbdcdababacc	TRUE
baaaaabbcddbbbbbaddcbcdbcdcdbdbcdd	FALSE
baaaddbcbbcdcbdbcbdddcdbbabbaaacda	FALSE
caaadabbaaaadccacadbbadcdccabcbabb	FALSE
daaacacddbdbdaacbcdadddbbabbcdcaac	FALSE
aacaaadbbdadcccadcddcbcddbbabccb	FALSE
abaabdbdabbdcaccbddaacbaccbaaddbcc	FALSE
acaaacdddbbcbcdbabdcaacbaacaccaadb	FALSE
acaaddcccadabcdcccbdbaddcbddaadbca	FALSE
adaacdcadbacdbcbaccabbcdaddaadaddd	FALSE
aacddbaddbdabcaabacbbccaabddadaa	FALSE
aabaccbdacabddddccdccdabccdbcbadcc	FALSE
aacacbbacdbbbcdbaabacdadbbaacddaad	FALSE
aadabadbdcdcccddcddabbcaaabdcabdcc	FALSE
aabadadbbbadaccabaaaabcccbbddbbc	FALSE
aaaabbbdaacddcacbaababababadaccadb	FALSE
aabcdabaaadabddacbdddcddacbcbbcba	FALSE
aacccbcccaadcdcdcdcababdcdddbacbb	FALSE
aadbdaadaadcdcbbacdbbabaabccbaadb	FALSE
ababbdabbbbaaabbadbdbdcbabbdaddca	FALSE
acabaaabdbbbdacddcbabbcbbbbbbabbb	FALSE
acadddcaddababcabbcdcadcaccddadcd	FALSE
adacdcdcaacbabbbabdacccdbccdcabab	FALSE
baabdcbcdadaccaddccbdcadbdcabbada	FALSE
caabaabadbadbcbcdccbddbdabdabadda	FALSE
daaacbdcadaabbbddcbbacbdcdababacc	FALSE
aaaaaadbcdbdccdcdbbbdcbdbbdccccacd	TRUE
aaabdadbbdccdcdbcabdbbdabcdabccbac	TRUE
aaacbdbbccaabdbddaddcbcaadcaadabca	TRUE
aaaccaaabdbdacdbdbdbaacaaacbbbcaaa	TRUE
aaacbdbbbdacacdcabbdabbcccdbdcdaaa	TRUE
aaaabacbabdddbbcdddbdcdbababbadacd	TRUE
aaaacbcdcdccbdcdccabbacabbdcdccadb	TRUE
aaaddabbcabbaccccaabacdbbdbbabacab	TRUE
aaadacbabcdacbdcbdddabddcdabdcbbdb	TRUE
aaadccaabccdadcdbcaabdadacaaabbdbc	TRUE
aaabbcadbcbadadaacdbabbaadadcaccab	TRUE
aaacbccabcddbcadacbadabadcdbaddcaa	TRUE
aaacacdddcbaddcdcccabcaaacaadaddca	TRUE
aaacbbbbcdcaddbccaadbbdacddbbbdaac	TRUE
aaabcaddabababbcabbadaacdcabdcacbd	TRUE
aaadaadabacdabcaabdccaadcbcbbadcdb	TRUE
aaabacaabcdaabadccdaccddbdcbbaaaad	TRUE
aaaccabdabdccacbaaacdacdcaacbbbbaa	TRUE
aaaaccaaccbcdcadbacdadcbbaacbbacba	TRUE
aaaddacadddabbdcbaddcadbbbddccdbbc	TRUE
aaadabcdccddacbcabbbacdabcddaabdda	TRUE
aaabbdadacacdacbaccbcbdcbdbdcbaadc	TRUE
aaacbdcacaddadcaadbbbbcbcacdabcbdd	TRUE
aaaccaaacacabccbcdbcabbaddcccccacb	TRUE
aaaadadddcbbaddbbdcacabcbadbddcbbc	TRUE
baaaaaadbcdbdccdcdbbbdcbdbbdccccacd	FALSE
baaabdadbbdccdcdbcabdbbdabcdabccbac	FALSE
caaacbdbbccaabdbddaddcbcaadcaadabca	FALSE
daaaccaaabdbdacdbdbdbaacaaacbbbcaaa	FALSE
aacbdbbbdacacdcabbdabbcccdbdcdaaa	FALSE
abaaabacbabdddbbcdddbdcdbababbadacd	FALSE
acaaacbcdcdccbdcdccabbacabbdcdccadb	FALSE
acaaddabbcabbaccccaabacdbbdbbabacab	FALSE
adaadacbabcdacbdcbdddabddcdabdcbbdb	FALSE
aadccaabccdadcdbcaabdadacaaabbdbc	FALSE
aababbcadbcbadadaacdbabbaadadcaccab	FALSE
aacacbccabcddbcadacbadabadcdbaddcaa	FALSE
aadacacdddcbaddcdcccabcaaacaadaddca	FALSE
aacbbbbcdcaddbccaadbbdacddbbbdaac	FALSE
aaabcaddababababcabbadaacdcabdcacbd	FALSE
aabdaadabacdabcaabdccaadcbcbbadcdb	FALSE
aacbacaabcdaabadccdaccddbdcbbaaaad	FALSE
aadccabdabdccacbaaacdacdcaacbbbbaa	FALSE
abaaccaaccbcdcadbacdadcbbaacbbacba	FALSE
abaddacadddabbdcbaddcadbbbddccdbbc	FALSE
acadabcdccddacbcabbbacdabcddaabdda	FALSE
adabbdadacacdacbaccbcbdcbdbdcbaadc	FALSE
baacbdcacaddadcaadbbbbcbcacdabcbdd	FALSE
caaccaaacacabccbcdbcabbaddcccccacb	FALSE
daaadadddcbbaddbbdcacabcbadbddcbbc	FALSE
aaaaaadccbbbccacdccdbdddccbdacbbbca	TRUE
aaadadddaccdbbbcacadbbaaacdabadcaad	TRUE
aaabcdabdaadbcaabddcbbcababcadbbdda	TRUE
aaacbcacadacccdabcabbcdbacdaacbcacc	TRUE
aaacbdddcadcabdbddacaabaacbbbbababd	TRUE
aaabaaccbbcdbdaacbcdacaddccdcdcabad	TRUE
aaacabdabbbabdbdaaccbdbbaadbdccbbcc	TRUE
aaaabaddacadbadddcbbbabacdadacadbdb	TRUE
aaadbbdaacababacdbcaaaaddbcdcadaadd	TRUE
aaaacabcdddacadabdabddddcbdaaaaaddb	TRUE
aaadadcdbacbdddbbccaccbbaabdccddabb	TRUE
aaababaaadcbbdabbcbadbdcbadbdaddcbc	TRUE
aaacaadbaaddcacadababcbbcaccdadbbad	TRUE
aaaccabdcdddbcdbcdbddadabadbaaccbdb	TRUE
aaabdabacbddacaaadcaaababdddcccbacb	TRUE
aaabcdcaaaaddddcdadcdccccdcbcbdccac	TRUE
aaacdcdcabdbacadaadcaabacadcdbcacdb	TRUE
aaaabaaccddddaddaadbaaccdabcbccbbab	TRUE
aaaacacdacaadcaadcddccdabdbacdcbadc	TRUE
aaadbcacbdabbdbbbdbccabdcaacdcdccdd	TRUE
aaabdccdaadcbbcaccbdaacadadbdcdbcac	TRUE
aaabaadaabcccbbcddddcabadcacbbaacda	TRUE
aaacccbadadaabdadbacccbdcdaccadcdbb	TRUE
aaaabbdbccabbccbaaddbbbacadaaabcdbb	TRUE
aaaaacdadccaaadacbabcbcbbaaacdcdcdc	TRUE
baaaaaadccbbbccacdccdbdddccbdacbbbca	FALSE
baaadadddaccdbbbcacadbbaaacdabadcaad	FALSE
caaabcdabdaadbcaabddcbbcababcadbbdda	FALSE
daaacbcacadacccdabcabbcdbacdaacbcacc	FALSE
aacbdddcadcabdbddacaabaacbbbbababd	FALSE
abaabaaccbbcdbdaacbcdacaddccdcdcabad	FALSE
acaacabdabbbabdbdaaccbdbbaadbdccbbcc	FALSE
adaaabaddacadbadddcbbbabacdadacadbdb	FALSE
adaadbbdaacababacdbcaaaaddbcdcadaadd	FALSE
aabaacabcdddacadabdabddddcbdaaaaaddb	FALSE
aabadadcdbacbdddbbccaccbbaabdccddabb	FALSE
aacababaaadcbbdabbcbadbdcbadbdaddcbc	FALSE
aadacaadbaaddcacadababcbbcaccdadbbad	FALSE
aaccabdcdddbcdbcdbddadabadbaaccbdb	FALSE
aaabdababddacaaadcaaababdddcccbacb	FALSE
aabbcdcaaaaddddcdadcdccccdcbcbdccac	FALSE
aaccdcdcabdbacadaadcaabacadcdbcacdb	FALSE
aadabaaccddddaddaadbaaccdabcbccbbab	FALSE
abaacacdacaadcaadcddccdabdbacdcbadc	FALSE
abadbcacbdabbdbbbdbccabdcaacdcdccdd	FALSE
acabdccdaadcbbcaccbdaacadadbdcdbcac	FALSE
adabaadaabcccbbcddddcabadcacbbaacda	FALSE
baacccbadadaabdadbacccbdcdaccadcdbb	FALSE
caaabbdbccabbccbaaddbbbacadaaabcdbb	FALSE
daaaacdadccaaadacbabcbcbbaaacdcdcdc	FALSE
aaaaaaaaabcabcbccccbcadababacbcdacba	TRUE
aaacdbcdaacdbacbdcdaddccbaaacbdccacc	TRUE
aaacacabbdbabbbbabdadbbcdbcbbdaaaadc	TRUE
aaabbbcddcddbabbdacddcddbbbacbbbdddb	TRUE
aaabddddcccbaabcadacabacbdcccddaaaba	TRUE
aaaaddbcccdccddabdabbdbbccddbccddbdc	TRUE
aaaaccdbcdcaaadbbbdaaccadcdcdcaccbdb	TRUE
aaaddbdacbcbcadcdcaabbcddbcadaacabda	TRUE
aaadabacbddacddbbbcbdccaaaabccdbcdbb	TRUE
aaacdcabdabbdcbabdbddabdbcacababadab	TRUE
aaaccaddbcaadbbcdabdabcbbaaacccccbbb	TRUE
aaacbaaccddaacdcdcadbbbcccababdbacab	TRUE
aaaacdbdaacbdaacbdbbadccaccddabdcadd	TRUE
aaaddcdbabaacdccbdbbcacabcbaaadaddda	TRUE
aaababdbbbadcdbdabadcabddcbbcbabdaad	TRUE
aaadaaacdbbcdbbbbddcccccdbcbabcacbbc	TRUE
aaabdccabcdcacbaccdbbaacbbbccdddbdcb	TRUE
aaabbdcbbbbcdcddcaccaadbcaabadbacccd	TRUE
aaaabaddbdcaaababdbcaadcbaddbdacddac	TRUE
aaaabdadadddccbaabcbbccadbbdaacdbdcd	TRUE
aaadcadbbadaadadaddbdcaabbddacbdcbcd	TRUE
aaadadabcdaaaccadcbbbacaaacdadbdbaab	TRUE
aaabddaccdadbaabcdbdbaaaadadcaadabda	TRUE
aaaaddcdaababccbbdcbbbaddcdaddabdcbd	TRUE
aaaabaccadabcaabbccbcbbaddbdccbbcbda	TRUE
baaaaaaaaabcabcbccccbcadababacbcdacba	FALSE
baaacdbcdaacdbacbdcdaddccbaaacbdccacc	FALSE
caaacacabbdbabbbbabdadbbcdbcbbdaaaadc	FALSE
daaabbbcddcddbabbdacddcddbbbacbbbdddb	FALSE
aabddddcccbaabcadacabacbdcccddaaaba	FALSE
abaaaddbcccdccddabdabbdbbccddbccddbdc	FALSE
acaaaccdbcdcaaadbbbdaaccadcdcdcaccbdb	FALSE
acaaddbdacbcbcadcdcaabbcddbcadaacabda	FALSE
adaadabacbddacddbbbcbdccaaaabccdbcdbb	FALSE
aacdcabdabbdcbabdbddabdbcacababadab	FALSE
aabaccaddbcaadbbcdabdabcbbaaacccccbbb	FALSE
aacacbaaccddaacdcdcadbbbcccababdbacab	FALSE
aadaacdbdaacbdaacbdbbadccaccddabdcadd	FALSE
aadaddcdbabaacdccbdbbcacabcbaaadaddda	FALSE
aaababdbbbadcdbdabadcabddcbbababdaad	FALSE
aabdaaacdbbcdbbbbddcccccdbcbabcacbbc	FALSE
aacbdccabcdcacbaccdbbaacbbbccdddbdcb	FALSE
aadbbdcbbbbcdcddcaccaadbcaabadbacccd	FALSE
abaabaddbdcaaababdbcaadcbaddbdacddac	FALSE
acaabdadadddccbaabcbbccadbbdaacdbdcd	FALSE
acadcadbbadaadadaddbdcaabbddacbdcbcd	FALSE
adadadabcdaaaccadcbbbacaaacdadbdbaab	FALSE
baabddaccdadbaabcdbdbaaaadadcaadabda	FALSE
caaaddcdaababccbbdcbbbaddcdaddabdcbd	FALSE
daaabaccadabcaabbccbcbbaddbdccbbcbda	FALSE
aaaaacaadcaddbbdbbdacaadccaadccdcabdd	TRUE
aaabaadadcdacddbabbcaaabdbdbcbddadcba	TRUE
aaacbdccdcbdcaabdcdaddbbbdaddcaccbbbc	TRUE
aaacabcdbbbcaabdaaaccacabdbcccccacbdc	TRUE
aaabdbbbaddbbbbcbadccddbcbadbacbabdac	TRUE
aaabbcaccccabcbdcdaccbbbababddaabdcab	TRUE
aaabaacaddbabcbdaaacccbaabacacbcbcdbb	TRUE
aaadddacbaccbdddcccbaddbbddcbdcdddbdd	TRUE
aaadccbcccadaabdccbcdacccbbacdabdbcad	TRUE
aaaddcbcddcdaaabdacadcbcaadbcbabcaaca	TRUE
aaadddaaaccddbacbdcbdccbabbbabbacadbd	TRUE
aaacccadbcdcaddccacbcdddaabcadccccbca	TRUE
aaaacbbacbabddccbbabdbacccccbcabdccdc	TRUE
aaacadacbbddcbaccabdacdbadddbdccbcaab	TRUE
aaaaaababbacabbdbcbabadcacabcabbbbccb	TRUE
aaadaabcaddddbabacbcadddddccdddbaddca	TRUE
aaaccbbbbdabdcdcbbbbcccbdaccbdbdcdddc	TRUE
aaacacdaacdabdbadbabdbbdbbbdbadbcacda	TRUE
aaaadccadccdbaaabbdacbcabaadacbccdbda	TRUE
aaaacadbabcbcdcdcbbdbbbdabadbbcbdbadc	TRUE
aaabdccbaabbdabdaacccadbdacccdabdacda	TRUE
aaabcadaddabcaccabcdbacbbcccdbbcdcdcb	TRUE
aaadcaadbacaadcddcdbccdddcabccdbcddcc	TRUE
aaacdbcbaadcbdaaadcaacbabccbcdcdbbcdc	TRUE
aaaabacbacccabbdabcaadcabadccdacccbcb	TRUE
baaaaacaadcaddbbdbbdacaadccaadccdcabdd	FALSE
baaabaadadcdacddbabbcaaabdbdbcbddadcba	FALSE
caaacbdccdcbdcaabdcdaddbbbdaddcaccbbbc	FALSE
daaacabcdbbbcaabdaaaccacabdbcccccacbdc	FALSE
daaabdbbbaddbbbbcbadccddbcbadbacbabdac	FALSE
aabbcaccccabcbdcdaccbbbababddaabdcab	FALSE
abaabaacaddbabcbdaaacccbaabacacbcbcdbb	FALSE
acaadddacbaccbdddcccbaddbbddcbdcdddbdd	FALSE
adaadccbcccadaabdccbcdacccbbacdabdbcad	FALSE
aaddcbcddcdaaabdacadcbcaadbcbabcaaca	FALSE
aabadddaaaccddbacbdcbdccbabbbabbacadbd	FALSE
aacacccadbcdcaddccacbcdddaabcadccccbca	FALSE
aadaacbbacbabddccbbabdbacccccbcabdccdc	FALSE
aacadacbbddcbaccabdacdbadddbdccbcaab	FALSE
aaaaaababbacabbdbcbabadcacababbbbccb	FALSE
aabdaabcaddddbabacbcadddddccdddbaddca	FALSE
aacccbbbbdabdcdcbbbbcccbdaccbdbdcdddc	FALSE
aadcacdaacdabdbadbabdbbdbbbdbadbcacda	FALSE
abaadccadccdbaaabbdacbcabaadacbccdbda	FALSE
acaacadbabcbcdcdcbbdbbbdabadbbcbdbadc	FALSE
acabdccbaabbdabdaacccadbdacccdabdacda	FALSE
adabcadaddabcaccabcdbacbbcccdbbcdcdcb	FALSE
baadcaadbacaadcddcdbccdddcabccdbcddcc	FALSE
caacdbcbaadcbdaaadcaacbabccbcdcdbbcdc	FALSE
daaabacbacccabbdabcaadcabadccdacccbcb	FALSE
aaaaaaabcdccbbcbcccadbbccbddbbddcddbcc	TRUE
aaaaabadbcabbccdcacdccddcacbbbbdcddbca	TRUE
aaadcaddccaacdabdaacbacdcbbdbcccbaabbc	TRUE
aaacdcbadacacccbdbcbcdcbdbacdcddcabbab	TRUE
aaadadcbaacccaccdacddccbcaadcdcabdddba	TRUE
aaacddcababbadcbcacccbcbbaddbccadbcdca	TRUE
aaacbdadacadbabbcccbdbddcbddabacaadcab	TRUE
aaabccabacacdbdccdbcabcdcaddaacbcabbcb	TRUE
aaabcccbadbccdabbcbbaaabddcaddbdddadca	TRUE
aaaadbbbdbbbaaaabbaadbcaaabbaaaaccbacb	TRUE
aaaddcadbcdccbddccdaaadcabcbbddbabcaaa	TRUE
aaacdbccccdacbaddcbcdcadccbdcbcbdbadbd	TRUE
aaacaaaabbbdbdabababcabccdbbdcdbdbddab	TRUE
aaacbbdcacadcbdddcdbcaaddbbbddcddabbdd	TRUE
aaaaacacacacbdbcadcadabbacbbabcabddcba	TRUE
aaadcdcdbdbcbdadddbaccbdcbabbdbbabbaca	TRUE
aaadbdbccdccdabbaddaaabddcacbaddcbbbac	TRUE
aaacccadacdbdddacddddadadacdccdbdcaabd	TRUE
aaacacccaddcbcacabdbcddaccbdbcacaabbab	TRUE
aaabbcddaccadccbdcccccccdbcbdcddadcacd	TRUE
aaaacdcbaabbadcbabbbaabdadadaacbbcccbb	TRUE
aaadccbbcadcccdaaaaadadbabaadabdbaaabb	TRUE
aaacdabbbcdcccccbbbaadadcaaabdcadcaacd	TRUE
aaacabbbcccbcaccdbbacaabdaccaaccdcdaba	TRUE
aaabacccddcadcdcccaabdcacccdbccbbbddda	TRUE
baaaaaaabcdccbbcbcccadbbccbddbbddcddbcc	FALSE
caaaaabadbcabbccdcacdccddcacbbbbdcddbca	FALSE
caaadcaddccaacdabdaacbacdcbbdbcccbaabbc	FALSE
daaacdcbadacacccbdbcbcdcbdbacdcddcabbab	FALSE
aadadcbaacccaccdacddccbcaadcdcabdddba	FALSE
abaacddcababbadcbcacccbcbbaddbccadbcdca	FALSE
acaacbdadacadbabbcccbdbddcbddabacaadcab	FALSE
adaabccabacacdbdccdbcabcdcaddaacbcabbcb	FALSE
aabcccbadbccdabbcbbaaabddcaddbdddadca	FALSE
aabaadbbbdbbbaaaabbaadbcaaabbaaaaccbacb	FALSE
aabaddcadbcdccbddccdaaadcabcbbddbabcaaa	FALSE
aacacdbccccdacbaddcbcdcadccbdcbcbdbadbd	FALSE
aadacaaaabbbdbdabababcabccdbbdcdbdbddab	FALSE
aacbbdcacadcbdddcdbcaaddbbbddcddabbdd	FALSE
aabaacacacacbdbcadcadabbacbbabcabddcba	FALSE
aabdcdcdbdbcbdadddbaccbdcbabbdbbabbaca	FALSE
aacdbdbccdccdabbaddaaabddcacbaddcbbbac	FALSE
aadcccadacdbdddacddddadadacdccdbdcaabd	FALSE
abacacccaddcbcacabdbcddaccbdbcacaabbab	FALSE
acabbcddaccadccbdcccccccdbcbdcddadcacd	FALSE
adaacdcbaabbadcbabbbaabdadadaacbbcccbb	FALSE
adadccbbcadcccdaaaaadadbabaadabdbaaabb	FALSE
baacdabbbcdcccccbbbaadadcaaabdcadcaacd	FALSE
caacabbbcccbcaccdbbacaabdaccaaccdcdaba	FALSE
daabacccddcadcdcccaabdcacccdbccbbbddda	FALSE
aaaaaabcacdadcbbacddaddacdaddbdadaadbca	TRUE
aaadadaadbcbaadddcadcdabdcacdbccabcdaaa	TRUE
aaaccaccbccaddaacdbaadbadbdcdbababbbdda	TRUE
aaacaccacbbdabdcdacaadcdacabacabcabaaca	TRUE
aaacbcaaabcabbdcaabbbbcccabdbcbdbdddcbc	TRUE
aaabcbbacadcccccbadabdacbababbbcbbcdacc	TRUE
aaaadcbdbcddacbdacdcadadbbbaadcaacdacba	TRUE
aaaabcdccccabbccaabdabbaacbcbdbdaadbddc	TRUE
aaadccdaabaabdacadacdcdadcadddddacbbcbd	TRUE
aaaddddccbcbadabadacddcacaaabcbacdbcabc	TRUE
aaadacccbbbdaabcbaabcadadbbcccabcabaaca	TRUE
aaacdabcdabbbcacabaccbcdcbbaacaaccbaadb	TRUE
aaabdbdaadcbdbadbacdaabbbcddcaabdbadcdd	TRUE
aaabdddcadabcdbbabcbdcbdbaadaacabdaddcb	TRUE
aaadabcbcbdcddddccdaccdbbdcbababdbbdbba	TRUE
aaadaccddccaaaacadddcbaababcbbccdaacdad	TRUE
aaacdbdabaaabbddcdbcacadccddcbacaccddbd	TRUE
aaabdbaddabcbbadddddbbcabbbccbbdbbcbbbd	TRUE
aaabacbcdbbcaccdaccdbdcdcaacdcbdccadabb	TRUE
aaaaddccbcbadcadcddccbdabcdaacbccddabcd	TRUE
aaaaaabdccadcadbbdbcdcacdacacbdcadddbba	TRUE
aaacddcacdadacdabdbdbadcabdabbcdcacccbd	TRUE
aaaccbbaacaacbbbbdccdabdabdbcbcaddcdcbc	TRUE
aaacbcccbdccabcdddbbddabdbbaababcadbcab	TRUE
aaabacabcaddaaabdbbabddbbadaacdcbcdacaa	TRUE
baaaaaabcacdadcbbacddaddacdaddbdadaadbca	FALSE
baaadadaadbcbaadddcadcdabdcacdbccabcdaaa	FALSE
caaaccaccbccaddaacdbaadbadbdcdbababbbdda	FALSE
daaacaccacbbdabdcdacaadcdacabacabcabaaca	FALSE
aacbcaaabcabbdcaabbbbcccabdbcbdbdddcbc	FALSE
abaabcbbacadcccccbadabdacbababbbcbbcdacc	FALSE
acaaadcbdbcddacbdacdcadadbbbaadcaacdacba	FALSE
adaaabcdccccabbccaabdabbaacbcbdbdaadbddc	FALSE
adaadccdaabaabdacadacdcdadcadddddacbbcbd	FALSE
aaddddccbcbadabadacddcacaaabcbacdbcabc	FALSE
aabadacccbbbdaabcbaabcadadbbcccabcabaaca	FALSE
aacacdabcdabbbcacabaccbcdcbbaacaaccbaadb	FALSE
aadabdbdaadcbdbadbacdaabbbcddcaabdbadcdd	FALSE
aabdddcadabcdbbabcbdcbdbaadaacabdaddcb	FALSE
aaadababcbdcddddccdaccdbbdcbababdbbdbba	FALSE
aabdaccddccaaaacadddcbaababcbbccdaacdad	FALSE
aaccdbdabaaabbddcdbcacadccddcbacaccddbd	FALSE
aadbdbaddabcbbadddddbbcabbbccbbdbbcbbbd	FALSE
ababacbcdbbcaccdaccdbdcdcaacdcbdccadabb	FALSE
acaaddccbcbadcadcddccbdabcdaacbccddabcd	FALSE
adaaaabdccadcadbbdbcdcacdacacbdcadddbba	FALSE
adacddcacdadacdabdbdbadcabdabbcdcacccbd	FALSE
baaccbbaacaacbbbbdccdabdabdbcbcaddcdcbc	FALSE
caacbcccbdccabcdddbbddabdbbaababcadbcab	FALSE
daabacabcaddaaabdbbabddbbadaacdcbcdacaa	FALSE
aaaaabadbacaaddbadaabaacaddaadcccaaacbbc	TRUE
aaaddaaacabbbdbbbcaabdcdcadadbbbbdbddbdd	TRUE
aaadcbaabcbbdccdddcdcabcdbaaccdccdacaaab	TRUE
aaabaccbdcdddadbbccaadbcadddcbabdacbaabc	TRUE
aaabccabbaddadccdcbcacabdacdbdadabcbacda	TRUE
aaaccccdcddbcdcdadbabbbbccdbdcdccbdcbbdb	TRUE
aaaabaabdddcbddaadadaccaabcdddbabbcbcbbc	TRUE
aaadbadcdccbdcbcaddccaccabbcddbadccdcccc	TRUE
aaabcadbddaadcddacabaabbabbdccaaadcbdcdc	TRUE
aaabcbccacbbdbcbddcadadadddbbddbbccdbcab	TRUE
aaacaabcadcdcddbccdaadbcddadcbddcadcabbb	TRUE
aaaaabbbdbcadcbbbbdbcdcbbbbbbdbdbccbbbad	TRUE
aaadbbcbdbdaaccbabacdbbbdacdbadabddbadbd	TRUE
aaadbacaaacacacddbabacbcdacccbddadaabdba	TRUE
aaadbbccadaadbbcbadaccadccdcabacbddacdba	TRUE
aaacadbddbaadcacbabdadbacbcaacacaabdadcb	TRUE
aaaabdbacbabbdbccbbbdadbdddcdacbddbdddad	TRUE
aaaaabdccbdbcbbaaabaababbaddddbccdddbabb	TRUE
aaaaadbaccdadccacdddccdbcaccbccdcbcadccb	TRUE
aaaddacacccbbabadbaccbddcadcacbdaacdcbca	TRUE
aaabbadcdccdcbbbdbdbccacdddabddccdaccbdc	TRUE
aaacddaabcbdbcaddddddcacdcabdcabcbccbbcc	TRUE
aaacbdbdbadabadbbbbddcccacacbbbaaadbcdaa	TRUE
aaaabbaababbbbbcbacdadccbcbdbacbadaaabbd	TRUE
aaadddccacaadbbbbdcbaddaddadcabbcdacbdda	TRUE
baaaaabadbacaaddbadaabaacaddaadcccaaacbbc	FALSE
baaaddaaacabbbdbbbcaabdcdcadadbbbbdbddbdd	FALSE
caaadcbaabcbbdccdddcdcabcdbaaccdccdacaaab	FALSE
daaabaccbdcdddadbbccaadbcadddcbabdacbaabc	FALSE
aabccabbaddadccdcbcacabdacdbdadabcbacda	FALSE
abaaccccdcddbcdcdadbabbbbccdbdcdccbdcbbdb	FALSE
acaaabaabdddcbddaadadaccaabcdddbabbcbcbbc	FALSE
acaadbadcdccbdcbcaddccaccabbcddbadccdcccc	FALSE
adaabcadbddaadcddacabaabbabbdccaaadcbdcdc	FALSE
aabcbccacbbdbcbddcadadadddbbddbbccdbcab	FALSE
aabacaabcadcdcddbccdaadbcddadcbddcadcabbb	FALSE
aacaaabbbdbcadcbbbbdbcdcbbbbbbdbdbccbbbad	FALSE
aacadbbcbdbdaaccbabacdbbbdacdbadabddbadbd	FALSE
aadadbacaaacacacddbabacbcdacccbddadaabdba	FALSE
aadbbccadaadbbcbadaccadccdcabacbddacdba	FALSE
aabcadbddbaadcacbabdadbacbcaacacaabdadcb	FALSE
aacabdbacbabbdbccbbbdadbdddcdacbddbdddad	FALSE
aadaabdccbdbcbbaaabaababbaddddbccdddbabb	FALSE
abaaadbaccdadccacdddccdbcaccbccdcbcadccb	FALSE
abaddacacccbbabadbaccbddcadcacbdaacdcbca	FALSE
acabbadcdccdcbbbdbdbccacdddabddccdaccbdc	FALSE
adacddaabcbdbcaddddddcacdcabdcabcbccbbcc	FALSE
baacbdbdbadabadbbbbddcccacacbbbaaadbcdaa	FALSE
caaabbaababbbbbcbacdadccbcbdbacbadaaabbd	FALSE
caadddccacaadbbbbdcbaddaddadcabbcdacbdda	FALSE
aaaaacbbadaddcdaaacaadcadbbdbcbaddbacbaad	TRUE
aaacabcbbbcdaadbbddacdddcdbabbdcccbdabcbc	TRUE
aaadddccaacabbabcbbaacabcdbbaadcabcbcdaad	TRUE
aaabccbdcbabacacddaacbaacadbcccaccacddcaa	TRUE
aaadacbbcccbabdbbbabddabcbbdaaadcbdbacaba	TRUE
aaabbacdacdabbabaadaaababbbaabccddddddddd	TRUE
aaaadcadcaccdbdccbcbddabdabbdacbcacccacac	TRUE
aaacddcccababdddddddcaacadacaaabbbcdbcdcc	TRUE
aaadddcaacdcacaabadaccaccaaaddaaabbdabcab	TRUE
aaacbabadabbadbdbadbdbbcbcccacbbdbbccabca	TRUE
aaadacabaaabbdcabcdcdbaacccadcbdbddbddcad	TRUE
aaabdadabbbcadbdbdbbacccdddbbaaccbbcabcac	TRUE
aaabdcbbbbbddcacabaaadcacbabccabdcbbabddc	TRUE
aaabcddaabbccddcadcdaabcaadddcabacabcdbab	TRUE
aaacaacabdabcabacdabcbbabbabcccddbcababca	TRUE
aaadcaccbdccacabcaadaddbacccadcbabcdbdbab	TRUE
aaabcbdabdcaabddabcdacbbcddadadbddddacaba	TRUE
aaaacdcbbbcbabbcbbccbbbbbcacbccacbbdccacb	TRUE
aaaaabaadbbdddbcaddddbbcbbcbbabcccaddadcd	TRUE
aaaccadabddbdbccbddaacaaaacabdaccbabdabda	TRUE
aaacdcdbcaddcbdaabdabcbadbbbcaadbdbddcbaa	TRUE
aaacacdbddaddcbbcacaadcbbbdbbccccccbccaad	TRUE
aaadabadbbbadabdbadbddbbdbdadbdbabdbadcaa	TRUE
aaaaccbbbabcaaaaabdcababdadbaacdabccdcabc	TRUE
aaaabbaccdaaabbdaccdaadcccdbcdcacbadaccad	TRUE
baaaaacbbadaddcdaaacaadcadbbdbcbaddbacbaad	FALSE
baaacabcbbbcdaadbbddacdddcdbabbdcccbdabcbc	FALSE
caaadddccaacabbabcbbaacabcdbbaadcabcbcdaad	FALSE
daaabccbdcbabacacddaacbaacadbcccaccacddcaa	FALSE
aadacbbcccbabdbbbabddabcbbdaaadcbdbacaba	FALSE
abaabbacdacdabbabaadaaababbbaabccddddddddd	FALSE
acaaadcadcaccdbdccbcbddabdabbdacbcacccacac	FALSE
acaacddcccababdddddddcaacadacaaabbbcdbcdcc	FALSE
adaadddcaacdcacaabadaccaccaaaddaaabbdabcab	FALSE
aacbabadabbadbdbadbdbbcbcccacbbdbbccabca	FALSE
aabadacabaaabbdcabcdcdbaacccadcbdbddbddcad	FALSE
aacabdadabbbcadbdbdbbacccdddbbaaccbbcabcac	FALSE
aadabdcbbbbbddcacabaaadcacbabccabdcbbabddc	FALSE
aabcddaabbccddcadcdaabcaadddcabacabcdbab	FALSE
aaacaacabdabcabacdabcbbaababcccddbcababca	FALSE
aabdcaccbdccacabcaadaddbacccadcbabcdbdbab	FALSE
aacbcbdabdcaabddabcdacbbcddadadbddddacaba	FALSE
aadacdcbbbcbabbcbbccbbbbbcacbccacbbdccacb	FALSE
abaaabaadbbdddbcaddddbbcbbcbbabcccaddadcd	FALSE
abaccadabddbdbccbddaacaaaacabdaccbabdabda	FALSE
acacdcdbcaddcbdaabdabcbadbbbcaadbdbddcbaa	FALSE
adacacdbddaddcbbcacaadcbbbdbbccccccbccaad	FALSE
baadabadbbbadabdbadbddbbdbdadbdbabdbadcaa	FALSE
caaaccbbbabcaaaaabdcababdadbaacdabccdcabc	FALSE
daaabbaccdaaabbdaccdaadcccdbcdcacbadaccad	FALSE
aaaaabccbaaaabcdadadddcdbbddccdaaacadcbacd	TRUE
aaaccadcddcbbaaaacacadcacdbdbdddacbdbaacdc	TRUE
aaacdbadadcbdcbaadaacdbadbaddaaaabcabaaabd	TRUE
aaadcacdadcaabbabcbcbccadbaabbaaddabcadada	TRUE
aaacbbcbacdcdacdaadbdcccacadacdabddaadacac	TRUE
aaadbdcaaadadabcbbdcbbbacdaccbdacbdabbacab	TRUE
aaadacbcbcdddcacaaabdcbcddcacccaababdacada	TRUE
aaaadaddbbbadbbadcacaababadbdcbaccdbddddba	TRUE
aaaccbdcdbcdaddaadbcacbbbacccddacadabdcbcc	TRUE
aaaaacbbaaabbbdcdbdcbaadbaadbaddccddbbadca	TRUE
aaacdcbacaccdbbddadaccdbddbaaccacaaaadbbba	TRUE
aaadcabcdaabcbcdadbadbbabcaadbcbbbdcdcbaaa	TRUE
aaabccbcaabdabdcbacdcaabcbdacdddaacbaddcac	TRUE
aaabcbabbdacdacaddcaaaddadacbacccddadccabd	TRUE
aaabcbabaddaddaddabdadbbdbababadbabcaddadb	TRUE
aaaddabdcaaabddcdcccabcdbdcdaadcbcacbabdbc	TRUE
aaabcbcccaccdcbdcbaaacdabbcddadcaadbbdadba	TRUE
aaabbadaabddbddcacdbabdbabaaadcabcabddaaad	TRUE
aaaabccdabbbccaaacdcbcadbabdcaabbdccddacbc	TRUE
aaacccabdbbddbbadcddcabcaacccccccabddcbdbd	TRUE
aaaddddbcbabbcadbabbbaacdcbbabddbddbbbcacc	TRUE
aaadadaddcbcbcadaadbdbcddbabddaacaabccbaaa	TRUE
aaabcddaabdddaddbdcbdcbcacaadabacabacacacb	TRUE
aaaacbadbdbdcddcdacdddcbaddddcaababcbbbdbb	TRUE
aaaabbcaaddcbaddadadcbdbdcaabcdccbbbccdacb	TRUE
baaaaabccbaaaabcdadadddcdbbddccdaaacadcbacd	FALSE
baaaccadcddcbbaaaacacadcacdbdbdddacbdbaacdc	FALSE
caaacdbadadcbdcbaadaacdbadbaddaaaabcabaaabd	FALSE
daaadcacdadcaabbabcbcbccadbaabbaaddabcadada	FALSE
aacbbcbacdcdacdaadbdcccacadacdabddaadacac	FALSE
abaadbdcaaadadabcbbdcbbbacdaccbdacbdabbacab	FALSE
acaadacbcbcdddcacaaabdcbcddcacccaababdacada	FALSE
adaaadaddbbbadbbadcacaababadbdcbaccdbddddba	FALSE
adaaccbdcdbcdaddaadbcacbbbacccddacadabdcbcc	FALSE
aabaaacbbaaabbbdcdbdcbaadbaadbaddccddbbadca	FALSE
aabacdcbacaccdbbddadaccdbddbaaccacaaaadbbba	FALSE
aacadcabcdaabcbcdadbadbbabcaadbcbbbdcdcbaaa	FALSE
aadabccbcaabdabdcbacdcaabcbdacdddaacbaddcac	FALSE
aabcbabbdacdacaddcaaaddadacbacccddadccabd	FALSE
aaabcbabaddaddaddabdadbbdbababaababcaddadb	FALSE
aabddabdcaaabddcdcccabcdbdcdaadcbcacbabdbc	FALSE
aacbcbcccaccdcbdcbaaacdabbcddadcaadbbdadba	FALSE
aadbbadaabddbddcacdbabdbabaaadcabcabddaaad	FALSE
abaabccdabbbccaaacdcbcadbabdcaabbdccddacbc	FALSE
abacccabdbbddbbadcddcabcaacccccccabddcbdbd	FALSE
acaddddbcbabbcadbabbbaacdcbbabddbddbbbcacc	FALSE
adadadaddcbcbcadaadbdbcddbabddaacaabccbaaa	FALSE
baabcddaabdddaddbdcbdcbcacaadabacabacacacb	FALSE
caaacbadbdbdcddcdacdddcbaddddcaababcbbbdbb	FALSE
daaabbcaaddcbaddadadcbdbdcaabcdccbbbccdacb	FALSE
aaaaabbabbdbcabcadbdccbcdddcdbccbddccbbadad	TRUE
aaaccaadbdcdbaabadcccbcaccaccbcdaaabaabaaab	TRUE
aaacdaadcdcabdacdabcaddccacddccdbdbbbabcaba	TRUE
aaadcddadbbbccdacdaadaacbabccacddaddcaabaaa	TRUE
aaacbdcdadcccbabbbdbdaadaccaddadcbaadbaddca	TRUE
aaadccccbdacaacdddabbbbddadaabbcababbbddcac	TRUE
aaabdddbdacaacaaccdcbddbdddbdbbbbdccadcabac	TRUE
aaaadbbcbccaabbddbbcddddcbaaaabacddcadcccab	TRUE
aaaccdabbbbcccdcbbcdcdaccddbaabbacbbbdacaba	TRUE
aaaaabdbcadbcbbbbdbccbbddaabdacddbadbbdacbb	TRUE
aaacdacaacbabccbadccdbcbdadaadbcbaaddabdbdc	TRUE
aaadcacbdbcccbbbabbbbacbddaddddacdacdaccddd	TRUE
aaabcbbabadaccabdcaadccaadabbdbddbcdaabdacb	TRUE
aaabcbaadacbbdabdbadbbcacdcdaabdcaccadbbaba	TRUE
aaadcdababadcdbbbabccbdbdbbdadabdcabadaadcd	TRUE
aaadbccabadbabdbbabcdcbddacaadacbddbababaad	TRUE
aaabacccbadabddddbddddaaaddcaaaaacbdbbbbddc	TRUE
aaaabcbccdaaacddbccdabbaacacccacdbdbbcdbdcc	TRUE
aaaccbdbcdcdbccccadbcbddaaadbcdccbcdbaddcaa	TRUE
aaadccabcaaaabbaabbcabdbbadcaadbbbdaacbacda	TRUE
aaadacacdbdbadbaccabdacccdabadaabbacbbababb	TRUE
aaabdcbadcccccbdabbbcacbcaabadacccddaabdbaa	TRUE
aaabbabdacabaacabbddcdcacbbccdcabacabdbbbaa	TRUE
aaababadccddddacaddbddbabccaccdbaacbdbddadd	TRUE
aaaabbacadaacccccbbdabddbaabddbcadcbbaccddd	TRUE
baaaaabbabbdbcabcadbdccbcdddcdbccbddccbbadad	FALSE
baaaccaadbdcdbaabadcccbcaccaccbcdaaabaabaaab	FALSE
caaacdaadcdcabdacdabcaddccacddccdbdbbbabcaba	FALSE
daaadcddadbbbccdacdaadaacbabccacddaddcaabaaa	FALSE
aacbdcdadcccbabbbdbdaadaccaddadcbaadbaddca	FALSE
abaadccccbdacaacdddabbbbddadaabbcababbbddcac	FALSE
acaabdddbdacaacaaccdcbddbdddbdbbbbdccadcabac	FALSE
adaaadbbcbccaabbddbbcddddcbaaaabacddcadcccab	FALSE
adaaccdabbbbcccdcbbcdcdaccddbaabbacbbbdacaba	FALSE
aabaaabdbcadbcbbbbdbccbbddaabdacddbadbbdacbb	FALSE
aabacdacaacbabccbadccdbcbdadaadbcbaaddabdbdc	FALSE
aacadcacbdbcccbbbabbbbacbddaddddacdacdaccddd	FALSE
aadabcbbabadaccabdcaadccaadabbdbddbcdaabdacb	FALSE
aabcbaadacbbdabdbadbbcacdcdaabdcaccadbbaba	FALSE
aaadcdababadcdbbababccbdbdbbdadabdcabadaadcd	FALSE
aabdbccabadbabdbbabcdcbddacaadacbddbababaad	FALSE
aacbacccbadabddddbddddaaaddcaaaaacbdbbbbddc	FALSE
aadabcbccdaaacddbccdabbaacacccacdbdbbcdbdcc	FALSE
aadccbdbcdcdbccccadbcbddaaadbcdccbcdbaddcaa	FALSE
abadccabcaaaabbaabbcabdbbadcaadbbbdaacbacda	FALSE
acadacacdbdbadbaccabdacccdabadaabbacbbababb	FALSE
adabdcbadcccccbdabbbcacbcaabadacccddaabdbaa	FALSE
baabbabdacabaacabbddcdcacbbccdcabacabdbbbaa	FALSE
caababadccddddacaddbddbabccaccdbaacbdbddadd	FALSE
daaabbacadaacccccbbdabddbaabddbcadcbbaccddd	FALSE
aaaaabddbcaaaaaccbcbabddadbddababacdabaabcdd	TRUE
aaadcacacabdcdadddbcdcbcdadbbcbccababccaccdb	TRUE
aaaccdbdacdcdbbaccadcdacbbaabdcddcdcadcabbcd	TRUE
aaaccbbcacbccaacacacdadaadbcdacdbbadcbbcdbdb	TRUE
aaadaaccacdcdcdbdaccabbcdbdaacacacdaadbbbaab	TRUE
aaadacacbaaacbbcdcccdcdabcabcaddabcbcadbddbb	TRUE
aaacbcdcabcddadbbcbacbbdadabaaaccdcbbbbddadd	TRUE
aaabbdabcbcabcccdcddbaaabdacadcaababacdcadcb	TRUE
aaabdcdcabaababcbdddbcccbacaaccbbabdadcabcca	TRUE
aaabcbbbdacbdddccadccbbabcdbdcacdacadddbbbbd	TRUE
aaaadcbadcacbabddbbddbdbdbdadcbaacacbbaabdbc	TRUE
aaaabdababbbcbacbbacbdbbcdbbdaadcbdabbddabaa	TRUE
aaadadaaaacbbdcdbddbbcacdbbcdcabbdcaadccadcb	TRUE
aaadccbbacbabcadcaabcacccbcabbaacadddddcdcac	TRUE
aaabbcaacdcbbabddacabaaacbbaddaaaabbbdaaaaca	TRUE
aaaacaacdbdbabcbdcbbadbccbcbdacbdcaacdabdacb	TRUE
aaaddaddcaadacbbaaddddcbcdabaddaddaaacacbbbd	TRUE
aaacdabddbacaabdabdbcdcbdaacaacdcccaadbbdddd	TRUE
aaabdbdbadaccadadcdaacbabdddbbcadabaacadcddb	TRUE
aaaadaacbaccbdbacaddbccddadddbaccdaadadddddb	TRUE
aaaaadbaaabcccdcbcaacabccbbbdbadbaccaadccbca	TRUE
aaacdcaccbcbadcadbbaabacbdadcddcbababcdddbcd	TRUE
aaacaacbaccdcacdcbbbccdbddcdcdaabbbcdddbddbc	TRUE
aaabbddbcaabbbccddcaccddbbddacdcdbacbadacdcd	TRUE
aaaacbdbaadadbcbcbdcaaabbdcdcdaaadabdcbdccad	TRUE
baaaaabddbcaaaaaccbcbabddadbddababacdabaabcdd	FALSE
baaadcacacabdcdadddbcdcbcdadbbcbccababccaccdb	FALSE
caaaccdbdacdcdbbaccadcdacbbaabdcddcdcadcabbcd	FALSE
daaaccbbcacbccaacacacdadaadbcdacdbbadcbbcdbdb	FALSE
aadaaccacdcdcdbdaccabbcdbdaacacacdaadbbbaab	FALSE
abaadacacbaaacbbcdcccdcdabcabcaddabcbcadbddbb	FALSE
acaacbcdcabcddadbbcbacbbdadabaaaccdcbbbbddadd	FALSE
adaabbdabcbcabcccdcddbaaabdacadcaababacdcadcb	FALSE
aabdcdcabaababcbdddbcccbacaaccbbabdadcabcca	FALSE
aababcbbbdacbdddccadccbbabcdbdcacdacadddbbbbd	FALSE
aacaadcbadcacbabddbbddbdbdbdadcbaacacbbaabdbc	FALSE
aadaabdababbbcbacbbacbdbbcdbbdaadcbdabbddabaa	FALSE
aadadadaaaacbbdcdbddbbcacdbbcdcabbdcaadccadcb	FALSE
aadccbbacbabcadcaabcacccbcabbaacadddddcdcac	FALSE
aabbbcaacdcbbabddacabaaacbbaddaaaabbbdaaaaca	FALSE
aacacaacdbdbabcbdcbbadbccbcbdacbdcaacdabdacb	FALSE
aacddaddcaadacbbaaddddcbcdabaddaddaaacacbbbd	FALSE
aadcdabddbacaabdabdbcdcbdaacaacdcccaadbbdddd	FALSE
ababdbdbadaccadadcdaacbabdddbbcadabaacadcddb	FALSE
acaadaacbaccbdbacaddbccddadddbaccdaadadddddb	FALSE
adaaadbaaabcccdcbcaacabccbbbdbadbaccaadccbca	FALSE
adacdcaccbcbadcadbbaabacbdadcddcbababcdddbcd	FALSE
baacaacbaccdcacdcbbbccdbddcdcdaabbbcdddbddbc	FALSE
caabbddbcaabbbccddcaccddbbddacdcdbacbadacdcd	FALSE
daaacbdbaadadbcbcbdcaaabbdcdcdaaadabdcbdccad	FALSE
aaaaaadbabcdacccddababadaabcdbbbbcdacbbbbdcbc	TRUE
aaacabdcbcbdcadcbaaadacaccddbcadbadcccddcabbc	TRUE
aaabddacaaaabbaaabbaccaaadccdccbcdacabdaccacc	TRUE
aaadbbccdcbcccabcacbdabdaaacadbadbacadbdadccd	TRUE
aaadcdbccabdadbbacabdddcbbdcadbcbcdccdbcaccdc	TRUE
aaadabbcdbdbadabababbcbbadbbbbabdccbdbacbcaac	TRUE
aaaacccbcbaadbabddaddababdcacaaaddcbcddacccac	TRUE
aaaacbacacccccbcbbcdbadaaadccaaabcadbdaabdabc	TRUE
aaadabacacddbcdcaadadddcacdabdcabdcaaccadcdcb	TRUE
aaaadcbabdaabdbdccbccbadccbcababbdcddabaabddd	TRUE
aaaccaaccdddbbabcbcccddbdaabacbcaddabdbddccba	TRUE
aaabcaaddbcdccbcbbcabddcadbddbcbabaacdbcaccba	TRUE
aaababaaacabcdcbdcdcccdaacabcabcccddccbcbbaaa	TRUE
aaabcbcdaccabbbbabcaddbcaadbcabddadbccdbbcccd	TRUE
aaacdacdbcbaabdababcdaccaaabccddbccadcabcdbcd	TRUE
aaacaccbbabbabbbcacacbcbccbbccbddcdaccbbdbaba	TRUE
aaabbcbdabacadcaaacbbdccabcdaccaabdbbbdadcccc	TRUE
aaadccabbbbbdabdcbabacbcbcdbbbbbcadacababbbcc	TRUE
aaadabaadcabbaabadbccdbbabaabcccacddccadddaab	TRUE
aaaabbacbaccdcdcadbcccadcccaaabbbcdcaccaabaca	TRUE
aaaccacacaabadbadddcdaadadcabdcdbadbadcabdddd	TRUE
aaacacbccbaccbacddcacddbadadadddbdbcbdbaabdcd	TRUE
aaabdccadacdadacbadcdbdabbcadbabaccbdabaacdcb	TRUE
aaadadadabcbaaddabbabbadaadddbaabdacabddabaac	TRUE
aaaabaaccbaddcbdcdabdddbbcdabcbbbdabdbbddbabb	TRUE
baaaaaadbabcdacccddababadaabcdbbbbcdacbbbbdcbc	FALSE
baaacabdcbcbdcadcbaaadacaccddbcadbadcccddcabbc	FALSE
caaabddacaaaabbaaabbaccaaadccdccbcdacabdaccacc	FALSE
daaadbbccdcbcccabcacbdabdaaacadbadbacadbdadccd	FALSE
aadcdbccabdadbbacabdddcbbdcadbcbcdccdbcaccdc	FALSE
abaadabbcdbdbadabababbcbbadbbbbabdccbdbacbcaac	FALSE
acaaacccbcbaadbabddaddababdcacaaaddcbcddacccac	FALSE
adaaacbacacccccbcbbcdbadaaadccaaabcadbdaabdabc	FALSE
aadabacacddbcdcaadadddcacdabdcabdcaaccadcdcb	FALSE
aabaadcbabdaabdbdccbccbadccbcababbdcddabaabddd	FALSE
aabaccaaccdddbbabcbcccddbdaabacbcaddabdbddccba	FALSE
aacabcaaddbcdccbcbbcabddcadbddbcbabaacdbcaccba	FALSE
aadababaaacabcdcbdcdcccdaacabcabcccddccbcbbaaa	FALSE
aabcbcdaccabbbbabcaddbcaadbcabddadbccdbbcccd	FALSE
aaacdacdbcbababdababcdaccaaabccddbccadcabcdbcd	FALSE
aabcaccbbabbabbbcacacbcbccbbccbddcdaccbbdbaba	FALSE
aacbbcbdabacadcaaacbbdccabcdaccaabdbbbdadcccc	FALSE
aaddccabbbbbdabdcbabacbcbcdbbbbbcadacababbbcc	FALSE
abadabaadcabbaabadbccdbbabaabcccacddccadddaab	FALSE
acaabbacbaccdcdcadbcccadcccaaabbbcdcaccaabaca	FALSE
acaccacacaabadbadddcdaadadcabdcdbadbadcabdddd	FALSE
adacacbccbaccbacddcacddbadadadddbdbcbdbaabdcd	FALSE
baabdccadacdadacbadcdbdabbcadbabaccbdabaacdcb	FALSE
caadadadabcbaaddabbabbadaadddbaabdacabddabaac	FALSE
daaabaaccbaddcbdcdabdddbbcdabcbbbdabdbbddbabb	FALSE
aaaaacacbdbdcbdbcbbddacbaaabdcabacdbbababdcbcd	TRUE
aaadcbdabdbadcdbdcbdccbbcbadcdcbdaddaaaabaacaa	TRUE
aaadabdbbbdbddbcbddbdcbbbddacdbcbbacddbaaacdda	TRUE
aaabbadbdccadbbccbbdcbbcbdacadddcbaccaacddacac	TRUE
aaabdddabbbccdcadcbdbcbbbbbcbddcacaacadddccbdc	TRUE
aaabadcccdbddbdcabbcdaddbabcbdbcadbcbcabbabcdd	TRUE
aaacadbabadbddcbbcbcadbdbccaddbcbddcababbacddb	TRUE
aaaabcddadcdccabcaaabbbbbbabaabaaabdbccdbabdad	TRUE
aaacadadababbdbdbbdacdccdabcdbbdaacabcccbdbbad	TRUE
aaaabbacdadcbabbabdbdadccdcbbadddbabcacdcaccdc	TRUE
aaadbabccddbabcdbcbbacdbaaaaacdbdbcbbaabaccccc	TRUE
aaadcccdcbbbdccacddcbddcdcbbcbaaabdabacddddabb	TRUE
aaadacccdddcbbdacccbcbdccbdaaadbbbbcacadcaabbb	TRUE
aaadcdbcadbbbaccabcdddaadadacccbdbdbddbbccbacc	TRUE
aaaaadaddaddcacdcccdbbadaacdcdddacaadcdcdbaacc	TRUE
aaadbcddbcabdbcadcadbaaadaadddbaccdadbbadcacdd	TRUE
aaabbccddcdadbbbcbddbdaaddaaccdbcdaaddbccccaca	TRUE
aaabcbaaaddcbaccddddbbcbcabcaccdbacccdcbcbbcdc	TRUE
aaacbbcdbbddccacbbdbbacddcaaacbcdbddcdacccdaad	TRUE
aaaaddadcdadabcadcaacdaacacadaabadcbccbabcbbbd	TRUE
aaaabbaddbaadccaaaaaddaaabbbddaadaadbbadcbdacc	TRUE
aaaaabacbaddbcddccdcbdcadbddcdbbcddbacaaacabdc	TRUE
aaabdcbccbdabbcbcacddbaabbbbcababdccccddabbcad	TRUE
aaacbdbbddaadcaccbbdadcbddcbcdabadbcbbccdcaddb	TRUE
aaacaadcabdbabcaadacdcddbbddccadcdcbcbacdabaab	TRUE
baaaaacacbdbdcbdbcbbddacbaaabdcabacdbbababdcbcd	FALSE
baaadcbdabdbadcdbdcbdccbbcbadcdcbdaddaaaabaacaa	FALSE
caaadabdbbbdbddbcbddbdcbbbddacdbcbbacddbaaacdda	FALSE
daaabbadbdccadbbccbbdcbbcbdacadddcbaccaacddacac	FALSE
aabdddabbbccdcadcbdbcbbbbbcbddcacaacadddccbdc	FALSE
abaabadcccdbddbdcabbcdaddbabcbdbcadbcbcabbabcdd	FALSE
acaacadbabadbddcbbcbcadbdbccaddbcbddcababbacddb	FALSE
adaaabcddadcdccabcaaabbbbbbabaabaaabdbccdbabdad	FALSE
aacadadababbdbdbbdacdccdabcdbbdaacabcccbdbbad	FALSE
aabaabbacdadcbabbabdbdadccdcbbadddbabcacdcaccdc	FALSE
aabadbabccddbabcdbcbbacdbaaaaacdbdbcbbaabaccccc	FALSE
aacadcccdcbbbdccacddcbddcdcbbcbaaabdabacddddabb	FALSE
aadadacccdddcbbdacccbcbdccbdaaadbbbbcacadcaabbb	FALSE
aadcdbcadbbbaccabcdddaadadacccbdbdbddbbccbacc	FALSE
aabaadaddaddcacdcccdbbadaacdcdddacaadcdcdbaacc	FALSE
aabdbcddbcabdbcadcadbaaadaadddbaccdadbbadcacdd	FALSE
aacbbccddcdadbbbcbddbdaaddaaccdbcdaaddbccccaca	FALSE
aadbcbaaaddcbaccddddbbcbcabcaccdbacccdcbcbbcdc	FALSE
abacbbcdbbddccacbbdbbacddcaaacbcdbddcdacccdaad	FALSE
acaaddadcdadabcadcaacdaacacadaabadcbccbabcbbbd	FALSE
adaabbaddbaadccaaaaaddaaabbbddaadaadbbadcbdacc	FALSE
baaaabacbaddbcddccdcbdcadbddcdbbcddbacaaacabdc	FALSE
baabdcbccbdabbcbcacddbaabbbbcababdccccddabbcad	FALSE
caacbdbbddaadcaccbbdadcbddcbcdabadbcbbccdcaddb	FALSE
daacaadcabdbabcaadacdcddbbddccadcdcbcbacdabaab	FALSE
aaaaadabbcaacacddbdccbbabdbdaacbadbdbccdaddbada	TRUE
aaadaaacbdabbaabccdaaabbbddbcdcaacdbcdbbcbcbcac	TRUE
aaaccadccbcdabddccdaccabdbcbccbdbdcbcabcdbcbaba	TRUE
aaacdcccacddccbccaddadccaaddcddbbdcddcdadabcaad	TRUE
aaadccbacadacccddaadcdbacacccddadbcaaccbaaabdaa	TRUE
aaacdbcbdaddcbaabdbdadcbaddbbcaacaddcdabaabacdc	TRUE
aaacbccaddbdbbcabbbddbdcbbbcccdcbcdbcbbaaadbaca	TRUE
aaabdbcaccadbdbdaaccadabadbcddcddabbacdacaccbdb	TRUE
aaacbcbcabdccddadbdacaabcccadaccadcdcabbadcccdb	TRUE
aaabddbdbbaccacdbdbacadcdacaaddcddbcdacbadabccb	TRUE
aaabcaacdbbbbdbbbdccdacaabcbcacbdbbdaabdbabadcb	TRUE
aaabaccbabadddadddadbccdbccdbcdbcbccdbcabcbbdcd	TRUE
aaabbcacdcbcaaaccdabcccbaaccaacbbbbdbddbdabcadc	TRUE
aaaacabaabcdcccacdccccdababbcbbccddcdacacadbcdc	TRUE
aaabddacbccccbdcacbdbabccddadccbaacdcdcddbaccdc	TRUE
aaabaacbadbcbddcdaccabcaccbbaabacaccbaaccabbdbb	TRUE
aaadddaaacaacdcaaaadabbdbdacbbbacacdbaacacbdbba	TRUE
aaacdccdbcbbdabdbbbdbbabcbcbadaabcadadadadcaaaa	TRUE
aaabccbdbdacddaddcacaadaacaabbabbdaaabdbadbcaad	TRUE
aaaacbcdabbaadccbbabbbbadbcaadddcbbbdbdbbabbdbb	TRUE
aaadddbacbcdddbcbbdaabcbabbbdadcaddbdbcbbadacbd	TRUE
aaacdcbabaddcacadccbcbbbbcbdccdcadddabcdadbbbad	TRUE
aaacbbcacddaadbabdadcdbcabacddaccdddabaaddcccca	TRUE
aaabcbadbddadbddcdcdbaabbdaccabdaaccbbdbbacabcb	TRUE
aaaacdbddacdcabbdccdccdddaadbbaadabcbacbbaccaab	TRUE
baaaaadabbcaacacddbdccbbabdbdaacbadbdbccdaddbada	FALSE
baaadaaacbdabbaabccdaaabbbddbcdcaacdbcdbbcbcbcac	FALSE
caaaccadccbcdabddccdaccabdbcbccbdbdcbcabcdbcbaba	FALSE
daaacdcccacddccbccaddadccaaddcddbbdcddcdadabcaad	FALSE
aadccbacadacccddaadcdbacacccddadbcaaccbaaabdaa	FALSE
abaacdbcbdaddcbaabdbdadcbaddbbcaacaddcdabaabacdc	FALSE
acaacbccaddbdbbcabbbddbdcbbbcccdcbcdbcbbaaadbaca	FALSE
adaabdbcaccadbdbdaaccadabadbcddcddabbacdacaccbdb	FALSE
aacbcbcabdccddadbdacaabcccadaccadcdcabbadcccdb	FALSE
aababddbdbbaccacdbdbacadcdacaaddcddbcdacbadabccb	FALSE
aacabcaacdbbbbdbbbdccdacaabcbcacbdbbdaabdbabadcb	FALSE
aadabaccbabadddadddadbccdbccdbcdbcbccdbcabcbbdcd	FALSE
aabbcacdcbcaaaccdabcccbaaccaacbbbbdbddbdabcadc	FALSE
aaaababaabcdcccacdccccdababbcbbccddcdacacadbcdc	FALSE
aabbddacbccccbdcacbdbabccddadccbaacdcdcddbaccdc	FALSE
aacbaacbadbcbddcdaccabcaccbbaabacaccbaaccabbdbb	FALSE
aacdddaaacaacdcaaaadabbdbdacbbbacacdbaacacbdbba	FALSE
aadcdccdbcbbdabdbbbdbbabcbcbadaabcadadadadcaaaa	FALSE
ababccbdbdacddaddcacaadaacaabbabbdaaabdbadbcaad	FALSE
acaacbcdabbaadccbbabbbbadbcaadddcbbbdbdbbabbdbb	FALSE
acadddbacbcdddbcbbdaabcbabbbdadcaddbdbcbbadacbd	FALSE
adacdcbabaddcacadccbcbbbbcbdccdcadddabcdadbbbad	FALSE
baacbbcacddaadbabdadcdbcabacddaccdddabaaddcccca	FALSE
caabcbadbddadbddcdcdbaabbdaccabdaaccbbdbbacabcb	FALSE
daaacdbddacdcabbdccdccdddaadbbaadabcbacbbaccaab	FALSE
aaaaadbbaaababaacaadcabacbbcdcaccabacdaaacdbcbcd	TRUE
aaabcbcdacacabbadcabacabbcaccdccbcbbacbaabbddbdd	TRUE
aaabaaabbadccacddaaacadbadbadbabbbbdaabcddababdb	TRUE
aaadaabcdddbcabbccccbcaabbcbdbcdacadaadbcbddcdcb	TRUE
aaadccddcabbcabbdacdbaaacccbadddcbbddacdddbbdddd	TRUE
aaacbdadcadcdddbacbdaacabdadaadcbdcbaabaaccaccca	TRUE
aaacaadcddadcbaccadacbdaabbadacccddcadccaabaccca	TRUE
aaaacddbbaabdaaadacccabaccdccaccdaaddacadcaddacb	TRUE
aaabbbccdadddbababbdbdcaddbdbccabcbaadbdbbbdddbb	TRUE
aaaaabdcbcdcabdbdbdadcbbbdadcbaacbcdbccbbadbbbba	TRUE
aaabbacaddbdaccbccbcabdadbcaaaccbcddaddcbdaddabb	TRUE
aaabcabbccbbbdacbbbbbcddbacaccdbbdbdbbcbaabcaacc	TRUE
aaadcbdbbcbbdcddbbbcbbdabddacacbddcadbdbbbccabcc	TRUE
aaadbbccdbcbbbcbaadbcdadbacdddbcdbdacadadaabdada	TRUE
aaaacdacdcabbcccbadcccdbadbbabacddaaadabccabaaab	TRUE
aaabcdaccbbbcddddcabaadadcdaaabbcdcbddadbbdccccd	TRUE
aaacbbcddcbdaccdccbbbaadbbdccdbcbdcdddbcbbbaaaac	TRUE
aaaccdbbcbcaadbadbadcacdbadaaabdddbabaacaadcabcc	TRUE
aaaadcaacaacbccdcaabdacacdacbcadacbdcadacbbcdbaa	TRUE
aaabbdabcbcbadbccbccbbdabcabaaadbaaaccbcdadadbaa	TRUE
aaabcadbddbccbacabddcdbbbddddadaaabcbcbbdccacbcc	TRUE
aaaddabaadbbcacbbcdbdabdabdabdaaaaccabddbaadbdbc	TRUE
aaadcacbcdccdbddaabcdabbcacbdaccdcdabbccdbcdaabd	TRUE
aaaccbbbbccdcdaaaacabbbbdcaabdbbaaadcbaccdddbabc	TRUE
aaaadbbdbabacdbbbcacccbabaaacabaddbaaaadbaabadbb	TRUE
baaaaadbbaaababaacaadcabacbbcdcaccabacdaaacdbcbcd	FALSE
baaabcbcdacacabbadcabacabbcaccdccbcbbacbaabbddbdd	FALSE
caaabaaabbadccacddaaacadbadbadbabbbbdaabcddababdb	FALSE
daaadaabcdddbcabbccccbcaabbcbdbcdacadaadbcbddcdcb	FALSE
aadccddcabbcabbdacdbaaacccbadddcbbddacdddbbdddd	FALSE
abaacbdadcadcdddbacbdaacabdadaadcbdcbaabaaccaccca	FALSE
acaacaadcddadcbaccadacbdaabbadacccddcadccaabaccca	FALSE
adaaacddbbaabdaaadacccabaccdccaccdaaddacadcaddacb	FALSE
adaabbbccdadddbababbdbdcaddbdbccabcbaadbdbbbdddbb	FALSE
aabaaabdcbcdcabdbdbdadcbbbdadcbaacbcdbccbbadbbbba	FALSE
aababbacaddbdaccbccbcabdadbcaaaccbcddaddcbdaddabb	FALSE
aacabcabbccbbbdacbbbbbcddbacaccdbbdbdbbcbaabcaacc	FALSE
aadadcbdbbcbbdcddbbbcbbdabddacacbddcadbdbbbccabcc	FALSE
aadbbccdbcbbbcbaadbcdadbacdddbcdbdacadadaabdada	FALSE
aabacdacdcabbcccbadcccdbadbbabacddaaadabccabaaab	FALSE
aabbcdaccbbbcddddcabaadadcdaaabbcdcbddadbbdccccd	FALSE
aaccbbcddcbdaccdccbbbaadbbdccdbcbdcdddbcbbbaaaac	FALSE
aadccdbbcbcaadbadbadcacdbadaaabdddbabaacaadcabcc	FALSE
abaadcaacaacbccdcaabdacacdacbcadacbdcadacbbcdbaa	FALSE
ababbdabcbcbadbccbccbbdabcabaaadbaaaccbcdadadbaa	FALSE
acabcadbddbccbacabddcdbbbddddadaaabcbcbbdccacbcc	FALSE
adaddabaadbbcacbbcdbdabdabdabdaaaaccabddbaadbdbc	FALSE
baadcacbcdccdbddaabcdabbcacbdaccdcdabbccdbcdaabd	FALSE
caaccbbbbccdcdaaaacabbbbdcaabdbbaaadcbaccdddbabc	FALSE
daaadbbdbabacdbbbcacccbabaaacabaddbaaaadbaabadbb	FALSE
aaaaaddccccbcbadacdacbacccadaaadbbdadbbaabdbaccbb	TRUE
aaadaccaaadbbacaccdbccbbdcdbcdcacbbdaabacdabacdbb	TRUE
aaacaadbbbbcbcabacacbabadcddbdabbcadcbddacbddadac	TRUE
aaabcdddabadbcaadcdabcdcbabadbdccabacbbcbbbacbcba	TRUE
aaabbacadabadadcaaaadbcdbdcbdaabaddbdbaadbaadcccd	TRUE
aaabababcdbaddbcdadcaccadbacdddacacadcacdbccadcbc	TRUE
aaabadcdabacbadcacbdcddbdcccdcacbddcbbbabcaadcbcc	TRUE
aaaabdbdbabbaadaaaccbdcbadaacacdadadddbcdbadddabb	TRUE
aaababadcbbbccbaacddaddbcadcbbabbcdacabcbbccdcccd	TRUE
aaaacdbcdacdbdcbbadabadabbcdbbaccdbacaacbaaadaacc	TRUE
aaaddbcadbbdcbadcdaabbcaacadbcadbcabcadbddbbdcbab	TRUE
aaacccbaacbadbbdbbcdbbadaaabbcccabaababbaabddacad	TRUE
aaabddabcdccccbcaabadaaabdabbdcdcabbbbbaabdaadddd	TRUE
aaacbdadbbaaccdbadcdabdcddabcabbaccadaddcbbadcadb	TRUE
aaadacbcacbcddcabbdbabbdacdbccacdcaaacbadababadbd	TRUE
aaaccbaacbaddcbcadacbbccbdbcccdddbcdaccbcadccadca	TRUE
aaabddbcddddadcdcdddcaaabccbadaadccacdacdcadcddcd	TRUE
aaabadcdcdbaddaabdabacbcdbcdaaadadabaabdbbbdbcadd	TRUE
aaaabadbddaaaaaacdacdcabddbaabdaaccbcdacdacdaaddc	TRUE
aaadcdabcbbddbabacbadcadadbbcbbcbbbbddcabdcaaabbc	TRUE
aaaccdcabdcbcccdcaddaadbaaacdacdccacadbddabccadbc	TRUE
aaaccacdaadbbaddadcaaadcdbaccdabbddacdbddbabaabbc	TRUE
aaacabbcbbcdbdbbddbddbcadadbddccbbdcabbabdaabacab	TRUE
aaacabdcaadacbcaddbbadbabcbdbbabdbcaacdbdabcbbccc	TRUE
aaabaacdbbbddddccdadbcbabdbaabaccddcdccdbabbdbccd	TRUE
baaaaaddccccbcbadacdacbacccadaaadbbdadbbaabdbaccbb	FALSE
baaadaccaaadbbacaccdbccbbdcdbcdcacbbdaabacdabacdbb	FALSE
caaacaadbbbbcbcabacacbabadcddbdabbcadcbddacbddadac	FALSE
daaabcdddabadbcaadcdabcdcbabadbdccabacbbcbbbacbcba	FALSE
aabbacadabadadcaaaadbcdbdcbdaabaddbdbaadbaadcccd	FALSE
abaabababcdbaddbcdadcaccadbacdddacacadcacdbccadcbc	FALSE
acaabadcdabacbadcacbdcddbdcccdcacbddcbbbabcaadcbcc	FALSE
adaaabdbdbabbaadaaaccbdcbadaacacdadadddbcdbadddabb	FALSE
aababadcbbbccbaacddaddbcadcbbabbcdacabcbbccdcccd	FALSE
aabaacdbcdacdbdcbbadabadabbcdbbaccdbacaacbaaadaacc	FALSE
aabaddbcadbbdcbadcdaabbcaacadbcadbcabcadbddbbdcbab	FALSE
aacacccbaacbadbbdbbcdbbadaaabbcccabaababbaabddacad	FALSE
aadabddabcdccccbcaabadaaabdabbdcdcabbbbbaabdaadddd	FALSE
aacbdadbbaaccdbadcdabdcddabcabbaccadaddcbbadcadb	FALSE
aaadacbcacbcddcabbdababbdacdbccacdcaaacbadababadbd	FALSE
aabccbaacbaddcbcadacbbccbdbcccdddbcdaccbcadccadca	FALSE
aacbddbcddddadcdcdddcaaabccbadaadccacdacdcadcddcd	FALSE
aadbadcdcdbaddaabdabacbcdbcdaaadadabaabdbbbdbcadd	FALSE
abaabadbddaaaaaacdacdcabddbaabdaaccbcdacdacdaaddc	FALSE
abadcdabcbbddbabacbadcadadbbcbbcbbbbddcabdcaaabbc	FALSE
acaccdcabdcbcccdcaddaadbaaacdacdccacadbddabccadbc	FALSE
adaccacdaadbbaddadcaaadcdbaccdabbddacdbddbabaabbc	FALSE
baacabbcbbcdbdbbddbddbcadadbddccbbdcabbabdaabacab	FALSE
caacabdcaadacbcaddbbadbabcbdbbabdbcaacdbdabcbbccc	FALSE
daabaacdbbbddddccdadbcbabdbaabaccddcdccdbabbdbccd	FALSE
aaaaaadbabdddccbbbabddcbdabccacabddddcabbdcbdbcbbb	TRUE
aaacbbcacdddbdcddcabccabdddcbbddabdaacdddccbbcddad	TRUE
aaabcccabaababccadcbabdbccdcbadcbddbcbccbaaadbadbc	TRUE
aaabbdaccddabdcaaacdbcaaaddbbabadddddbbcdabcccccdd	TRUE
aaabdabaccbbcdbbcaacbaaaaccaabcbddbacdcdbdbccaacba	TRUE
aaadbcbbaabacdabbcabdcbddadbacabbabbdbbadaadbbcaba	TRUE
aaaaccdbaacbabdddaabadabaadbddbdcdcbddcacbbabdaaab	TRUE
aaaaddcbccbdbddbbccaaadcdccbbdaaaaabddadddadcdaadb	TRUE
aaabcccdcabdbadbcadcdbbccbddddddddbaccabddcddddadc	TRUE
aaacacaccbccdadbadcbbbcbdbcaaacdcdadbbdccacbcdbabd	TRUE
aaabcbbaccdabacaddbddbacadbbbbdcacaaddccaadcdadbdd	TRUE
aaabaadbcbbccadbaddcbcbbbdadadacacbacdcaccdcdbbdac	TRUE
aaadbddcabddcbbbdaccabdccbcbccacaaacdababdadcadbdb	TRUE
aaadccdcdacbacbaacbbcabaadcbcdbdacbabadbbcaabbadda	TRUE
aaabbbadbdccbdaaaabaacddbaababdcbddbacdbadadacdddc	TRUE
aaabcccadbacdccacccadbacacdcdbadbadcdbdacadddaabbc	TRUE
aaababddbabccbbcccdcaacacaaacaaddcdadcaddadcbddbcd	TRUE
aaababbdcddcdacaaabacddaddaacbdabadcdbddbaaaadccdd	TRUE
aaaddddaadcbacbacaadbdccbdbddcadcaabaacccdadcabadd	TRUE
aaaacbdaabbdcbdcdabacdcbabdbdcccacbcdaddcbddbaacab	TRUE
aaaaacbaddabadcdbaddabcdacadbadcbdadbdaccccbacdbcd	TRUE
aaabcabcdcbadbcacbdaccccccbbbaddbccadaccdabbddcaad	TRUE
aaadccaddbadccaddcadbadbdadbabcbaabaabbadbbbdccabb	TRUE
aaaddaabcddbaacbbbcaaaaaaabacbabddcbcabbccacddacca	TRUE
aaaabdacdcacadddccacbdabccbdbdcabdbdaabbbbbcdcdcad	TRUE
baaaaaadbabdddccbbbabddcbdabccacabddddcabbdcbdbcbbb	FALSE
baaacbbcacdddbdcddcabccabdddcbbddabdaacdddccbbcddad	FALSE
caaabcccabaababccadcbabdbccdcbadcbddbcbccbaaadbadbc	FALSE
daaabbdaccddabdcaaacdbcaaaddbbabadddddbbcdabcccccdd	FALSE
aabdabaccbbcdbbcaacbaaaaccaabcbddbacdcdbdbccaacba	FALSE
abaadbcbbaabacdabbcabdcbddadbacabbabbdbbadaadbbcaba	FALSE
acaaaccdbaacbabdddaabadabaadbddbdcdcbddcacbbabdaaab	FALSE
adaaaddcbccbdbddbbccaaadcdccbbdaaaaabddadddadcdaadb	FALSE
adaabcccdcabdbadbcadcdbbccbddddddddbaccabddcddddadc	FALSE
aacacaccbccdadbadcbbbcbdbcaaacdcdadbbdccacbcdbabd	FALSE
aababcbbaccdabacaddbddbacadbbbbdcacaaddccaadcdadbdd	FALSE
aacabaadbcbbccadbaddcbcbbbdadadacacbacdcaccdcdbbdac	FALSE
aadadbddcabddcbbbdaccabdccbcbccacaaacdababdadcadbdb	FALSE
aadccdcdacbacbaacbbcabaadcbcdbdacbabadbbcaabbadda	FALSE
aaabbbadbdccbdaaababaacddbaababdcbddbacdbadadacdddc	FALSE
aabbcccadbacdccacccadbacacdcdbadbadcdbdacadddaabbc	FALSE
aacbabddbabccbbcccdcaacacaaacaaddcdadcaddadcbddbcd	FALSE
aadbabbdcddcdacaaabacddaddaacbdabadcdbddbaaaadccdd	FALSE
abaddddaadcbacbacaadbdccbdbddcadcaabaacccdadcabadd	FALSE
acaacbdaabbdcbdcdabacdcbabdbdcccacbcdaddcbddbaacab	FALSE
adaaacbaddabadcdbaddabcdacadbadcbdadbdaccccbacdbcd	FALSE
adabcabcdcbadbcacbdaccccccbbbaddbccadaccdabbddcaad	FALSE
baadccaddbadccaddcadbadbdadbabcbaabaabbadbbbdccabb	FALSE
caaddaabcddbaacbbbcaaaaaaabacbabddcbcabbccacddacca	FALSE
daaabdacdcacadddccacbdabccbdbdcabdbdaabbbbbcdcdcad	FALSE
