aaaaaadbbccdccbbdbac	FALSE
addaaadacadbabacdcbb	FALSE
aaaddaabcbbdbbaacdbb	FALSE
aaaaabccbcdbcdaddaad	FALSE
aaaadaddcadcaacdbddd	FALSE
aaaaaabbcaccdcbdbabb	FALSE
adaaaadbbbacdaaddacc	FALSE
aaaaadbbcadabbbcadda	FALSE
aaadaacaabcccabbabcd	FALSE
aaaaabaddbbccbcbdbba	FALSE
aaadadacabdbdadddadc	FALSE
aaaaabdaacbaaabbbcdd	FALSE
aaaaacdbacbbacdadbac	FALSE
aaaadaaacbdccbaaabdb	FALSE
aaaaadbcbadccdccdaaa	FALSE
aaaaacabdbaaacacbbaa	FALSE
aaadaaabdbcacadcbbba	FALSE
aaadadabdbabbbabcacb	FALSE
aaaaaddacadacdcddcda	FALSE
aaaaaddcbaddaaddbddb	FALSE
aaddadaaaccdbaabcccc	FALSE
aadaaaaadabadbbbccbd	FALSE
aadadaacaddcbadaaadc	FALSE
aadaaabcdababbbddbbb	FALSE
aaddaaaaccdadaccdcab	FALSE
aaadaddaabcdaddabadb	FALSE
aaaaacdbdcbdcdbcbaad	FALSE
adaaaaadcadbcbdcadbb	FALSE
adaaaaacdabdddacaabd	FALSE
adaaaabccabccadbcdba	FALSE
adaadaacdabacddacdda	FALSE
adadadadaaabcaabbbaa	FALSE
adaddadadaaddaadadac	FALSE
addaaadabcaaddbdacbd	FALSE
addaadadacacdcaacbdd	FALSE
aaadaabbbdacacaaabdb	FALSE
aaadaaabbddbadccdbba	FALSE
aaaadddaddccaadccbcd	FALSE
ddaaadadacbadbadccba	FALSE
daaaaacbcdcdadcbbdad	FALSE
daadadddaaacacbabcbb	FALSE
daaaaaddbdcccbdcadcb	FALSE
daaaddddaacbdbcccbcb	FALSE
daadaadaadbdcbcbbbba	FALSE
daaaaacbbacbaabcbbac	FALSE
dadaadaaddbbbbadddba	FALSE
daaaadadcccbdddcbbcd	FALSE
ddaaaaabaccdaaaccbad	FALSE
ddaadadaacccbbbccaab	FALSE
ddaddaaaacdbdabddadc	FALSE
baaaaaadbbccdccbbdbac	TRUE
baddaaadacadbabacdcbb	TRUE
caaaddaabcbbdbbaacdbb	TRUE
aaaabccbcdbcdaddaad	TRUE
abaaadaddcadcaacdbddd	TRUE
acaaaaabbcaccdcbdbabb	TRUE
acdaaaadbbbacdaaddacc	TRUE
aabaaadbbcadabbbcadda	TRUE
aacadaacaabcccabbabcd	TRUE
aaabaabaddbbccbcbdbba	TRUE
aaacdadacabdbdadddadc	TRUE
aaaacabdaacbaaabbbcdd	TRUE
aaaabcdbacbbacdadbac	TRUE
aaaadcaaacbdccbaaabdb	TRUE
aaabadbcbadccdccdaaa	TRUE
aaadacabdbaaacacbbaa	TRUE
aaadacaabdbcacadcbbba	TRUE
aaadbdabdbabbbabcacb	TRUE
aabaaddacadacdcddcda	TRUE
aadaaddcbaddaaddbddb	TRUE
aadbdadaaaccdbaabcccc	TRUE
aadaaaaababadbbbccbd	TRUE
aadadbaacaddcbadaaadc	TRUE
aaddaabcdababbbddbbb	TRUE
aaddbaaaccdadaccdcab	TRUE
abadaddaabcdaddabadb	TRUE
adaaacdbdcbdcdbcbaad	TRUE
adbaaaaadcadbcbdcadbb	TRUE
adacaaaacdabdddacaabd	TRUE
adaaabccabccadbcdba	TRUE
adaabaacdabacddacdda	TRUE
adacadadaaabcaabbbaa	TRUE
adaddadbadaaddaadadac	TRUE
addaadabcaaddbdacbd	TRUE
adddadadacacdcaacbdd	TRUE
baadaabbbdacacaaabdb	TRUE
caadaaabbddbadccdbba	TRUE
daaadddaddccaadccbcd	TRUE
cdaaadadacbadbadccba	TRUE
dabaaaacbcdcdadcbbdad	TRUE
daacdadddaaacacbabcbb	TRUE
daaaacddbdcccbdcadcb	TRUE
daaadbddaacbdbcccbcb	TRUE
daadabdaadbdcbcbbbba	TRUE
dadaaacbbacbaabcbbac	TRUE
dadaadcaddbbbbadddba	TRUE
dbaaadadcccbdddcbbcd	TRUE
ddaaaabaccdaaaccbad	TRUE
ddaabadaacccbbbccaab	TRUE
ddcddaaaacdbdabddadc	TRUE
aaaaaaaabbabdadacddda	FALSE
adaaadaabcdcdaccddabc	FALSE
aaadaddacadccadddddad	FALSE
aaaaabcbcbacdcbcddaab	FALSE
aaaadacbcaddadddcddbc	FALSE
aaaaacdaadacccdbacdab	FALSE
aaaadacacbcdbcaaaccab	FALSE
aadddaaaaccddbaadacbd	FALSE
aaaaabcdddabbaddcdbcb	FALSE
aaadaacdbccdaccdaaaad	FALSE
aaaadabdaabccbcdabccb	FALSE
aaaaacadcddbbdaadddac	FALSE
aaaaacbdacaabcadbcbad	FALSE
aaaaddddddadbdccabddc	FALSE
aaaadabcbbcbcbddcbccd	FALSE
aaadadacbbabbdcdcaada	FALSE
aaaddaadaaadcdcdabadd	FALSE
aaaaacbcddddabdcddbdc	FALSE
aaaaabbbabccbaadaddbb	FALSE
aadadadadbbababbdbadb	FALSE
aadaaadbcaadababaddda	FALSE
aadadddddaadadbccccad	FALSE
aadddaddadaccacabbdcc	FALSE
aadddddadaacadaacccdc	FALSE
aaaaabddacaccdbaabcda	FALSE
aadaaacbbacacdbcdacab	FALSE
adaaaaaacddadcbadcdca	FALSE
adaaaaccbcbdccdbccadb	FALSE
adaaadacbdcbaadcddadb	FALSE
adaadaabdcaaacaaaacaa	FALSE
adadaaaadccabcbaddcab	FALSE
adaaaacacbacabcaadbbc	FALSE
addaaaaddcdaabcddacad	FALSE
adddadaddadaccadbbdad	FALSE
aadaaacccaccccbacbdac	FALSE
aaaadadadcdaabdcadadb	FALSE
aaaaacdbacadbdcccdacb	FALSE
daadaaadddcdbbaadddcd	FALSE
daaaaabacadabbccbbdcb	FALSE
daaaadaacddaacabdadbc	FALSE
daaaaacbbcadaadbaadbd	FALSE
daaadaaaabbacdbacbaba	FALSE
daadaaaadcbbcccacddcb	FALSE
daaddaadaccddcccbbdbd	FALSE
dadaadadadacacaaacbcc	FALSE
dadadaadabbccdccccabc	FALSE
daaddaaaddbacaaadacdb	FALSE
ddadaaadaaaabcbcaadaa	FALSE
ddaadaaaadaccbdbacaab	FALSE
ddaaaadaccdcaaaacdddb	FALSE
baaaaaaaabbabdadacddda	TRUE
badaaadaabcdcdaccddabc	TRUE
caaadaddacadccadddddad	TRUE
aaaabcbcbacdcbcddaab	TRUE
abaaadacbcaddadddcddbc	TRUE
acaaaacdaadacccdbacdab	TRUE
aaadacacbcdbcaaaccab	TRUE
aabdddaaaaccddbaadacbd	TRUE
aaaabcdddabbaddcdbcb	TRUE
aaabdaacdbccdaccdaaaad	TRUE
aaadabdaabccbcdabccb	TRUE
aaaacadcddbbdaadddac	TRUE
aaaadcbdacaabcadbcbad	TRUE
aaaadddddcadbdccabddc	TRUE
aaacdabcbbcbcbddcbccd	TRUE
aaadcadacbbabbdcdcaada	TRUE
aaadbaadaaadcdcdabadd	TRUE
aabaacbcddddabdcddbdc	TRUE
aadaabbbabccbaadaddbb	TRUE
aadcadadadbbababbdbadb	TRUE
aadaaadbcaadababadddba	TRUE
aadabddddaadadbccccad	TRUE
aadcdaddadaccacabbdcc	TRUE
aadddddadcacadaacccdc	TRUE
acaaabddacaccdbaabcda	TRUE
addaaacbbacacdbcdacab	TRUE
adcaaaaaacddadcbadcdca	TRUE
adaabaaccbcbdccdbccadb	TRUE
adaaadbcbdcbaadcddadb	TRUE
adaadbabdcaaacaaaacaa	TRUE
adadacaaadccabcbaddcab	TRUE
adbaaacacbacabcaadbbc	TRUE
addaaabddcdaabcddacad	TRUE
addddaddadaccadbbdad	TRUE
badaaacccaccccbacbdac	TRUE
caaadadadcdaabdcadadb	TRUE
daaaacdbacadbdcccdacb	TRUE
caadaaadddcdbbaadddcd	TRUE
daaaabacadabbccbbdcb	TRUE
daacaadaacddaacabdadbc	TRUE
daaaaccbbcadaadbaadbd	TRUE
daaadabaaabbacdbacbaba	TRUE
daacaaaadcbbcccacddcb	TRUE
daaddaaddccddcccbbdbd	TRUE
dadcaadadadacacaaacbcc	TRUE
dadadadabbccdccccabc	TRUE
dbaddaaaddbacaaadacdb	TRUE
ddabdaaadaaaabcbcaadaa	TRUE
ddaadacaadaccbdbacaab	TRUE
dddaaadaccdcaaaacdddb	TRUE
aaaaaadacacbbcbbcdcdab	FALSE
addaaadabdccabdabbcabb	FALSE
aaddaadabccacaadcabcad	FALSE
aaaadddacccaccbdcbcadc	FALSE
aaadaacdccbdcbadadcccc	FALSE
aadaaadcadbadbcbaacadc	FALSE
aaaaabacacdbabbaabcdda	FALSE
aaaaabbbbdabbbaabddacb	FALSE
aaaaacdabbcbcabcacdcda	FALSE
aaaaaaddaddcdaaabcaaca	FALSE
aaaaadaababdcdbcdaaccd	FALSE
aaaaacbdbbaddcbaaaaabc	FALSE
aaaaabbadaaababbabbbdd	FALSE
aaaaddaadcdcabbddcdcab	FALSE
aaaaacaadbbacbcbdacbaa	FALSE
aaadadacddbdcacddaacaa	FALSE
aaadadacbdcaddacddcbab	FALSE
aaadddaacbbdcabddabbcd	FALSE
aaaadadaaaacdcdccabcac	FALSE
aadaaddabcbccabbdbccca	FALSE
aadaaaccdcabcbdcabdbca	FALSE
aadadaacdccccbbaadbbdc	FALSE
aaddaaddabdcbaadccacaa	FALSE
aadddaaddaacdcabbbbddd	FALSE
aaddaaadddcdacdaddbbbb	FALSE
aaaaadbbadbdcddbaccdac	FALSE
adaaadaabdcbbdbacabbcb	FALSE
adaaaaadccaacbdbcdcbda	FALSE
adaaaadcdbabaaacbdabac	FALSE
adaaadacdadcdaccbbadba	FALSE
adaaaabcbbadbacbbbbcdc	FALSE
adadddadadacccbbacbdca	FALSE
addaaaacbdaaadbacbcbda	FALSE
addaaaaccacddcaadaaccb	FALSE
aaaadaabcddbbadabaddbc	FALSE
aaaaacdadbdcbaaadaaacd	FALSE
aaaaaccabcbbddadbaaaad	FALSE
daaadaddabdcbccdbadbaa	FALSE
dddaaaaaabdbbabbabccca	FALSE
daaaaadcbadaaadddcbcad	FALSE
daaaaaabadccadaaaccddb	FALSE
daaaaacdaabccadcddbbac	FALSE
daaadaacaaddcaababaada	FALSE
daaddadadadbcadcbacbba	FALSE
dadaaaaccdacabacdbdbab	FALSE
dadaaaaddacabcbbadbccb	FALSE
daaaaadcbaadabcaacbbda	FALSE
ddaaaaacbacacbcbaaadad	FALSE
ddaadaaaccadddadccdbbb	FALSE
ddaaadadacdadaaaaccdad	FALSE
baaaaaadacacbbcbbcdcdab	TRUE
baddaaadabdccabdabbcabb	TRUE
caaddaadabccacaadcabcad	TRUE
aaadddacccaccbdcbcadc	TRUE
abaadaacdccbdcbadadcccc	TRUE
acadaaadcadbadbcbaacadc	TRUE
aabaaabacacdbabbaabcdda	TRUE
aacaaabbbbdabbbaabddacb	TRUE
aaaacdabbcbcabcacdcda	TRUE
aaacaaaddaddcdaaabcaaca	TRUE
aaaabadaababdcdbcdaaccd	TRUE
aaaacbdbbaddcbaaaaabc	TRUE
aaaadbbadaaababbabbbdd	TRUE
aaaaddbadcdcabbddcdcab	TRUE
aaacacaadbbacbcbdacbaa	TRUE
aaadbadacddbdcacddaacaa	TRUE
aaadadcbdcaddacddcbab	TRUE
aaadddacbbdcabddabbcd	TRUE
aacadadaaaacdcdccabcac	TRUE
aacaaddabcbccabbdbccca	TRUE
aadaacaccdcabcbdcabdbca	TRUE
aadadcaacdccccbbaadbbdc	TRUE
aadcaaddabdcbaadccacaa	TRUE
aadddaadbaacdcabbbbddd	TRUE
abddaaadddcdacdaddbbbb	TRUE
adaaadbbadbdcddbaccdac	TRUE
acaaadaabdcbbdbacabbcb	TRUE
adabaaaadccaacbdbcdcbda	TRUE
adaaabadcdbabaaacbdabac	TRUE
adaaddacdadcdaccbbadba	TRUE
adadaabcbbadbacbbbbcdc	TRUE
adadddadddacccbbacbdca	TRUE
addaaacbdaaadbacbcbda	TRUE
addbaaaccacddcaadaaccb	TRUE
baaadaabcddbbadabaddbc	TRUE
caaaacdadbdcbaaadaaacd	TRUE
daaaaccabcbbddadbaaaad	TRUE
caaadaddabdcbccdbadbaa	TRUE
dcddaaaaaabdbbabbabccca	TRUE
daabaaadcbadaaadddcbcad	TRUE
daaaabaabadccadaaaccddb	TRUE
daaadacdaabccadcddbbac	TRUE
daaddaacaaddcaababaada	TRUE
daaddadcdadbcadcbacbba	TRUE
dadaaaccdacabacdbdbab	TRUE
dadcaaaddacabcbbadbccb	TRUE
dcaaaadcbaadabcaacbbda	TRUE
ddacaaaacbacacbcbaaadad	TRUE
ddaadaadccadddadccdbbb	TRUE
ddbaadadacdadaaaaccdad	TRUE
aaaaaadbaddbacacadbacdc	FALSE
adaaaacdaabbbbdcdccbbba	FALSE
aaaaaccdddddcabbcacccca	FALSE
ddaadddadaaccdbcadddbab	FALSE
aaaaaacbbdacadbabbccbdb	FALSE
adaadaacddcdccdbadbaccb	FALSE
adaaaaaaadbadcbbabcdacb	FALSE
aaaaaddaaddbbdbcbbbcbba	FALSE
aaaaadcaacdaaacabbcbccd	FALSE
aaaadacacccbacacbcbaabc	FALSE
aaaaacbccbdaddbddcbbadd	FALSE
aaaadadaacaabaabcdbcdba	FALSE
aaaaabaabdadcabbcccacca	FALSE
aaaaabcddbacadacbcdddaa	FALSE
aaaaddabcdbacabdcaddddb	FALSE
aaaaadcdbbccbbacbdbbcbb	FALSE
aaaddaadabbadabdbcadbda	FALSE
aaadaababdaacabbbbcdcbb	FALSE
aaadddddddaddaaaabcdbbd	FALSE
aaadaacccaadaaabaacddba	FALSE
aaaddaacbdacaadaaacbcdd	FALSE
aadaaddabbaccaccbddbdcb	FALSE
aadaadaccccdabdadaddcaa	FALSE
aadaaabdddbddcabccaccdb	FALSE
aaddaaaabdbbdacdcdaabca	FALSE
aaaddadacdcabddbcdddbad	FALSE
aaaddaababccbdacaabddba	FALSE
adaaddaaccacabaaadadbbb	FALSE
adaadaaccddcdddadacdacb	FALSE
adaaaaacdcabccbccaacadd	FALSE
adaadaddabaaccaccdccaad	FALSE
adadaddaaacdadccccbaaac	FALSE
adadaaadcbdbacbccccbbda	FALSE
addaaaadbddacaabaddbbbb	FALSE
adddaaddaaaabddddbbaada	FALSE
aaddaaadbbcccccabbacddb	FALSE
aaaddaddacbacddaadddccc	FALSE
adaaaabcddcaaacadcbcdcd	FALSE
daaadadacbdcdcbcbcdbdca	FALSE
daaaddaadcdccbacbbcbbcb	FALSE
daadadaacbabadaaddcccba	FALSE
daaaaacaccabcbdbdcbccdb	FALSE
daaadaadddbbcccbaaddabb	FALSE
daadaadaccddaabcbabacdb	FALSE
daadaaabdaadbacadddbbcd	FALSE
dadaaaabaddacbcaddcacba	FALSE
daddddaaaabbddbadccabab	FALSE
ddadadaaabaaadccbbbbaab	FALSE
ddaaddaaaacaddbacbdcbcd	FALSE
ddaadaaddabbaccdbdcdaaa	FALSE
baaaaaadbaddbacacadbacdc	TRUE
badaaaacdaabbbbdcdccbbba	TRUE
caaaaaccdddddcabbcacccca	TRUE
cddaadddadaaccdbcadddbab	TRUE
abaaaaacbbdacadbabbccbdb	TRUE
abdaadaacddcdccdbadbaccb	TRUE
acdaaaaaaadbadcbbabcdacb	TRUE
aabaaaddaaddbbdbcbbbcbba	TRUE
aacaaadcaacdaaacabbcbccd	TRUE
aaadacacccbacacbcbaabc	TRUE
aaacaacbccbdaddbddcbbadd	TRUE
aaaabdadaacaabaabcdbcdba	TRUE
aaaaabaabdadbabbcccacca	TRUE
aaaadbcddbacadacbcdddaa	TRUE
aaaaddbbcdbacabdcaddddb	TRUE
aaacadcdbbccbbacbdbbcbb	TRUE
aaacdaadabbadabdbcadbda	TRUE
aaadabbabdaacabbbbcdcbb	TRUE
aaaddcdddddaddaaaabcdbbd	TRUE
aabdaacccaadaaabaacddba	TRUE
aadddaacbdacaadaaacbcdd	TRUE
aadabaddabbaccaccbddbdcb	TRUE
aadaadcccccdabdadaddcaa	TRUE
aadcaabdddbddcabccaccdb	TRUE
aaddcaaabdbbdacdcdaabca	TRUE
abaddadacdcabddbcdddbad	TRUE
acaddaababccbdacaabddba	TRUE
abaaddaaccacabaaadadbbb	TRUE
adadaaccddcdddadacdacb	TRUE
adaaabaacdcabccbccaacadd	TRUE
adaacaddabaaccaccdccaad	TRUE
adadbaddaaacdadccccbaaac	TRUE
adbdaaadcbdbacbccccbbda	TRUE
addaaadbddacaabaddbbbb	TRUE
adddaaddacaabddddbbaada	TRUE
baddaaadbbcccccabbacddb	TRUE
caaddaddacbacddaadddccc	TRUE
ddaaaabcddcaaacadcbcdcd	TRUE
dbaaadadacbdcdcbcbcdbdca	TRUE
dabaaddaadcdccbacbbcbbcb	TRUE
daacdadaacbabadaaddcccba	TRUE
daaaadcaccabcbdbdcbccdb	TRUE
daaadcadddbbcccbaaddabb	TRUE
daadaadcaccddaabcbabacdb	TRUE
dacdaaabdaadbacadddbbcd	TRUE
dadabaabaddacbcaddcacba	TRUE
daddddaabaabbddbadccabab	TRUE
ddbadadaaabaaadccbbbbaab	TRUE
ddaabdaaaacaddbacbdcbcd	TRUE
ddcadaaddabbaccdbdcdaaa	TRUE
aaaaaadadacadccccbdbcbbd	FALSE
adadaaaacaabbcccdaaacada	FALSE
aaaadabccaddcdddbcdbbcdb	FALSE
ddaddaddaaabdabdcaaccbab	FALSE
aaaaabdaaacbbbdcccaddcda	FALSE
aaaaabbcadbdbbbbcdddcbcc	FALSE
aaaadabccdaddbbbbcdaaccb	FALSE
aadaaddaaadcdbbdddbcdbbb	FALSE
aaaaadcaaacdcadcaabcdddc	FALSE
aaaaabcdabadacccaaccbcda	FALSE
aaaaaadaddbcdbdbdcdcabad	FALSE
aaaaaabbdddcadcadabbdaab	FALSE
aaaadacadbdaddddcbccabca	FALSE
aaaaabacdbcbcacadddbcbcc	FALSE
aaadaadbbbabaacbaddbdacd	FALSE
aaadadabdaacbdbddddaaddb	FALSE
aaadaacdacccccdaddbaacdb	FALSE
aaaaacbdddbaaadacbdcddad	FALSE
aaaaacbadbaacddbcccbbdda	FALSE
aadadaabcadadaaaabccacda	FALSE
aadaaabaacacddbddbcbadcc	FALSE
aadadaaaaccaddbdacddbcca	FALSE
aaddadaadaddaccdaabbcabd	FALSE
aaaaaabadccdbbccbbbccbdc	FALSE
aaaaadcbcadaaababccdbaad	FALSE
aaaaacacabdcbaccbaaabdac	FALSE
adaaaabdbcabcabacadacbac	FALSE
adaaddaadddbccdcddadabcb	FALSE
adaaaadabbdccaadbbacbaad	FALSE
adaadaaabdcbdabaadbaaaaa	FALSE
adadaaacccbabdadbadcdabb	FALSE
adaaddaaabbccccaabddbadd	FALSE
addaaaabccbddbacbdadccdb	FALSE
adddaaaaabbbcbabbadabbcd	FALSE
aaaadaaabbccabdaabaccccd	FALSE
aaaadaaabbaddbdcddcdbdab	FALSE
aaaadadddbcdbabccdcbacbb	FALSE
daaaaabadacdabdbaaadcdbd	FALSE
ddaadddaaacbbbdddccacbab	FALSE
daaaaadbdbccabadbbbdaccb	FALSE
daaaaabbabbcdbadcddcbbcc	FALSE
daaadaacdcccccacddddbcbc	FALSE
daaddaadaaadaaaddabdbcbb	FALSE
daaddaaadbdaccaccbdcdaab	FALSE
daddaaadaadbccbddccbbbdb	FALSE
dadadadadabcaabadbdbadbd	FALSE
dadaaaadacddcdbbdcacdabd	FALSE
ddaaaadaaadbcabdacdbbddc	FALSE
ddaaaadaccacbcadbadbdbaa	FALSE
ddaaadadadbbcabdadbbabca	FALSE
baaaaaadadacadccccbdbcbbd	TRUE
badadaaaacaabbcccdaaacada	TRUE
caaaadabccaddcdddbcdbbcdb	TRUE
cddaddaddaaabdabdcaaccbab	TRUE
abaaaabdaaacbbbdcccaddcda	TRUE
acaaaabbcadbdbbbbcdddcbcc	TRUE
aaadabccdaddbbbbcdaaccb	TRUE
aabdaaddaaadcdbbdddbcdbbb	TRUE
aaaadcaaacdcadcaabcdddc	TRUE
aaacaabcdabadacccaaccbcda	TRUE
aaaacaadaddbcdbdbdcdcabad	TRUE
aaaababbdddcadcadabbdaab	TRUE
aaaabacadbdaddddcbccabca	TRUE
aaababacdbcbcacadddbcbcc	TRUE
aaabaadbbbabaacbaddbdacd	TRUE
aaadacdabdaacbdbddddaaddb	TRUE
aaadcacdacccccdaddbaacdb	TRUE
aabaacbdddbaaadacbdcddad	TRUE
aadaacbadbaacddbcccbbdda	TRUE
aadcadaabcadadaaaabccacda	TRUE
aadaabbaacacddbddbcbadcc	TRUE
aadadabaaccaddbdacddbcca	TRUE
aaddbadaadaddaccdaabbcabd	TRUE
abaaaabadccdbbccbbbccbdc	TRUE
acaaadcbcadaaababccdbaad	TRUE
adaaacacabdcbaccbaaabdac	TRUE
adbaaaabdbcabcabacadacbac	TRUE
adacaddaadddbccdcddadabcb	TRUE
adaaacdabbdccaadbbacbaad	TRUE
adaadacabdcbdabaadbaaaaa	TRUE
adadaacacccbabdadbadcdabb	TRUE
adbaddaaabbccccaabddbadd	TRUE
addaaabbccbddbacbdadccdb	TRUE
adddbaaaaabbbcbabbadabbcd	TRUE
baaadaaabbccabdaabaccccd	TRUE
caaadaaabbaddbdcddcdbdab	TRUE
daaadadddbcdbabccdcbacbb	TRUE
caaaaabadacdabdbaaadcdbd	TRUE
dcdaadddaaacbbbdddccacbab	TRUE
daabaaadbdbccabadbbbdaccb	TRUE
daaaabbabbcdbadcddcbbcc	TRUE
daaadacdcccccacddddbcbc	TRUE
daabdaadaaadaaaddabdbcbb	TRUE
daaddaacdbdaccaccbdcdaab	TRUE
dacdaaadaadbccbddccbbbdb	TRUE
dadadadababcaabadbdbadbd	TRUE
dbdaaaadacddcdbbdcacdabd	TRUE
ddacaaadaaadbcabdacdbbddc	TRUE
ddaacadaccacbcadbadbdbaa	TRUE
ddbaadadadbbcabdadbbabca	TRUE
aaaaaaaadbbcabbcaacdbbdaa	FALSE
addaddddadaabdccdadaddaaa	FALSE
aaadaacbdadaadcbcadbbabbb	FALSE
aaaaaddbaadbacadcdccdbcda	FALSE
aaaaabdbadbcaadabdcababcd	FALSE
aaaaabbacbadaddcdddbcbaac	FALSE
aaaaadcabbcabbccbacbbdbbd	FALSE
aaadddaacbaadbcabcacccdca	FALSE
aaaaacadcdaccddbbbddacbba	FALSE
aaaaaaadccabbdbbacddddcdd	FALSE
aaaaababaacbaaccbbcacabcd	FALSE
aaaaacdccccacddbcbbacbdca	FALSE
aaaaacbcccababbbdccbacbbb	FALSE
aaaaddaababadadbbbccaaabd	FALSE
aaaaabddabdbcbacdbbbbcbcc	FALSE
aaadaacdaabaadcadacddbcba	FALSE
aaadaddadbcdbadaddcccaabb	FALSE
aaadddaabaabacadbbdbaaddb	FALSE
aaaadabddabbcdacbabcabddd	FALSE
aadadaacdaddabdaaddbbbbcb	FALSE
aadaaaadadbddaddabcadbbba	FALSE
aadadaaacbcbbcabddacdbbac	FALSE
aaddadaaacccbdcdcccbbacaa	FALSE
aaddddadaabbaacddabdaaaca	FALSE
aaddaaacdacacbabbaccbdcba	FALSE
aaaaacadcbabcaabcbdadccda	FALSE
adaadaacbadddadcaccacadcc	FALSE
adaadaadbbacacdbabadabbad	FALSE
adaaaaaacddcdcdbaabcaddab	FALSE
adaadaababdbcdaccdbbbabcc	FALSE
adaddaadacdacccdddbbaccdd	FALSE
adaddadadacdcbccccdcbbccc	FALSE
addaaaabcbcbdcbadbbccbdda	FALSE
addaadadadcccdaaccbbbdabb	FALSE
aaadaaacacbadbbdccdaccdbd	FALSE
aaaaabcaaaaddbcacbcabdbad	FALSE
aaaaadcddadbccbdcdbddcacd	FALSE
daaadaacddabbbdccdcccbddd	FALSE
ddadadadadabdabcbdccdbacc	FALSE
daaaaabbdcdbcdacbdaaddabd	FALSE
daaaadaaaabbacabbdcbcdacb	FALSE
daaaaacacbcbcaccccbbbdbca	FALSE
daaadaddabbaadbccaaaabdbb	FALSE
daaddaaabbabdcbbddaadabab	FALSE
dadaaaadbaaddbaacdbdddaba	FALSE
dadadaddadacbbdcdadcddbca	FALSE
daaaadabdbccdcddacbaadddc	FALSE
ddaadaaabaacddcdccadddaba	FALSE
ddaaaddaaddbbccaccbbcdacd	FALSE
ddaaddaaabddbadcccacddbcb	FALSE
baaaaaaaadbbcabbcaacdbbdaa	TRUE
baddaddddadaabdccdadaddaaa	TRUE
caaadaacbdadaadcbcadbbabbb	TRUE
aaaaddbaadbacadcdccdbcda	TRUE
abaaaabdbadbcaadabdcababcd	TRUE
acaaaabbacbadaddcdddbcbaac	TRUE
aaaadcabbcabbccbacbbdbbd	TRUE
aabadddaacbaadbcabcacccdca	TRUE
aaaacadcdaccddbbbddacbba	TRUE
aaacaaaadccabbdbbacddddcdd	TRUE
aaaabababaacbaaccbbcacabcd	TRUE
aaaacdccccacddbcbbacbdca	TRUE
aaaaccbcccababbbdccbacbbb	TRUE
aaaaddbaababadadbbbccaaabd	TRUE
aaacabddabdbcbacdbbbbcbcc	TRUE
aaadbaacdaabaadcadacddbcba	TRUE
aaadaddcdbcdbadaddcccaabb	TRUE
aaaddddabaabacadbbdbaaddb	TRUE
aacadabddabbcdacbabcabddd	TRUE
aadbadaacdaddabdaaddbbbbcb	TRUE
aadaaaadadbddabdabcadbbba	TRUE
aadadabaacbcbbcabddacdbbac	TRUE
aadcadaaacccbdcdcccbbacaa	TRUE
aaddddacdaabbaacddabdaaaca	TRUE
abddaaacdacacbabbaccbdcba	TRUE
adaaacadcbabcaabcbdadccda	TRUE
acaadaacbadddadcaccacadcc	TRUE
adabadaadbbacacdbabadabbad	TRUE
adaaacaaacddcdcdbaabcaddab	TRUE
adaadbaababdbcdaccdbbbabcc	TRUE
adabdaadacdacccdddbbaccdd	TRUE
adaddadbdacdcbccccdcbbccc	TRUE
addabaaabcbcbdcbadbbccbdda	TRUE
addbadadadcccdaaccbbbdabb	TRUE
baadaaacacbadbbdccdaccdbd	TRUE
caaaabcaaaaddbcacbcabdbad	TRUE
daaaadcddadbccbdcdbddcacd	TRUE
caaadaacddabbbdccdcccbddd	TRUE
dcdadadadadabdabcbdccdbacc	TRUE
daabaaabbdcdbcdacbdaaddabd	TRUE
daaaabdaaaabbacabbdcbcdacb	TRUE
daaacacacbcbcaccccbbbdbca	TRUE
daacdaddabbaadbccaaaabdbb	TRUE
daadbaaabbabdcbbddaadabab	TRUE
dadbaaaadbaaddbaacdbdddaba	TRUE
dadadaddabacbbdcdadcddbca	TRUE
dbaaadabdbccdcddacbaadddc	TRUE
ddadaaabaacddcdccadddaba	TRUE
ddaaaddcaaddbbccaccbbcdacd	TRUE
ddbaddaaabddbadcccacddbcb	TRUE
aaaaaabddcabcbcbaaccaaadad	FALSE
adaaddaadbcbcdcbcdbbabcaba	FALSE
aaadddaacbdcdbdacbaabccdcc	FALSE
aaaaabbbcadcdaacbbbaddcacc	FALSE
aaadadaadaaacdbbcbdabbcabb	FALSE
aaadaaaacdcbddbdadcbbabbac	FALSE
aaadaaccbddbdcdbadcdbccacb	FALSE
aaddaaaaabbaaacdbadbdbdccd	FALSE
aaaaacdcacbbbadddbbcbbcacd	FALSE
aaaaaaaccaaaacbcbabbddcdac	FALSE
aaaaacbddacbddaadaaadccbbc	FALSE
aaaaacaaabdabaadbccacbcadb	FALSE
aaaadaccaaccccbbdadcddbbbd	FALSE
aaaaadaaabdbaacbbcddcbddbc	FALSE
aaaaaccdabdbadcbdaadadadba	FALSE
aaadaabcdaabcbddcdcabccdca	FALSE
aaaddadacadcbbaacbcbacccdd	FALSE
aaadaadddaccddddbddbdcacbb	FALSE
aaaadddadcdccbbbadccdbcbdb	FALSE
aadaaabbbadbdaddbbccddadad	FALSE
aadaaabdbadbdbbdddcaaaadda	FALSE
aadadaabcddaddcbabdccdcdca	FALSE
aaddaaaccabacccaaaddbcbaca	FALSE
aaaaabacbcdabcaddddcaccaba	FALSE
aaaadabdcdbabaccacabcccacd	FALSE
aadadadaccbdbbcaaddcacdccb	FALSE
addaadaaadcaaccbdbbbbbaada	FALSE
adaddaaadcddbabacbbbabaadc	FALSE
adaaaacdbbaaabdadadbdddcdc	FALSE
adaadaaacbaddabbacdcdcccba	FALSE
adadaaacacaacaaaacdbcccadd	FALSE
adaadaabaaadccbaccbddbcabd	FALSE
addaaaadaaccadddadbbcdacda	FALSE
adddaaaaaaccacacdadcaccbdd	FALSE
aaaaddadbcabbdcadbbbccadac	FALSE
aaadaadcbbdaaddbddcaabbcab	FALSE
aaaadacaadddadcdcacabdacda	FALSE
daaadadaccbcbcadddcbcddcbc	FALSE
daaaaaabcccdacadabdcaacccd	FALSE
daaadaaccdbcbbbdcbbadbadcb	FALSE
daaaaacbbdaabddbbccbacbdcc	FALSE
daaaaababadccdbadbbbbbbabb	FALSE
daaaaabcadddbbddaabbccccdd	FALSE
daadadadacbcadddadddbaacbd	FALSE
daaddaddaaaccdccdccdcddbab	FALSE
dadaadaabbdbbdcaaddbcadcac	FALSE
daddadaaabccbaacbccdaccccd	FALSE
ddadaaddaaadcabbccbdcdddcb	FALSE
ddaaadadababacdbbbccaabcba	FALSE
ddaddaadddaadabadadcbabcac	FALSE
baaaaaabddcabcbcbaaccaaadad	TRUE
badaaddaadbcbcdcbcdbbabcaba	TRUE
caaadddaacbdcdbdacbaabccdcc	TRUE
aaaabbbcadcdaacbbbaddcacc	TRUE
abaadadaadaaacdbbcbdabbcabb	TRUE
acaadaaaacdcbddbdadcbbabbac	TRUE
aadaaccbddbdcdbadcdbccacb	TRUE
aabddaaaaabbaaacdbadbdbdccd	TRUE
aaaacdcacbbbadddbbcbbcacd	TRUE
aaacaaaaccaaaacbcbabbddcdac	TRUE
aaaabacbddacbddaadaaadccbbc	TRUE
aaaaacaaabdababadbccacbcadb	TRUE
aaaabaccaaccccbbdadcddbbbd	TRUE
aaabadaaabdbaacbbcddcbddbc	TRUE
aaadaccdabdbadcbdaadadadba	TRUE
aaadacabcdaabcbddcdcabccdca	TRUE
aaadcadacadcbbaacbcbacccdd	TRUE
aabdaadddaccddddbddbdcacbb	TRUE
aadadddadcdccbbbadccdbcbdb	TRUE
aadaabbbadbdaddbbccddadad	TRUE
aadaadbdbadbdbbdddcaaaadda	TRUE
aadadcabcddaddcbabdccdcdca	TRUE
aaddadaccabacccaaaddbcbaca	TRUE
abaaabacbcdabcaddddcaccaba	TRUE
acaadabdcdbabaccacabcccacd	TRUE
addadadaccbdbbcaaddcacdccb	TRUE
adbdaadaaadcaaccbdbbbbbaada	TRUE
adacddaaadcddbabacbbbabaadc	TRUE
adaaadcdbbaaabdadadbdddcdc	TRUE
adaadcaacbaddabbacdcdcccba	TRUE
adadaacacacaacaaaacdbcccadd	TRUE
adbadaabaaadccbaccbddbcabd	TRUE
addaacaadaaccadddadbbcdacda	TRUE
adddbaaaaaaccacacdadcaccbdd	TRUE
baaaddadbcabbdcadbbbccadac	TRUE
caadaadcbbdaaddbddcaabbcab	TRUE
daaadacaadddadcdcacabdacda	TRUE
caaadadaccbcbcadddcbcddcbc	TRUE
dabaaaaabcccdacadabdcaacccd	TRUE
daabadaaccdbcbbbdcbbadbadcb	TRUE
daaaacacbbdaabddbbccbacbdcc	TRUE
daaadababadccdbadbbbbbbabb	TRUE
daadaabcadddbbddaabbccccdd	TRUE
daadadddacbcadddadddbaacbd	TRUE
dacddaddaaaccdccdccdcddbab	TRUE
dadaadabbdbbdcaaddbcadcac	TRUE
daddbdaaabccbaacbccdaccccd	TRUE
dcadaaddaaadcabbccbdcdddcb	TRUE
ddaaadbadababacdbbbccaabcba	TRUE
ddaddaadddabadabadadcbabcac	TRUE
aaaaaaadaaccdddbbbcdababcdd	FALSE
adaadaabacbddbccacdcbccdddd	FALSE
aadaaaaadadcbcbdcbbbacbbbcd	FALSE
aaaaacaaaccbcbcacbdcbdddcca	FALSE
aaaaacdcbacdcbcaddbcccababa	FALSE
aaaaaddaaadabacdcccabbccbbd	FALSE
aaaaabaabdcdcbaacbadaadacba	FALSE
aadaaaadbcbddcbaacbcdcbcdaa	FALSE
aadadaabdbcdcccdddcdbbabacb	FALSE
aaadaaddadbabadaacaccbacbaa	FALSE
aaaadadbaacbbbdccbaddaddddc	FALSE
aaaadacacdadcdccadcdccbdabb	FALSE
aaaaaddcabdbadbaccbdbaccbac	FALSE
aaaadaabaadbbdbdacdccdaddbb	FALSE
aaaaacbabbabdcbbbbbccdadcad	FALSE
aaadaaabdcccdcbdbdaabbdbaab	FALSE
aaadaadbcbabbbabccbccbcabba	FALSE
aaaddaacdcdcbdcaaccbdccdbdb	FALSE
aaadadabcbadbaddacdbddbacdc	FALSE
aaadaabdcbdddbcacbddcbabdcd	FALSE
aadaaabcdcbaabaddcadccbbbba	FALSE
aadaadacbacdddccbaccbdcabbc	FALSE
aadaaaacdaddaadaaadbadbbbad	FALSE
aaddaadddaabbbacbacccdaabcc	FALSE
aaaadabcdabacbdcbdcdbabdcda	FALSE
aaadaadacabbddaaadacddcadbd	FALSE
adadadaddaaacdcadcadabbdbcb	FALSE
addaaddaabcdcddbbbbddaacbdc	FALSE
adaadadadbdadbadcadcbdccdad	FALSE
adaaaddabaabcaccbabddcdaaad	FALSE
adaaaaddbadcabddacbacdcaacd	FALSE
adaddadaabbccbadcdadcabbaca	FALSE
addaaaacdaccdcbbdaacddadbdc	FALSE
addadadaabdbcbdbccdcbdaadab	FALSE
aaaaabaadcbadcadddbccbcaddc	FALSE
aaaaadbdbbdaacdabdbcbdbccbd	FALSE
aaaaacacdbaadbcbaadbbabadab	FALSE
daaddaadaddcdccadcdbbdccdbc	FALSE
ddaadaaacaadcccaabbadbbbdbd	FALSE
daaaaabdcccaacaccdaadccabca	FALSE
daaaaabacaabdbcadcbcdadccbb	FALSE
daaaaacccdcacbcadcbdaadcacb	FALSE
daaaddaadcbdbbccdadccdcccdb	FALSE
daaddaaadbbbcddabdbaadbdddb	FALSE
dadaaaacacddadacabbbdbdaadb	FALSE
dadadaaadaabacbadcdaaadaada	FALSE
daaadaadcbcadbcaadaddbccacb	FALSE
dddaaaaabbbaabcbcdadbcddddb	FALSE
ddaadaaaddbbdcaacbdaadcadcc	FALSE
ddaadaaaaccaaacdddddbbacdaa	FALSE
baaaaaaadaaccdddbbbcdababcdd	TRUE
badaadaabacbddbccacdcbccdddd	TRUE
caadaaaaadadcbcbdcbbbacbbbcd	TRUE
aaaacaaaccbcbcacbdcbdddcca	TRUE
abaaaacdcbacdcbcaddbcccababa	TRUE
acaaaaddaaadabacdcccabbccbbd	TRUE
aaaabaabdcdcbaacbadaadacba	TRUE
aabdaaaadbcbddcbaacbcdcbcdaa	TRUE
aacdadaabdbcdcccdddcdbbabacb	TRUE
aaabdaaddadbabadaacaccbacbaa	TRUE
aaadadbaacbbbdccbaddaddddc	TRUE
aaaacdacacdadcdccadcdccbdabb	TRUE
aaaacddcabdbadbaccbdbaccbac	TRUE
aaaadcaabaadbbdbdacdccdaddbb	TRUE
aaabacbabbabdcbbbbbccdadcad	TRUE
aaadbaaabdcccdcbdbdaabbdbaab	TRUE
aaadaddbcbabbbabccbccbcabba	TRUE
aaaddacacdcdcbdcaaccbdccdbdb	TRUE
aabdadabcbadbaddacdbddbacdc	TRUE
aaddaabdcbdddbcacbddcbabdcd	TRUE
aadabaabcdcbaabaddcadccbbbba	TRUE
aadaabacbacdddccbaccbdcabbc	TRUE
aadbaaacdaddaadaaadbadbbbad	TRUE
aaddaadcdaabbbacbacccdaabcc	TRUE
abaadabcdabacbdcbdcdbabdcda	TRUE
acadaadacabbddaaadacddcadbd	TRUE
abadadaddaaacdcadcadabbdbcb	TRUE
adcdaaddaabcdcddbbbbddaacbdc	TRUE
adaacdadadbdadbadcadcbdccdad	TRUE
adaaaddcabaabcaccbabddcdaaad	TRUE
adadaaddbadcabddacbacdcaacd	TRUE
adaddadabbccbadcdadcabbaca	TRUE
addcaaaacdaccdcbbdaacddadbdc	TRUE
addadadadbdbcbdbccdcbdaadab	TRUE
baaaabaadcbadcadddbccbcaddc	TRUE
caaaadbdbbdaacdabdbcbdbccbd	TRUE
daaaacacdbaadbcbaadbbabadab	TRUE
baaddaadaddcdccadcdbbdccdbc	TRUE
dcdaadaaacaadcccaabbadbbbdbd	TRUE
daabaaabdcccaacaccdaadccabca	TRUE
daaaacabacaabdbcadcbcdadccbb	TRUE
daaadacccdcacbcadcbdaadcacb	TRUE
daacddaadcbdbbccdadccdcccdb	TRUE
daaddaabdbbbcddabdbaadbdddb	TRUE
dadcaaaacacddadacabbbdbdaadb	TRUE
dadadaabadaabacbadcdaaadaada	TRUE
dbaadaadcbcadbcaadaddbccacb	TRUE
ddcdaaaaabbbaabcbcdadbcddddb	TRUE
ddaadcaaaddbbdcaacbdaadcadcc	TRUE
ddbadaaaaccaaacdddddbbacdaa	TRUE
aaaaaadacbbbcddddccddbbdbbac	FALSE
adaadadacacaacaddcbddbbcbada	FALSE
aaadaacdabddbbddbddcacdaaaac	FALSE
dddaadaaaacddbcadcdbbdccccac	FALSE
aaaaabacbdabcdcaddcabdbdbbaa	FALSE
aaaaacadcbacbdacdcdcdadcdcdb	FALSE
aaaaabadcbdcdbabddbdbdcccdac	FALSE
aaadddaabaaaaaddbbabacaacbbc	FALSE
aadadadabcccdadcadacdcbddddc	FALSE
aaadaabadccdcccacbacaacbdcac	FALSE
aaaaaadbdacabadbbacdddadacba	FALSE
aaaaaddcdbddbbddcbbbabaccddb	FALSE
aaaaadcaacadddcccccaaadaadbd	FALSE
aaaadaacacccccaaaadbbcacbcdb	FALSE
aaaadadacdcccbcbdaccabcbbabd	FALSE
aaadadacdbbaabcbdaaaaccbdcbd	FALSE
aaadaabbbdcbdcabacadacbddadd	FALSE
aaaddaddacbabcbbccadadaccadd	FALSE
aaaaaadbbdccbabadabcabadbbcd	FALSE
aadaaacdadaccaccdcbbcadadcac	FALSE
aadaaaaabcbdddbbdbcaddaaaacb	FALSE
aadaaddacbdddcdbcdadbdaabadb	FALSE
aadaddaabbacdbddabddaccdddcb	FALSE
aaddadaadbdadabdacacaacbadab	FALSE
aadaaaabbbaddddbdbcadbcbccbb	FALSE
aaddadadaababcbaaabbdbcbcddd	FALSE
adaaaacdbadaabbcadccaabdcbbc	FALSE
adaaaddacaddbdcbbbbbbbacaaaa	FALSE
adaaadaaadbcccacbdadccbdaadb	FALSE
adaaaabbbddbbcdacbbabcaadbdc	FALSE
adaaaaacacaabdacbdccaccbacca	FALSE
adadaaacdbadaacbccaabcacbcdd	FALSE
adddddaddaaaccddbcdaddabdccb	FALSE
addaaaabaaccbcbaccaabbaccabb	FALSE
aaaaabbbcdcabbccacbbaddbbadc	FALSE
aaaaacadbcaccbdcdcadcbbbcdcb	FALSE
aaaaacababbcddbdcddacbbbcdcd	FALSE
daaaadadccaccbccdbacacabcbdb	FALSE
dadddadaddadacacbdcddcdbabac	FALSE
daaaaabbcddcdcdbdbdbcbdabbad	FALSE
daaaaadbdabadcabbdabddcbacdc	FALSE
daaaaaaabccdaabadadbcbacdbba	FALSE
daaadddaadacbadbcabaacdbbadb	FALSE
daadadaadbacbbdabcbabadcabcc	FALSE
dadddadaddadacabaddcadbcbcda	FALSE
dadadaaadddbcaddbbcadacadcbd	FALSE
daaaadacdddcaddaaadbccdadcaa	FALSE
ddaaaaadbdacccabdddbbbaccabc	FALSE
ddaaaaabdbdbddaaaaaddadaaccd	FALSE
ddaaaaacbdaddacaacbacadaaddc	FALSE
baaaaaadacbbbcddddccddbbdbbac	TRUE
badaadadacacaacaddcbddbbcbada	TRUE
caaadaacdabddbbddbddcacdaaaac	TRUE
cdddaadaaaacddbcadcdbbdccccac	TRUE
abaaaabacbdabcdcaddcabdbdbbaa	TRUE
acaaaacadcbacbdacdcdcdadcdcdb	TRUE
aaaabadcbdcdbabddbdbdcccdac	TRUE
aabadddaabaaaaaddbbabacaacbbc	TRUE
aacdadadabcccdadcadacdcbddddc	TRUE
aaabdaabadccdcccacbacaacbdcac	TRUE
aaaabaadbdacabadbbacdddadacba	TRUE
aaaaddcdbddbbddcbbbabaccddb	TRUE
aaaacdcaacadddcccccaaadaadbd	TRUE
aaaadbacacccccaaaadbbcacbcdb	TRUE
aaabdadacdcccbcbdaccabcbbabd	TRUE
aaacadacdbbaabcbdaaaaccbdcbd	TRUE
aaadacbbbdcbdcabacadacbddadd	TRUE
aaaddaddccbabcbbccadadaccadd	TRUE
aacaaadbbdccbabadabcabadbbcd	TRUE
aabaaacdadaccaccdcbbcadadcac	TRUE
aadacaaaabcbdddbbdbcaddaaaacb	TRUE
aadaaddacbdddcdbcdadbdabadb	TRUE
aadaddcabbacdbddabddaccdddcb	TRUE
aaddadcaadbdadabdacacaacbadab	TRUE
abdaaaabbbaddddbdbcadbcbccbb	TRUE
acddadadaababcbaaabbdbcbcddd	TRUE
acaaaacdbadaabbcadccaabdcbbc	TRUE
adabaaddacaddbdcbbbbbbbacaaaa	TRUE
adaaacdaaadbcccacbdadccbdaadb	TRUE
adaadabbbddbbcdacbbabcaadbdc	TRUE
adabaaacacaabdacbdccaccbacca	TRUE
adadbaacdbadaacbccaabcacbcdd	TRUE
adcdddaddaaaccddbcdaddabdccb	TRUE
addacaabaaccbcbaccaabbaccabb	TRUE
baaaabbbcdcabbccacbbaddbbadc	TRUE
caaaacadbcaccbdcdcadcbbbcdcb	TRUE
daaaacababbcddbdcddacbbbcdcd	TRUE
caaaadadccaccbccdbacacabcbdb	TRUE
dcadddadaddadacacbdcddcdbabac	TRUE
daabaaabbcddcdcdbdbdbcbdabbad	TRUE
daaaadbdabadcabbdabddcbacdc	TRUE
daaabaaabccdaabadadbcbacdbba	TRUE
daaadddcaadacbadbcabaacdbbadb	TRUE
daadadaadbacbbdabababadcabcc	TRUE
dabddadaddadacabaddcadbcbcda	TRUE
dadadaadddbcaddbbcadacadcbd	TRUE
dbaaadacdddcaddaaadbccdadcaa	TRUE
ddcaaaaadbdacccabdddbbbaccabc	TRUE
ddaadaabdbdbddaaaaaddadaaccd	TRUE
dddaaaacbdaddacaacbacadaaddc	TRUE
aaaaaaaacccbbacadaadbbbbbdacd	FALSE
aaddaaabbbdacdbdddbabdbadbadb	FALSE
aaaadaaabcbadadddcaacacbbbdaa	FALSE
dadadadaacbaadbbccabdcbbbabab	FALSE
aaaaabcacadddcdcddddcdcccbaad	FALSE
aaaaabbcbacbcbcaccbacccadcddb	FALSE
aaaadabdaddaddccabbbcdcacdccb	FALSE
aadadaaaaaddccadccbcccbcaccdb	FALSE
aaaaadddbccdadabbdbcdcabbaaac	FALSE
aaaaaabdbaddccdcdaddbabcacddb	FALSE
aaaaaabaabccacbbcdaddaabcadad	FALSE
aaaaabaadbaddacbcaddadbabbcaa	FALSE
aaaaacbddadcdcadcbadbabcaccdc	FALSE
aaaaddabaacbcadcccbcdbdcccaca	FALSE
aaaadadbacddcdcadbdbabaccdbbd	FALSE
aaadadabdbbbcccddbbbccaacdacc	FALSE
aaadaabdcaabbbbcaabdccbddbaab	FALSE
aaaaadaddaccddbcabbbbdaccbbcd	FALSE
aaaadaaaaddacddaacbdacbcbbbcb	FALSE
aadaadadabdccaacdbbabdcbbabda	FALSE
aadaaabcdcbdacbdbbaaddccadada	FALSE
aadaaabcabddbbdaaacccdbdadbad	FALSE
aadaaadcdddcbcdbbbbbaadcbaadc	FALSE
aaddadddddaacdaabcccdcbdbacad	FALSE
aaadadaaaddababbdbcaacccdcbaa	FALSE
aaadddaabaccccdbdcccabdadabaa	FALSE
adaadadaabbcadaddaccaccbabcdb	FALSE
adadaaaaccbaaddaacbcbbaccaaac	FALSE
adaaadadadcbbdbaadbbaddabbdaa	FALSE
adaaadabaacdbcbbadccbbdaadcac	FALSE
adaadaacdadcdcccacbddbbddacac	FALSE
adadaadddacdababacdbaccdcbbab	FALSE
adddddaaaacccbbacadacabacbbdb	FALSE
addaadaddabcdbaacadccdaccadca	FALSE
aaaaaadddacbaabacbdcaaabdccdd	FALSE
addaadadabbcacbacbddcaaacdadd	FALSE
adaaaaadabddbcbcccacaacbadcbd	FALSE
daadaaddabdddbdccbccbbbdbcabb	FALSE
daaaaacbbadccaabdabcabadbcabb	FALSE
dadadadaaaabcccacadaadcbdbbbb	FALSE
daaaaaccacddacdbaaddadabadcbb	FALSE
daaadddadadcaddadcbcdcbcddaad	FALSE
daaaaacdadbbdaadaaccaabccadab	FALSE
daadadaaaaadcddcacdbccbbbbcbb	FALSE
daaaaaddbbbaaaccdbaaacacaadac	FALSE
dadaaadabcbbacaadbabbcaacaada	FALSE
dadddadaaabbabdbcaddbaddbdadc	FALSE
ddaddadaaadcbadbcacbacadddddc	FALSE
ddaaaaaddccbdccaddcdacbcdbdad	FALSE
ddaadaadaccabdccacdcddacbdaac	FALSE
baaaaaaaacccbbacadaadbbbbbdacd	TRUE
baaddaaabbbdacdbdddbabdbadbadb	TRUE
caaaadaaabcbadadddcaacacbbbdaa	TRUE
cdadadadaacbaadbbccabdcbbbabab	TRUE
abaaaabcacadddcdcddddcdcccbaad	TRUE
acaaaabbcbacbcbcaccbacccadcddb	TRUE
aaadabdaddaddccabbbcdcacdccb	TRUE
aabdadaaaaaddccadccbcccbcaccdb	TRUE
aaaadddbccdadabbdbcdcabbaaac	TRUE
aaacaaabdbaddccdcdaddbabcacddb	TRUE
aaaabaabaabccacbbcdaddaabcadad	TRUE
aaaabaadbaddacbcaddadbabbcaa	TRUE
aaaadcbddadcdcadcbadbabcaccdc	TRUE
aaaaddbabaacbcadcccbcdbdcccaca	TRUE
aaacdadbacddcdcadbdbabaccdbbd	TRUE
aaadcadabdbbbcccddbbbccaacdacc	TRUE
aaadcabdcaabbbbcaabdccbddbaab	TRUE
aabaadaddaccddbcabbbbdaccbbcd	TRUE
aacadaaaaddacddaacbdacbcbbbcb	TRUE
aacaadadabdccaacdbbabdcbbabda	TRUE
aadaabcdcbdacbdbbaaddccadada	TRUE
aadababcabddbbdaaacccdbdadbad	TRUE
aadcaadcdddcbcdbbbbbaadcbaadc	TRUE
aaddadddddacacdaabcccdcbdbacad	TRUE
abadadaaaddababbdbcaacccdcbaa	TRUE
acadddaabaccccdbdcccabdadabaa	TRUE
abaadadaabbcadaddaccaccbabcdb	TRUE
adcadaaaaccbaaddaacbcbbaccaaac	TRUE
adaabadadadcbbdbaadbbaddabbdaa	TRUE
adaaacabaacdbcbbadccbbdaadcac	TRUE
adaaddacdadcdcccacbddbbddacac	TRUE
adadaddddacdababacdbaccdcbbab	TRUE
adbdddaaaacccbbacadacabacbbdb	TRUE
addaddaddabcdbaacadccdaccadca	TRUE
baaaaadddacbaabacbdcaaabdccdd	TRUE
bddaadadabbcacbacbddcaaacdadd	TRUE
cdaaaaadabddbcbcccacaacbadcbd	TRUE
baadaaddabdddbdccbccbbbdbcabb	TRUE
dcaaaaacbbadccaabdabcabadbcabb	TRUE
dacdadadaaaabcccacadaadcbdbbbb	TRUE
daaaacaccacddacdbaaddadabadcbb	TRUE
daaabddadadcaddadcbcdcbcddaad	TRUE
daadaacdadbbdaadaaccaabccadab	TRUE
daadadcaaaaadcddcacdbccbbbbcbb	TRUE
dadaaaddbbbaaaccdbaaacacaadac	TRUE
dadadadabcbbacaadbabbcaacaada	TRUE
dadddadaaabababdbcaddbaddbdadc	TRUE
ddbaddadaaadcbadbcacbacadddddc	TRUE
ddaabaaddccbdccaddcdacbcdbdad	TRUE
ddbadaadaccabdccacdcddacbdaac	TRUE
