aaailalkjomodpmcilgp	TRUE
leffkeeafcgcalmlnggm	TRUE
hafbjpkiahdiagilaioa	TRUE
akhjakokbdhiknjfpjak	TRUE
ooalkcpcdipiagpgkgkj	TRUE
abbhikdbohfacidgconi	TRUE
amgmdpdnobnlkiacjdlf	TRUE
afddcjbmkagbnioghhpl	TRUE
akdhkhoeeofhmdifoglb	TRUE
aebclnioefeagpgoohlh	TRUE
eabchgokjkfailjimjgg	TRUE
egjklffefljfnjmafdib	TRUE
ekmailejfomppcnkpilg	TRUE
epkmiflmalejjljekkcg	TRUE
fealpnfhofkaglcgdepp	TRUE
fjfhifaeefncommalodf	TRUE
folmlgeffapiblgmoigm	TRUE
ggelgalpecjdaopnbbca	TRUE
ghakibhbhpjlfgbfadgp	TRUE
gmimnacekffhlnibaigo	TRUE
hjphahmjocglbgfigcfh	TRUE
hgflokgpeeandnhcgolc	TRUE
hkkamldpihbiefkddpii	TRUE
hpliaeapohojiadnnaoe	TRUE
iadmpbfillbjjdgielck	TRUE
iigfoefmambpmmindikn	TRUE
inkeinmjhmpaehgjcnmo	TRUE
jkapmofmekoilddhkjme	TRUE
jgmfjanjgbglbhdeklof	TRUE
jlafcgnobafpaglanjba	TRUE
kgnhjlanmpnpeaenblkp	TRUE
kfajppcledmfhifgnlhd	TRUE
kkadcbfhembemojeedce	TRUE
kpgkgplghngfadbgneki	TRUE
labfelpgdmjhcflmhoma	TRUE
lilnaijnkifokakjpmgj	TRUE
lnakfnkjnfgccglnekid	TRUE
maddongmebcoopdghomd	TRUE
mgpkgpkolablhbbknffc	TRUE
mmolfnaefhophpodaion	TRUE
nfaedkbcncmaljgpilna	TRUE
ngonnfjoafaigohekakm	TRUE
nmajbpdogloamllkdfpd	TRUE
omkakbnbnalojdfijjah	TRUE
ofieegkkannlodabjdff	TRUE
ojjffmfjlgknaligajdf	TRUE
onojngpacebnnodghnah	TRUE
pmeaobhibiimafkkdefh	TRUE
pgnnjiganoigkbfkfaoi	TRUE
pknimifeknadhgnhonle	TRUE
baaailalkjomodpmcilgp	FALSE
bleffkeeafcgcalmlnggm	FALSE
chafbjpkiahdiagilaioa	FALSE
dakhjakokbdhiknjfpjak	FALSE
dooalkcpcdipiagpgkgkj	FALSE
abbhikabohfacidgconi	FALSE
dmgmdpdnobnlkiacjdlf	FALSE
hfddcjbmkagbnioghhpl	FALSE
kkdhkhoeeofhmdifoglb	FALSE
oebclnioefeagpgoohlh	FALSE
edabchgokjkfailjimjgg	FALSE
egjklffecljfnjmafdib	FALSE
ekmcilejfomppcnkpilg	FALSE
epkcmiflmalejjljekkcg	FALSE
fdalpnfhofkaglcgdepp	FALSE
fjfhbfaeefncommalodf	FALSE
fclmlgeffapiblgmoigm	FALSE
gcgelgalpecjdaopnbbca	FALSE
ghbkibhbhpjlfgbfadgp	FALSE
gmcimnacekffhlnibaigo	FALSE
cjphahmjocglbgfigcfh	FALSE
hgflokgbeeandnhcgolc	FALSE
hkcamldpihbiefkddpii	FALSE
hcliaeapohojiadnnaoe	FALSE
iidmpbfillbjjdgielck	FALSE
iigdfoefmambpmmindikn	FALSE
inkeincjhmpaehgjcnmo	FALSE
jckapmofmekoilddhkjme	FALSE
jgmbjanjgbglbhdeklof	FALSE
jlbfcgnobafpaglanjba	FALSE
bgnhjlanmpnpeaenblkp	FALSE
kfljppcledmfhifgnlhd	FALSE
kkjdcbfhembemojeedce	FALSE
kpbgkgplghngfadbgneki	FALSE
lhbfelpgdmjhcflmhoma	FALSE
lildnaijnkifokakjpmgj	FALSE
lnpkfnkjnfgccglnekid	FALSE
mbddongmebcoopdghomd	FALSE
mgpkgpkolgblhbbknffc	FALSE
mmbolfnaefhophpodaion	FALSE
nbfaedkbcncmaljgpilna	FALSE
ngobnnfjoafaigohekakm	FALSE
nmfjbpdogloamllkdfpd	FALSE
dmkakbnbnalojdfijjah	FALSE
ofieegckannlodabjdff	FALSE
ojjffmcjlgknaligajdf	FALSE
onojngpdacebnnodghnah	FALSE
pcmeaobhibiimafkkdefh	FALSE
pgnnbiganoigkbfkfaoi	FALSE
pknimifeknjdhgnhonle	FALSE
aaoeanbcapnjgkcjldpac	TRUE
kafgecmhnaoofpahapjgl	TRUE
eapiikpmhadlnneblpfia	TRUE
ooeeeepakamjmpadhlpfg	TRUE
ijaamlankahgfjkdmplkf	TRUE
amdknkbcpbnknccncpaja	TRUE
ammadljefjhcclgcgdiif	TRUE
amooneoflgfdcjkinijfn	TRUE
aidblcnklelhjnmdnfncp	TRUE
afmefhficnoogjgcamokf	TRUE
eofmnaffhhkddhpkagedd	TRUE
eeifgennhiaojldjofebc	TRUE
ejaodhhkcodpelmeifplk	TRUE
enohehaanadgcpbmeclab	TRUE
fhafkafdcjfnjebakfepn	TRUE
fgomggohacjgiebkjmoja	TRUE
flehnancgkjcnmhpbcbkg	TRUE
gppnflllpkacohbnlmllc	TRUE
ggadhjjiinpejgbibdgah	TRUE
glkmemhahhecdhkjdmkga	TRUE
hakpnkfnhdcikgcafhfbk	TRUE
hfggnnonablcdfafihoid	TRUE
hkhpppkpjkggaocabpgec	TRUE
hpfjiioakdddhfkocjche	TRUE
iagnbgeegdokmkdfbebef	TRUE
iifadekbkbjidpgjlghae	TRUE
inknapoaalbmbppnbdnik	TRUE
jacpcdbofaibgfemileed	TRUE
jikonmojlfealbdfjfckm	TRUE
jmlmooagkooipdjhhaofp	TRUE
kadfacdejeobnichkbfji	TRUE
kflfpkmliadkhhdnfkdgj	TRUE
kkagbjfgmalckghokcilp	TRUE
kpgngaacdddggimcgalig	TRUE
lemablfajkomacnkagcop	TRUE
limfmflhpnpfakjfijckm	TRUE
lmieakigkmjhbceplpbog	TRUE
mpnjaedohgnoemngofjcn	TRUE
mfkaakmmbficaabddgobg	TRUE
mkfahbblpkfedfaihonbb	TRUE
mpoinjgjmnnaoffimcmgd	TRUE
negagmpmblfmepigjilae	TRUE
niooaiomglaomeaaidjaa	TRUE
nnioandcbdaagfaegjccd	TRUE
oamlnbeipgnbiaegmjaio	TRUE
ogkaabocdhibmjfpejfeh	TRUE
olkanehcmecjahckiifnk	TRUE
pmkmmkhkannpapmefajin	TRUE
pfljfohnehabpnnhlgmfj	TRUE
pkfmihjpeaocjihbnbldi	TRUE
baaoeanbcapnjgkcjldpac	FALSE
bkafgecmhnaoofpahapjgl	FALSE
ceapiikpmhadlnneblpfia	FALSE
cooeeeepakamjmpadhlpfg	FALSE
dijaamlankahgfjkdmplkf	FALSE
mdknkbcpbnknccncpaja	FALSE
bmmadljefjhcclgcgdiif	FALSE
emooneoflgfdcjkinijfn	FALSE
iidblcnklelhjnmdnfncp	FALSE
mfmefhficnoogjgcamokf	FALSE
bofmnaffhhkddhpkagedd	FALSE
eeifgednnhiaojldjofebc	FALSE
ejpodhhkcodpelmeifplk	FALSE
enohehcanadgcpbmeclab	FALSE
fdhafkafdcjfnjebakfepn	FALSE
fgomggohicjgiebkjmoja	FALSE
fldhnancgkjcnmhpbcbkg	FALSE
bppnflllpkacohbnlmllc	FALSE
ggodhjjiinpejgbibdgah	FALSE
glkdmemhahhecdhkjdmkga	FALSE
cakpnkfnhdcikgcafhfbk	FALSE
hfggnnonablcdfafihobid	FALSE
hkhpppkpjdggaocabpgec	FALSE
hpfjiionkdddhfkocjche	FALSE
ingnbgeegdokmkdfbebef	FALSE
iifdadekbkbjidpgjlghae	FALSE
inkdapoaalbmbppnbdnik	FALSE
jacpcdbofaibgfcemileed	FALSE
jickonmojlfealbdfjfckm	FALSE
jmlmoofgkooipdjhhaofp	FALSE
kcadfacdejeobnichkbfji	FALSE
kflfpkmlciadkhhdnfkdgj	FALSE
kkfgbjfgmalckghokcilp	FALSE
kpgnbaacdddggimcgalig	FALSE
lcmablfajkomacnkagcop	FALSE
licmfmflhpnpfakjfijckm	FALSE
lmideakigkmjhbceplpbog	FALSE
dpnjaedohgnoemngofjcn	FALSE
mfkbaakmmbficaabddgobg	FALSE
mkfchbblpkfedfaihonbb	FALSE
mpoinjgcjmnnaoffimcmgd	FALSE
negbgmpmblfmepigjilae	FALSE
niodaiomglaomeaaidjaa	FALSE
nnioindcbdaagfaegjccd	FALSE
odamlnbeipgnbiaegmjaio	FALSE
ogdaabocdhibmjfpejfeh	FALSE
olkdanehcmecjahckiifnk	FALSE
cmkmmkhkannpapmefajin	FALSE
pfljfcohnehabpnnhlgmfj	FALSE
pkcfmihjpeaocjihbnbldi	FALSE
aakmcdadbgadeioahjfdbd	TRUE
llkmjlhhoohgihgaopaofa	TRUE
efejghnlaokpboejefoamd	TRUE
nnpnkkpaipbldifjempkad	TRUE
jefpafihlglcmaphdgkaml	TRUE
afmlahebcobipcpogmgdlb	TRUE
apijahjkipngcgnnfmbpap	TRUE
ajigdkcfedhjbipimnnaif	TRUE
abeknpekohgcegccnjefmg	TRUE
akdaadkdiglhimbiafalmb	TRUE
eadalnlnnkfigohppjpioe	TRUE
eglagdpmpadhoajedcjfmk	TRUE
elopgapapbfeghhcinieii	TRUE
fkaccndhgdjkbhfnmoahbf	TRUE
ffadjmemcgekolbdekonaj	TRUE
fkafofcdeoaoblhpbachhc	TRUE
fonadjikjdoelkmnnhdich	TRUE
gapbdeiejlocohlfknieji	TRUE
gilifogofaeckiajlnlmgg	TRUE
gnhaepiibhgbcjhaaaeejk	TRUE
hahajkeegbokpfjcfbijog	TRUE
hgomihhjloiponnhihjkao	TRUE
hlfgpajlkffaekgghkglkl	TRUE
hpoilkfmfeklggabcfhgge	TRUE
iabfgnajkdpmnnmfjpocmo	TRUE
iimoojabnnfpbahconhphd	TRUE
inahijgcfoohfponkjnmdf	TRUE
jjoagggmdjmcfdnmmbbaeh	TRUE
jgilfkiadfnkgcppfgjcpn	TRUE
jlkamfockjigfnjplfamfa	TRUE
kajngipnodecjljopdifok	TRUE
kfijgaefgaokldbooihoja	TRUE
kklaoafblbiijabnknkbbd	TRUE
komeiogfiaaaiickklckbg	TRUE
laojkdideepebhjalbahgj	TRUE
lhhgnkgmfmkkppalkkfnil	TRUE
lmfpanicdgmjmciachdkfb	TRUE
mlpioljalknpdabebjefai	TRUE
mfmmaeacbkahakmalikpic	TRUE
mkmamfgegbpdoocdpoedoc	TRUE
nagmiabfdiccjbkiondpgc	TRUE
nejmjnenoapfjlonkhjgcc	TRUE
njjoekfgaafpobmedogoef	TRUE
nookaneocjdmflnglncmhl	TRUE
oakbdpclhfdignolgpoked	TRUE
oiilomlamdmlfhbifcgpag	TRUE
omoadcobhmkpialbnojgbe	TRUE
pojglfabfnilaedcpfpdbn	TRUE
pfjhkaaffebbkpaahicpok	TRUE
pkjadedmdibldpjnjfegfk	TRUE
baakmcdadbgadeioahjfdbd	FALSE
bllkmjlhhoohgihgaopaofa	FALSE
cefejghnlaokpboejefoamd	FALSE
cnnpnkkpaipbldifjempkad	FALSE
djefpafihlglcmaphdgkaml	FALSE
afmlahebcobipcpogmgdab	FALSE
bpijahjkipngcgnnfmbpap	FALSE
fjigdkcfedhjbipimnnaif	FALSE
ibeknpekohgcegccnjefmg	FALSE
mkdaadkdiglhimbiafalmb	FALSE
dadalnlnnkfigohppjpioe	FALSE
egbagdpmpadhoajedcjfmk	FALSE
eldopgapapbfeghhcinieii	FALSE
ckaccndhgdjkbhfnmoahbf	FALSE
ffjdjmemcgekolbdekonaj	FALSE
fkafofcdeoaoblhpabachhc	FALSE
fonbadjikjdoelkmnnhdich	FALSE
glpbdeiejlocohlfknieji	FALSE
gilifogodaeckiajlnlmgg	FALSE
gnhoepiibhgbcjhaaaeejk	FALSE
hdahajkeegbokpfjcfbijog	FALSE
hgomihhjloiconnhihjkao	FALSE
hlfgpdajlkffaekgghkglkl	FALSE
hpoilkfmfeblggabcfhgge	FALSE
inbfgnajkdpmnnmfjpocmo	FALSE
iimoojabnnfabahconhphd	FALSE
injhijgcfoohfponkjnmdf	FALSE
jcjoagggmdjmcfdnmmbbaeh	FALSE
jgbilfkiadfnkgcppfgjcpn	FALSE
jlkmfockjigfnjplfamfa	FALSE
dajngipnodecjljopdifok	FALSE
kfijdaefgaokldbooihoja	FALSE
kblaoafblbiijabnknkbbd	FALSE
komeiogfdaaaiickklckbg	FALSE
lcojkdideepebhjalbahgj	FALSE
lhhgnkgmfmkkpdalkkfnil	FALSE
lmfpanibcdgmjmciachdkfb	FALSE
dlpioljalknpdabebjefai	FALSE
mfmcmaeacbkahakmalikpic	FALSE
mkbamfgegbpdoocdpoedoc	FALSE
bagmiabfdiccjbkiondpgc	FALSE
nejmjnbenoapfjlonkhjgcc	FALSE
njjoekfgcafpobmedogoef	FALSE
nocokaneocjdmflnglncmhl	FALSE
odkbdpclhfdignolgpoked	FALSE
obilomlamdmlfhbifcgpag	FALSE
omokdcobhmkpialbnojgbe	FALSE
pbojglfabfnilaedcpfpdbn	FALSE
pfjhbkaaffebbkpaahicpok	FALSE
pkjcadedmdibldpjnjfegfk	FALSE
aaifmgkbiobhbiohlnfkpkg	TRUE
lfjeabimfmohffplhhhdhbi	TRUE
fplanchljkondclmnnbfigo	TRUE
ajfokmkcimnnfincnhmepja	TRUE
mgaafaajdadmekngapnhnlk	TRUE
akcdmapaaoakmbbadbokbkd	TRUE
akeidpfjdgciklpdccaelkd	TRUE
akpkebppkhjljfcbilaoiak	TRUE
alcpdmncdenkeejoedfmlnk	TRUE
aifhcngamcakofbdnbmdkkd	TRUE
ekaffbdipdnhhpbdnpejfcm	TRUE
egmagclkakgobgdakhefeig	TRUE
ekhgekeadefnjbaicphknme	TRUE
epeinoglfjejhhklacfkkbn	TRUE
fappohpggehgnjpmhnmllcd	TRUE
fhkelpeelknaninogfddnpp	TRUE
flmejpafdldbbpmpppadlbe	TRUE
gagmhnnlhgjjlkojadgmgnk	TRUE
gflnjjigfhadekdhnfihllh	TRUE
glalgjbgdkdeogghmbljhce	TRUE
gppfohafjjkgbcbggighjhi	TRUE
heghnklnkllacidddanagaf	TRUE
hippenjgkkapannkhicldgm	TRUE
hnlngkpieiakcoeeonlknec	TRUE
ijgiekhnameidhmjhkaceme	TRUE
ihlojeimaekjpdgfgadhclc	TRUE
inpoenoacgjihbfnajgidoh	TRUE
jnackondcibknjfbhejknbc	TRUE
jfahgpifkfbejiepkapeofg	TRUE
jknofacifhmpidcdmnbodkh	TRUE
jpgjfimpajnfclbiklfmipd	TRUE
kackajaenkkaffikghmibim	TRUE
kiopolgigjomjlkagkndchj	TRUE
knfplhnoakeeneikplmfgmp	TRUE
laehbidcoajhiogoajfphbj	TRUE
lhapnicilngmcglnnpdcjlb	TRUE
lmphefafcbjkgmdmlmookie	TRUE
mmaanmmeegnagpcfpjaalph	TRUE
mfnlemehlnefglkaojopbbk	TRUE
mkleophgienkaoboaklikph	TRUE
mpaopiofogkmpbinmdhappe	TRUE
nanjiijnglhdlncheaebklc	TRUE
niplplgiplafgcpjcfmlalf	TRUE
noiomjlmmjpllphmabeclbp	TRUE
oajcjmlejclimledidonfof	TRUE
oigopoadnkngmlanjpooilc	TRUE
onmlamgajacecagldmgbbec	TRUE
paabgabkcacmbcmoeffnkbo	TRUE
pgnmkpabebbipmngplnimjk	TRUE
pknjlaieifecpbbjnajjdne	TRUE
baaifmgkbiobhbiohlnfkpkg	FALSE
blfjeabimfmohffplhhhdhbi	FALSE
cfplanchljkondclmnnbfigo	FALSE
dajfokmkcimnnfincnhmepja	FALSE
dmgaafaajdadmekngapnhnlk	FALSE
akcdmapaaoakmbbadboabkd	FALSE
ckeidpfjdgciklpdccaelkd	FALSE
fkpkebppkhjljfcbilaoiak	FALSE
jlcpdmncdenkeejoedfmlnk	FALSE
nifhcngamcakofbdnbmdkkd	FALSE
eckaffbdipdnhhpbdnpejfcm	FALSE
egmngclkakgobgdakhefeig	FALSE
ekhgckeadefnjbaicphknme	FALSE
epeinoglfjejhhklpcfkkbn	FALSE
feppohpggehgnjpmhnmllcd	FALSE
fhkcelpeelknaninogfddnpp	FALSE
flmejpbfdldbbpmpppadlbe	FALSE
dagmhnnlhgjjlkojadgmgnk	FALSE
gflnjjcgfhadekdhnfihllh	FALSE
glllgjbgdkdeogghmbljhce	FALSE
gppfohgfjjkgbcbggighjhi	FALSE
heghnkcnkllacidddanagaf	FALSE
hippenjgkkdapannkhicldgm	FALSE
hnlngkdpieiakcoeeonlknec	FALSE
idjgiekhnameidhmjhkaceme	FALSE
ihlojeibmaekjpdgfgadhclc	FALSE
idpoenoacgjihbfnajgidoh	FALSE
cnackondcibknjfbhejknbc	FALSE
jfihgpifkfbejiepkapeofg	FALSE
jknoficifhmpidcdmnbodkh	FALSE
jpgjbimpajnfclbiklfmipd	FALSE
kockajaenkkaffikghmibim	FALSE
kiopolgigjomjbkagkndchj	FALSE
knfpclhnoakeeneikplmfgmp	FALSE
laehbidcdoajhiogoajfphbj	FALSE
lhmpnicilngmcglnnpdcjlb	FALSE
lmphefnfcbjkgmdmlmookie	FALSE
dmaanmmeegnagpcfpjaalph	FALSE
mfnlemehlbnefglkaojopbbk	FALSE
mkleophgcenkaoboaklikph	FALSE
mpdaopiofogkmpbinmdhappe	FALSE
npnjiijnglhdlncheaebklc	FALSE
niplplgiplfgcpjcfmlalf	FALSE
noiomjlmmjpcllphmabeclbp	FALSE
oijcjmlejclimledidonfof	FALSE
oigopoidnkngmlanjpooilc	FALSE
oncmlamgajacecagldmgbbec	FALSE
pbaabgabkcacmbcmoeffnkbo	FALSE
pgbnmkpabebbipmngplnimjk	FALSE
pknjlgieifecpbbjnajjdne	FALSE
aackflbjgjjjlfjjblcdalgf	TRUE
llahclkidbjdkkdmijddjclc	TRUE
gihajpoppgaajbapalogmhoo	TRUE
aknglnfmcgpakmamlldfjleh	TRUE
oiadnjiofaocbkmhjnjdjjlg	TRUE
aljhbmocbkdminphnjfpaibe	TRUE
abnmbfbnobnpjdnecpmedaik	TRUE
acnhchenhjldpbomplhppdng	TRUE
akmjghcpnkgchdcmlpjhpfkb	TRUE
agbmdeabeknpmciphegmoeoo	TRUE
eemlpoiepgjnojlkknadekia	TRUE
efgkhfpffelafhhcfjbpmbeh	TRUE
eknacobojhbjknkjomgcimbl	TRUE
epfepphkhofamoadinmbfmbo	TRUE
fapibgodempcgeldcoimbghn	TRUE
fiacmckabnoponoocfpgpiac	TRUE
fneeinegnffinoenafdadnkh	TRUE
gacmpginomahkhdnndlklpgn	TRUE
giacjkfgdllpoakfgjobibhl	TRUE
gnajgcoclkndcabndkphnnai	TRUE
hejaghpbjdakagiflcnleimk	TRUE
hgoaollifbhjpfcboodoclgp	TRUE
hkkjeahninnmkpgjanghioan	TRUE
hphnkmnkeabphnfacemioane	TRUE
ienkfpainnbighkngcinmchi	TRUE
ijklgfacaihanijocbhfhgng	TRUE
ingppjhkaihjjgnbnlfnjkce	TRUE
jmjjalbefongbnhohppgnebl	TRUE
jialkidgjblnjlingnplfjol	TRUE
jnflganabindebkfbpkbhohm	TRUE
kaafniiiijcnhahhgbandjab	TRUE
khampbfakbhnpbkcbgamfonc	TRUE
klkemfoeaghclmadlfmnoghf	TRUE
kplaaamfnfjolfdkbfkejglp	TRUE
lapolpmokmcjcdclgjpepmaa	TRUE
likgmhjmmmfmkkmaaacehcai	TRUE
lnhfohjgnnfeoaakjfjokljc	TRUE
mnlaoimhdggdcebncjkjihii	TRUE
mialpkljnpmnpmjngghpeifo	TRUE
mnlafmdogdicfbkkhcdmpoce	TRUE
nejpjajmpmpkohgglennckaa	TRUE
nganjpepinphihmpceomiddg	TRUE
nkiaojcfghbilccageebcddm	TRUE
npfphpgnfaedgblfdddjnpph	TRUE
oaibcihebemdnfognkbmmhfo	TRUE
oikjogoeeagophigefbfbedd	TRUE
omiihhefmopaipabpmahjhai	TRUE
peopmnkadobpoahiopnnkbmk	TRUE
pgnhafknfmdhnpdjhkfdbmlh	TRUE
pleaojhilhioicngpdaacojh	TRUE
baackflbjgjjjlfjjblcdalgf	FALSE
bllahclkidbjdkkdmijddjclc	FALSE
cgihajpoppgaajbapalogmhoo	FALSE
daknglnfmcgpakmamlldfjleh	FALSE
doiadnjiofaocbkmhjnjdjjlg	FALSE
aljhbmoclkdminphnjfpaibe	FALSE
bbnmbfbnobnpjdnecpmedaik	FALSE
ecnhchenhjldpbomplhppdng	FALSE
ikmjghcpnkgchdcmlpjhpfkb	FALSE
mgbmdeabeknpmciphegmoeoo	FALSE
bemlpoiepgjnojlkknadekia	FALSE
efcgkhfpffelafhhcfjbpmbeh	FALSE
eknfcobojhbjknkjomgcimbl	FALSE
epcepphkhofamoadinmbfmbo	FALSE
fepibgodempcgeldcoimbghn	FALSE
ficmckabnoponoocfpgpiac	FALSE
fneeinegnffibnoenafdadnkh	FALSE
gjcmpginomahkhdnndlklpgn	FALSE
gipcjkfgdllpoakfgjobibhl	FALSE
gncajgcoclkndcabndkphnnai	FALSE
hbejaghpbjdakagiflcnleimk	FALSE
hgcoaollifbhjpfcboodoclgp	FALSE
hkkjbahninnmkpgjanghioan	FALSE
hphnkmnkebbphnfacemioane	FALSE
ienkfpninnbighkngcinmchi	FALSE
ijkdgfacaihanijocbhfhgng	FALSE
ingppdhkaihjjgnbnlfnjkce	FALSE
jdmjjalbefongbnhohppgnebl	FALSE
jielkidgjblnjlingnplfjol	FALSE
jnfdganabindebkfbpkbhohm	FALSE
kaafniiiijcnhahhgbancdjab	FALSE
khpmpbfakbhnpbkcbgamfonc	FALSE
klkedfoeaghclmadlfmnoghf	FALSE
kpdaaamfnfjolfdkbfkejglp	FALSE
lopolpmokmcjcdclgjpepmaa	FALSE
likgmhjcmmfmkkmaaacehcai	FALSE
lnhfdhjgnnfeoaakjfjokljc	FALSE
mdnlaoimhdggdcebncjkjihii	FALSE
mielpkljnpmnpmjngghpeifo	FALSE
mnlofmdogdicfbkkhcdmpoce	FALSE
ncejpjajmpmpkohgglennckaa	FALSE
ngjnjpepinphihmpceomiddg	FALSE
nkiaojofghbilccageebcddm	FALSE
ncfphpgnfaedgblfdddjnpph	FALSE
ooibcihebemdnfognkbmmhfo	FALSE
oikjogobeagophigefbfbedd	FALSE
omiihhefmdopaipabpmahjhai	FALSE
pbeopmnkadobpoahiopnnkbmk	FALSE
pgbnhafknfmdhnpdjhkfdbmlh	FALSE
plceaojhilhioicngpdaacojh	FALSE
aacjiejadhoncdbjgljddcckc	TRUE
kekaofdbafcidomaffmbjnald	TRUE
hkhlgmahopgldiaocmnbkoicf	TRUE
alllndppndoegmddeckbdgbgk	TRUE
aenbblfmnkdmcfhebngmhcnij	TRUE
aojkmbcedbbcpkifpeohifnjc	TRUE
agnmnfccblcjfbpgfjbjmeekk	TRUE
acblolnliknjooflbcbggedkk	TRUE
ampffniplglfbnclplfkodfln	TRUE
adhamlemfmhacmfegifgbignj	TRUE
egakicajimanegididojngdlp	TRUE
efjnnknpjgabnhohoobbmdjpm	TRUE
elkieggmmplnhaeagligcemeh	TRUE
fhappoijihaffhelmiknodlni	TRUE
fepellekeieajccebjgbmpkcf	TRUE
fjkadamoglnlndomkdgpoellf	TRUE
foijkajpkglhdjlehbogjnocf	TRUE
gankpdaifbdkalehaogmogccn	TRUE
ghnmogeaemaiapblpoogdghpl	TRUE
gnfkfalgjcjmohbjpeengdlda	TRUE
hpeaccmjblnnbcifelkkbhaak	TRUE
hgajnbdoeilcldkfhkhfpobgj	TRUE
hkpmemojaekdhnkkjdegmmdpl	TRUE
hponpgpalkakdlfbdbmfcmbaj	TRUE
iehokjgllahlngfnppbgegchd	TRUE
iijillakfkifcanmboblelahh	TRUE
imolehakepeedjeppcbkofpdn	TRUE
jhagbedimfjkhhjepjfjjadao	TRUE
jgpmmepjnneeaippdldifmjak	TRUE
jmaknmiimjdjpoabohckkdghn	TRUE
knaenhoadeabfokbiplbcmjfe	TRUE
kflaachhhladmhlhghhdgjmhl	TRUE
kkancomjlchjoliefajablcom	TRUE
kogabknlpglcdjloflbgiomec	TRUE
laoojgmioccfelkmlibioidfk	TRUE
lhmhgoemnhghaifapphhdeceg	TRUE
lmjeadmclkllnmkajmcldhpif	TRUE
mmkahgfceladjpolhkcllofnd	TRUE
mgmlpngglacpahiaheefjlhkf	TRUE
mmekeampliiaibjohgjfephec	TRUE
ngadjadgmlgonkbphpjhmgolh	TRUE
nfpejioeapabffamiodelagcn	TRUE
nkajomboakbiiaeoniiddhiig	TRUE
nolfeojmiabipempcfiokafib	TRUE
oealndjgaolkgmilcjdhipmcg	TRUE
ojfenijglaoklfammpdnaloja	TRUE
onkemelpkokkmepabfhcljplp	TRUE
ppeahnglcbmmodiejkibjocdc	TRUE
pghpnhgigappngdajldfpnkap	TRUE
plgfngapiiicgfmbhdpkllami	TRUE
baacjiejadhoncdbjgljddcckc	FALSE
bkekaofdbafcidomaffmbjnald	FALSE
chkhlgmahopgldiaocmnbkoicf	FALSE
dalllndppndoegmddeckbdgbgk	FALSE
enbblfmnkdmcfhebngmhcnij	FALSE
aojkmbcedbbcpkifpeodhifnjc	FALSE
cgnmnfccblcjfbpgfjbjmeekk	FALSE
ecblolnliknjooflbcbggedkk	FALSE
impffniplglfbnclplfkodfln	FALSE
ldhamlemfmhacmfegifgbignj	FALSE
cgakicajimanegididojngdlp	FALSE
efjcnknpjgabnhohoobbmdjpm	FALSE
elkieggmmpbnhaeagligcemeh	FALSE
bhappoijihaffhelmiknodlni	FALSE
fepebllekeieajccebjgbmpkcf	FALSE
fjkmdamoglnlndomkdgpoellf	FALSE
foijkejpkglhdjlehbogjnocf	FALSE
gfnkpdaifbdkalehaogmogccn	FALSE
ghndogeaemaiapblpoogdghpl	FALSE
gncfkfalgjcjmohbjpeengdlda	FALSE
hbpeaccmjblnnbcifelkkbhaak	FALSE
hgcjnbdoeilcldkfhkhfpobgj	FALSE
hkpmemojcekdhnkkjdegmmdpl	FALSE
hpcnpgpalkakdlfbdbmfcmbaj	FALSE
iehokjglljhlngfnppbgegchd	FALSE
iijilbakfkifcanmboblelahh	FALSE
imolehnkepeedjeppcbkofpdn	FALSE
jdhagbedimfjkhhjepjfjjadao	FALSE
jgpmmepjnnedeaippdldifmjak	FALSE
jmnknmiimjdjpoabohckkdghn	FALSE
kbnaenhoadeabfokbiplbcmjfe	FALSE
kflcaachhhladmhlhghhdgjmhl	FALSE
kkbncomjlchjoliefajablcom	FALSE
kogebknlpglcdjloflbgiomec	FALSE
lcoojgmioccfelkmlibioidfk	FALSE
lhmhgoemcnhghaifapphhdeceg	FALSE
lmjedmclkllnmkajmcldhpif	FALSE
mcmkahgfceladjpolhkcllofnd	FALSE
mgmlpnggcacpahiaheefjlhkf	FALSE
mbekeampliiaibjohgjfephec	FALSE
cgadjadgmlgonkbphpjhmgolh	FALSE
nfpejioebapabffamiodelagcn	FALSE
ndajomboakbiiaeoniiddhiig	FALSE
nolfeojmikbipempcfiokafib	FALSE
obalndjgaolkgmilcjdhipmcg	FALSE
ojfendijglaoklfammpdnaloja	FALSE
onkemelpkokkmepbbfhcljplp	FALSE
pdpeahnglcbmmodiejkibjocdc	FALSE
pghpnhgdgappngdajldfpnkap	FALSE
plgfngopiiicgfmbhdpkllami	FALSE
aeldaeeacaloailldfhnpolcho	TRUE
loplhaamlgjabpohggmkkcieaa	TRUE
hlphhgeaaeoahlndlpkfkahnna	TRUE
akcamnokicbnnjlnkaonlgokpc	TRUE
mfoealfifjaoaafcjfkiajdcnj	TRUE
ahpekgdbfepfddacindjjbhhcd	TRUE
accgolnegcdchpmhejakebhofi	TRUE
amhchiaifgbpiidicckbbipkek	TRUE
ajpjfbbjmcoiepkjjjneijckkm	TRUE
amjlgdbeogbojhcnpfebgpcfca	TRUE
alljbpkcobelacomlakanfamgc	TRUE
eeabnlclingbifgiajbdjgpife	TRUE
eimpifjacljhiamcafahccghnl	TRUE
enflpoeanfdnpcckcicfjmkhac	TRUE
fkhjaabeanfjphgeblehnehijl	TRUE
fginlpfgabkmicgogboalkmlbk	TRUE
fllkanfdpmilnhlogoofgbfgjh	TRUE
fpghlghnkkianlbbkockppnlfj	TRUE
gellnalfddgolbapkkadahkjaj	TRUE
gjkmikgpabmahgkbmjhgkhmhmb	TRUE
gookpgpjkainciphdcoldpcenp	TRUE
heiegalbkcjbjgpgleblhmokok	TRUE
hjjakpecbjlihofcbdbaphppml	TRUE
hofghhekhaifgjfedlnmckjlgg	TRUE
ialndjijbjbnbfdenmjpljpefd	TRUE
iifmolklomohfacoabfilknggo	TRUE
imjaaknfkjkmmfkdkfclgbgnbd	TRUE
jaoikchngacilaebnbeonnbnlo	TRUE
jfknhiknahakjfmacbepogmldf	TRUE
jkgjingefjaconpdcfgeiifjfb	TRUE
jpnjjjoeojaaeaobgakchoifmn	TRUE
kfehppnmelmiapccffnokhbgmn	TRUE
kjnjjaojmombaniankmkpfjhpo	TRUE
koikgoaonolcdffggneokafnho	TRUE
lajipdokibooapbnlacpaoljog	TRUE
liohghlpghnajpagfhdbajdbae	TRUE
lohkjieokfenohgnlgeabdhlia	TRUE
malnegdajdabnmdcmiadpcfnkb	TRUE
mipkiaapopbgbjjpniaoddecip	TRUE
mnhnojgoghihagapikkpmnpffa	TRUE
npahoehccbblmepjpemeahiegd	TRUE
ngfabmklhaoeggbagoihheiflj	TRUE
nknoholmjpamndffejcmgekhao	TRUE
ohenkimoahpcoedeleclngnigl	TRUE
oenmladmmnpheapekbogjoiikf	TRUE
ojgepgagbgikaogbpibhpbbome	TRUE
ooipganeonlbeljdafglcljddn	TRUE
paefehghbeefpenlidfpaiajpp	TRUE
pialfkkfeacfmiicphcapgeldk	TRUE
pmhmakcaojclgklomhnfpkhklp	TRUE
baeldaeeacaloailldfhnpolcho	FALSE
bloplhaamlgjabpohggmkkcieaa	FALSE
chlphhgeaaeoahlndlpkfkahnna	FALSE
dakcamnokicbnnjlnkaonlgokpc	FALSE
dmfoealfifjaoaafcjfkiajdcnj	FALSE
ahpekgdbfepfddacindajjbhhcd	FALSE
accgolndgcdchpmhejakebhofi	FALSE
dmhchiaifgbpiidicckbbipkek	FALSE
hjpjfbbjmcoiepkjjjneijckkm	FALSE
lmjlgdbeogbojhcnpfebgpcfca	FALSE
plljbpkcobelacomlakanfamgc	FALSE
ebabnlclingbifgiajbdjgpife	FALSE
eimpifjncljhiamcafahccghnl	FALSE
enflbpoeanfdnpcckcicfjmkhac	FALSE
fckhjaabeanfjphgeblehnehijl	FALSE
fgiblpfgabkmicgogboalkmlbk	FALSE
fblkanfdpmilnhlogoofgbfgjh	FALSE
fpghlghnkkcanlbbkockppnlfj	FALSE
gellnplfddgolbapkkadahkjaj	FALSE
gjkmikgpmbmahgkbmjhgkhmhmb	FALSE
gookpgpjkfinciphdcoldpcenp	FALSE
hebiegalbkcjbjgpgleblhmokok	FALSE
hjjbkpecbjlihofcbdbaphppml	FALSE
hofghhbekhaifgjfedlnmckjlgg	FALSE
idlndjijbjbnbfdenmjpljpefd	FALSE
iifmolklomohfcoabfilknggo	FALSE
imjcaaknfkjkmmfkdkfclgbgnbd	FALSE
jcaoikchngacilaebnbeonnbnlo	FALSE
jfknhikbnahakjfmacbepogmldf	FALSE
jkgjingefjdconpdcfgeiifjfb	FALSE
jpcjjjoeojaaeaobgakchoifmn	FALSE
kfehppnmelmimpccffnokhbgmn	FALSE
kjndjaojmombaniankmkpfjhpo	FALSE
koikgobonolcdffggneokafnho	FALSE
lljipdokibooapbnlacpaoljog	FALSE
liohghlpgcnajpagfhdbajdbae	FALSE
lohkjieokfenohgnlgepbdhlia	FALSE
mnlnegdajdabnmdcmiadpcfnkb	FALSE
mipkcaapopbgbjjpniaoddecip	FALSE
mnhnojgdghihagapikkpmnpffa	FALSE
ncpahoehccbblmepjpemeahiegd	FALSE
ngfabmklhaoeggbagoihbeiflj	FALSE
nknoholmjdpamndffejcmgekhao	FALSE
bhenkimoahpcoedeleclngnigl	FALSE
oenmlbdmmnpheapekbogjoiikf	FALSE
ojgepgkgbgikaogbpibhpbbome	FALSE
ooipganeonlbeljdafgblcljddn	FALSE
pbefehghbeefpenlidfpaiajpp	FALSE
pibalfkkfeacfmiicphcapgeldk	FALSE
pmhmjkcaojclgklomhnfpkhklp	FALSE
aebndnbbebdilgchgkfidpgaapf	TRUE
kmoafhdcackonllnciejaccdphe	TRUE
fhepalahmikdgiphoibnfdkdfab	TRUE
akafjealindnkicnmijfbnohmla	TRUE
aepofcmmgbkkgchdfbggcgbhhga	TRUE
ajcimdnpaehjjgagmmaacmljdfg	TRUE
ailcamepaffpfacmloldcnkaplh	TRUE
agfhfecaekocaicjagoicdibdjo	TRUE
addjjelgpbpnjfmpgncjamieabo	TRUE
ahnmdagaipojgbomhjkknlmkeif	TRUE
enhnmipmoekakedmhphebjigdok	TRUE
egeglpgllaanhjkdjeaeemkhhkl	TRUE
elonplgfmnfkgnmanjcjfhjkgjd	TRUE
fhallaeadogenpipkfmkjchdjdj	TRUE
feapipblnpccpjdeonbcfpaniff	TRUE
fjfpnkpeafomilfcjcfncgnmlfc	TRUE
fnmpnefmepajmpdlciiciebfnmm	TRUE
gginmapjmcackomoefbfndjekjd	TRUE
gghnapgijnljegbjglkknieijgl	TRUE
glmlmellkaepebpeheloojmahjf	TRUE
hfgjmafdiclggegolmoingkkmab	TRUE
heigajdemaojaigalhjkiadlcmb	TRUE
hjjhpkfjknaiinbamabmgbnflei	TRUE
hokapekcfkpljojnkjjihdiehid	TRUE
iaopbcclpcdlcjoajlihfhnjghd	TRUE
ihmfmnpjabjmojlpegmjipfgoml	TRUE
imnagidpgehpoepbggkhoadoocd	TRUE
jkpnmeikapgaocjphnjonhjajob	TRUE
jgalaadjppogfkjphaahlpfdpaj	TRUE
jlajoelddifjbeepinggjpahgcf	TRUE
jpjeioimgoppnajhebepjakjjfn	TRUE
kfajfdnklfmjofodjgmkgimfhij	TRUE
kkljjjhfnhioaajcoijdibdmdbm	TRUE
kpopfoojnllfjoogaeleppajpoa	TRUE
leoamfpanoldgeemcjlbkajfkko	TRUE
ljgaeljddodmkpfmnolnkndjpie	TRUE
loakceibplknncoplcokdiledbp	TRUE
maohbjfhnchnjnelcpmcceindfe	TRUE
miabchfochclaeoonibniknpekl	TRUE
mmpfinhgkaaicmkepjdepoiokgb	TRUE
nfjgimkkaefflepkcoekopcjamb	TRUE
ngjpakdojeiicbjdagemcfllgmj	TRUE
nkohahjclhangpcmidncjhfahlm	TRUE
npjihelmaombbmaelklankognen	TRUE
oeloppagnecalfmfhmncpakojjk	TRUE
ojegkknafedcdpafjkhjdmgojhp	TRUE
onejaaiandhgpjmfjkgddgceogg	TRUE
pkejngefaonhdckkekdgneagjjg	TRUE
pfliojkabkoacoafioinlecklin	TRUE
pkpfhmgnfoapcapekcbjmlppemk	TRUE
baebndnbbebdilgchgkfidpgaapf	FALSE
bkmoafhdcackonllnciejaccdphe	FALSE
cfhepalahmikdgiphoibnfdkdfab	FALSE
dakafjealindnkicnmijfbnohmla	FALSE
epofcmmgbkkgchdfbggcgbhhga	FALSE
ajcimdnpabehjjgagmmaacmljdfg	FALSE
bilcamepaffpfacmloldcnkaplh	FALSE
egfhfecaekocaicjagoicdibdjo	FALSE
hddjjelgpbpnjfmpgncjamieabo	FALSE
mhnmdagaipojgbomhjkknlmkeif	FALSE
ecnhnmipmoekakedmhphebjigdok	FALSE
egcglpgllaanhjkdjeaeemkhhkl	FALSE
elonplgfmnfkgnbanjcjfhjkgjd	FALSE
challaeadogenpipkfmkjchdjdj	FALSE
feopipblnpccpjdeonbcfpaniff	FALSE
fjfbpnkpeafomilfcjcfncgnmlfc	FALSE
fnmpnefcepajmpdlciiciebfnmm	FALSE
gcginmapjmcackomoefbfndjekjd	FALSE
gghnjpgijnljegbjglkknieijgl	FALSE
glmlmebllkaepebpeheloojmahjf	FALSE
cfgjmafdiclggegolmoingkkmab	FALSE
heighjdemaojaigalhjkiadlcmb	FALSE
hjjhpckfjknaiinbamabmgbnflei	FALSE
hdkapekcfkpljojnkjjihdiehid	FALSE
iaopbcclpcdlcjoajlicfhnjghd	FALSE
ihmfmdnpjabjmojlpegmjipfgoml	FALSE
imnjgidpgehpoepbggkhoadoocd	FALSE
jbkpnmeikapgaocjphnjonhjajob	FALSE
jgcalaadjppogfkjphaahlpfdpaj	FALSE
jljjoelddifjbeepinggjpahgcf	FALSE
jpjeioimgoppnhjhebepjakjjfn	FALSE
kfbjfdnklfmjofodjgmkgimfhij	FALSE
kklbjjjhfnhioaajcoijdibdmdbm	FALSE
kpopfoojnllfcjoogaeleppajpoa	FALSE
lboamfpanoldgeemcjlbkajfkko	FALSE
ljbgaeljddodmkpfmnolnkndjpie	FALSE
lbakceibplknncoplcokdiledbp	FALSE
mfohbjfhnchnjnelcpmcceindfe	FALSE
mibchfochclaeoonibniknpekl	FALSE
mmpfinhbgkaaicmkepjdepoiokgb	FALSE
dfjgimkkaefflepkcoekopcjamb	FALSE
ncjpakdojeiicbjdagemcfllgmj	FALSE
nkohhjclhangpcmidncjhfahlm	FALSE
npjicelmaombbmaelklankognen	FALSE
oecoppagnecalfmfhmncpakojjk	FALSE
ojedgkknafedcdpafjkhjdmgojhp	FALSE
onebaaiandhgpjmfjkgddgceogg	FALSE
pckejngefaonhdckkekdgneagjjg	FALSE
pflcojkabkoacoafioinlecklin	FALSE
pkpfhmgncoapcapekcbjmlppemk	FALSE
aafmgbchnmpbpmgaimalpnbkepjb	TRUE
nnkkahmdbggcpjkmfldfikimnkgn	TRUE
makhhjohhhemjkeaakncpdjlbibg	TRUE
ggpmjhjaiocdghooheglkkijgjoe	TRUE
ahlmnlgfmodpdbcjhcpbldhjdcgi	TRUE
ajcjabhfcddannnganidljlpacam	TRUE
aacdjfmbfeednloldlcopgfbnapb	TRUE
ajchmndmcgeeebikgpkodkjfjfjb	TRUE
abnbeefmiliikiiolkkkmiagnhmm	TRUE
achbofdhfcdjakghldhdpdmjkbnj	TRUE
ejfhgjaejildjeiflfjioholhcek	TRUE
eghandinpegmcoidhbclcoibgidj	TRUE
elmoagjodidgdipplhhmnkljhloo	TRUE
ffamfodmocploebljemcpcmoinof	TRUE
ffabnmnbdkkmhcdgcfnfgjjnahlk	TRUE
fjpjoaaagfcfofplhknlbmagobof	TRUE
fpabfjijnnagndnaoahhnndekobl	TRUE
gajmfhpgklbfmckdfgpipgiilpkb	TRUE
gillapbacbdmmcoeopcbkppjpnng	TRUE
gngjpgflllpaagiklgkbcmdelmec	TRUE
heabjckaealjcliaofpdejakligm	TRUE
hgghinekemohjagfbmicaieipdfn	TRUE
hkmpiffpkpapigecgcenmlbpiiio	TRUE
hppegpkofhabmpdpnbaapkalppjg	TRUE
iaclnknjblfkccnajmakpahjmpdh	TRUE
iiohpnaleegmgfeokbofgedhjjlc	TRUE
inaeikcimphnpnpcncgfeglmamle	TRUE
jamhfneiilhmpolmehaeffokpgbh	TRUE
jgkamnhbcdblnaddfjkciiibgafm	TRUE
jlhlelaehckfledlgcpjmgbcpdpg	TRUE
kjjefhamdopmekanbdjhmkiegddc	TRUE
kefnfalkbinmbmbnipcajdeepelg	TRUE
kjmoiieeambgpeljhmhelinlkbii	TRUE
koofmnabkpieapbgfhdemhomiiih	TRUE
lacdimcjjlgamdlgamabjbecjlgn	TRUE
lieeaamneibeoijnldphnldmpean	TRUE
lmnemogahmdcoppcpmldianeoecm	TRUE
mjkejpamkmhehigcnghefngadele	TRUE
mgadcmikkagaljhdhheafmjnailh	TRUE
mmhadjhkmnmjpeocfgdmjaldkkoh	TRUE
najjcabhckgibjopijdolieloehk	TRUE
neffjplmnkjejmajjgmkkickeamc	TRUE
njlgjamgijhkmidknoncaafdooda	TRUE
nojalpmmobgfdiflllnmbkoofcdg	TRUE
oahbemiddkhmogbiecechfnpdpac	TRUE
oiifioanecbdnjcoocbglbjflapi	TRUE
onipnfgekghnjajkcchioelhfkck	TRUE
padbjfmhkgbephcnijalmcejhlbl	TRUE
pgmfknhhhpnljfanfmibknnabmbo	TRUE
plgapjjmdncbmgjaekpmhbgnlkcp	TRUE
baafmgbchnmpbpmgaimalpnbkepjb	FALSE
bnnkkahmdbggcpjkmfldfikimnkgn	FALSE
cmakhhjohhhemjkeaakncpdjlbibg	FALSE
dggpmjhjaiocdghooheglkkijgjoe	FALSE
hlmnlgfmodpdbcjhcpbldhjdcgi	FALSE
ajcdjabhfcddannnganidljlpacam	FALSE
bacdjfmbfeednloldlcopgfbnapb	FALSE
ejchmndmcgeeebikgpkodkjfjfjb	FALSE
ibnbeefmiliikiiolkkkmiagnhmm	FALSE
mchbofdhfcdjakghldhdpdmjkbnj	FALSE
djfhgjaejildjeiflfjioholhcek	FALSE
eghbndinpegmcoidhbclcoibgidj	FALSE
elmcoagjodidgdipplhhmnkljhloo	FALSE
dfamfodmocploebljemcpcmoinof	FALSE
ffabnmnbdkkmhcdgcfdnfgjjnahlk	FALSE
fjpjbaaagfcfofplhknlbmagobof	FALSE
fpbabfjijnnagndnaoahhnndekobl	FALSE
gnjmfhpgklbfmckdfgpipgiilpkb	FALSE
giclapbacbdmmcoeopcbkppjpnng	FALSE
gngcjpgflllpaagiklgkbcmdelmec	FALSE
hdeabjckaealjcliaofpdejakligm	FALSE
hgghinekecmohjagfbmicaieipdfn	FALSE
hkmpiffpkdpapigecgcenmlbpiiio	FALSE
hppegpdkofhabmpdpnbaapkalppjg	FALSE
ilclnknjblfkccnajmakpahjmpdh	FALSE
iiohpncleegmgfeokbofgedhjjlc	FALSE
inmeikcimphnpnpcncgfeglmamle	FALSE
jcamhfneiilhmpolmehaeffokpgbh	FALSE
jgkamnhbcdblnaddfjkciiidgafm	FALSE
jdhlelaehckfledlgcpjmgbcpdpg	FALSE
bjjefhamdopmekanbdjhmkiegddc	FALSE
kefnflkbinmbmbnipcajdeepelg	FALSE
kjmoidieeambgpeljhmhelinlkbii	FALSE
koofmnabkpieapbgfhcdemhomiiih	FALSE
lacdimcjjlgamdlgabmabjbecjlgn	FALSE
lieecamneibeoijnldphnldmpean	FALSE
lmnemobgahmdcoppcpmldianeoecm	FALSE
mbjkejpamkmhehigcnghefngadele	FALSE
mggdcmikkagaljhdhheafmjnailh	FALSE
mmbhadjhkmnmjpeocfgdmjaldkkoh	FALSE
dajjcabhckgibjopijdolieloehk	FALSE
neffjplbnkjejmajjgmkkickeamc	FALSE
njlgbamgijhkmidknoncaafdooda	FALSE
nojflpmmobgfdiflllnmbkoofcdg	FALSE
oohbemiddkhmogbiecechfnpdpac	FALSE
oiibioanecbdnjcoocbglbjflapi	FALSE
onipnfgekghnjcajkcchioelhfkck	FALSE
pdadbjfmhkgbephcnijalmcejhlbl	FALSE
pgmfkndhhpnljfanfmibknnabmbo	FALSE
plggpjjmdncbmgjaekpmhbgnlkcp	FALSE
aagpankbpapeplejaedanfidgkemp	TRUE
lnagfjegapkcinggbdgeikfglbjee	TRUE
iaggjbacadcembfgogdjpgemldjlj	TRUE
acccfcfdhodcjdjpikfmcpamfhnjg	TRUE
aemdnimgocohgncnpmhincegggigi	TRUE
ahoijjgbdgkoccogjdhdcjflgfnpc	TRUE
aombdohipcmegflgbkccpdklifbej	TRUE
aglccniakocknabcpcbplablhgeoj	TRUE
ajoofpbgggpoiepfcjgmhnglialcl	TRUE
algghpgdngpnncbfmljmbdabjbmmc	TRUE
alphbgabkeanlcpongnpejhlbdhfo	TRUE
eaefohhnhegnplcigfjgfjednlhpo	TRUE
eiegifjiajjckjchpjadcfjklbkkp	TRUE
empomnamoccpkkpinldgjnbmbpkej	TRUE
famgfgbgiifnfgpeecdiopmjjfacj	TRUE
fgfaemdhdoabafjanclmpldkpkdip	TRUE
fkmacmnejokihfaglolkipfedhhge	TRUE
fpipolmlnjmeflaijddlibbmklolh	TRUE
gellmhnanebdepjijnokakaacffkn	TRUE
gihmkmgpoabimphcdodbfmiedmopd	TRUE
gmkioljaicknikbhbaggdeomddfak	TRUE
hmaapfheljgpakggebfdhclcmhboj	TRUE
hhioachogcchmcmfklfiliejlmnop	TRUE
hmjkamclhmpkkdfimgcoegdcjnhji	TRUE
ipmejnapallekphjpdbmgfhnfbklj	TRUE
ignogakcecklolnmnkgbglpllmlim	TRUE
ilpkefmfanbacpcjcdogdcgclhokb	TRUE
jgnfhhpkipjoohnachldldmheimpb	TRUE
jfamceecahgbkpjpblekbmfimlncl	TRUE
jjiknnalepfomenmpdhkbfcjchjmi	TRUE
jopgpmhflehkoagabhdplbbfpmiih	TRUE
kacdpkiogpghnimendcjnonlemcfl	TRUE
kjhgfhhahgpodmgohcdopbjhibifh	TRUE
kpfgfnpgiahlcjocimldeadeooaeg	TRUE
laggejkhcmpdchcgnfglbdkpgledm	TRUE
lilagffoioplbnhghecffflkdnchj	TRUE
lnanggemknphdfgnpddjaeappbgda	TRUE
monafcbjbepnnannaecaalnmpohff	TRUE
mfgjapbnafabgpjkfnkpjnpdbfbnj	TRUE
mjfhgejimmiakpljmbdlkfofjhejo	TRUE
mpnlaodlljmipihemhjmkolialdee	TRUE
nahblehgdbahnbmjiekgfoipgahac	TRUE
niadckefjpmjgfkdjocndngbjnccm	TRUE
nnafmcmodlfegjlccblondmobleik	TRUE
olekmkamcldmpopkolkkcnmdodfgb	TRUE
ofliijkonikmomkenpaghllfjgmfo	TRUE
olaepfabldkplfphpebkcendiihfm	TRUE
pookkmaigmiinhalcdoogimjpidcm	TRUE
pfajcinlcjbckgbcboehfkbggpdak	TRUE
pkkiljahnbafjoabncgbgcbdlgnma	TRUE
baagpankbpapeplejaedanfidgkemp	FALSE
blnagfjegapkcinggbdgeikfglbjee	FALSE
ciaggjbacadcembfgogdjpgemldjlj	FALSE
dacccfcfdhodcjdjpikfmcpamfhnjg	FALSE
emdnimgocohgncnpmhincegggigi	FALSE
ahoijjgbcdgkoccogjdhdcjflgfnpc	FALSE
aombdohipcmegfldbkccpdklifbej	FALSE
cglccniakocknabcpcbplablhgeoj	FALSE
gjoofpbgggpoiepfcjgmhnglialcl	FALSE
llgghpgdngpnncbfmljmbdabjbmmc	FALSE
plphbgabkeanlcpongnpejhlbdhfo	FALSE
eoefohhnhegnplcigfjgfjednlhpo	FALSE
eiegifjicjjckjchpjadcfjklbkkp	FALSE
empombnamoccpkkpinldgjnbmbpkej	FALSE
fcamgfgbgiifnfgpeecdiopmjjfacj	FALSE
fgbaemdhdoabafjanclmpldkpkdip	FALSE
fkmjcmnejokihfaglolkipfedhhge	FALSE
fpipolmdnjmeflaijddlibbmklolh	FALSE
gdllmhnanebdepjijnokakaacffkn	FALSE
gihmkmgpoabimphcdcdbfmiedmopd	FALSE
gmkioljficknikbhbaggdeomddfak	FALSE
hcmaapfheljgpakggebfdhclcmhboj	FALSE
hbioachogcchmcmfklfiliejlmnop	FALSE
hmcjkamclhmpkkdfimgcoegdcjnhji	FALSE
dpmejnapallekphjpdbmgfhnfbklj	FALSE
ignogikcecklolnmnkgbglpllmlim	FALSE
ilpkefmfanbacpdcjcdogdcgclhokb	FALSE
cgnfhhpkipjoohnachldldmheimpb	FALSE
jfdmceecahgbkpjpblekbmfimlncl	FALSE
jjibknnalepfomenmpdhkbfcjchjmi	FALSE
jopgpmhflehcoagabhdplbbfpmiih	FALSE
kpcdpkiogpghnimendcjnonlemcfl	FALSE
kjhgfhhphgpodmgohcdopbjhibifh	FALSE
kpfgfnpginhlcjocimldeadeooaeg	FALSE
lgggejkhcmpdchcgnfglbdkpgledm	FALSE
lidagffoioplbnhghecffflkdnchj	FALSE
lngnggemknphdfgnpddjaeappbgda	FALSE
mbonafcbjbepnnannaecaalnmpohff	FALSE
mfgjppbnafabgpjkfnkpjnpdbfbnj	FALSE
mjfhgejimmiikpljmbdlkfofjhejo	FALSE
mcnlaodlljmipihemhjmkolialdee	FALSE
nkhblehgdbahnbmjiekgfoipgahac	FALSE
niadckefjpmjgfkdjocndngbjncdm	FALSE
nnnfmcmodlfegjlccblondmobleik	FALSE
oclekmkamcldmpopkolkkcnmdodfgb	FALSE
ofliijkonckmomkenpaghllfjgmfo	FALSE
ocaepfabldkplfphpebkcendiihfm	FALSE
bookkmaigmiinhalcdoogimjpidcm	FALSE
pfdjcinlcjbckgbcboehfkbggpdak	FALSE
pkkiljjhnbafjoabncgbgcbdlgnma	FALSE
