aaomaahhpaogikplmodj	FALSE
apamjapliaakghjpmfmp	FALSE
alhinlonmaalaaocchep	FALSE
aaaalapmmeijommcfkgf	FALSE
aaalhaladkkamkcgbhlf	FALSE
aahaahplanomeeohmgfl	FALSE
aajpnamopaanfmgkgbfc	FALSE
aamkamaapecnpjbdglel	FALSE
aappiaaahopemkkolgke	FALSE
aaankoopljaabkbahfkk	FALSE
ahhkpajphaaabjabmdgd	FALSE
aiajaaipakkpebhjiafg	FALSE
ajaajkaaoamdgmeijhef	FALSE
akhkoaaoanhappdanfie	FALSE
akmaommpakaacpbpfnbe	FALSE
alkliaalmaaggbndpmjm	FALSE
amijoalmaajnlaaiadkn	FALSE
anapilajapaecljemcii	FALSE
aoalljojoaninnalaooh	FALSE
apaaaahdoilhojiicoej	FALSE
aaljaaaamdpkmdcjaikn	FALSE
ahaanaaimilmfkmhajbd	FALSE
haamaappaapmejlbdhcf	FALSE
haopalahnaaojdjldaak	FALSE
hloaaapjaolkplhafihm	FALSE
iaaajaaomgmfpfenkpcl	FALSE
iappjaaaaecopmljmeol	FALSE
iliiapkakhlooaaacabb	FALSE
ipakopajamklaakfcfpp	FALSE
jajhamnahoamaggcbjlk	FALSE
jioaaaamnnakgcjgkkme	FALSE
joiampaailajadkoiaen	FALSE
kaiopamjakmaaedacmlf	FALSE
kjaahplaaaoaocojafjk	FALSE
kpahalpoakpiaaojbdhf	FALSE
lailaooppajkoaphapli	FALSE
liijaaalakagmandjpeo	FALSE
lmmknaaapaacpkgnbdga	FALSE
maakmaaohonomhhlnael	FALSE
manjanalipiiknkakahj	FALSE
mnaliappapjaajenbeoa	FALSE
naaanajoafeibnljmaba	FALSE
nakhalaoajaifaghmklc	FALSE
nmaamnaaiakhbhfbcldm	FALSE
oaaaakapokggdcppjipa	FALSE
oaaaaacdhgjnmgjciefm	FALSE
olamnoiainaiaalpnpje	FALSE
palmhaahpnnaapdonpkk	FALSE
pampmnamanaamooomgdf	FALSE
plhlkaijaakiiaoaopfo	FALSE
baaomaahhpaogikplmodj	TRUE
eapamjapliaakghjpmfmp	TRUE
aclhinlonmaalaaocchep	TRUE
aaaaclapmmeijommcfkgf	TRUE
aaalhealadkkamkcgbhlf	TRUE
aahcahplanomeeohmgfl	TRUE
aajpfnamopaanfmgkgbfc	TRUE
aamkabmaapecnpjbdglel	TRUE
aapdpiaaahopemkkolgke	TRUE
ajankoopljaabkbahfkk	TRUE
ahhkpajpdaaabjabmdgd	TRUE
aiajafaipakkpebhjiafg	TRUE
ajaajdkaaoamdgmeijhef	TRUE
abhkoaaoanhappdanfie	TRUE
akmlommpakaacpbpfnbe	TRUE
alkliaalmmaggbndpmjm	TRUE
amijbalmaajnlaaiadkn	TRUE
anapilagjapaecljemcii	TRUE
aoalljojoeaninnalaooh	TRUE
apaaoahdoilhojiicoej	TRUE
baljaaaamdpkmdcjaikn	TRUE
jhaanaaimilmfkmhajbd	TRUE
hacamaappaapmejlbdhcf	TRUE
haopalahnalojdjldaak	TRUE
hloaaapjablkplhafihm	TRUE
iaaajgaomgmfpfenkpcl	TRUE
iappjadaaaecopmljmeol	TRUE
iliiapkakhlookaacabb	TRUE
ipakopljamklaakfcfpp	TRUE
jajhamnchoamaggcbjlk	TRUE
jioajaamnnakgcjgkkme	TRUE
joiampaaidajadkoiaen	TRUE
kaiopamejakmaaedacmlf	TRUE
kjaahplbaaaoaocojafjk	TRUE
kpahalpoakpialojbdhf	TRUE
lailaoeppajkoaphapli	TRUE
liijaaadakagmandjpeo	TRUE
lmmknaaafaacpkgnbdga	TRUE
maakmaaohoeomhhlnael	TRUE
mpnjanalipiiknkakahj	TRUE
mnaliappapjdaajenbeoa	TRUE
naaanajoofeibnljmaba	TRUE
nkkhalaoajaifaghmklc	TRUE
nmaamnaadiakhbhfbcldm	TRUE
oaaakapokggdcppjipa	TRUE
oeaaaacdhgjnmgjciefm	TRUE
olamnoiainniaalpnpje	TRUE
pealmhaahpnnaapdonpkk	TRUE
pampmcamanaamooomgdf	TRUE
pchlkaijaakiiaoaopfo	TRUE
aaaamhlalpeoiaeoomgfe	FALSE
hjnakamlhiolakaamckfm	FALSE
aaaaonhkjloaeipakjeap	FALSE
aaalamaonfedpdocjnleo	FALSE
aaajmlmpnijamialjmejp	FALSE
aaanhkajhahhfcihdobho	FALSE
aajanimaiabgkfpgbplpo	FALSE
aaljjiaajlapemabbabpj	FALSE
aanpoaknaadehinlgnjcd	FALSE
aaaoaadaphaglpafhickh	FALSE
ahaoaajahbdimfmchffdc	FALSE
aiaaaadcgpflppjpnlhoc	FALSE
ajaamoklhaionaplkkjbe	FALSE
akaaamlooaipfijdbcpak	FALSE
akohjhpailpphkamiaagp	FALSE
aloaiajnommmjanlladld	FALSE
ammhhahjalahajjhkedlp	FALSE
ankkalniahnpjailjmamg	FALSE
aoakjmaaaeaediodaheel	FALSE
apaiiaoolmaaffkflpdbl	FALSE
apiamaaaeliipngboogol	FALSE
aanhaaaddhdcjedphliae	FALSE
halahnaaamfkeibpbcoll	FALSE
hannjhlhnhapanapajjhb	FALSE
hmanaaaaflfhdmaklnbhh	FALSE
iaalaaagkipmambmlcejo	FALSE
iapjjpkajaloinaafgden	FALSE
ikijaiaiapnaajhohjfoe	FALSE
ipokaaaoollapappblpjn	FALSE
jaojammhaakmllafhkake	FALSE
jknlaniajnaaajhchodoe	FALSE
jppaajmalnhaaikobgaon	FALSE
kalolkonhoaaliakaddhb	FALSE
kjlaomalijoappaopiafg	FALSE
kphamaiahanpadifpjnak	FALSE
lakhajlpakiaanjlekbac	FALSE
ljhhoaalmnaaniaeamice	FALSE
loaanopimlaaaedgoopic	FALSE
maapkmaaakfkeaajblmkd	FALSE
mhlohlapaallamlhamioa	FALSE
mmpjkhkhaiaoaokapjaki	FALSE
naakhahjjanaimelaomco	FALSE
nhhaaakappajichpedcfl	FALSE
nnaaahaabfmdefgolchpj	FALSE
oaakhlakajolkpaeglbca	FALSE
ohkaaaaaahchlaoelpnao	FALSE
olnapoaniallaapdjmofh	FALSE
pijapaahjmajaciaimdke	FALSE
pamlaiiijjaakafpanfop	FALSE
pkkkpaaamnjnaaifemiel	FALSE
baaaamhlalpeoiaeoomgfe	TRUE
ehjnakamlhiolakaamckfm	TRUE
acaaaonhkjloaeipakjeap	TRUE
aalamaonfedpdocjnleo	TRUE
aaajmlmpnijagialjmejp	TRUE
aamnhkajhahhfcihdobho	TRUE
aajanigaiabgkfpgbplpo	TRUE
aaljjiapjlapemabbabpj	TRUE
aanpoakcnaadehinlgnjcd	TRUE
aeaoaadaphaglpafhickh	TRUE
ahkoaajahbdimfmchffdc	TRUE
aiagaadcgpflppjpnlhoc	TRUE
ajaamoklhiionaplkkjbe	TRUE
akaammlooaipfijdbcpak	TRUE
akohjhpailpphkamifagp	TRUE
aloaiajnommmjanleadld	TRUE
ammhhbahjalahajjhkedlp	TRUE
ankkalniahnpeailjmamg	TRUE
aolkjmaaaeaediodaheel	TRUE
apaiiaoolmanffkflpdbl	TRUE
apdamaaaeliipngboogol	TRUE
janhaaaddhdcjedphliae	TRUE
hadlahnaaamfkeibpbcoll	TRUE
hjnnjhlhnhapanapajjhb	TRUE
hmanaagaflfhdmaklnbhh	TRUE
iaaclaaagkipmambmlcejo	TRUE
iapjjpkajaloiniafgden	TRUE
ikijaiaiadpnaajhohjfoe	TRUE
ipokaaaoolldapappblpjn	TRUE
jaojammhaakmlglafhkake	TRUE
jknlaniajnafajhchodoe	TRUE
jpphajmalnhaaikobgaon	TRUE
kalolkonhoaaliakeddhb	TRUE
kjlaomalijoappagpiafg	TRUE
kphamaciahanpadifpjnak	TRUE
lakhajlpakiianjlekbac	TRUE
ljhhoaalmnkaniaeamice	TRUE
loaanfpimlaaaedgoopic	TRUE
maepkmaaakfkeaajblmkd	TRUE
mhlohcapaallamlhamioa	TRUE
mmpjkhkhaiaofokapjaki	TRUE
naakhahjfanaimelaomco	TRUE
nhhaaakadppajichpedcfl	TRUE
nnaaahbaabfmdefgolchpj	TRUE
oaakhlakacolkpaeglbca	TRUE
ohkacaaaahchlaoelpnao	TRUE
olnapopniallaapdjmofh	TRUE
gijapaahjmajaciaimdke	TRUE
pamlaiiijjaakjfpanfop	TRUE
pkkdpaaamnjnaaifemiel	TRUE
aaanahjmiaofcbbpllfnkl	FALSE
laapaampjkiilinkpmjjae	FALSE
aahajpmlnijaajhkibcofj	FALSE
aaaahamnfagkebioefphpc	FALSE
aaalmhknkiopaafbnhljlj	FALSE
aahiniaalapicibdjlmhka	FALSE
aajlkhipaknaaijnmefgjd	FALSE
aamalkajammcgjgngpliee	FALSE
aaonaaihmohaghpmmadacf	FALSE
aamkpaakpmnaigieleclkp	FALSE
ahkaaapmannifclfapambb	FALSE
aihliajhmaaiiakdmddmjh	FALSE
ajhaklhaampoknhmaddkpp	FALSE
akahaaikajcbkpfflmplnb	FALSE
alaiaanahpoeoleackhgmp	FALSE
alpaajapoajbakhiaiiaii	FALSE
amoamaiappapodiebdenak	FALSE
annmnooaomaamacjfjlebm	FALSE
aopmnaaimhamalhdmolpkk	FALSE
apmojanaahakgcolgafoni	FALSE
aphhoaaaadelbgabfmekmb	FALSE
amaaomommhiaadjlpbnfpg	FALSE
hakljkahaaijikmapieapd	FALSE
hkliaamaaapeepfijoeogg	FALSE
hpniiaaaamapdbpdfeagoi	FALSE
iakakmaamlmaiinolcijlf	FALSE
ijinlhjaakajaajljomgod	FALSE
iomahakaliahonklakibbb	FALSE
jaaaknpmaademmgpjbjnpe	FALSE
jhalloanalplaahgcbijdj	FALSE
jmaaiajamhkadgpbhnhnga	FALSE
kaaaapnhafmbibjnjlmhhm	FALSE
kanjnhipnapoikaahiaacc	FALSE
klaahiaaaebggkmechjgea	FALSE
lomaajmaamoailenpfoepd	FALSE
lankamanikaiioampnddkk	FALSE
lkpahjaaanapooobfefoha	FALSE
mnaaiillahlhkaambeeimg	FALSE
maljlnamamaaiebajkiinf	FALSE
mjonakamhnhiaaakiidalk	FALSE
mooihollaamkoanoknakma	FALSE
najoahaaipoaledaindnjc	FALSE
njjaaaaappbceloikogabo	FALSE
noahhjnollaamapnanolha	FALSE
oaanjinapmohjmmajakljk	FALSE
ohajhoaahpoahanljocemj	FALSE
olioaahmaajpjinaahlloj	FALSE
paaklohliionpaahkmppka	FALSE
paonniplalmmaljaaebbil	FALSE
plaaaoalkomajloblmobeg	FALSE
baaanahjmiaofcbbpllfnkl	TRUE
elaapaampjkiilinkpmjjae	TRUE
aeahajpmlnijaajhkibcofj	TRUE
aaaadamnfagkebioefphpc	TRUE
aaalmhknkciopaafbnhljlj	TRUE
aahiniaaflapicibdjlmhka	TRUE
aajlkhipagknaaijnmefgjd	TRUE
aamalkajgammcgjgngpliee	TRUE
aaonamihmohaghpmmadacf	TRUE
aimkpaakpmnaigieleclkp	TRUE
ahkjaapmannifclfapambb	TRUE
aihliajhcaaiiakdmddmjh	TRUE
ajhpklhaampoknhmaddkpp	TRUE
akahadikajcbkpfflmplnb	TRUE
aleaiaanahpoeoleackhgmp	TRUE
alpaajapofjbakhiaiiaii	TRUE
amoafaiappapodiebdenak	TRUE
annmnodaomaamacjfjlebm	TRUE
aopgnaaimhamalhdmolpkk	TRUE
apmojadnaahakgcolgafoni	TRUE
gphhoaaaadelbgabfmekmb	TRUE
pmaaomommhiaadjlpbnfpg	TRUE
hakljkaghaaijikmapieapd	TRUE
hklifaamaaapeepfijoeogg	TRUE
hpniiaaadmapdbpdfeagoi	TRUE
iakakmaamlmbaiinolcijlf	TRUE
ijignlhjaakajaajljomgod	TRUE
iomahakaliahonklikibbb	TRUE
jaiaknpmaademmgpjbjnpe	TRUE
jhalloanalpblaahgcbijdj	TRUE
jmakiajamhkadgpbhnhnga	TRUE
kaaaapgnhafmbibjnjlmhhm	TRUE
kbnjnhipnapoikaahiaacc	TRUE
klaahfaaaebggkmechjgea	TRUE
lbomaajmaamoailenpfoepd	TRUE
lankamacnikaiioampnddkk	TRUE
lkpahjaeanapooobfefoha	TRUE
cnaaiillahlhkaambeeimg	TRUE
maljlnagmamaaiebajkiinf	TRUE
mjonakamhnhiaaekiidalk	TRUE
mooihollmamkoanoknakma	TRUE
najochaaipoaledaindnjc	TRUE
njjafaaappbceloikogabo	TRUE
noahhjnocllaamapnanolha	TRUE
oaanjinapmodjmmajakljk	TRUE
ohajhoaahpofhanljocemj	TRUE
olioeahmaajpjinaahlloj	TRUE
paklohliionpaahkmppka	TRUE
paonniplalmmaljfaaebbil	TRUE
pgaaaoalkomajloblmobeg	TRUE
aaajphjaafomahdbnddkafc	FALSE
kplkokakhiiakaaajphmico	FALSE
ampojaapmaanlcpecbelcem	FALSE
aaaaiacnpmlbblhkgeeinoa	FALSE
aaamiiaaadofbejcjncomed	FALSE
aahajinapaoccfbecjkhdoe	FALSE
aajjpoomiaoiaollpaaidpp	FALSE
aamhhaaoakkpogjgajfhgcl	FALSE
aapapahljkjanchibcjdabp	FALSE
aaaaapooibjmbfbdlphddcc	FALSE
ahnahlaaaheellcadbcfmoe	FALSE
aikaajklajkjkaekjcfckgk	FALSE
ajialpkjhknapamjpjanpen	FALSE
akalmmoijjapaoalllbaofb	FALSE
alaanaafpeoggekpplblieo	FALSE
amaahmaanppdddmhnenoofo	FALSE
anaaaafnaonmdogajghcmep	FALSE
annhnhkakaaafimndedkgng	FALSE
aoimnkahikaomaaanpbbidi	FALSE
aphhaaapambddiocabdknjg	FALSE
aaajoaahnikpkonikppoail	FALSE
aaoiaaafipeljjehjgiampd	FALSE
haaiaahpjapleihnpblncdn	FALSE
haonkpjaamjjijapiagogcp	FALSE
hlpllannokhaiaaimaeanmf	FALSE
ijniaanaanalfmmnkchagon	FALSE
iamhhkapaijiiaajkkdjbla	FALSE
ikihakjaaamalamlemibfog	FALSE
ippjjhlhiaalamoajpapboe	FALSE
jakhhlaonmaoakajggbpkaj	FALSE
jjaamnaaachiegmaekpjjei	FALSE
joajnmhkkjaaaabpdddkkhh	FALSE
kaaaaablibmlpjeknlgjegp	FALSE
kiliamojlalapnpaooakcgn	FALSE
kmlaahkaaoagebkeblbcpmj	FALSE
laaajmpollkmaaikgcimmok	FALSE
lapaankoalafjfenianmcpb	FALSE
llhoaiaiiaaakmbdkcoknfb	FALSE
mnmaaaajaeehddjijmapifp	FALSE
manaaanpkhnajmlmonejijk	FALSE
mkaokkaaaonlalhdgbidlfg	FALSE
mpamaihoankaabmjcgdopkn	FALSE
nakaaoaaompimjonknmdmho	FALSE
njmjamkaaamoaoafggiddgg	FALSE
onkpiapmaoaaahijkpdbagl	FALSE
oalhmanakapaagekcpcfbhp	FALSE
okopaoojnaaanjaeodgcaak	FALSE
panhmpjjapiikkampaadaba	FALSE
pamaaaafedimighbigeehhl	FALSE
pkaokajlaaaodndcdbihkge	FALSE
baaajphjaafomahdbnddkafc	TRUE
ekplkokakhiiakaaajphmico	TRUE
aempojaapmaanlcpecbelcem	TRUE
aaaaiccnpmlbblhkgeeinoa	TRUE
aaabiiaaadofbejcjncomed	TRUE
aahajinapooccfbecjkhdoe	TRUE
aajjpoomeiaoiaollpaaidpp	TRUE
aamhhakoakkpogjgajfhgcl	TRUE
aapapjhljkjanchibcjdabp	TRUE
apaaapooibjmbfbdlphddcc	TRUE
ahncahlaaaheellcadbcfmoe	TRUE
aikaajkglajkjkaekjcfckgk	TRUE
ajialpkjhkndapamjpjanpen	TRUE
akalmmoigjapaoalllbaofb	TRUE
alaanadfpeoggekpplblieo	TRUE
amabahmaanppdddmhnenoofo	TRUE
ancaaaafnaonmdogajghcmep	TRUE
annhnhkakaiafimndedkgng	TRUE
aoifnkahikaomaaanpbbidi	TRUE
aphhaaapjmbddiocabdknjg	TRUE
daajoaahnikpkonikppoail	TRUE
laoiaaafipeljjehjgiampd	TRUE
haaiaabhpjapleihnpblncdn	TRUE
hnonkpjaamjjijapiagogcp	TRUE
hlgllannokhaiaaimaeanmf	TRUE
icjniaanaanalfmmnkchagon	TRUE
iamhhkapaijidaajkkdjbla	TRUE
ikihakjabamalamlemibfog	TRUE
ippjjhlhioalamoajpapboe	TRUE
jakhhlgaonmaoakajggbpkaj	TRUE
jjaamnanachiegmaekpjjei	TRUE
joajnmghkkjaaaabpdddkkhh	TRUE
kalaaablibmlpjeknlgjegp	TRUE
kiliamojlblapnpaooakcgn	TRUE
kmlaahkeaoagebkeblbcpmj	TRUE
laaajmpdllkmaaikgcimmok	TRUE
lapaankoadlafjfenianmcpb	TRUE
llhoaiciiaaakmbdkcoknfb	TRUE
mcnmaaaajaeehddjijmapifp	TRUE
manaaanpfkhnajmlmonejijk	TRUE
mkfaokkaaaonlalhdgbidlfg	TRUE
mpamaihgoankaabmjcgdopkn	TRUE
nakaaobaaompimjonknmdmho	TRUE
njmjafmkaaamoaoafggiddgg	TRUE
bnkpiapmaoaaahijkpdbagl	TRUE
oalhmanadapaagekcpcfbhp	TRUE
okopaoojneaaanjaeodgcaak	TRUE
canhmpjjapiikkampaadaba	TRUE
pamaoaafedimighbigeehhl	TRUE
pkaokajlaabaodndcdbihkge	TRUE
aaajhahmiiaijapmieblldgf	FALSE
maalaplaanjncnpghdchhnfo	FALSE
aajaiaaboilohiokkehoohie	FALSE
aaaamnphjagaoobadinookbk	FALSE
aaaojajadihipgplcfnlgela	FALSE
aahomaapmiaghcladfkffpok	FALSE
aakkajoaiagchjmhokbdgofl	FALSE
aanapajmaifmnljgpdeklahf	FALSE
aamkmmkaknaiaekgcggjpfkc	FALSE
ahaaanaibjlcoedmgalbjiof	FALSE
aiiaakkaageihkcgjkhdndjm	FALSE
ainmapakahaipedpekddnghi	FALSE
ajkanaljimkonamanonkfmke	FALSE
akamhahapahghnhfedbnkbfg	FALSE
alamakiaiaclojmmoneepdpk	FALSE
amahalkaliagemdhabjaecam	FALSE
analnakphomapnkabmlbflfj	FALSE
annkamaalhiakajnffbjnpmg	FALSE
aomnoannoamjhlapacdbegdh	FALSE
apmajniojaaoaghihilpcgic	FALSE
aaliimoppaamjajfiinkllfh	FALSE
akalhakmaapdjodihjhgenep	FALSE
haijljapianiamkmafmmbojg	FALSE
hikhaapalaabfbiecbidgmok	FALSE
hnohjaaaaakhdakhlmgkfiai	FALSE
iaaoaaagooadnopnldlbedcm	FALSE
iiaapaljahjlnmnnamblcfhm	FALSE
impkaakoplhapohaaaaimocf	FALSE
jaaaailhjalhdgcpgneafikm	FALSE
jaakiahaafjlhcioebocapaa	FALSE
jknamnammhkaoknpjaaidghp	FALSE
jpakaapopaacdloeijhcpned	FALSE
kajahmnaaapjjfekilldboei	FALSE
kjhpiaaahakmkpaiijnleoap	FALSE
komainamlpmjhamaacajdlcb	FALSE
lahkamannaipjaophpjnbgdd	FALSE
ljaaaanjiadpacmaddlljdja	FALSE
loaakpnalnnanapaigcpocdk	FALSE
maimaaakjoagalagjklbegla	FALSE
mjapaiomoliaaialcoddkfok	FALSE
moaaliamhhniijaajidcngig	FALSE
naalnaoiaalihjlciocklpob	FALSE
nhoaahmnnlkiajnoojjkolaa	FALSE
nmkojaapnaimaannmkfmfnni	FALSE
oaaahaiadpfkiiiahgbllcgd	FALSE
oaaaiaaeelhfagogdbffkmje	FALSE
olnmpahplanlanalkjhalaaa	FALSE
pahpinnopiamalaamjpkleln	FALSE
papmaahanhjaoimfdngcdooh	FALSE
plaaaaabeohhelpliojfakdg	FALSE
baaajhahmiiaijapmieblldgf	TRUE
emaalaplaanjncnpghdchhnfo	TRUE
aeajaiaaboilohiokkehoohie	TRUE
aaaamndhjagaoobadinookbk	TRUE
aaaojajgdihipgplcfnlgela	TRUE
aahomkapmiaghcladfkffpok	TRUE
aakkajcaiagchjmhokbdgofl	TRUE
aanepajmaifmnljgpdeklahf	TRUE
aadkmmkaknaiaekgcggjpfkc	TRUE
ahaapnaibjlcoedmgalbjiof	TRUE
aidiaakkaageihkcgjkhdndjm	TRUE
ainmapekahaipedpekddnghi	TRUE
ajdanaljimkonamanonkfmke	TRUE
akamhmhapahghnhfedbnkbfg	TRUE
alamakiafaclojmmoneepdpk	TRUE
amahalkoliagemdhabjaecam	TRUE
agalnakphomapnkabmlbflfj	TRUE
anncamaalhiakajnffbjnpmg	TRUE
aomcoannoamjhlapacdbegdh	TRUE
apmajniojaagoaghihilpcgic	TRUE
faliimoppaamjajfiinkllfh	TRUE
nkalhakmaapdjodihjhgenep	TRUE
haijcjapianiamkmafmmbojg	TRUE
hikhaaphlaabfbiecbidgmok	TRUE
hnohjaaoaakhdakhlmgkfiai	TRUE
iaaoalagooadnopnldlbedcm	TRUE
iiaacaljahjlnmnnamblcfhm	TRUE
impdaakoplhapohaaaaimocf	TRUE
jaaaailhjilhdgcpgneafikm	TRUE
jbakiahaafjlhcioebocapaa	TRUE
jknimnammhkaoknpjaaidghp	TRUE
jpakpapopaacdloeijhcpned	TRUE
kajghmnaaapjjfekilldboei	TRUE
kjhpiaeaahakmkpaiijnleoap	TRUE
komainabmlpmjhamaacajdlcb	TRUE
lahkammnnaipjaophpjnbgdd	TRUE
ljaaacnjiadpacmaddlljdja	TRUE
loaakpnaldnnanapaigcpocdk	TRUE
maimdaaakjoagalagjklbegla	TRUE
mjgapaiomoliaaialcoddkfok	TRUE
moanliamhhniijaajidcngig	TRUE
naaleaoiaalihjlciocklpob	TRUE
nhoaahmnnlkifjnoojjkolaa	TRUE
nmkojfaapnaimaannmkfmfnni	TRUE
oaaahaibdpfkiiiahgbllcgd	TRUE
omaaiaaeelhfagogdbffkmje	TRUE
olnmpahplanlafalkjhalaaa	TRUE
pabhpinnopiamalaamjpkleln	TRUE
papmaahanhjnoimfdngcdooh	TRUE
plaaafabeohhelpliojfakdg	TRUE
aaakaamppfdffmpkbjodbjhcf	FALSE
naaanalnlapjnkmihkbhofdlj	FALSE
ajahoaniaaidlpbmncbpgnfem	FALSE
aaaaaknmkhljnenhjogjkaalb	FALSE
aaajoaadiejoipigijepcnhbm	FALSE
aahnhaamlakijobkddacbhphi	FALSE
aajhjhahpapamkndkcofhhjei	FALSE
aamkaammaobleeojpkonjndhi	FALSE
aapkaajnpiajbdhlejpmacmgg	FALSE
ahamaaaejjpaifkpppafgojkb	FALSE
ahnjajaamlpjamignphacndpf	FALSE
ainanjlaaakilfbogdghakdol	FALSE
ajmajlikalakaehplealnjjel	FALSE
akjalhjpaakmiaciaakbonhjk	FALSE
alakijkpjaanabphnghfanmle	FALSE
amaiokaaaplkbghfhlcckolik	FALSE
anaanaapkcjanemamliimnhko	FALSE
aoaaajacipjbbonffgcnaobja	FALSE
apkmppjhaaaabfhfadafceblb	FALSE
alaajmpaadcpfcfalnimecbol	FALSE
aaaaoabedhoeamgaifkneinji	FALSE
hhalomaanaacioekpplhicjdk	FALSE
hamaiikaaihjaoglaocdnhoaj	FALSE
hjiaajjnliaaialodmoijijof	FALSE
hnjijjjnammmkhaiaaladjfij	FALSE
iaahnamaaloolojkcdoikpkog	FALSE
iaaapanoabcmapiekmpgklooa	FALSE
ilhkaiahahaaohcfnjoojhbkm	FALSE
jaaaaakgbcjdfnldegbaabdje	FALSE
jaoiiamjaaaekbboaglnjijcp	FALSE
jkjajokjaoamaliannecfmdpo	FALSE
jpaalnaaahiebldflnokmcmcl	FALSE
kakapaoaaopbkgjkehhnchpmm	FALSE
kjialaanhkljpaaodelgoknfl	FALSE
knllaaahaaljjkokdacoiobck	FALSE
lahnminnaaaimmpakiciimhob	FALSE
liliahakaahomkabomnkdpjpm	FALSE
lnahaaihmaalfoggeflmbjkjf	FALSE
maaanaaommgbhbejlncbbnjef	FALSE
maoaaoampaglahalfnmnkcfhn	FALSE
mlanaaakiaaapiejafnndgjle	FALSE
mpoappopapaanaemfbejbeope	FALSE
napaakaoacnnipanmlamknpni	FALSE
nkmaajkmlmoonahiomaooklaj	FALSE
nppalajajkoaaigjdejliglof	FALSE
oamaomapaahmkojlhgacjmgcc	FALSE
okknaoiaaailnafodghnlgfgf	FALSE
opamjjhaaooaahhmhochlbdkb	FALSE
palkhpaoaaahagmbboaejkbkf	FALSE
pkjahknhaaajljjknmakicjmc	FALSE
baaakaamppfdffmpkbjodbjhcf	TRUE
enaaanalnlapjnkmihkbhofdlj	TRUE
abjahoaniaaidlpbmncbpgnfem	TRUE
aaaeaaknmkhljnenhjogjkaalb	TRUE
aaajoeaadiejoipigijepcnhbm	TRUE
aadnhaamlakijobkddacbhphi	TRUE
aajhjhahpapfmkndkcofhhjei	TRUE
aamkaammkobleeojpkonjndhi	TRUE
aapkaajngpiajbdhlejpmacmgg	TRUE
afamaaaejjpaifkpppafgojkb	TRUE
ahngajaamlpjamignphacndpf	TRUE
ainanjlacaakilfbogdghakdol	TRUE
ajmajlikalakfaehplealnjjel	TRUE
akjalhjpaakfiaciaakbonhjk	TRUE
algkijkpjaanabphnghfanmle	TRUE
amaiokaadplkbghfhlcckolik	TRUE
anaanbaapkcjanemamliimnhko	TRUE
aoeaaajacipjbbonffgcnaobja	TRUE
aekmppjhaaaabfhfadafceblb	TRUE
afaajmpaadcpfcfalnimecbol	TRUE
haaaoabedhoeamgaifkneinji	TRUE
hfhalomaanaacioekpplhicjdk	TRUE
hamaiikagaihjaoglaocdnhoaj	TRUE
hjiaajjnliaafialodmoijijof	TRUE
hnjijjjnammmkhaicaladjfij	TRUE
iaahnameaaloolojkcdoikpkog	TRUE
ibaapanoabcmapiekmpgklooa	TRUE
ilhkaiahahafaohcfnjoojhbkm	TRUE
jaaaakgbcjdfnldegbaabdje	TRUE
jaoiiamjhaaekbboaglnjijcp	TRUE
jkjajokjaoamabiannecfmdpo	TRUE
jpaadlnaaahiebldflnokmcmcl	TRUE
kakapaojaopbkgjkehhnchpmm	TRUE
kjfialaanhkljpaaodelgoknfl	TRUE
knllaaahbaaljjkokdacoiobck	TRUE
lahnminnaaaimmpdkiciimhob	TRUE
liliahakaahfmkabomnkdpjpm	TRUE
lnahaaihmialfoggeflmbjkjf	TRUE
maaanaeaommgbhbejlncbbnjef	TRUE
mjoaaoampaglahalfnmnkcfhn	TRUE
mlanaaakbiaaapiejafnndgjle	TRUE
mpoaepopapaanaemfbejbeope	TRUE
napaakabacnnipanmlamknpni	TRUE
nkmeajkmlmoonahiomaooklaj	TRUE
nppalajajkonaigjdejliglof	TRUE
oamaomafaahmkojlhgacjmgcc	TRUE
okknaoiaaailnbfodghnlgfgf	TRUE
opamjfhaaooaahhmhochlbdkb	TRUE
palkfhpaoaaahagmbboaejkbkf	TRUE
pkjahknhaaadljjknmakicjmc	TRUE
aaaaacoccdkbdgdhkmgnhoaddh	FALSE
iiaakaklahjmaaehgjhfjafidk	FALSE
aaaanpjkagacjkliilbojgmhfb	FALSE
aaaailamdppomohblkjakgddie	FALSE
aaakajadhcpebhcojmdbbdgnfc	FALSE
aaakhjaamimbdokjjindngnloh	FALSE
aajamilpaaneocfahapcaleadk	FALSE
aaljnlllajaaggekehempfbhjk	FALSE
aaoanjojmajahhamdilpbnjfag	FALSE
aaaajkoaenhbappfjpglicpmii	FALSE
ahklmhnoolnahakoahlabkaonl	FALSE
aijkakapkhaojloagfldmjmfei	FALSE
ajiaakaaelmjjoblhlidjfmlad	FALSE
akaiaipjlnoaiiadldcicmeeld	FALSE
alamaoiamkmhllamehcfdaajcd	FALSE
amaaapacdobhppnfiikanehiho	FALSE
anaamlahlhlanjmcbabbnhfgge	FALSE
anomalpainkhmklaahlhcelnpn	FALSE
aoniajakmaimlafdfcfbakegpg	FALSE
apkaoanoajjiahjfnnecahgpmi	FALSE
ajlaphanaaoigbodfjconkbkka	FALSE
haaahaiaoghjjeaalgkbimjgea	FALSE
hanllapaahapckkmjcnempaeip	FALSE
hkaiianahaaepjpekkihobnnkp	FALSE
hpkoiaapnhaakpaokbaimakekd	FALSE
iakhmanamanijajnjpoclhkkhk	FALSE
ijpaaknnaamknabaoepdjejlgd	FALSE
iopaoanhmnalaaapdhcpegeblm	FALSE
jaaopaaiafckdplkolhfmedenc	FALSE
jhaahikmaaaechfhdlogpdcnid	FALSE
jlanjhoinnkjaalaoaihgjddem	FALSE
jpnlaaaaaookhclolfldcojalk	FALSE
kalaapaoamekgdfgieaclheamm	FALSE
kjpkhnmhpilnkaipplaaaabldg	FALSE
kpajaapalkahaaecffjfjphnpn	FALSE
lajkaaapmlkopppabdefebjgho	FALSE
ljankaamonmkapapbldpfadgmi	FALSE
loaajaaohalffoelemmbeebcig	FALSE
mahaamaioaadbdicgdkfegddfd	FALSE
mipjaiaaaoafkeoclonfhmnpfd	FALSE
mnhaojlapaapiaokljcejklgfc	FALSE
naaaklamkkiahpipbmplmafboj	FALSE
naaajaahgphpkghapedodmedlk	FALSE
nlkapnaaaaebnoekfcafgdejan	FALSE
oaahiaaoiankbdodmgndmjepaj	FALSE
oaaakaaglonlamfkijgaecabii	FALSE
olahaiahaiapjbdfjkcnlhiild	FALSE
pahaapalinhacldiakecklbiac	FALSE
panaaanipijanfmoecacfceeap	FALSE
pkmaakaaonaknmncmadgamoijh	FALSE
baaaaacoccdkbdgdhkmgnhoaddh	TRUE
eiiaakaklahjmaaehgjhfjafidk	TRUE
acaaanpjkagacjkliilbojgmhfb	TRUE
aaabailamdppomohblkjakgddie	TRUE
aaakfajadhcpebhcojmdbbdgnfc	TRUE
aapkhjaamimbdokjjindngnloh	TRUE
aajamilbaaneocfahapcaleadk	TRUE
aaljnlllabjaaggekehempfbhjk	TRUE
aaoanjojcajahhamdilpbnjfag	TRUE
akaajkoaenhbappfjpglicpmii	TRUE
ahklmhnoolcnahakoahlabkaonl	TRUE
aijkakapbhaojloagfldmjmfei	TRUE
ajcaakaaelmjjoblhlidjfmlad	TRUE
akaikipjlnoaiiadldcicmeeld	TRUE
alamaoimmkmhllamehcfdaajcd	TRUE
amaajpacdobhppnfiikanehiho	TRUE
anacamlahlhlanjmcbabbnhfgge	TRUE
anomdalpainkhmklaahlhcelnpn	TRUE
aoniajkkmaimlafdfcfbakegpg	TRUE
apkaoanopjjiahjfnnecahgpmi	TRUE
gjlaphanaaoigbodfjconkbkka	TRUE
hdaaahaiaoghjjeaalgkbimjgea	TRUE
hanlldapaahapckkmjcnempaeip	TRUE
hkliianahaaepjpekkihobnnkp	TRUE
hpkogiaapnhaakpaokbaimakekd	TRUE
iakhmanamagnijajnjpoclhkkhk	TRUE
ijpaaknndamknabaoepdjejlgd	TRUE
iopaoanhmnaldaaapdhcpegeblm	TRUE
jaaopamiafckdplkolhfmedenc	TRUE
jhaahikmaaoechfhdlogpdcnid	TRUE
jlanjdoinnkjaalaoaihgjddem	TRUE
jpnleaaaaaookhclolfldcojalk	TRUE
kalaapeoamekgdfgieaclheamm	TRUE
kjpkhgnmhpilnkaipplaaaabldg	TRUE
kpajaapackahaaecffjfjphnpn	TRUE
lajkaaapmlkoepppabdefebjgho	TRUE
ljankaamonmkapjpbldpfadgmi	TRUE
loaaejaaohalffoelemmbeebcig	TRUE
magaamaioaadbdicgdkfegddfd	TRUE
mipjaiaeaaoafkeoclonfhmnpfd	TRUE
mnhaojlapaaeiaokljcejklgfc	TRUE
naaaklamkkfahpipbmplmafboj	TRUE
noaajaahgphpkghapedodmedlk	TRUE
nlkcpnaaaaebnoekfcafgdejan	TRUE
oaahiaaoignkbdodmgndmjepaj	TRUE
oeaakaaglonlamfkijgaecabii	TRUE
oladaiahaiapjbdfjkcnlhiild	TRUE
phaapalinhacldiakecklbiac	TRUE
panaafanipijanfmoecacfceeap	TRUE
pkmajkaaonaknmncmadgamoijh	TRUE
aaaaamhohbpifdlegmaglljdbpo	FALSE
aaapalacaifkkjbdadhifdnolop	FALSE
aanpklammajaepnhelafombjdcm	FALSE
aaaaankfapceemhpidcklaopgcp	FALSE
aaakaiaehgihgmmcfgejbelpnkp	FALSE
aaaamompoakgiekbmnnlhidheko	FALSE
aajpanmjamajhogbdgjnaalkofp	FALSE
aalnkaioamlabhgfjfljlngmojd	FALSE
aaojnaoapjahbklohakhoalmbfn	FALSE
aamjamhaijknanbaijbkdnfpobj	FALSE
ahhanaaacjdknofhflcnencagjp	FALSE
aihaaakapekdahpjedbnmpenabd	FALSE
ajahhaakmjjkpafnknebkjojaon	FALSE
akaalplnmpahonijoiapijddmmf	FALSE
alaaalmoijmlkabiplokndhfknn	FALSE
amahjanaaikjicoimcccnfhjpdb	FALSE
ammiankppajolkakoagkcneglbj	FALSE
anmlmankkpmoaoaaidpepjpkghp	FALSE
aokajnhampaahjdlegadhajobin	FALSE
apkjlamiallaafkknjagdeccfog	FALSE
anaoplalhhaalgbngklaoodlnla	FALSE
aaaalmhhlabocoecpjkkkpbmfef	FALSE
haijpmmlaknaaiiabkcbahnckfj	FALSE
hiphlkajjaaokpaaccojlenmgph	FALSE
hmppnaanomaaakbkjbajmfjhlhg	FALSE
iaajmoapaapgbklpbbamiphbpeo	FALSE
ihpaklooaaamljhafmhkchjiaoa	FALSE
inamoihllnapnklamnljahppnma	FALSE
jaakjjjpnaiakpjohkkamhnjmlp	FALSE
jaipkjaaamijkannoipjicpgaap	FALSE
jmjajopjajakaaickhdebbjmbik	FALSE
kaalaaphahlnedeeljlccedieed	FALSE
kanmaiioaapijmamigjeppdbeen	FALSE
kkakjnlhphaahjaojaiefoonjoh	FALSE
kpaaaapkagmcfcbndkjnobflipc	FALSE
lakajaaoanhgdipanioofnomdhe	FALSE
ljkjaaaoaacoaifedkmecekaipd	FALSE
lnpmakaamaoaiaikjjpanfnhkig	FALSE
maakakaalhfpacjaahckphdjnjj	FALSE
mhahpalpnaaagfjkffnbpdaaaeg	FALSE
mmaaaaagnpdcdiipkohbdkdacad	FALSE
najiianoljanahanicpfjbajdno	FALSE
najajakajajnlcekphcjicoapmg	FALSE
nmjpkolaakpkomipajakpakmpfj	FALSE
oaaaaoalchedjalphlcbmbkdijm	FALSE
oajpaakannamjnmjmolpgdkcjob	FALSE
ommilaahakhnaahilebfagingoj	FALSE
pajajanaabckehabnjcedjeoopc	FALSE
panallainhajajonecelhiejdoj	FALSE
pjlkaajkiapoajagppnpbbjhfbi	FALSE
baaaaamhohbpifdlegmaglljdbpo	TRUE
eaaapalacaifkkjbdadhifdnolop	TRUE
abanpklammajaepnhelafombjdcm	TRUE
aaacaankfapceemhpidcklaopgcp	TRUE
aaakaijehgihgmmcfgejbelpnkp	TRUE
aagamompoakgiekbmnnlhidheko	TRUE
aafpanmjamajhogbdgjnaalkofp	TRUE
aalnkcioamlabhgfjfljlngmojd	TRUE
aaojnaoapjphbklohakhoalmbfn	TRUE
ahmjamhaijknanbaijbkdnfpobj	TRUE
ahhagaaacjdknofhflcnencagjp	TRUE
aihfaaakapekdahpjedbnmpenabd	TRUE
ajahhankmjjkpafnknebkjojaon	TRUE
akaalplnmpabonijoiapijddmmf	TRUE
alaaalfmoijmlkabiplokndhfknn	TRUE
abahjanaaikjicoimcccnfhjpdb	TRUE
ammiankppajolknkoagkcneglbj	TRUE
anmlmankkpmoaoabaidpepjpkghp	TRUE
aokajnhamfpaahjdlegadhajobin	TRUE
apkjlnmiallaafkknjagdeccfog	TRUE
fnaoplalhhaalgbngklaoodlnla	TRUE
paaalmhhlabocoecpjkkkpbmfef	TRUE
haijpmmlakneaiiabkcbahnckfj	TRUE
hiphlkajjaaokpkaccojlenmgph	TRUE
hmppnacanomaaakbkjbajmfjhlhg	TRUE
iaafmoapaapgbklpbbamiphbpeo	TRUE
ihpaklooaaamljhfafmhkchjiaoa	TRUE
inamoihllnapnklamenljahppnma	TRUE
jaakjjjpnaifakpjohkkamhnjmlp	TRUE
jgipkjaaamijkannoipjicpgaap	TRUE
jmjajeopjajakaaickhdebbjmbik	TRUE
kaadlaaphahlnedeeljlccedieed	TRUE
kanmaiioaapijbmamigjeppdbeen	TRUE
kkakjnlhphaaghjaojaiefoonjoh	TRUE
kpaaaapkdagmcfcbndkjnobflipc	TRUE
lakajafaoanhgdipanioofnomdhe	TRUE
ljdjaaaoaacoaifedkmecekaipd	TRUE
lnpmakaamaogiaikjjpanfnhkig	TRUE
maakabaalhfpacjaahckphdjnjj	TRUE
mhahpalpnaahgfjkffnbpdaaaeg	TRUE
mmaaagagnpdcdiipkohbdkdacad	TRUE
nagjiianoljanahanicpfjbajdno	TRUE
nejajakajajnlcekphcjicoapmg	TRUE
nmjpkolaakpkomcpajakpakmpfj	TRUE
oaaaaoblchedjalphlcbmbkdijm	TRUE
opjpaakannamjnmjmolpgdkcjob	TRUE
ommilaahaekhnaahilebfagingoj	TRUE
pacjajanaabckehabnjcedjeoopc	TRUE
panaleainhajajonecelhiejdoj	TRUE
pjlekaajkiapoajagppnpbbjhfbi	TRUE
aamaahaolkgginijpfehdoifnjha	FALSE
omionajpphaaakaenlcfanejmocd	FALSE
aakaaaogilejalemeocohginplml	FALSE
aaaanaeoflfomoagefennbfkljba	FALSE
aaalpanpjjakjikhobgjpolccdab	FALSE
aahnplaphnaappleficcbcoedpan	FALSE
aakajhiaailkcfenfdfallgeicdm	FALSE
aamlalaopmpahgjglgpcadadnfbj	FALSE
aapjkahhaakmibpidjokllhkedjl	FALSE
ahaajahioianijodcdolpgbmacpk	FALSE
ainaoaaajlandbfkndfnloiapmka	FALSE
ainkpkhnjalajaadkbkialhiifhc	FALSE
ajlaippaaaioeiejpengpakkeman	FALSE
akkaaahpoagpkhigofapfoanldne	FALSE
alhahlakaadjlaaddgmngligfaoo	FALSE
amanamaadfaannklmikaiecakgad	FALSE
anajapppjilnaakeabjlbgnnmppn	FALSE
aoaaaliadgfjdbgmkeojfaldbpod	FALSE
aoppphaiojhjiphllmkaakpmmlha	FALSE
apooaahalknohjajdgppojlmidhb	FALSE
aamlpiialaamdpejbopcjaggdfmk	FALSE
haijakamaaflefnkbgjpflkbhaga	FALSE
hananalnoaimiafioimmebmoknho	FALSE
hlhllkaaaaoagaaajkbnibnhmhpj	FALSE
hpkaamakknaacdleldhbknigoacc	FALSE
iamaajapafbnkocjjogagmfkdccm	FALSE
ijnahojkakplaohpajaldikjpnab	FALSE
ipmnjojhanjhmjpoalaaianojjjg	FALSE
jalaaaankcbhggbgidpfabojegcm	FALSE
jkhhahapahaacpkldbdakijobajf	FALSE
kaaoiaaaembakejgmbbnedfofjai	FALSE
kakmaanknhhpoaamhcjjonhipaln	FALSE
kkaaakaabmblpdleghdpgmbphegc	FALSE
kojaaoaajljaggdhggdmjiidghhc	FALSE
lahnomiiaaaafghfnbbjlceoocja	FALSE
liiahnanomampaiaobafhigkgomi	FALSE
lmmjalamaohanlaekocfokaigbdd	FALSE
maaaopmiaadgmmmihlgfdhoifpja	FALSE
maaalhoakajnfndhmmenlfhjpbpm	FALSE
mlaoapmaklpjaopangnbpofkihdi	FALSE
noioaaalnhlaaoeejanhgomjcaal	FALSE
naooakamnkaanfomnbccgjehealo	FALSE
nkikaaaaiphihadgecejjacpfglh	FALSE
noijjhplaaanialhlahoodocjhba	FALSE
oaakiaplolhakanagehjeinnjlpo	FALSE
oakaaamafckjdnmcajehemkanhnn	FALSE
olhajlaakanangkjaoddekgijgme	FALSE
oplkaioaaaahjbemmomlmgpcbcli	FALSE
paklannnjahiaaocndckehdbjlea	FALSE
pkaapiakpolaopaldfalgfhifgpa	FALSE
baamaahaolkgginijpfehdoifnjha	TRUE
eomionajpphaaakaenlcfanejmocd	TRUE
aeakaaaogilejalemeocohginplml	TRUE
aaaaenaeoflfomoagefennbfkljba	TRUE
aaalpanpdjjakjikhobgjpolccdab	TRUE
aahnplaphnhappleficcbcoedpan	TRUE
aakajhieaailkcfenfdfallgeicdm	TRUE
aamlalaopdmpahgjglgpcadadnfbj	TRUE
aapjkahhdaakmibpidjokllhkedjl	TRUE
ahaajahiofianijodcdolpgbmacpk	TRUE
agnaoaaajlandbfkndfnloiapmka	TRUE
ainkpkhbjalajaadkbkialhiifhc	TRUE
ajlaippamaioeiejpengpakkeman	TRUE
akkaanhpoagpkhigofapfoanldne	TRUE
alhabhlakaadjlaaddgmngligfaoo	TRUE
amanacaadfaannklmikaiecakgad	TRUE
anajapdpjilnaakeabjlbgnnmppn	TRUE
aoaanliadgfjdbgmkeojfaldbpod	TRUE
aoppphaiojhjiphllmkadakpmmlha	TRUE
apooaahalknohjhjdgppojlmidhb	TRUE
hamlpiialaamdpejbopcjaggdfmk	TRUE
hfaijakamaaflefnkbgjpflkbhaga	TRUE
hancnalnoaimiafioimmebmoknho	TRUE
hlhdllkaaaaoagaaajkbnibnhmhpj	TRUE
hpkaamakknaocdleldhbknigoacc	TRUE
iamabajapafbnkocjjogagmfkdccm	TRUE
ijnihojkakplaohpajaldikjpnab	TRUE
ipmnjojhanjhmjpoalcaianojjjg	TRUE
jalaaoankcbhggbgidpfabojegcm	TRUE
jkhhahapaehaacpkldbdakijobajf	TRUE
daaoiaaaembakejgmbbnedfofjai	TRUE
kakmpanknhhpoaamhcjjonhipaln	TRUE
kkaadakaabmblpdleghdpgmbphegc	TRUE
kocaaoaajljaggdhggdmjiidghhc	TRUE
lahnomdiaaaafghfnbbjlceoocja	TRUE
liiahnanfmampaiaobafhigkgomi	TRUE
lmmjalamaohaclaekocfokaigbdd	TRUE
maaaopmibaadgmmmihlgfdhoifpja	TRUE
mhaalhoakajnfndhmmenlfhjpbpm	TRUE
mlaoapmaklpjfaopangnbpofkihdi	TRUE
goioaaalnhlaaoeejanhgomjcaal	TRUE
naooakamnkalnfomnbccgjehealo	TRUE
ndikaaaaiphihadgecejjacpfglh	TRUE
noijjhplhaanialhlahoodocjhba	TRUE
oadkiaplolhakanagehjeinnjlpo	TRUE
onkaaamafckjdnmcajehemkanhnn	TRUE
oghajlaakanangkjaoddekgijgme	TRUE
oplkaioaaajhjbemmomlmgpcbcli	TRUE
paklgnnnjahiaaocndckehdbjlea	TRUE
pkaapiakpolmopaldfalgfhifgpa	TRUE
aajaaafajegfillcpemkephpbbnfn	FALSE
apapahmimamalinadlbhknncndljn	FALSE
aapnlaajphakemdgconabeidcgijn	FALSE
aaaajabdkemnnllkmdkhmemdifbdn	FALSE
aaalajjabbljmcepofaencjclgnci	FALSE
aahaiaalpijhphkiphmnnppbidcgb	FALSE
aakjaamhiaimgdchcepmiaafikflf	FALSE
aammkjnmnnjoajkamaimcdkcdgfdm	FALSE
aapmanlajappaepdnphfpngfalhkn	FALSE
ahapaaaijoipgmdmijkbfblkinpan	FALSE
ahoajakalaamcafniolghbdeffchn	FALSE
ailahjlnlahaapfnldjjaahhjjepi	FALSE
ajjanllaahpmajhhpkaedegalnokj	FALSE
akkahpannaoiiiajoancjlbefgakk	FALSE
alkkpmaoioaaahhfhhjonljpiipjn	FALSE
amaaojomjhhalahdgnkilkalblanb	FALSE
anaaaajkcmimigpgjbojhfhjpamjj	FALSE
aoaaojajahemicjophgjcgfpaggjb	FALSE
apaamnaamdjlilieefelcfkgnnifd	FALSE
apoaamaaeheinpmdpdbpjbglbldnp	FALSE
apaapoajajiholnjgjghaicbbjenm	FALSE
haaaoapoaaoolbpckjgennjhialgg	FALSE
haaikaaaohkpjmlodcdgohdbpndng	FALSE
hlnaappkkknalmaojmiiabkkbikmc	FALSE
iaahaakacmbkjpghielancecpbkjl	FALSE
iamppannkmaiaaofdffpghncbolje	FALSE
ikhaaaiimmphlajknjhjjllaobnfn	FALSE
ipajnaanmaiaocjpkihbkihpgkmpj	FALSE
jakapakkmlmpmanllmakndeoebepo	FALSE
jjipilaokkijaakaadmkpliebepll	FALSE
joajlaakaanpjmcmaocncbejjhbne	FALSE
kaakljmoaaacpjkmdjagcgokbnjfa	FALSE
khaapnpaamnagjpmpfkkefoeelipg	FALSE
knaammananhhpoalfonhkjmclflhf	FALSE
laaiaapaddechbpifheklfiekcnij	FALSE
lhaaaklapakhhfjfpliahkcbbecgb	FALSE
lmklaaakaphkkjnjjknpnammpidph	FALSE
maaahooaafbaeodilhnkdbdnooddg	FALSE
maolhanooaahhlkacihjoghpfejan	FALSE
mkiaohjaampahadldcebpghgkhbkm	FALSE
mpamaaiaadpagonchkkgkhijjhoap	FALSE
najkahkaaahkgeffnbmgdkfbmogdf	FALSE
njakahjnmihaapplaonhdlhkbelan	FALSE
nnljiialnkmaijiamaaaginjhpcfi	FALSE
oaamaajjkmojnoadjbleomapkjgfa	FALSE
oihkalhmomamapaaioklkamlofhle	FALSE
onapapaallalonmehdjhagnjmhmcj	FALSE
paaakpjllaaabeomoejbboblepmho	FALSE
pahaalakaafjadbiapgecmkocangi	FALSE
plaanmakaikabijkjpgmgpndeddlj	FALSE
baajaaafajegfillcpemkephpbbnfn	TRUE
fapapahmimamalinadlbhknncndljn	TRUE
aeapnlaajphakemdgconabeidcgijn	TRUE
aaaafabdkemnnllkmdkhmemdifbdn	TRUE
aaalajjbbbljmcepofaencjclgnci	TRUE
aahgiaalpijhphkiphmnnppbidcgb	TRUE
aakdjaamhiaimgdchcepmiaafikflf	TRUE
aammkjnmngnjoajkamaimcdkcdgfdm	TRUE
aapmanldajappaepdnphfpngfalhkn	TRUE
ahpaaaijoipgmdmijkbfblkinpan	TRUE
ahoajakalgaamcafniolghbdeffchn	TRUE
ailihjlnlahaapfnldjjaahhjjepi	TRUE
ajjanllafhpmajhhpkaedegalnokj	TRUE
akkahpfnnaoiiiajoancjlbefgakk	TRUE
alkkpmaoioaakhhfhhjonljpiipjn	TRUE
amdaojomjhhalahdgnkilkalblanb	TRUE
anadaajkcmimigpgjbojhfhjpamjj	TRUE
aoaaojeajahemicjophgjcgfpaggjb	TRUE
apaamnagamdjlilieefelcfkgnnifd	TRUE
apoaamgaeheinpmdpdbpjbglbldnp	TRUE
ipaapoajajiholnjgjghaicbbjenm	TRUE
haaaoapdaaoolbpckjgennjhialgg	TRUE
hnaikaaaohkpjmlodcdgohdbpndng	TRUE
hlnaappkkknalmbojmiiabkkbikmc	TRUE
icaahaakacmbkjpghielancecpbkjl	TRUE
iamppannkmaieaaofdffpghncbolje	TRUE
ikhaakiimmphlajknjhjjllaobnfn	TRUE
ipajnjanmaiaocjpkihbkihpgkmpj	TRUE
jakaphkkmlmpmanllmakndeoebepo	TRUE
jjgipilaokkijaakaadmkpliebepll	TRUE
joajlaeakaanpjmcmaocncbejjhbne	TRUE
kaakljgoaaacpjkmdjagcgokbnjfa	TRUE
khbapnpaamnagjpmpfkkefoeelipg	TRUE
knaammananhhfoalfonhkjmclflhf	TRUE
laaimapaddechbpifheklfiekcnij	TRUE
lhadaaklapakhhfjfpliahkcbbecgb	TRUE
lmklaaakaphkkjnjjkgpnammpidph	TRUE
maaahodoaafbaeodilhnkdbdnooddg	TRUE
maolhanooachhlkacihjoghpfejan	TRUE
mkiafohjaampahadldcebpghgkhbkm	TRUE
mpadmaaiaadpagonchkkgkhijjhoap	TRUE
najkahkamahkgeffnbmgdkfbmogdf	TRUE
njakahjnmihcapplaonhdlhkbelan	TRUE
nnljiialfnkmaijiamaaaginjhpcfi	TRUE
oaamdaajjkmojnoadjbleomapkjgfa	TRUE
oihkalhmomaeapaaioklkamlofhle	TRUE
onapapadllalonmehdjhagnjmhmcj	TRUE
paaakpjlelaaabeomoejbboblepmho	TRUE
pfhaalakaafjadbiapgecmkocangi	TRUE
plaanmakcaikabijkjpgmgpndeddlj	TRUE
