aaapfeopapaajailchdo	TRUE
aaanapaalanhjhchohcf	TRUE
aaagnnmnialmaigaahpb	TRUE
aaeaaaoaiekemehaodem	TRUE
aagnjgapkonhagfikaaa	TRUE
aakagjaekmaakjliafle	TRUE
aanhllahpnaaiijajiah	TRUE
aamigmmlaiiaafkafahm	TRUE
aekoaoaaapfaafhndkjb	TRUE
aflahapmamgkaoaadeee	TRUE
agloflaomaaahapkmoae	TRUE
ahmmglaeaiffajaalpka	TRUE
aimoaaankkhaajjoeanf	TRUE
ajnhjahfjaiaajehgeaa	TRUE
alnaamappahoiiafalnb	TRUE
amagnpanaeaapahcgnmn	TRUE
angaaagoohiaaiiakekn	TRUE
aojahkmmhaealaaaldbf	TRUE
apjoaifanpaigajakaga	TRUE
amhkanaehgoaaamlaffe	TRUE
eaafeaaoaapjfkenaomh	TRUE
eehanaoaapmjoaaiepea	TRUE
emlnmmamhkakaganmaaa	TRUE
faiaiaaafaoafbppkjjn	TRUE
fkaaaaganlgallancnjh	TRUE
gaalaknhjmhaagaohamo	TRUE
ghagahapkaamagjgadgg	TRUE
gpaaamoaiaiaealjenko	TRUE
hamlknmpaaklamaalhha	TRUE
hjheaaahapajhaiapjco	TRUE
iaglnaapnoampaaalpic	TRUE
ieeaanaghlamganhaajo	TRUE
inaajaaapaalmpbppojk	TRUE
jahpjjlklmaaajaaaddf	TRUE
jiaajmgiaflanaihaaon	TRUE
kaaaafpanieoaoaepojl	TRUE
kaokaemfaniohaaeanla	TRUE
kmajaajagaoaljnhojpa	TRUE
laaoeanaahammljepiao	TRUE
lhamanaagoapaennkapg	TRUE
mogfalaafnaaolaijiac	TRUE
memjpjakaajaaeapglac	TRUE
mmamaaoaaalaogipemek	TRUE
nagangaleaenaenaeake	TRUE
nhaajaoaalgjahpgacle	TRUE
npieajgafagaaakepahi	TRUE
oamoaalmjaalnhlgamma	TRUE
omaakkaajaalhmplamhj	TRUE
paeoalnafahliapgapam	TRUE
phkiaajijeaafnnaaaij	TRUE
baaapfeopapaajailchdo	FALSE
acaanapaalanhjhchohcf	FALSE
aaagnnmnialmcigaahpb	FALSE
aaeaaaoaiekebehaodem	FALSE
aagnjgnpkonhagfikaaa	FALSE
aakagjaekmaabkjliafle	FALSE
aanhllohpnaaiijajiah	FALSE
agmigmmlaiiaafkafahm	FALSE
aekoaokaapfaafhndkjb	FALSE
aflabapmamgkaoaadeee	FALSE
agldoflaomaaahapkmoae	FALSE
ahmmglaeaiffajaalpkb	FALSE
aimoaadnkkhaajjoeanf	FALSE
ajnhjahfjbaiaajehgeaa	FALSE
abnaamappahoiiafalnb	FALSE
amacnpanaeaapahcgnmn	FALSE
angaaagoohianiiakekn	FALSE
aojahkmmhaenlaaaldbf	FALSE
apjoaifanpaigajakbga	FALSE
hmhkanaehgoaaamlaffe	FALSE
eaafeaaoaapjfcenaomh	FALSE
eehanaoaapmjobaaiepea	FALSE
emlnmmamhkakaganmaka	FALSE
faiacaaafaoafbppkjjn	FALSE
fkaajaganlgallancnjh	FALSE
gaalaknhjmhaageohamo	FALSE
ghagahgpkaamagjgadgg	FALSE
gpbaaamoaiaiaealjenko	FALSE
hamlknmpaaklamaglhha	FALSE
hjheaaahapajhkiapjco	FALSE
ibaglnaapnoampaaalpic	FALSE
ieceaanaghlamganhaajo	FALSE
inaajaajpaalmpbppojk	FALSE
jahpjjlklmaiajaaaddf	FALSE
jiaajmgiaflanaihgaon	FALSE
kaaaadfpanieoaoaepojl	FALSE
kdokaemfaniohaaeanla	FALSE
kmajaajagaoaljnbhojpa	FALSE
laboeanaahammljepiao	FALSE
lhamanaagompaennkapg	FALSE
mcogfalaafnaaolaijiac	FALSE
memjdjakaajaaeapglac	FALSE
mmcmaaoaaalaogipemek	FALSE
nagangaleaenaenadeake	FALSE
nhaajaoaalgjahbpgacle	FALSE
npieojgafagaaakepahi	FALSE
olmoaalmjaalnhlgamma	FALSE
omaakkaajablhmplamhj	FALSE
paeoalnafahliapgaplm	FALSE
phkiaijijeaafnnaaaij	FALSE
aaajhaoiejeppkkaegnaa	TRUE
aaaiohipofooakhjaapac	TRUE
aaagmjmikeoialemagaea	TRUE
aaeihnaliaaeaikpabkap	TRUE
aaiaaeaaabannhilcaffi	TRUE
aalanppafjfaajkapcfja	TRUE
aaoioapgagannnolapjad	TRUE
aeaaakpilelhpjahhahja	TRUE
aephleakjohaiiaahamja	TRUE
agajpppaaiajmailhlona	TRUE
ahaempjgakiaahgaoalep	TRUE
aigapjjajoaemphapagoa	TRUE
ajfjajgnogalaaemkaabj	TRUE
akehigenajnaaajeaakge	TRUE
aliaaahkenmaimllaeahb	TRUE
amieanfhnaaenefpahaha	TRUE
annlimemeaaakilaaaflp	TRUE
apgkaahaeafjmnapaiohe	TRUE
appmaapanaaadobccbgko	TRUE
aaiamafaklfonhokaapfp	TRUE
eajfhhaflaanlaaaakpnl	TRUE
einaemmaaoaejjaomajao	TRUE
falmalagaepaappnmalii	TRUE
ffeaagghalaaapmnapeko	TRUE
fnalaojgapmjmajaaiahe	TRUE
gakiagaakaloiamfacnbd	TRUE
giaaammaljlmanpanloaa	TRUE
hlhgfjeaegaahaakahaed	TRUE
hfaejlekigamapomaoaaa	TRUE
hnapmakaajplfaffgpaea	TRUE
iajhkhfaafjaaenafeagp	TRUE
iioaaanaaagealkfefchm	TRUE
jkhaeafmagoaggaiaaonb	TRUE
jamgaaajhalafopiaclej	TRUE
jlhiakmaieaeaeaehhgaa	TRUE
kafaamiaapkofahmkadei	TRUE
khegiiefaafpllaaaamab	TRUE
kojpaafaaahahppogadln	TRUE
laolajalalpkoahaagjme	TRUE
llehagmamlaanmaagjmao	TRUE
maekpnnnaaaalakgaghfj	TRUE
mgmiaaflnhaknahafhjaa	TRUE
mnmkaakaajanfjaapnnom	TRUE
nakaaohaiaiikmaflhoag	TRUE
njafafpaaolapnoaeagje	TRUE
oaamepfgkjaonajapoaal	TRUE
ofajfikgahajlaiijajaa	TRUE
omfeaaiaaannkfiahjmma	TRUE
pajojekhkjaliaahaaakp	TRUE
phpgmgolaagafaaaejila	TRUE
baaajhaoiejeppkkaegnaa	FALSE
acaaiohipofooakhjaapac	FALSE
aaagmjbmikeoialemagaea	FALSE
aaeihnaliaaeaikpgbkap	FALSE
aaiaaecaaabannhilcaffi	FALSE
aalanppafjfiajkapcfja	FALSE
aaoiopgagannnolapjad	FALSE
aeaaakpilelhpjahhihja	FALSE
aephleakjoheiiaahamja	FALSE
agajpppaaiadjmailhlona	FALSE
ahdempjgakiaahgaoalep	FALSE
aigapjjajoaemphcpagoa	FALSE
ajfjljgnogalaaemkaabj	FALSE
akehigenajnaacjeaakge	FALSE
aliaaahbenmaimllaeahb	FALSE
amieanfhnaabnefpahaha	FALSE
annlimemeaaakilabaflp	FALSE
apbgkaahaeafjmnapaiohe	FALSE
appmgapanaaadobccbgko	FALSE
laiamafaklfonhokaapfp	FALSE
eajfhbhaflaanlaaaakpnl	FALSE
einaemmcaoaejjaomajao	FALSE
fcalmalagaepaappnmalii	FALSE
ffeaagghalaaapmndpeko	FALSE
fnalnojgapmjmajaaiahe	FALSE
gakiagaakaloiamfcacnbd	FALSE
giaaammaljlmanpdanloaa	FALSE
hblhgfjeaegaahaakahaed	FALSE
hfaejlekigamapomaoaak	FALSE
hnapmakanjplfaffgpaea	FALSE
iajhkhfaafjaenafeagp	FALSE
iioaaanaaagedalkfefchm	FALSE
bkhaeafmagoaggaiaaonb	FALSE
jjmgaaajhalafopiaclej	FALSE
jlhiakmaieaeaeaehhgha	FALSE
kafaamiaapkofahmkdadei	FALSE
khecgiiefaafpllaaaamab	FALSE
kojpaafaaahahppogidln	FALSE
laolajplalpkoahaagjme	FALSE
llehagmamlainmaagjmao	FALSE
maekpnnnaaaalakgfghfj	FALSE
mgmiaaflnhaknahfhjaa	FALSE
mnmkaakaajanfjajpnnom	FALSE
nakaaohaiaiickmaflhoag	FALSE
njafafphaolapnoaeagje	FALSE
oacamepfgkjaonajapoaal	FALSE
ofajfikgahajlaiijajab	FALSE
omfeaaiaaannkfiahjmda	FALSE
pajojekhkjaliaahnaakp	FALSE
phpgmgolahgafaaaejila	FALSE
aamaapiamoamgoapibbhbn	TRUE
amhmfojnaaoaaemkeamaki	TRUE
aaakajnaeaelhabnhlmega	TRUE
aafmkpfalhaaahpgaoebfi	TRUE
aajalakafplepgaofmalka	TRUE
aankianamjofaheamahpih	TRUE
aaaljakmeikkhlaaafdbjh	TRUE
aepaiajmamlmjfmihaaoap	TRUE
agaeaieipgaaaejfieafgn	TRUE
ahagagomkaaoahgikjhlac	TRUE
aieinhfhaaahlfaalpamdk	TRUE
ajlafihaahpmfaaofgihag	TRUE
akmilkaoaejflaglaaabkp	TRUE
alpihaaojjoefehoaoaaad	TRUE
ampjnapaahhanfeilaakdm	TRUE
aoaffjkooaajenamiaadno	TRUE
apakhpjijanaknaklaoeab	TRUE
aahajihlaekfoljifaajpa	TRUE
eaaphlihgaaapjafjhaoef	TRUE
egaaheaanalejjaahomdko	TRUE
eoaaegajoihlalaagkamgp	TRUE
falaaijpakflepaepeifaa	TRUE
fkaekaaoahlagoflaofjam	TRUE
gaahafnillggaaaacppjen	TRUE
ggaaehilfonaaigmakhaan	TRUE
gllffpaaapaaialehghadb	TRUE
haaifapeeafkikooafakma	TRUE
hfmaapmifnigaajakfamap	TRUE
hoaaoaameagnmamhaonomj	TRUE
iaiiamhafaoajpnoapmapm	TRUE
ihkneaalanialaaponamgl	TRUE
ionlnjfmaaaealeimpaoaa	TRUE
jalfaeemafijhakoaoaeoa	TRUE
jjeahofaiehpakkoaaamal	TRUE
kaafpfajpiaajlaneabpch	TRUE
kaeohapfoaflnifaakkgaa	TRUE
klopneamjaflmaafaaeagi	TRUE
lajaaganoaoiaaeklkcnmk	TRUE
lianaeaomaenaigjaephad	TRUE
leahaafaegoahfkinmaoma	TRUE
mapelojfkaajaaeanafoep	TRUE
mkaaagglgaalnamadedgei	TRUE
nkaoaeokagjehanjaafmia	TRUE
nfaaaaalfiaapmmmhiibeh	TRUE
nmjanlahamalfakapeigha	TRUE
oafnaglfalgaaalimpadea	TRUE
ohekafajpaankpajanmahp	TRUE
onfapeaahaehallgaacmic	TRUE
pamnaeeakaakhaminkfnka	TRUE
pijllaankapakpaaploadn	TRUE
baamaapiamoamgoapibbhbn	FALSE
acmhmfojnaaoaaemkeamaki	FALSE
aaakajnaeaechabnhlmega	FALSE
aafmkpfaclhaaahpgaoebfi	FALSE
aajalakafbplepgaofmalka	FALSE
aankianamjofahdeamahpih	FALSE
amaljakmeikkhlaaafdbjh	FALSE
aepaiajmamlmjfmihiaoap	FALSE
agaeaieipgadaaejfieafgn	FALSE
ahagagomkfaoahgikjhlac	FALSE
aieinhfdaaahlfaalpamdk	FALSE
ajlafihaahpmfaacfgihag	FALSE
akmilkaoaejflagblaaabkp	FALSE
alpibaaojjoefehoaoaaad	FALSE
ampjnapaahhanfecilaakdm	FALSE
aoaffjkooaajenambaadno	FALSE
apakhpjijanmknaklaoeab	FALSE
fahajihlaekfoljifaajpa	FALSE
eaaphlihgaaapjofjhaoef	FALSE
egaahealnalejjaahomdko	FALSE
edaaegajoihlalaagkamgp	FALSE
falaaijpakflepadpeifaa	FALSE
fkaekaaoahlagoflaofjcam	FALSE
gaahafnillggajaacppjen	FALSE
ggaaehilfonaabigmakhaan	FALSE
gllffpaaapaaialehghgdb	FALSE
haaicfapeeafkikooafakma	FALSE
hfmajpmifnigaajakfamap	FALSE
hoaaocaameagnmamhaonomj	FALSE
iaiiamhafaoajpcnoapmapm	FALSE
ihkneacalanialaaponamgl	FALSE
ionlnjfmdaaealeimpaoaa	FALSE
jalfaeemafijhpkoaoaeoa	FALSE
jjeahofaiehpakkoajamal	FALSE
daafpfajpiaajlaneabpch	FALSE
kbeohapfoaflnifaakkgaa	FALSE
klopneamjaflmaabaaeagi	FALSE
lajaaganoaoieaeklkcnmk	FALSE
lianaeaomenaigjaephad	FALSE
lcahaafaegoahfkinmaoma	FALSE
mapelojfkaajaeanafoep	FALSE
mkaaagglgaalnlmadedgei	FALSE
ndkaoaeokagjehanjaafmia	FALSE
nfaaaaaldiaapmmmhiibeh	FALSE
nmjanlahamalfkapeigha	FALSE
oafnaglfalgfaalimpadea	FALSE
ohekbafajpaankpajanmahp	FALSE
onfapeaahaehallgbacmic	FALSE
pamnaeeakaakhaminkfnkda	FALSE
pijllaankapakpabploadn	FALSE
aaaaanfaanlkgdjgmkopicg	TRUE
amaapheggnajllahaakeidc	TRUE
aaaijaogffngaeoaojaicik	TRUE
aafakamaopphjakajfcjkah	TRUE
aajknlameolmokeafaallae	TRUE
aannjfnppaajaoakikgkoae	TRUE
aeakaajeoghaalhhpkkmaii	TRUE
affaeaeaflaiegoplhaagdm	TRUE
agiahaapaahigacjdikgije	TRUE
ahkeaaglkgoajgkeaoafabb	TRUE
ainoleiaamapogjaaljajok	TRUE
akanjhaejlfnaeoanaapepe	TRUE
algpeopmahkoejaamgaaane	TRUE
amkfnaaaeaihhgakpkfpaeb	TRUE
anmaklaaehaflogfmplaeai	TRUE
aolkakaaagjhjiniagomajd	TRUE
apmfoaagaakikanoheiaohf	TRUE
eamfeakfpahajpaiiamfhja	TRUE
eapheainmpaaeagnkaojkam	TRUE
emaaioilmafhpaagaamoppb	TRUE
fafehaiefgimalpaaaopgal	TRUE
fghmakkaapaaikapacpoehg	TRUE
fnfaffkplnagamnahhgagaa	TRUE
gajhlimilkmlmiiaaaaafea	TRUE
gjlaooangpgialakgeanaha	TRUE
hjakaapkgkoepoeeakeajaa	TRUE
hennoojkaaamffaaoaapmne	TRUE
hkigaaeaaakoaandichokeh	TRUE
iaajkahghfaljnfjkpaaanc	TRUE
ieeamjafahgoaaaaainiple	TRUE
impafagahagaanhoomjajnk	TRUE
jagokliapmeaaokailgaaon	TRUE
jiafmahalfhjaaeamackjdi	TRUE
jpaafmahllgamagenmaaecj	TRUE
kaaiaakgmkiapkaakdkimel	TRUE
kleaanaahkkhaejgeaeapfk	TRUE
laanajaekjhlemgfjhaaaef	TRUE
lgaagpjgaaoakjmmlapaicl	TRUE
lmlagoaaogmaainijnaoagc	TRUE
magmpfalaanhnaiiaaemjhk	TRUE
mhaiaaoaljahlmeilahpamn	TRUE
moaaaipeajoiahkaagjohfd	TRUE
naiigaahamaehfajnlpiaml	TRUE
nhkgheoahgiimeaaaoaaeac	TRUE
npananhlajnalgmaooaoafn	TRUE
oaolgjaoanfaamliafahcnc	TRUE
ojkjeaamgagaaahahjlfoil	TRUE
pmefkipihaaoaaaakaimeeg	TRUE
papgapkaagomfhnalojepaa	TRUE
pjjnafnaapelkknaamihaai	TRUE
baaaaanfaanlkgdjgmkopicg	FALSE
abmaapheggnajllahaakeidc	FALSE
aaaijaogffngmeoaojaicik	FALSE
aafakpmaopphjakajfcjkah	FALSE
aajknlambolmokeafaallae	FALSE
aannjfnppaajaoakikgkope	FALSE
aeakfajeoghaalhhpkkmaii	FALSE
affaeaeaflaiegoplhacgdm	FALSE
agiahaapaahigkcjdikgije	FALSE
ahkeaaglkgoajgceaoafabb	FALSE
ainoleiaamapogjakljajok	FALSE
akanjhaejlfnaeoangapepe	FALSE
algpeopmahkoejaamgakane	FALSE
amkfnaaaeaihhgakpkfpgeb	FALSE
anmaklaaehaflogcfmplaeai	FALSE
aolkakaaagjhjiniadgomajd	FALSE
apmfoaagaabikanoheiaohf	FALSE
camfeakfpahajpaiiamfhja	FALSE
eapheainmpcaaeagnkaojkam	FALSE
emaaioilmafhpaagcamoppb	FALSE
fafehaiefgimflpaaaopgal	FALSE
fghmakkaapcaaikapacpoehg	FALSE
fnfaffkplnagcamnahhgagaa	FALSE
gajhlimilkmlmiiaacaafea	FALSE
gjlaooangpgialakgeanahf	FALSE
hdjakaapkgkoepoeeakeajaa	FALSE
hennoojkaabamffaaoaapmne	FALSE
hkigaaelaakoaandichokeh	FALSE
iajkahghfaljnfjkpaaanc	FALSE
ieeabjafahgoaaaaainiple	FALSE
impbfagahagaanhoomjajnk	FALSE
jagokliapmeaaokailgiaon	FALSE
jiafmbhalfhjaaeamackjdi	FALSE
jpaafmahllgamagenmabaecj	FALSE
kcaiaakgmkiapkaakdkimel	FALSE
kleaabaahkkhaejgeaeapfk	FALSE
laanajaekjhlemgfjhalaef	FALSE
lgaagpjgaaoakjmmclapaicl	FALSE
lmlagoaaogmaainijndaoagc	FALSE
magmpfalaanhnaiiiaemjhk	FALSE
mhciaaoaljahlmeilahpamn	FALSE
moaaaipeajoiahkaigjohfd	FALSE
naiigaahamaehfjjnlpiaml	FALSE
nhkgheoahgiimeaaaoadeac	FALSE
npanlnhlajnalgmaooaoafn	FALSE
oaolgjjoanfaamliafahcnc	FALSE
ojkjeaamgagaahahjlfoil	FALSE
cmefkipihaaoaaaakaimeeg	FALSE
papgapkaagomfhnalojebaa	FALSE
pjjnafnabpelkknaamihaai	FALSE
aakpaaffmkafpoaaiijebgfb	TRUE
agokginklaeaajiafaiomfaj	TRUE
aaakafoplefemhganamampae	TRUE
aagaihggakaflaaeodjmjckf	TRUE
aakffjmnaakkigaeigaojahi	TRUE
aapaallaplniiahamimnpkba	TRUE
aeafallaojkomjmaalafhcpa	TRUE
afjaahgaokaeahaicfilonfh	TRUE
agkgaffahfaflaaifkabmbkp	TRUE
ahpnaiafomhaeaofhhpaaded	TRUE
ajajaaiaemgjgaohnafaeecc	TRUE
akelnkoapnkokahaagpoamac	TRUE
alfkmakhhagpakipakiohaam	TRUE
amjpagaalfjamghnahmaffhc	TRUE
annahigaaammfafgoepaakmn	TRUE
apalknhlangpianaaabmhfgg	TRUE
ankphahpfaaopeamhafannca	TRUE
eaaaiamhfpgelaaafgfklenm	TRUE
eegkaaalfafaafkkeeggmadk	TRUE
elkjaakohlagilafoakaahgn	TRUE
faahoakjaakaajpllicmahdo	TRUE
fekanhmajehnipahifaaagna	TRUE
flkaipkfahaaaaaepbflilna	TRUE
gaaeaaalfgiaohmfghmaopaf	TRUE
ggpognaakgljmgfalaafaifa	TRUE
gnkagkaeagjnaakgniaahnkn	TRUE
hangaakaaaafjiehmflmfbkg	TRUE
hippaaaaapaenfafjdkamilf	TRUE
hooaanafahpkloggkkfeanaa	TRUE
ieaahanaaplaabgmglghmhal	TRUE
ikilanaaaoalkiampeenhafo	TRUE
jaaplaaklgjafpanjefhagcb	TRUE
jgkaaogaakhhhgmamoeaacnn	TRUE
jniahlhjjoakaoiajhaaolaf	TRUE
kaiaipjanhaalafkalmncalk	TRUE
khaikeglaaapahmpafgambng	TRUE
kpnhahakkafpaekaijaaaokm	TRUE
lapaoingfgpaigiaaaglapll	TRUE
ljmigaegneajaaaaambkdogh	TRUE
mflaaapkaafeaoaiffjdfblj	TRUE
mepaljeaiaoiaiahnnfejaaj	TRUE
mlgajkolkajhpaaalafgaioh	TRUE
nafaajhihpfaooagehoelnaa	TRUE
ngnijamffagpagaanjgaalck	TRUE
nnaaameaolaoalkiimmgipaf	TRUE
oaimaahakhhaeahigeagmiaj	TRUE
ohaioalajafgolaaadeefppo	TRUE
oohaljanennaifaaaepafcgb	TRUE
pamkefaaimaahngahafncdln	TRUE
pieefpaaeiaalohaoalaeike	TRUE
baakpaaffmkafpoaaiijebgfb	FALSE
acgokginklaeaajiafaiomfaj	FALSE
aaakafoplefemhgacnamampae	FALSE
aagaihggakaflameodjmjckf	FALSE
aakfbjmnaakkigaeigaojahi	FALSE
aapaallaplniiahbamimnpkba	FALSE
aeifallaojkomjmaalafhcpa	FALSE
afjaadhgaokaeahaicfilonfh	FALSE
agkgaffahfaflaiifkabmbkp	FALSE
ahpnadafomhaeaofhhpaaded	FALSE
ajajaaidaemgjgaohnafaeecc	FALSE
akelnkopnkokahaagpoamac	FALSE
alfkmakhhagpbakipakiohaam	FALSE
amjpagaalfjamghnahmnffhc	FALSE
annahigaaammfafgbepaakmn	FALSE
apalknhlmngpianaaabmhfgg	FALSE
enkphahpfaaopeamhafannca	FALSE
eaaaiachfpgelaaafgfklenm	FALSE
eegkaaalfafanfkkeeggmadk	FALSE
elkjaakohlagilafcakaahgn	FALSE
faahoakjaacaajpllicmahdo	FALSE
fekandmajehnipahifaaagna	FALSE
flkaipkfkhaaaaaepbflilna	FALSE
gaceaaalfgiaohmfghmaopaf	FALSE
ggpognaakglbjmgfalaafaifa	FALSE
gnkagkaeagjnaacgniaahnkn	FALSE
hangaakaaacafjiehmflmfbkg	FALSE
hippaaaapaenfafjdkamilf	FALSE
hooadanafahpkloggkkfeanaa	FALSE
ieaahcnaaplaabgmglghmhal	FALSE
ikildnaaaoalkiampeenhafo	FALSE
jaaplaaklgjnfpanjefhagcb	FALSE
jgkaaogjakhhhgmamoeaacnn	FALSE
jniahchjjoakaoiajhaaolaf	FALSE
kaiaipjanhcaalafkalmncalk	FALSE
khaikegdaaapahmpafgambng	FALSE
kpnhahakkafpcekaijaaaokm	FALSE
lapaoingfgpaigiakaglapll	FALSE
ljmigaegnemjaaaaambkdogh	FALSE
dflaaapkaafeaoaiffjdfblj	FALSE
mepaljeaiaoiaiahnnfejcaaj	FALSE
mlgajkblkajhpaaalafgaioh	FALSE
nafaajhihpfaoofgehoelnaa	FALSE
ngncjamffagpagaanjgaalck	FALSE
nnaaameaolaoalkiimmgipdf	FALSE
oaimaahakhhaeahigcagmiaj	FALSE
ohaioalajafgoloaadeefppo	FALSE
oohaljgnennaifaaaepafcgb	FALSE
pamkefabaimaahngahafncdln	FALSE
pieefpaaeiablohaoalaeike	FALSE
aaaaaaabfajdmfagclbnopmgp	TRUE
aapjaeaaahaodefchopkmbpod	TRUE
aaaknahmgejlafkanamocfbfn	TRUE
aagmmmhaagaajapbgolnjfaon	TRUE
aalaageamlpaacelnlhaccabm	TRUE
aafonphnnfaaiahelieamango	TRUE
afaanhhakohenaaadpnhhdcbk	TRUE
agegaoajajnafaaapgpecdkin	TRUE
ahjaoaepfkiaaaogpaoaedbif	TRUE
aipjnijaagnakaimmiiamiapb	TRUE
akaoohhhjmaejijfahfaaaohp	TRUE
alffenlaianajoalaaehejgka	TRUE
amialahajffinahajkeacdkgd	TRUE
annokaffahefmfaaaaadfacmj	TRUE
aopajhnmaiflmjaoaajagelkh	TRUE
ahelahaaiknaaiadmplddikmk	TRUE
eaaenpeakaninflaomnaaohjd	TRUE
efamnjmaanjaaagakakbonpcp	TRUE
emmagnomhjanomaaeaafjpack	TRUE
fahoaiifaaalegkamfklmapfa	TRUE
fijaapampjnaianeajaebjgii	TRUE
fpijoankaaffnkhaaaffhnhaf	TRUE
gapaaaikmggofaehmepojofaa	TRUE
gjgpapfkgapiofknaiaagafak	TRUE
hmfhmnpfiiaaafaigakhahabn	TRUE
haogpkaepaaajofhngliakmaf	TRUE
hiikpmjalapiafkoaaaohaiho	TRUE
hofalaakefpkkaeafajmklael	TRUE
ianpoanigaggaaahejfjhfhal	TRUE
ijaagaaalajhmoakbajbkficc	TRUE
ipigaaafpljjpaepakianeima	TRUE
jeeanhaaiagaokjaachhbiocb	TRUE
jkieamahkkaoaoneijenaaoah	TRUE
kaaahpaoolegaeliampaheege	TRUE
kfaemehkahkehaajkakajkoaf	TRUE
klalmimaamghoafgkfmoaaiaj	TRUE
laagfaiehmfljapoigloaaadd	TRUE
lelfagaaakafmennamnhkamib	TRUE
llajljjlaeopajomnaaajaeej	TRUE
maapaenaiegafaolalcpcfkko	TRUE
mgpajlainpaaoakkaekabdfol	TRUE
mnmaajjgiapaaljgnkafniabg	TRUE
nahiaaaaaamemldcklmdngmaj	TRUE
nhaakapklmahaafhlllloofma	TRUE
nnkamaohgflpejhanjpaahaja	TRUE
oahgejfkahfmaaignajaajckh	TRUE
ogpgagajhlaaajajhajijjkgj	TRUE
oneaaikoaeaaahablgohkaeod	TRUE
pakgalgklmaggaannfnaaljjb	TRUE
pjaoeeagaanhpkoaoapapcgpi	TRUE
baaaaaaabfajdmfagclbnopmgp	FALSE
apjaeaaahaodefchopkmbpod	FALSE
aaaknahmgejlefkanamocfbfn	FALSE
aagmmmhaagaajlpbgolnjfaon	FALSE
aalaageamlphacelnlhaccabm	FALSE
abfonphnnfaaiahelieamango	FALSE
acaanhhakohenaaadpnhhdcbk	FALSE
agegaoajajnafabaapgpecdkin	FALSE
ahjaoaepfkiadaaogpaoaedbif	FALSE
aipjnidaagnakaimmiiamiapb	FALSE
akaoohhhjmaejicjfahfaaaohp	FALSE
alffenlaianajcoalaaehejgka	FALSE
amialahkjffinahajkeacdkgd	FALSE
annokabfahefmfaaaaadfacmj	FALSE
aopajhnmaiflmjaoaajkgelkh	FALSE
chelahaaiknaaiadmplddikmk	FALSE
eaaenpeakanidflaomnaaohjd	FALSE
efamnjmaanjadagakakbonpcp	FALSE
emmagnomhjanomaaegafjpack	FALSE
fahcaiifaaalegkamfklmapfa	FALSE
fijaapampjnaianeacaebjgii	FALSE
fpijoabnkaaffnkhaaaffhnhaf	FALSE
gapaaaikmggofaehmepcjofaa	FALSE
gjgpapfkgapiofknaiaagacfak	FALSE
hbmfhmnpfiiaaafaigakhahabn	FALSE
haogpkaepaaajofhdgliakmaf	FALSE
hiikpmjalapiafkoagaohaiho	FALSE
hofaliakefpkkaeafajmklael	FALSE
ianpoanigaggaoahejfjhfhal	FALSE
ijapgaaalajhmoakbajbkficc	FALSE
ipignaafpljjpaepakianeima	FALSE
jeeanhaaiagaokjlachhbiocb	FALSE
jkieamahkkaoaoneijenbaoah	FALSE
kaaahpaoodegaeliampaheege	FALSE
kfaemehkahkehaajkakajkobf	FALSE
klalmimaamghoafgkfmbaaiaj	FALSE
laagfaiehmfljapoigloadadd	FALSE
lelfagpaakafmennamnhkamib	FALSE
lcajljjlaeopajomnaaajaeej	FALSE
maapaenaiegafaolhlcpcfkko	FALSE
mgpajlpinpaaoakkaekabdfol	FALSE
mnmaajjgiapbaaljgnkafniabg	FALSE
nahikaaaaamemldcklmdngmaj	FALSE
nhaakapklmahcaafhlllloofma	FALSE
nnkamaohgflpejhanjpkahaja	FALSE
oahgejfkahfmabaignajaajckh	FALSE
ogpgagajhlalajajhajijjkgj	FALSE
oneaaikokeaaahablgohkaeod	FALSE
pakgadgklmaggaannfnaaljjb	FALSE
pjaoeeagaanhpdkoaoapapcgpi	FALSE
aaalknmilnhaannolopigiaiam	TRUE
ahhamihleaaeakmmekamopglab	TRUE
aaannaimomalmpkfaaldhhjcfh	TRUE
aahafoionpjailoafaoafihikn	TRUE
aammalomkanaigfagkapijbdan	TRUE
aeaaegkajlnmaijlnkffagekal	TRUE
affaaoanaaoejlnpflfmfopial	TRUE
agaimajalgaaandkcclfngckke	TRUE
ahanjfgapnoanajpplpiemahia	TRUE
aiepkanpaghankafllpaiadadi	TRUE
ajknipaaalpjaafpfkffimakbj	TRUE
aknaolaihaemgpafeanjohacid	TRUE
alpfiegkaapaapamjfoamfphgg	TRUE
analaaiieamoaeaggbiodjophb	TRUE
aoankoaofafilpkjknojakaagd	TRUE
aphlfanfaegphajongpaaeakeo	TRUE
aogafoonafaeaaahbkidolcdca	TRUE
eahlaihlajgkfapmikjlimaaaj	TRUE
eianmaeiaalnaloajekohpjgap	TRUE
eojaaanaioppilgmaaphamhfln	TRUE
fanmaaonkafepomkngiaaapicn	TRUE
fkaijeaiaimlaloihglaioeaah	TRUE
gaafiehoaljjmakfnmhlapaakj	TRUE
gfpolhjaaiieaagkaoijjapabe	TRUE
gmanioamiaapikmpamjaklaede	TRUE
hagagnmpainfmpaleamaioafpm	TRUE
hgmggalheomaheagahmhaaoaoo	TRUE
hngpnnkaamajhnaaaolanakchg	TRUE
iaahafnpjkelaeagpmnogaamdj	TRUE
ikikloakgaajiaamhakankcahg	TRUE
ipnlemaoilkajaojaeagjaadeo	TRUE
jfamahpaalfaejgoajanblpfgp	TRUE
jllaofolaailnhaofagnaaiiii	TRUE
kaakmpnajjpkfifaiflapangan	TRUE
kfaemaeaemaaookapnaknbnjpd	TRUE
kllmaajaiafpkaagmeeafpikji	TRUE
lafoinjlaapljahknaaahdopkp	TRUE
lgfgfimaamaaeglghanahhjnia	TRUE
lnaiealaaahgighgipjoamanki	TRUE
makapolaenigpeahaaannonnph	TRUE
mialamamhahfeiagalnoabiejk	TRUE
moaaagfpaaakifahfmonhkbdon	TRUE
najoapiaooekaajfamhfgaiohj	TRUE
nhgahfihnapaapjgaenoaaknmk	TRUE
noakfanlghiahaleaaiogamlbj	TRUE
oakaoagoioanfhlafhhfaghlab	TRUE
ohlajahfaelaaihglhhnlalalf	TRUE
onmmhaanjlapmnpaiinameheaa	TRUE
pankikaahlafmoapgjajipffap	TRUE
pjipaaokpalaaakahkacofjgbg	TRUE
baaalknmilnhaannolopigiaiam	FALSE
achhamihleaaeakmmekamopglab	FALSE
aaannaimomalmpkfacldhhjcfh	FALSE
aahaboionpjailoafaoafihikn	FALSE
aammalomkanaigfdgkapijbdan	FALSE
aeamegkajlnmaijlnkffagekal	FALSE
affaaoanaboejlnpflfmfopial	FALSE
agbimajalgaaandkcclfngckke	FALSE
ahanjfgapnolnajpplpiemahia	FALSE
aiepkanpaghankafllpacadadi	FALSE
ajknipaaalpjaafpckffimakbj	FALSE
aknaolaihemgpafeanjohacid	FALSE
alpfiegkaapaapcmjfoamfphgg	FALSE
analaaiieambaeaggbiodjophb	FALSE
aoankoaofafilpkjkndjakaagd	FALSE
aphlfacnfaegphajongpaaeakeo	FALSE
gogafoonafaeaaahbkidolcdca	FALSE
eahlaihlajgkfabpmikjlimaaaj	FALSE
eianmaeifalnaloajekohpjgap	FALSE
eojaaanaioppilgmdaaphamhfln	FALSE
fanmaabonkafepomkngiaaapicn	FALSE
fkaijeaiaimblaloihglaioeaah	FALSE
gaafiehoaljjmcakfnmhlapaakj	FALSE
gfpolhjaaiieadagkaoijjapabe	FALSE
gmanioamiaapikmpamjaklnede	FALSE
hagagnmpainfmpaleamadioafpm	FALSE
hgmggalheomaheagabhmhaaoaoo	FALSE
hngpnnkaamcajhnaaaolanakchg	FALSE
ioahafnpjkelaeagpmnogaamdj	FALSE
ikidkloakgaajiaamhakankcahg	FALSE
ipnlemaoilkajcojaeagjaadeo	FALSE
jfamahpaalbaejgoajanblpfgp	FALSE
jlladfolaailnhaofagnaaiiii	FALSE
kaakmpnajjpkfifaiflabpangan	FALSE
kfaemaeacmaaookapnaknbnjpd	FALSE
kllmaajjiafpkaagmeeafpikji	FALSE
lafoinjlaabljahknaaahdopkp	FALSE
lgfdfimaamaaeglghanahhjnia	FALSE
lnaiealaaahgighgipjcamanki	FALSE
makapolaenigpeahdaaannonnph	FALSE
mialamcmhahfeiagalnoabiejk	FALSE
moaaagfpabakifahfmonhkbdon	FALSE
najoapijooekaajfamhfgaiohj	FALSE
nhgahfihnadpaapjgaenoaaknmk	FALSE
noakfhnlghiahaleaaiogamlbj	FALSE
oakaoagoioanfhlofhhfaghlab	FALSE
ohlajahfaelaaihglhhnlalhlf	FALSE
onmmhaanjlapdnpaiinameheaa	FALSE
pankikabhlafmoapgjajipffap	FALSE
pjipaaokpalcaaakahkacofjgbg	FALSE
aapijoaaeeagomaaodalbbgiiol	TRUE
aaaehgallpahaahipajbocecmcl	TRUE
aaeaaaealmhjliakliaebcnnigc	TRUE
aailfhgfahaeajfhgnfaaiedmdm	TRUE
aaoionpaeheplkpjpanoppjaaah	TRUE
aeinamkfkgapaoaaamnlhchmiij	TRUE
afkanjakanmaanfnmafcaeolaak	TRUE
agmimaeakahjeeaeeaffalhkbji	TRUE
aialfkfafmpgaaiaheajcgpohlm	TRUE
ajfagomaahokkpgjaiajiabhgdb	TRUE
aklpjaheamaanfaafmafjfemjea	TRUE
almhnaeiiaaamikhakkhaeobkfa	TRUE
ammgpaaafgggamognhkiffaamjl	TRUE
aoaianejgmkalepjanakjgpablj	TRUE
apeeapjfakihpaflphloalaalmn	TRUE
akiaaakalnfoiijanihmilphpaf	TRUE
ekkioaagpaahaiahoojakfickfo	TRUE
eegmaagpnoakfmaingjaamajhnf	TRUE
elagigakjaieamkialejhlajaam	TRUE
faaoomopajaipkehaapilhipalf	TRUE
fhjaoggafaiaiapajojkehfaffc	TRUE
fnamaapanhanaphephppeamjnac	TRUE
galahealkafapppekaagbhpllha	TRUE
gineenaagpnaaoejhaeeaangppd	TRUE
goagkemegaaaajggjjlkakjabjc	TRUE
hakiakjeoailahaamlmhaajkhbo	TRUE
hianeiafajlgaafjnaaaohjcgap	TRUE
honakjjofaeminapfakoaafjabk	TRUE
iaoliajiaolaaiknagapjkeljml	TRUE
ikahiagefaoanfopkfpakfjaafp	TRUE
ipoaoaniakpaopkfppgaanmmham	TRUE
jfeeiamgkapefnfaknaaijnafaj	TRUE
jmfnoaagafhmhaaanmhnjacldjp	TRUE
kaeelaneafoamalgmihapabgmni	TRUE
khfagiajgkmkaafaalaeoeeggmd	TRUE
knlaalaemakapjmfpaokfnpamee	TRUE
lajempinloamapganapfaagjibh	TRUE
liamnaaapkkoajahgaccffnbooa	TRUE
lohjphfgaaafanaiaaoppjpeklg	TRUE
mamnlkaaehmpoijfkiaanlmfafa	TRUE
mippjakapgjaaohaagkknnkaopf	TRUE
mpajgnaalapajgmaaeahejnojmb	TRUE
nanppoaakfaleaikgmgeiaaojjk	TRUE
njapljaaafolaloialjieabjbdf	TRUE
nppjinhjaaepnajhaafahmeapfn	TRUE
oeejjkhoaeoagamaiaaiejkakkh	TRUE
okfjehamafagahfafgjojaabgpa	TRUE
paiaalgaknoagkhgkegapkhnjab	TRUE
paaaahaagjpijamjpkeejijoglc	TRUE
pjiknanhlnhaeaihkoagejfaaja	TRUE
baapijoaaeeagomaaodalbbgiiol	FALSE
adaaehgallpahaahipajbocecmcl	FALSE
aaeaaaealmhjlickliaebcnnigc	FALSE
aailfhcgfahaeajfhgnfaaiedmdm	FALSE
aaoionpaeceplkpjpanoppjaaah	FALSE
aeinamkfkgapaoaalmnlhchmiij	FALSE
afkenjakanmaanfnmafcaeolaak	FALSE
agmimaepkahjeeaeeaffalhkbji	FALSE
aialfkbfafmpgaaiaheajcgpohlm	FALSE
ajfagomaahokkpgjiiajiabhgdb	FALSE
aklpjaheamaadfaafmafjfemjea	FALSE
almhnbeiiaaamikhakkhaeobkfa	FALSE
ammgpcaaafgggamognhkiffaamjl	FALSE
aoaianejgmkalepjadakjgpablj	FALSE
apeeapjfakihpnflphloalaalmn	FALSE
fkiaaakalnfoiijanihmilphpaf	FALSE
eckkioaagpaahaiahoojakfickfo	FALSE
eegmaagpnoakfmaingbjaamajhnf	FALSE
elagigakjaieamkialejdhlajaam	FALSE
faaoomopajaipkehaapilhibalf	FALSE
fhdjaoggafaiaiapajojkehfaffc	FALSE
fnamdapanhanaphephppeamjnac	FALSE
galahealkafapppekdaagbhpllha	FALSE
gineenfagpnaaoejhaeeaangppd	FALSE
goagbkemegaaaajggjjlkakjabjc	FALSE
hakiakjeoailahaamlmchaajkhbo	FALSE
hianeiafdjlgaafjnaaaohjcgap	FALSE
honakjjofaeminapfnkoaafjabk	FALSE
iaoliajcaolaaiknagapjkeljml	FALSE
ikahiagefaoanfodkfpakfjaafp	FALSE
ipooaniakpaopkfppgaanmmham	FALSE
jfeeiamgkapefnfaknadijnafaj	FALSE
jmfnoacgafhmhaaanmhnjacldjp	FALSE
kaeelaneafoamdlgmihapabgmni	FALSE
khfagiajgkmkanfaalaeoeeggmd	FALSE
knlbaalaemakapjmfpaokfnpamee	FALSE
lajempinldamapganapfaagjibh	FALSE
liamnnaapkkoajahgaccffnbooa	FALSE
lohjphfgaaafangiaaoppjpeklg	FALSE
mamclkaaehmpoijfkiaanlmfafa	FALSE
mippjakapgjaaohaagkknnklopf	FALSE
mpabgnaalapajgmaaeahejnojmb	FALSE
nanppoaakfaleaikgmgeiapojjk	FALSE
njapcjaaafolaloialjieabjbdf	FALSE
nppjbnhjaaepnajhaafahmeapfn	FALSE
oeejjkhoaeoagamaiahiejkakkh	FALSE
okfjehamafadgahfafgjojaabgpa	FALSE
piaalgaknoagkhgkegapkhnjab	FALSE
poaaahaagjpijamjpkeejijoglc	FALSE
pjiknanhlnhaeaihkolgejfaaja	FALSE
aajomaialaljohalhflkaddbkbji	TRUE
amkeaonkaaanmmofppkaamclgmcf	TRUE
aaaopklmnaikefakglpfagnfalob	TRUE
aaiaeigmiafkjgaanmaecjdodlgf	TRUE
aanoaapaooapammcobpnopaocggk	TRUE
aefaiaaahmgahapgfjncfhbfebkp	TRUE
afmgaafimakmgjoikaiilaaionbi	TRUE
ahhlnafofammjapenlaoapiaelpe	TRUE
aiganghallajflajfamfiojekjaj	TRUE
ajnanalaoanoaadaekbomkbmikgh	TRUE
akpmfaoaaojajaogfehijnefahkg	TRUE
amalgfajoekanifaiphpahapnhjl	TRUE
anhnahaeaekamioajapiinnolbjp	TRUE
aomgppigaaoiafanooagmfemanip	TRUE
agnaamkkangfhnemanaliamafkmf	TRUE
eaaeomlpagmfanhlplnhniafakia	TRUE
eejflaakgpiaalommlnkaajhaiip	TRUE
ejkaafnpfmajaeeknmnpkaaanghi	TRUE
fakalkaniaaaagcnbboefjfmpgaf	TRUE
fgmaanakampalemaacaehjnkcdid	TRUE
fnaanaeeigaaipegpnlnhmaeoalp	TRUE
gajjaaahafgnaakpbkgeadmmmhcb	TRUE
ggjoakfinhfaliaghhmiafhjaaaf	TRUE
gmomaiaaoppjpkhmahpanajakenf	TRUE
hahiajjoiajmipafaaabfmlcahdg	TRUE
hiaganajahgpfimaeeoaflmlialh	TRUE
hpagpheagaaalajnjjknhfmlanei	TRUE
iapieaefaaokaaadohefifeipaep	TRUE
iifllhalopoaaaaanjphifaeknbd	TRUE
ioaoakppaaaagakoblfbgfgffohh	TRUE
jajaaloakeaffafabaaelodgegnm	TRUE
jikfaianmganaaaaafakplggdhgk	TRUE
jolimiaoajpmlpamaomimahaaicp	TRUE
kaalnelnahhaihkalgaadbhhbaej	TRUE
kkikoaaghkaoaefgpaaaedcmadjd	TRUE
laaamfkamahfanmalfbjdednaoag	TRUE
leehpaplfgahaeeppaaagmnahlec	TRUE
lkaghaaoahiegijhmfajpaaflkgj	TRUE
mlaanifejaifomihfahanoeakema	TRUE
mefmpaiaokaojhnaafhpgipakgka	TRUE
mkaaananjkeoojnopgapamokolai	TRUE
mplgfgaoaaaplaoaiadfkclllhhd	TRUE
napeemnnnmkahafpkaaemanmgang	TRUE
njioaalhggnmihaahonjhfalaagh	TRUE
npokfaehkhneaaagampioeamallk	TRUE
oafkgafkpeaaafnaakebcpapfonf	TRUE
okeaaalpalhpakmiljmneeplmaao	TRUE
opfgaafhaaahepnajhladbppfddh	TRUE
panaipaihmfaaangnlkfadobpcco	TRUE
pjaimangmeefaoakkjaggafgeagc	TRUE
baajomaialaljohalhflkaddbkbji	FALSE
acmkeaonkaaanmmofppkaamclgmcf	FALSE
aaaopklmnaikefakglpfagnfhlob	FALSE
aaiabigmiafkjgaanmaecjdodlgf	FALSE
aanogapaooapammcobpnopaocggk	FALSE
aefjiaaahmgahapgfjncfhbfebkp	FALSE
afmgaafimakmgjodikaiilaaionbi	FALSE
ahbhlnafofammjapenlaoapiaelpe	FALSE
aiganghallabjflajfamfiojekjaj	FALSE
ajnanalaonoaadaekbomkbmikgh	FALSE
akpmfaodaaojajaogfehijnefahkg	FALSE
amalgfajoekanifaiphplhapnhjl	FALSE
anhnahaeaekomioajapiinnolbjp	FALSE
aomgppigaaoiafanoogmfemanip	FALSE
cgnaamkkangfhnemanaliamafkmf	FALSE
eaaeomlpagmfanhlplnhniafakio	FALSE
eejflaakgpdaalommlnkaajhaiip	FALSE
ejkaafnpfmajaeeknmnpkaaenghi	FALSE
fdakalkaniaaaagcnbboefjfmpgaf	FALSE
fgmaanakampadlemaacaehjnkcdid	FALSE
fnamnaeeigaaipegpnlnhmaeoalp	FALSE
gajjaoahafgnaakpbkgeadmmmhcb	FALSE
ggjocakfinhfaliaghhmiafhjaaaf	FALSE
gmomaiaaoppjpkhmmhpanajakenf	FALSE
hahiajjoiajmipmfaaabfmlcahdg	FALSE
hijganajahgpfimaeeoaflmlialh	FALSE
hpagpheagpaalajnjjknhfmlanei	FALSE
iapieaefaaokaaedohefifeipaep	FALSE
iifllhalopoaaeaanjphifaeknbd	FALSE
ioaoakppaaafgakoblfbgfgffohh	FALSE
jajaaloakeafdafabaaelodgegnm	FALSE
jidkfaianmganaaaaafakplggdhgk	FALSE
jolimiadajpmlpamaomimahaaicp	FALSE
kbalnelnahhaihkalgaadbhhbaej	FALSE
kkikoaaghkaoaefgpaabedcmadjd	FALSE
laadamfkamahfanmalfbjdednaoag	FALSE
leehpaplfgahaeeppaabgmnahlec	FALSE
lkaghaaoahiegijhmfajdaaflkgj	FALSE
mblaanifejaifomihfahanoeakema	FALSE
mefmpaiaokaojhnaafhdpgipakgka	FALSE
mkaaananjkeoojnopgaplmokolai	FALSE
mplgfgaoaaaplaoaigdfkclllhhd	FALSE
nipeemnnnmkahafpkaaemanmgang	FALSE
njioaalhggnmihaahonjhfalaegh	FALSE
npokfaedkhneaaagampioeamallk	FALSE
odfkgafkpeaaafnaakebcpapfonf	FALSE
okeaaalpaldpakmiljmneeplmaao	FALSE
opfggafhaaahepnajhladbppfddh	FALSE
panaipaihmfaamngnlkfadobpcco	FALSE
pjaimangmeefaoakkjaggafgedgc	FALSE
agkamheaaiaaekgadhddonabhgekn	TRUE
aafalaafjhkgiakoamfcdgnfphbob	TRUE
aaemakkgmanagamffegalkcebagkn	TRUE
aakeapoanapamofleokpnaoeeojko	TRUE
aafeeakaagmaafiecphncdbamgbkc	TRUE
afafhaimlhfekipalkjgmgaallnam	TRUE
agglaalahkganfphffnmapafkjgoj	TRUE
ahlannaoalnapokefgolfeakkmaob	TRUE
ainoiaihiohgaijkakeagkoleafak	TRUE
akeaeaepoihfgaakmhaagjohgilpb	TRUE
aliemjgakglapalhenhakinlogaaf	TRUE
amlkjmjggalianoonejmaiaahaoao	TRUE
anplffoijghiakaafalljkeklahna	TRUE
apakplleojamepkfmoeapioagaadm	TRUE
aoaohkmelpphaanfkkekpaaagbemi	TRUE
eaenepofajgleigpokahelahaaaci	TRUE
egpoeaaaapfjilkahaoamplhhjach	TRUE
emjaianlkalapjaanmpnablkoldif	TRUE
falaepleooaimkinoaaapmmapnkik	TRUE
fjlfmajanahaagafeoadejmbkpnll	TRUE
gglajagahaeahlejpnehaghakngcc	TRUE
gfeafkgifalahaaoljhajeaibgifa	TRUE
gkneapnfiaenoeaaeaneeiajkaebg	TRUE
hamaafammfakhahoalblhdjfnigdj	TRUE
hakehkaakaajjmaoacknmljbmfdme	TRUE
hkaaphfjagahaahlofoajchhbnbfk	TRUE
hpfaahhhgiankahkhnmjihahhmana	TRUE
iaeeagaipalaomaaofnnolpdpalnf	TRUE
ijhainaehklaapffnoaajoadbmnjc	TRUE
ipgnhglgaeejaakapmgaanjiakhge	TRUE
janoajlnlfjhiiaoealllfaaejamc	TRUE
jijoaglgnjliaihaajemkaananlbg	TRUE
joaagahmaiakfiepnnaailbdllmfn	TRUE
kajjaaaamoakmacbobjbngninhjbo	TRUE
khpjlaaooaekjhojalepiakjpeaag	TRUE
kohaipkgakhajaamhfkhjakpmfnha	TRUE
lanaangaonnhlaanjigfabejjjbgc	TRUE
lignhamahhhneaaagaipakcpbjjla	TRUE
logpappmpokfaamafajllmpagfpan	TRUE
maliahaemgnjphaeaglaifkmjfana	TRUE
mihaififnlmmaaeiknhafilmjaaac	TRUE
mopaagalnkkajnkemmnaejafadofh	TRUE
neajmlaaaanfaneihoeeokiaoalen	TRUE
njnjlalleahfgaaamanhknnadonhm	TRUE
npjkonklaajamlaaihahkilhohamm	TRUE
oeajanhohpnmahahaahlanegildhj	TRUE
ojaffkaalaaemlaehaipepbbodkbm	TRUE
phapaoageeioieklnimaoahhaoajf	TRUE
pepajkeheaanaalfaoeiagikdhnkl	TRUE
pkggaagaaeiipjangfhiiihaaipoi	TRUE
bagkamheaaiaaekgadhddonabhgekn	FALSE
adafalaafjhkgiakoamfcdgnfphbob	FALSE
aaemakkgmanagjmffegalkcebagkn	FALSE
aakeapoadnapamofleokpnaoeeojko	FALSE
abfeeakaagmaafiecphncdbamgbkc	FALSE
afafhaimlhfekipablkjgmgaallnam	FALSE
agglaalahkgjnfphffnmapafkjgoj	FALSE
ahlannaoalnapokbfgolfeakkmaob	FALSE
ainoiaihiohgaijkakeagkoleadak	FALSE
akeneaepoihfgaakmhaagjohgilpb	FALSE
aliemjgakglapalhenhakinlogabaf	FALSE
amlkjmjggalianoondejmaiaahaoao	FALSE
anplffoijghiakadfalljkeklahna	FALSE
apakplleojamepkfmoeacpioagaadm	FALSE
doaohkmelpphaanfkkekpaaagbemi	FALSE
eaenepofajgleigpokahelahdaaaci	FALSE
egpboeaaaapfjilkahaoamplhhjach	FALSE
emjaianlkdalapjaanmpnablkoldif	FALSE
faloepleooaimkinoaaapmmapnkik	FALSE
fclfmajanahaagafeoadejmbkpnll	FALSE
gdglajagahaeahlejpnehaghakngcc	FALSE
gfeafkgifalahkaoljhajeaibgifa	FALSE
gkneapnfiaenoeaaeaneeiljkaebg	FALSE
bamaafammfakhahoalblhdjfnigdj	FALSE
hkkehkaakaajjmaoacknmljbmfdme	FALSE
hkaaphfjagahaahlofohjchhbnbfk	FALSE
hpfaahhhgiankahkhnmjihahhmena	FALSE
ipeeagaipalaomaaofnnolpdpalnf	FALSE
ijhainaehklalpffnoaajoadbmnjc	FALSE
ipgnhgdgaeejaakapmgaanjiakhge	FALSE
jenoajlnlfjhiiaoealllfaaejamc	FALSE
jijoaglgnjliaihaajemkcananlbg	FALSE
joaagahmaiakficepnnaailbdllmfn	FALSE
kajjaaiamoakmacbobjbngninhjbo	FALSE
khpjlaaooaekjhodalepiakjpeaag	FALSE
kohaipkgakhajpamhfkhjakpmfnha	FALSE
lanaangconnhlaanjigfabejjjbgc	FALSE
libnhamahhhneaaagaipakcpbjjla	FALSE
logpappmpokfaamafajllmpagfpban	FALSE
maliahaemgdnjphaeaglaifkmjfana	FALSE
mihaififnlmmakeiknhafilmjaaac	FALSE
mopaagalnkkajnkemmnaejlfadofh	FALSE
neajmladaanfaneihoeeokiaoalen	FALSE
njnjlalleahfgaaamanhknnbdonhm	FALSE
npjkonklaajamlaaihahkblhohamm	FALSE
oeajanhohpnmahahaahbanegildhj	FALSE
ojaffkaalaaemleehaipepbbodkbm	FALSE
pbhapaoageeioieklnimaoahhaoajf	FALSE
pepajkebheaanaalfaoeiagikdhnkl	FALSE
pkgbgaagaaeiipjangfhiiihaaipoi	FALSE
