aaabacpgachhpfipbhiljmbkceekfjp	TRUE
aanggnipojplogjglhlflajeejejcbg	TRUE
afllkikkoejakijaooikihbghgjokpc	TRUE
ahpfhkajpojgfadkcphkabjpbpndphg	TRUE
akglaakgjmmlnbbeokgiabfjdcbdpca	TRUE
anaooafphdjjlhhlogombhplkdjilfn	TRUE
eaahjnpjhfkegjeflmacoolifmkmnio	TRUE
elaanaeoloflfihklblhcapflfapiip	TRUE
ffkakapjeaippiclpckdflbamodomdc	TRUE
fpgpfhhgjajaikiafdpbbnjphbmcjbd	TRUE
gifglgimaagoghkfimaobfhfiacablg	TRUE
hapmehamalphcihkfngjnfkaphnjcni	TRUE
hlnakangafdgliojdejinkcdedfcnfd	TRUE
iggiofangajjnookajcgppkdkabpfbe	TRUE
jaaangdblgcokbihiiobakhnjldipgg	TRUE
jlamilioomihkkeanabfdmnkgjmibei	TRUE
kfikfaeealajenoomkliddnfoobbhoh	TRUE
lafggaafbpldflffcpcjoecfdjafeio	TRUE
lmeemanfnoglknlolhlamadapfklnig	TRUE
mhgpaeaklangdibgndpgmmbbcdkboge	TRUE
naeanjampkdhpkgedeboehglkannene	TRUE
nkmlklponggaagahodkohhoahobfkkf	TRUE
oaopggejmahpaecddafickhkaplheka	TRUE
omlkapplagiaopnlnppndhmobieckbp	TRUE
pfiakpoamajocmpcachajlhoppkppom	TRUE
aaaajmebolklnibijcjfibgofmaeefi	FALSE
aloanemnffpdheeeaobjejehmejpodk	FALSE
benlilbjangaiodpebfolfcekmmhbpo	FALSE
bpmejicgmpdkfohoieabpfbpbilahne	FALSE
clofdophabokhkkblplnpmneebmnahp	FALSE
dgcffghnejjapkafplkikojmgogiaac	FALSE
ebdnkmcmkdnihneamdkahmbeflhilmh	FALSE
elipikkigggjhaeoilhkfbedkcnlkai	FALSE
feegllcfccanbnfeoldaaebfaopolnn	FALSE
fpaikmpndkhahpfhigfiokngjhffmod	FALSE
gkfkglbpkdbbijkbbopbfhlkcmahdpm	FALSE
hekhodocfbgchdmopkageacdeanikjm	FALSE
hoahfjjpjipggpiahoipdggmghkghkp	FALSE
ihmlagkdihcfglkhmjjohbdojkhlmih	FALSE
jbhgbkhihidmeckeoocnogknpipngel	FALSE
jlkhkpnlcpphmaabmnggklhdcanmooe	FALSE
kehihkpbpmofkggbepkiminllhfpejl	FALSE
kohkbfejhnhmapjimdneihlimkgcjjl	FALSE
ljgpmgapeehnkggbelgipghhfibmdcm	FALSE
meifgddkhkgmbiffknafnegbinbinjl	FALSE
mniffdpoepgeibgnfhjmddfnlfokmjf	FALSE
nicfcgfgdclikhhbjlingnhalfhjaci	FALSE
odbjoagcokofklnippflngckgeaamdh	FALSE
oninmloajalmhkbkeojdbflihibmiom	FALSE
pflbfcnefnbalmlhpjbcaomldfpkepj	FALSE
aaabkfadibnoalbideclimalkeekncom	TRUE
aalengjagfjnncihioghcabapdljmcef	TRUE
afkafoabnmlbpnemllbhcmiljdkpdiab	TRUE
aihgakfaehgfimfcfgnmkahnkdccmbfp	TRUE
alakkalgnhhcgebgelbanepjfhdpfkom	TRUE
ankhamadlfempfabiaebalcdedpllfig	TRUE
eaapaibjmnamablofahdafdihlojgglj	TRUE
ejllhaojahaphdlooebpimiooghdlnih	TRUE
faoiefefgiljfkljiflnjmagoeammmmo	TRUE
fogajmpgfljgeefmjaelknakembcjnhl	TRUE
gjgaapanpppllkbghkecbpeanbfhigcp	TRUE
halgahghlamojfccjhcjljnpmmbdhibp	TRUE
hmakakoiphaieepghipjgeggolnflojf	TRUE
ifnjamaeifmhokloglimpglnggeacelp	TRUE
jaaglhglfffagiibhjamfnjookhfifcf	TRUE
jnemaafmablgmhogmbejoldgcohkkhbi	TRUE
kheoikakmpeannpabolmkhklkedhbfgj	TRUE
laeplkkjihhjhgpgepfpaanemccehpgi	TRUE
lmheeiaoaflhamjlhghijecgfdgoclmg	TRUE
mfpijgiaiaailcjdpgoigfbooogkmijj	TRUE
mpfjpaaomieggapdgcokfeeengmhfgab	TRUE
nkggfpahmalahjebmiccpbelmbbcigmf	TRUE
oegagjanabbagobbcdaekbfpjfjabnpb	TRUE
ooaahimpepeanfhfchcdbknbbemmhjoo	TRUE
pgklnmljaaankibekjgbfaloomepkpho	TRUE
aabbkjckogeifhmjhkifiolffobpicln	FALSE
aiofbhbmlmbplcacoknjmahopngfojga	FALSE
bdnngjgdbbbbolnnkbolbaiccamkpnfi	FALSE
bpihfpledkfihlcjgfaagiehghjmdcjn	FALSE
ckehlopglokfomjgmppofadcgknpbjfn	FALSE
debgnmgmockfpoeigeimhdkdbdkjpbie	FALSE
dnihppjocfcojpobagcdildpohgjbgfh	FALSE
eiganmcboedikmlfabklidmcbgjbfccc	FALSE
fbjlhbialdanjiaflbddiipidgiajjaa	FALSE
flmohmjnlofcinnkmkbaikhkpkpjcjlc	FALSE
gfidapgmiaelohkdbckbimgiiahecede	FALSE
gpmlpflofflfpbppkjdfjicdljjbfpid	FALSE
hkbmjdlfakhhoafconfamjlpmpoapjco	FALSE
ifaojfpcmokjhcaaiegpkdcljdcdieng	FALSE
ipgmljengjlholklmncelppncjfjkilk	FALSE
jihjmighagnhnbgnfmgkneboomjjdhcl	FALSE
kchfamkcigkklkgllaaaajoipjagpnca	FALSE
kmgekpojohjkiekdplbjdgbdhjpffbmj	FALSE
lhbhnondacgdeigakokfncdkilapldpo	FALSE
mdaandmmoklgliammmlcklnphhnhkaoj	FALSE
mniikoefjliaccdklanjcdhgkenpgcgo	FALSE
ngfjlopnmdjejhdlkllccnhodpmlnabo	FALSE
obncpahamfadgokbnkdlbpjhbhkaonfn	FALSE
oloapeejchbkhclalkaboanlohckdjob	FALSE
pfonlnedldobdbfngbihmjkkbekifkaa	FALSE
aaabcifkppplgilibphlpahlabgjokbbd	TRUE
aalnigacbbfohencjjmhckmijmompdnoo	TRUE
afaknaepeimgildbmgbnikohgflghihnm	TRUE
aiaeggoiabeknfakgamejdijppbkpfmeh	TRUE
akkaajdbibjihalmlgndngnbkbekbpcoo	TRUE
anaookokhjnmklhmeaikmdnbcmngjlicf	TRUE
aplajkonfkfnafmlplfbpjiodjanhjdfm	TRUE
eilaalpejjklaipogkikoelfjndhejdkj	TRUE
famaleaibecegkbcghkpbhejakkmngfmb	TRUE
fofiaooiahioaibnbapopjffdlaplebjo	TRUE
gjahkafpmafikegiidgbkchilgbonafbo	TRUE
hapoimfmhoajjllheadfefggbalegocka	TRUE
hmplplphpmakmngkaohpoopljlomknman	TRUE
ignlaalkamekjfdofedobfecefoachanc	TRUE
jaafagmlohbeioninfdnhjejnpklblilf	TRUE
jmjmkjgklnaljaadbficpbgibagieilgk	TRUE
kfmajfknaapckcbmkcokkbhhnehjbligl	TRUE
kpainhafknimkheelakkndanehidnlcad	TRUE
ljilllanaioablobkccgkhobmajlbccka	TRUE
malplpkfpaanpidppgiookkdhdhleaibp	TRUE
mlfkhngkgaaoapdeoegpjblibamlnoomf	TRUE
nfoamamaimcdodceebjkmpgdapblkbhmp	TRUE
oaanpglmnopappifdcglhloffceeengjj	TRUE
olffpahiagpmjalfpjbbbkkfhddlonfpi	TRUE
phiigaenfmkamkggfhjanpnfhihiehejf	TRUE
aadgldohdkljiiiboopokghapcfoophph	FALSE
alfoegjmbocndgoddoiagodffpliajlfb	FALSE
bfjkjckeehbjaggnnibljilecanmgfbpp	FALSE
cacdadcknigmdlbnhlnlablhbjfbdnfgb	FALSE
clhkllkbgkajpbgijjfpdhfpkgppcdadm	FALSE
ddmlfelnnoigdfjepfffinkgkikjekfof	FALSE
dnijjnikejedeaonfedhanidkiflagidi	FALSE
ehehafpjdjgmcbcnecemfdakehnipfbdi	FALSE
fbjglkglbaljlffiepgkgpplcikokadfc	FALSE
fmlggofeilkdeaofkmbihodlbpeefknoa	FALSE
ghakodnofnbnbnjbphjmagfmnlnkmjcgb	FALSE
hbfpdecikhlndblfcdkikgebgailbnepm	FALSE
hmiffjdapnjbcnibkpljeeaghnhlhodbh	FALSE
iglcdfgnmclnkpgfaflmflmclhglpgbpn	FALSE
jbmmjohojppffabahioadkcnimlamopee	FALSE
jmgfjlpheocnbblkpcimmoadckjnbjelp	FALSE
kfhjklceikdkjbhkgfallakpnhfebdpcp	FALSE
kpglancjkiflplibohoehkidcfhlhkild	FALSE
lillkoandkaejkmocccbiojaiicbdhldf	FALSE
mcfhcacihmdndfegnobhaheblkjkdcgfa	FALSE
mmdggfhmpdnkpimicflciihebjebaphpm	FALSE
nfofhchiacjkeejgafmealoamindcflen	FALSE
npcnhogbjmeimijagdmoljdhobakgekbl	FALSE
ojkgmlcnkolkgoididggicaefcjhkldab	FALSE
pfgbmlfffeammmbbllfgknkfggfamdhga	FALSE
aaabbdbooiigkiaicdhjgfnplkgjpmjihn	TRUE
aajlngepabmblicfcgjkfphfojjoenekcg	TRUE
aekjaekghaecklhadoaogcegnchpbaefib	TRUE
agkhfajacmdknggkhkaajgmcehkdonmjkk	TRUE
ajaeafgbaddicohelgapnlaeinadphemec	TRUE
alogfaglmaidjabdfjchoocgbpaobldlof	TRUE
aofaffmlaojcdnfidanjfmblhdbdkghfng	TRUE
eagoikaalpepmkfihbipnknlkbhehkfcbj	TRUE
elejjagapalkjcadbakofngkcgjpgiojmj	TRUE
ffhmogaaphgjkgabfhkkfecgboicoonfbc	TRUE
fphfmgalkikjpjmkanaflnlcmlhbnnflei	TRUE
gnppaepmaojagemhcnfndjkmohnaidkncf	TRUE
hjggopjikhfkhaaamgglchcaaijoocogfh	TRUE
iapjnaanihhhgpchgokgmbhiaecbhemdia	TRUE
ioaegoaamjjhpckmpcjfljfkbidehakeoo	TRUE
jjeaomafgjjmkapfnneolbpgamkpbcmkjl	TRUE
kaooilppaiabphcpdmbcoejllfoodelpej	TRUE
knejoampnhaapkjmcggpnoebdakmjbaokg	TRUE
ljaaamifjcleklkdmooenhllnoojgamaap	TRUE
mapapadampogenddilaidmmganfjfbjhfb	TRUE
mnpjajieikmmklopnpappikfnjkjealmoh	TRUE
niaeloalgmniaholgmcmbpkjhpbphgnhje	TRUE
oalnpahpaeompmofefjbjpomgeecdanahg	TRUE
onhpannakhahjleghodjlhieiijlmgamke	TRUE
phjphgokflhpoaiimilianpjapchiojhgl	TRUE
aacchlpbmkkmjdnndanjoekjiodhcfacmf	FALSE
akjdppfonlfjnahdmiedckbcagheidcbgm	FALSE
bgjlmgndahcdonffdgknmpflkgffgdndmn	FALSE
caabkgmjaleimocbckoemaoplgmppiifnb	FALSE
ckijmbgafigcbonkeodchmogaaabbbjdcd	FALSE
deonogjklpncoffbpjakehpaccbcdnblhc	FALSE
dohmblcagboineenjiohpnenplecdhplpl	FALSE
ehehjbnihfkndjadefojmbccdbgpbbiefi	FALSE
fblfpkaojodilffjdneldgdmielkighemm	FALSE
flhanijhihommeedoemjagcchjiihpafmi	FALSE
gfcckfhfgbnopngnnbahkgccaejcfefphp	FALSE
haobdaphclfbaeknojmddgiabeohommkgi	FALSE
hldemlbbkeblkipedpipkjbhihkibfmlmg	FALSE
igakbnffachbhjnpklbgacgfdlbhkjpgkm	FALSE
jaaopclgmgkkpcbhiokchdfgeppecpemio	FALSE
jkcbbpkpjammmpepekfhogbngoinhmglan	FALSE
kemcfikmemnnadkbhpmmlckjlbkfbhlbai	FALSE
knnhnleabdjmhcmdaldaegnhaedhbibjmc	FALSE
lhieclolhebbpeabnbanobmjgjhamkpeph	FALSE
malkoemadipcnmnnebegbojccmkdnefpoh	FALSE
mkfopnjpiihfnmafogjbkeagdepcebhkpd	FALSE
nfaabiebddpffpejhhkpgcbcdlkocpppmg	FALSE
nplbhgclejijfjkcobpmkmfociglhbjbfp	FALSE
okifknpkdopabjiiambofggoecpeclabcp	FALSE
pfhnbppladhinkkcfdjlnpmpdhnppmhamg	FALSE
aaabaimaonhnoilbcdhoonacageiihnabbb	TRUE
aakgamhhhckgpjbhacopldadhfnldpkhbae	TRUE
aenoanaekkdneboojddipaejonbgmdffmbh	TRUE
ahgnanmaonbjbdkffiacbgboendmiggeofe	TRUE
akapgenanngbfpigldoilmlbemgjppaedej	TRUE
amlappopamcfmdochnmlfknbbdmcngappkj	TRUE
aoomapkfaebaomdapkgjjchjdebbgkedioj	TRUE
eglemnaaanocebpgiiapjbngjnjgkdmkpko	TRUE
epjniaaacalidncmmimhgadkagejakbkiha	TRUE
fjgnaaajdfncelicbklndanflejgpkefmlo	TRUE
gaojpfjapknlikiikejnpieeiamjddoanoi	TRUE
gmofoifmkpkjpoeapaafdoikjclbjnhhmnm	TRUE
hgnjjmgnpnikikphlpnianhgmfkaefhkajk	TRUE
hpapaamfhjkngleichmeodkhnhblfgkikoh	TRUE
iiangjamplahkcahokjnijokdhfhcaennpl	TRUE
jenlikoaipjaanobjinghimhoefecjjbalk	TRUE
kafahapfcbccdllpfkfpoapffepieiammhm	TRUE
kkkigaajkmpnpfkelamlciaefkinonanmcm	TRUE
lgaajamohjmpjidojbknkioaebngpbancec	TRUE
makiinfaeaeeckkhjlmheeiggmpclcfpond	TRUE
mmanjnfalmhjangojjbegjbebmjgnocnihb	TRUE
nhnfhalfpjagaiffmgbfmpebimichfhilgb	TRUE
oaffknaabfjaidnjkmnjinhanjocfbkicha	TRUE
olgfapjaiadmdgfafjdopgpcnfpmofpdlfm	TRUE
pgegaanabniobobkllndinckajeahdkajmj	TRUE
aacchpdnihfhnlnhacnfkeiggpgohecndip	FALSE
alkckgnpbkipddmipjpeiddmidpohiifiek	FALSE
bffignnckcbfcmjjckheejgigmiklmkjkoo	FALSE
bogbiablblfhkbaohnapokmicbjdidepbfn	FALSE
chpemgkfacbcdllabilccmocblihbfhajhl	FALSE
dcafnminamepabpieldaageooijemgddpen	FALSE
dlfhlokopcjhndgbcdpbipdcnlhhipbbgbd	FALSE
edfafcmlkcapapfdojghmallbkoeleifija	FALSE
enmakmppacaniobehbihmfachnafejdopjk	FALSE
fhnboifnfefgkclcdeebimfalcjklfomiaf	FALSE
gckcfdkpjbggimgcalkniljnaicdkkfioka	FALSE
gnkkejpgnnbbgpocfoflmiihnjdfcmfnlgd	FALSE
hjjfmdfopnlnokhadljeppifaehjhnfoheo	FALSE
idldjdoakmiomegkmclmkfdebieghbogodk	FALSE
inidleaggamkdcgigliepbefhenoakjljda	FALSE
jinibgjbkhnegbbnlipfkdjoejbjjoiikif	FALSE
kcdahbiclfaeflbibjgplpmjimnpmeogdmg	FALSE
kokpbffipabblnhkggnhkdokoobpecphkdp	FALSE
liliomodnbdbgnpfcdiofmgdmgfapdphcel	FALSE
mddjglfdbjoojibckanajndanilfflgmmge	FALSE
mnljhlfcllmibccfncodkddpaobgancfggc	FALSE
nhfhjmdjdmmpohpooenolapnlcmbhhbmjcf	FALSE
nppppadacgnpgingbmgllgghaahcoonddaj	FALSE
olfaipjjiokalmeaonnmjaajfllnjbkfeig	FALSE
pghblhifndfhpdonaioodpphaaglakdemmc	FALSE
aaadjfddhjbamjiapijbgnjbbgooagiliddn	TRUE
aaliabegpjhlpmlepeihfjokmifookmjnkpk	TRUE
afhaadhjlohfcpmhibkafjnbppgggokbfacm	TRUE
aiighjapnfhajciicnmkblcickoopbhkaikg	TRUE
akmanajioilnicfceakjlifhjdoeiphdmoab	TRUE
aoafojadjbaoklbkgjmegnjolgcjbbdblfje	TRUE
eaaojgeabanbdnbmcmjjhiilaeglokpfoabm	TRUE
ekkakgoalleagpchkgcbegdfeonlgonidokh	TRUE
fapiijiafgfhhachmflpjhaephecngemgmen	TRUE
foiaaalhkkkndbkeonokdjnhocnaligciflg	TRUE
gjjmkfmeoapiaapdkkdflgbkadglhjdikmnd	TRUE
hameolaipmiaboafaakcppifcahnklcnmlga	TRUE
hmhejnkfiaemnalmaoimgdamncmbjfichhgp	TRUE
ifijmhkfaopkpaiadlfeaoboaoacgdhlbcik	TRUE
ipimajappladmaciabmmicikpjadefeaocnf	TRUE
jjjehoajaohhaeblgbmcoehghmfpccfpmeep	TRUE
kehmheiaemnmgkiaandnlbjlkjdahhiknoaj	TRUE
kneagfpjkjmnfhkmleaofefadkeipllnegap	TRUE
liemlaimnopikjjeaigfjabgmjoinblnoiil	TRUE
malamhafdjohnmioipoeccjdhkmdkomdmecp	TRUE
mnjfeppaoajacagebnmfgfoiaobamdjbcimk	TRUE
njalpkkapkppmmikfalgdpbblkndfomopldh	TRUE
oeaanpgmlfagmgfbffmehohgejoblgineeci	TRUE
onaaadpklnbpkkmgpohglplkgnpkpchpmblk	TRUE
pfilaomgjaafcpmjfnpmmdheppnbkijoakmc	TRUE
aadfpjbgbbomnnbmenoeoamffgpnpkhhnjel	FALSE
akmdnnkmegkhmehogjgebbekfehclacnicha	FALSE
bfofkeajlhkkaglajohgchlccfbhlcgnkmpi	FALSE
bpkedclofejmbngdgkagaecjaladhligfidm	FALSE
cjkgoinlpnbmaknahiklchpcgampfjiogebd	FALSE
degfbpnjndeloladocdjknpnkofadobjhkmg	FALSE
dpfjddbkpknbbcgfgakepbegpmfkmhmomajo	FALSE
ekabgbakhfgikoelgebeoinlgcoekmmcbghe	FALSE
felgcfkpdjoohliklfjbfjdjbpndcbbhjmoc	FALSE
foimbhplaegbdhfbcapieghpgcfgflmbjdnb	FALSE
ghkkofonpplhdnpnphbkajiniaoaficfhmhi	FALSE
hbkpacbhafdgehmhkpmjdjjaekknmlglhgje	FALSE
hkpjnlpdkoaopnfhddhokdfdiocpbmkfcmob	FALSE
iepkmfegjioeheccbbcidainhdhibbnhgmng	FALSE
ioeiloambklabbcaafcennmnecdkcjgnlacp	FALSE
jijbjkkighicjojomdkaalipcojegikgiaig	FALSE
kediijjjbnhldkmifmhijhaomepmccjkjldo	FALSE
kngagofdlniedpekgjldimcfejffhjojmgkn	FALSE
lgplpdpeadgefidcilbbcanmachodhniignk	FALSE
mamfbngjngpklkggaiaendlegaifadicljpc	FALSE
mkobbigbfdbomibfidlfdnknamfbfoiebpdo	FALSE
nfbabmpedgijamkaicdakchelaeeolcgocho	FALSE
oaiokpmlbbfmcohepgjabppocknbeleapolm	FALSE
ojgpcjnkalnbcjfeiaiiclejjaibaefkdjmf	FALSE
peeeeejikgkhhadbfjkhijdkadojoinkpipb	FALSE
aaablamjimcdinmajiajdibppjcojjlmibmgk	TRUE
aalgihjaflhndjhoijaobjkkajaebbejghmio	TRUE
affmhlajipgilacanabkelhifgfjgihapmkpd	TRUE
ahljnoiokajakhcfmnppkajeddelnjlgmfbdc	TRUE
akeenomlilfknalmhfmiaicglnbdlfgijaiml	TRUE
anagflnjajcfjnmcnegllkfoakapboehceomm	TRUE
apmnapaennbdkjojabbpfkkdafeonopemjmja	TRUE
eipaeahghpakcmikppkcbolkjopdjnfgohgbh	TRUE
fajamokahpdkijfjepndeapjfjdojmhfifdmm	TRUE
fmapnaefoacjbeaeaioboblandaefdkepdilg	TRUE
ghjmopennnoaahlomjgegmfemkeaidcjgoibn	TRUE
haihhopmlohplnkoanacfmmemgmafanfbjbaj	TRUE
hmlaaeajjmlgclpccepldfjnidajoeheghmjm	TRUE
ifljkelghnmjpmaeapailfgmddpnoaedoaohe	TRUE
ippejpmahlnkhaijffggfacelkmfnnlnmmocm	TRUE
jknaalpoeoagodgnfjekcceecgkfkhfmjmmhl	TRUE
kenleplhjgammjnfepogoplamaiohngpjoloc	TRUE
kpmfahigkileahjopabjclnjoaoijjkefdidk	TRUE
ljpagioaioppoaojdoopfpnohedkiighgfgkp	TRUE
memajfpaahpiglpnncpjgmkhdljdeameohhco	TRUE
mnlagmefhmhlfjmiaagobkgapmembpihfnghm	TRUE
nhhgiipigipgeakaahfdomhffnmfmfapipoll	TRUE
oafmaoplahbfaakjkohgjkjpgjicihjjghdjh	TRUE
omaajadaeialigppenedjekjdkeachofpkhhp	TRUE
pfnefaaoggpempagnnbkmhocfpkbnbpnahpkm	TRUE
aaaefonjaolagnnfieojdindemhkafgiajjpk	FALSE
amaebheagmfalkjgadcdohbdokmkbljojnigm	FALSE
bfndggknlbgkobcdekcclhcpdofiokblnfmbn	FALSE
caggbpfhbblpbookonbcbldipgkkcoipibikg	FALSE
ckokhloidmijmlkjkadldoiofcneplmigmljg	FALSE
deofbamoficbadnpgbbbnlpldhokifnihbdgd	FALSE
eabmoopebdbmibdbcdookcpdhnhkclnklheho	FALSE
ekjjjnbfompallgnlnmmfnelifhnkepedejpc	FALSE
ffhbhgoaiilfkelbcanlaadidihcgecpggiab	FALSE
fpehcfmfpdmobgagfbblomjhlodeilimlbaod	FALSE
gipbpobogdppjohbjccighcdnpkafeffbbddo	FALSE
hedfeckccafdjnplflpmhkbffckgpjnfmnfbb	FALSE
holeokmgpdioamdkjjonndlkahpbmidifmnpb	FALSE
iimkhlaafdeijmhajjofdefbkdcgdedkmehoh	FALSE
jdnmdiopkcbljalkiioeclebbeajnnpnnhhfn	FALSE
jnnmmepgmhllncgpaomhjnpihoigpnfijkafn	FALSE
khjlogppcmcblekhbedaiebomjdpamlnabeoe	FALSE
lanaenpdaooblmckhffmkdlobehcnhjidjamg	FALSE
ljfhppgmifpbcnnfkbjelbmoibejdpecdhigf	FALSE
mdgioiggkfbkeepblhhlhnidllofnalpellkb	FALSE
mmnelhdfdlngoopkjollooijlpmbleblpchhe	FALSE
nfmdockhmdblcicldncchhhoehnpdcekhngik	FALSE
oaeflobommmhpkdjbifpbopannlbafjcfhlgh	FALSE
olliemlgackainnmjeobnnoeakndoglnbbepp	FALSE
phhhjdobkeojecdkcfjgpdolamindcgckldkl	FALSE
aaabkcmefpbejbonbcllpacjijgapomdlbhlhg	TRUE
aajacniijmjiaipfjcbodmmlhpjkchnihjfhhj	TRUE
aelaijaiklckmklemplocncmhddlmikjnfjfib	TRUE
ahagehejajngncjppchlbjkefglhpfgjlfjhoc	TRUE
ajappagndkhimefmjcfbolmjogenhbhmkibppd	TRUE
alnpmahmeaoendjmkoifdfknfbbngjeinlffmm	TRUE
aonmanfmohfpphelacjbmkfmpeefodaghiegep	TRUE
efnjkkeahkaakihekojoknfndbbagmjpgogghb	TRUE
eonlgklnpaljmlakjfaooocanohcbdejhcgbla	TRUE
fipegopikaaabkbnmlloocgicehcbomociimcm	TRUE
gfeahakeiaihjgkjbghlfdhggpgicjplpjghlm	TRUE
haaakccnaoilmfcfcjhogifpckaipdjeoofceg	TRUE
hiamnkapiabpamdbjohoaakpdjcichladcjbdm	TRUE
iaiaolmpeeepadcecjhgnbjiamaiflopoegnej	TRUE
imenieojjjpleaeaphaghpgkflkgofiigjekci	TRUE
jiaalojaemblhikfjllchdbegckbjddepnlgkh	TRUE
kamjkamjkljfeaooleomgmldjkpijhbgaejmnp	TRUE
kneeajaaecenpkhapkjcekcapemhddhkhdnpkk	TRUE
lkafggmlaeahnldjbipnigkgbdmkiofhglhokk	TRUE
mapgaacoikaiidcafikeikagodidoigpnpncpe	TRUE
mnmghnlpagjgaahgnnjnkggdnhgbkfkcjgiecg	TRUE
niklepllfgnhneaihakgjeadjjiibkeoombgdm	TRUE
oaknnggajiemagmjobhfghojfejjhcialnfabd	TRUE
omaninhhhnmnpoehlamaclgjppmnchknjeclml	TRUE
phaafpackbmddakpcchmmfpjpgolljdnhalade	TRUE
aabbndnhhlpajjbhmapgdchmgeeiaoohkjhhii	FALSE
ajpacdjlmhacfdiaojaojaanilljpccahllnhj	FALSE
befgnklmjlpiadobaompedpmkljjdknfgdcmjb	FALSE
boikemapdcnjlgilmkkginkpfcknnpbelfbink	FALSE
cicklpebbappbbmbcmmlmmjnfigbgljphlmfib	FALSE
dbomodfdfldnbikilckdbcnaeaicmbgeonhhdg	FALSE
dlfmnbnikabicmbjlacjldkbknndjoiibkcfej	FALSE
eeanecfgglmhbdcoeakcfdgelcigfocckkjbba	FALSE
eomhgaacefkjmchmpgfheaiedbenjjcehdnmao	FALSE
fidilodkjmfiegkenobafiebfjaaiegiojnobg	FALSE
gbolhgllcaofblgjddngfoophmiijhpfaakmdh	FALSE
gllbhjonjbbpdabchmpbpbokcphbooklgbfbpo	FALSE
hfbgfmipajaeghpdbdmoccfcaioefpfpaibpjn	FALSE
hpkpmlfoefibbflfdbfdmahmdbgejcgdphlahk	FALSE
ilhacojjjlfcgmpdpaemalgfkgdbaobheimpje	FALSE
jfdpaaldkhkgnjecpljgknelcpfipklemikioc	FALSE
kaebfpmgjbefbpdccmbiildacbgiafihlnpdpm	FALSE
klimdbpokmkdpdobohbfhoepfhnaaiaapphopd	FALSE
lgmlbabjmiklogmckbalnomdchgplpfmejoccd	FALSE
lplioffignnhccgghjidemfmefeailfahpekhp	FALSE
mjgfkclhlalhihaoclfggiiokoanghbokahgkj	FALSE
ndmobjomaimjldhdmmbnejfbeelbaclijgolbd	FALSE
nnocdjjablloiffjgpfcnlbllaapiclfefnhkg	FALSE
ojebkcmamdmiadpnknlbaiadmiejmbkhjcecbe	FALSE
peofhhknlghhjmnacijhiejjindloghefignbi	FALSE
aaabbielgpklampaajnllfphchcbpcclhakkabm	TRUE
aajjpjiejeofgadopaohedpkhhfphhkdlpjbkep	TRUE
aenmaablfkmmbjfhebkkhhkmpiciefnphefgfbj	TRUE
ahkajageflcoaciilbbmaociepfecelabkcfpkl	TRUE
ajmpjkioanffngahjedjikgdgempminlbcnbbeb	TRUE
amfapkmkfkeheaclagingcjommlagdkmlmgghkp	TRUE
aolknimkgfplkhoaifpfjafljhobiodfmddmaag	TRUE
efjaoannakgpeboamcojbkdblmkhnpmgggkoibp	TRUE
fagaeaijknjbjohjbejihhhclminajpibjfpmjo	TRUE
fnaiofflapgggappcicocdjjmbphpcfkhndhiag	TRUE
gimnnimieaeaadnkhmcecbajjglfpdgnaiiehfm	TRUE
henioagaijachgdocacacecimhknmfhjmbopili	TRUE
hnilfaahjaeicebbjijhfpdjimhbminklpmgbko	TRUE
ihaoelgaambjihhpooclhdhpngiemjccjglgiah	TRUE
jaehiaimffonajmbcagbbjiocpkbocegpoikpea	TRUE
jkoaiiaajeehflcgdfcabhdgedfnhfihljnikbh	TRUE
kapnehgmjalnaihmekbifknomcbkhofhhnlpoof	TRUE
kmnjjapfhaflabdjaknkfikcgmdkmghomkpfell	TRUE
lhpflepmahhnjpapapccnnadbdngolpknemamig	TRUE
magamkajjnebmeeligfpbfdlndjjgmopebhgfdd	TRUE
mninfaigpaanocaoinllliojnjpjdmfjieibhij	TRUE
njaanlnfkomnioadhlokpkkfnjdekjjihmgdmcj	TRUE
oalefmmaalkgdmbfffjehnajandeggalnligajf	TRUE
onflepaajngafpkoldhomckimfdelhambjedkhj	TRUE
pgiapaighlffghanmopphnnmbepbhjcjneecedm	TRUE
aaeocobbpnfbmhpdnigmobibagbfeplnelalbil	FALSE
alchlbjmcoilhmnpajocgfipkibhpofiblglfhh	FALSE
bglenjeejknbocegljmhendegdjanalcohpcoko	FALSE
ccbfbhonmeipdhhegpafeinliamfobaadelpldf	FALSE
clkibecgmplgkoppkkaijjommibdgnklielfdfo	FALSE
dfofigghnmkkpmaelgpngadhhdofifppgaekknj	FALSE
dpgemgajjadkpdhkheonoebmoogkbbkcnlpalmp	FALSE
einonhjagkcofbjnoegcdopjjpnkgcbilcmfbdn	FALSE
fcphgmnpkifnlcogfclelnkjmiopomdhjjhkhgp	FALSE
flgpjdhfefdcmpakidlijbcdijhnbonpdfalilf	FALSE
ghjlmgffchhplfafiabopenhckonndmnjnmcmej	FALSE
hccjklefnofacbcdmaljldjgkklpjaodmbhcnmo	FALSE
hmkjcoddohlhiblkmpinkmedfpeddflinkakmjh	FALSE
igpbglfcbbfhhchaaicbipbjcilkcndjlccfppb	FALSE
jafadmfmegmohbhifchdaoilkjiiemphkngcgci	FALSE
jjccjhhfgfdlhlnhfoeldkdgoinfddgkockamhl	FALSE
kdhgdlfmljafdjnbfmbknabjpagkabanciohibd	FALSE
kodfflomlkjpicnmblaacbaihfjbklkdpfbdjac	FALSE
liiiljgdohgdcamccemjilaoghkpgbkpjbainpm	FALSE
mdenbehmdlkdnjifflcnhfgcikpjciccfpcgbgg	FALSE
mpcjipjldiaiekdibbjmmfbedbldmeampbliini	FALSE
nkebfmkinhognnfjfmiffnfphipnflappeimfhl	FALSE
odnefkihgdcanmbmbkdogggbmmgfbckgbicijpe	FALSE
omndhbdpakanhghefmmpdkbhkpjgolngbikdpak	FALSE
pemdmcgokcckhpfgbfholjijopophpbeohhfpgm	FALSE
aaabdbgofbbjkfhfaniopcgjcdpelohdkccoiefj	TRUE
aakladendhblpdoipifhclhccblaaohgmnnclola	TRUE
afgpgjamoeinjaondljijboleilkhpffiknnoonp	TRUE
ahlkoakkakkgpkkmijipcfficdafnboimiachhja	TRUE
aknaeealphdecegpbmmjkglkdblehmmoidofbndo	TRUE
amokgfjhaepkhaonblbceanambiimecheglaaeif	TRUE
apaadghpddcmbgfdicpnifkihchlcmfdolojlnhh	TRUE
eikloafiphaamhimbjhnhmnedfdmfohikcnknjed	TRUE
fagjpnagoaedbnhhkakibpnfcmijfmjfjjaochde	TRUE
flpfaehgaagjkpdjlbpkbhpckaiceikkodfdaggh	TRUE
ggajgiofhalalgdehbdjbndeffamcjngppkhagdd	TRUE
haakaggjonpfjefpdjoinkpnpamekelphgpebngh	TRUE
hkheopmanjnlmaabfahipfengogkanhhdgegmmpm	TRUE
ielaalngkhlpgklajljpjlekmdoamgfbehlljaap	TRUE
iohajkjiapofloanbbghciklloipedgjpabakeaf	TRUE
jjaajkfamhcemmpmnbckbillbnjkemnioajhjeam	TRUE
kannhnaeeaookifnefjdphlohmhljnnmphofgdod	TRUE
kmhgpnjihaehlagkkfnfjabcdiflmphgfaadgdip	TRUE
lfggjnffgjjnmiphlaojjaioijacllimhfcmoihe	TRUE
makkpaahfbnmoedoecjbkllhpomjgjhomehokjfc	TRUE
moajaaoliokddfaocajglmggdldaojmjejlkmeck	TRUE
njgmooknmjkaalphnollilmameoleeeopbnnfdjc	TRUE
oagkaeolfinadijceidagpjfjlmaldbpepgfmfjd	TRUE
olghakhfmkagmoaiccankdpnkjhmdbeagcdimhpg	TRUE
pfhlpphaajjafckhfiaoljmepmndphngnphfpnjo	TRUE
aabiadffojjhocnpcbhjjdamilfpjglaakiakbdn	FALSE
ajdjlcljhodccnnhegcpmdnehjjokceecbifmmjg	FALSE
bdjhohaijglnncmfcakmefffajjfigkniccghcbn	FALSE
bnhkmjheelkkhlmkpdijgobjbeafipfdeplkdjao	FALSE
cicilclleeakgigffnbochalencnddcepjfekeoo	FALSE
deigpmdkkggokdjmfhpgblbofpaemfbhhcefckac	FALSE
doaeciagadifmidejiccbaeafgmjahohkmfmdhfn	FALSE
eiifcekblcmjfgigmjiccegoggjkcdndhokejpij	FALSE
fchjmedbgkfeeehkhdjgmfeempjngjambnpbemfg	FALSE
fmciomopehpcincgedopabmpbbkjfailcmfjhflg	FALSE
gfemdknelpbohnennigbongahlamllcdmchfgfop	FALSE
gomhopodpmcfhappfbdlpjnfdfhglfapidljombg	FALSE
hjknadiplfiohdboafoknpkedhanbmhcbclefglm	FALSE
idnlbmcicgaiacahaieolhfcbjgkdajikikpkfeo	FALSE
ioflgjnapigmdihfmionlncgdfmnjhbgfhodjmgl	FALSE
jhkeoallhiebkecafgjdmdkgdefmgkagdkbampin	FALSE
kcoamohlmpnaepkidfdggepfcihmnkkbegifipic	FALSE
klocamenlhbhfoendfehcfoclcoggjkpkkdlgcoc	FALSE
lfhcgfhmogiobmdmbbdonobakcpmdpgolcbhdfkb	FALSE
lpecmchflddhcbdoooeafhhglcgbcjilcaojmceb	FALSE
mjnfcmcpjilfnnjojblobafmaopjplmcjfpcibgn	FALSE
nejimljhljcmjhledmhoocmlnadpagogmfppkfgk	FALSE
nplndekpacehlgdaomdoimeppgaofjkepdogflmb	FALSE
okfakilnigmadnoekpbanjkkepgajbidaaeilinn	FALSE
pfibhijedflichpbcpabcidokhdnblimkignkbme	FALSE
aaabchcnjpngmbleicpfacnlapaadfanoipkdafbl	TRUE
aalaoddnjiifmjcajpdkhjahocoelkcciidobclcm	TRUE
afapeadgeihongpfhlbkfimjkpjjfpmlccpahcgfh	TRUE
aiaacjgoffnpbimckbikjamdphijpkcebhoonljfa	TRUE
akkmaalpcgjdajkkgjdcbfhnanegbmpkmhbnmglfh	TRUE
amphffgklfjfafalobagbmpjaghjmoeneojmdaeik	TRUE
apjaiaoengbcapngpjdkkilhkebeblgommkakhiho	TRUE
eikjoiafaahciekiedllmegngnkiolgmbdkiplfhm	TRUE
faehfofipillfaadlodekncdgnbgnnckpdecghggn	TRUE
fkpealnaapmnedeibllnlifoakmledkmbdgmfffhi	TRUE
gfeoaenlleeiamajkgpkgjokohcbdgbanniidldfd	TRUE
haaagcbgflojoedbgeiiipielaefolmmjokelaplk	TRUE
hlaaeakejipkjeimljjfpplclkbfalknjmhgkgjgf	TRUE
ieokajeeapgljagojlchehdlfpmfobhoicekeamdj	TRUE
ioefalpaaipfobleieabeaakbflcbahogclfoliof	TRUE
jilalaapobgkmclfnogpijjdgicceallbocmaikhh	TRUE
kaknlhffaaemmocekfanmcbofdoihdkcmaaijdgia	TRUE
knlamlaankceeajjngokfibdhbejnikmaldcpeilk	TRUE
lhfkmheoahiofjaeejoambbgcoallankcaogmnkli	TRUE
maieaanpofgjmnpfpjbdoddhgadaadnhmfiajjgkk	TRUE
mmoefklahjnaacijcaaipicfpgdcfhjnnolcnbglg	TRUE
nhiaojanahjcnmfpglnkobphmoimegpblcabldbpc	TRUE
nppalapagchobhennmnljdggioalmehbjfpbfbkff	TRUE
okjohaaaghokgncgdmhilfokffipkepiinggofdid	TRUE
pgaeiipnllnalklabbjdolffppenajfbjlenbllgl	TRUE
aadblpeojgjijihdejcgpgjcmfmblgkpgcknccjna	FALSE
ampiepblgjflcjaedoghkhkbnhdfpnpedlejojmjo	FALSE
bgkfbildknmpbcfeagoghpopicecegeiphbbniakj	FALSE
cbiafdocgbdioggidmhedphjnppkgfapafheaojco	FALSE
clolilkdphhkmabmlpgkihmhkbnjiamicnelaaihk	FALSE
dfklokiddhcniipejbcaplbgepepalgpagbgfbeck	FALSE
dnfnldlomiaicdhccjbegbghafmganfnjkpmdjegp	FALSE
eipmhdiabmfjblegcfkfillaclfilphgffonhhalh	FALSE
fddknbgfnnbhoicdkmhkleglkkiipkopijmbdkmfl	FALSE
fnomgpddpkhbggcpaekoojknhbjpmpbehhhhfokhb	FALSE
giikacgmmbjcmpblodbpiojmhbenoloblhfaocilm	FALSE
heohdnbamadbgpfgonlkhhpdegcjpckbghoopilic	FALSE
holjljchncpldcjoiejdlcfolcoljllbkopmcilmo	FALSE
ijhifnfhcpiepblofaejdeddhmlnccnjeeodjdjbj	FALSE
jcfpcpalcohjmnpbciacmnjhoclfdhjbahbbglaao	FALSE
jmdhejhcfklmlffpecodpbgjeaccmdehdcmbojdgg	FALSE
kecejmblpifafhbldhcflpkcepkoapmbgdiglfeik	FALSE
knolnadbigpelcnihjjjjiedbldkjefmdmhbndklj	FALSE
lieggficlenabmfcbcdkhnengejmdbdbaefncpcmi	FALSE
mbmlhpiaekfhpcmchhhelclgeiajkkoohjbeppgkm	FALSE
mnekkddfdfcmbhaconhepbhjoeiigbnhchgopnckf	FALSE
nhoolfkjhdgdhjhdnopjeakokffbcoeimhompkedl	FALSE
obopbnhobbehalnioigcgkmopnoalcadekcbbmnfb	FALSE
oniomchdancdmjbkbmfoeenglfjmkeghjnffhgico	FALSE
phajgfdodcfgdnolgoooadacnlhjmapnbghondamf	FALSE
aaabfapfbefihogegkncemlmklokdkeckekbccnjdk	TRUE
aakialikheibgolpgjhblniihfocfddaadkfogeoaf	TRUE
afamafoddjeghplhdeflhcidahmlgckjcbdifimlok	TRUE
ahipkmaanifpdjebcannicepafkedckollddolghok	TRUE
akaafodlcgapbphmcflkljennadibgpmkdakppmpng	TRUE
ammgkfgkagjhgolojnflhllpeaejphhnldbfdkpnec	TRUE
apiepfaajlhdkcmnoedfbipidcoobmgkilbmeodkol	TRUE
eimgmfhhkakleaeigafjiphfbipopkchheamhbhdhe	TRUE
fammaaelojjkfilnlcpcinfldldgnjnccaohakblma	TRUE
fpaaakjccacgnhbgcpldpabdocoocagehhlohdflai	TRUE
gihnofjfjglfienjlopjgpahfeflgnlnhhaachhmbe	TRUE
hapagjleikmfokfehgaifighpnlpbhjpeecgjefbhk	TRUE
hnmonipapkoijjnfjjlajifoeabclfnkhfolfpceja	TRUE
igpnaoaakcmlfbkekafppjiaikfogcokcmcgianlej	TRUE
jaehahheijofloaldkmekdoikadlhbpcfdageoigdn	TRUE
jkmniaalgfogakmogbecdipnoigkmhpnilpooiklmc	TRUE
kefhjonelaohalhpepoeimejpgeahbgffhelgeokhb	TRUE
koakeppgnlhhahalllibfcadaccjndhgpodomicahh	TRUE
lhkakffkfmioapjailleibpcmmilhaelcehpnekdhn	TRUE
mailgaanndjmojlgkagjmdafngcbdodapmcljboffm	TRUE
mnahgnaeffmamocejbdnknedemcomlnaaojmomigii	TRUE
nhejpnmamplkpglgfpaapjdogjijghkejhimljcacf	TRUE
oalfiihaeahdcnhjknmpgdiecnghbfigcjebdlmggp	TRUE
omfioafeppnaafcnkanochbmkehgjfncihbnacjbmh	TRUE
pfngjhfinioahafmokakhedoceempdhagmjmolhlbb	TRUE
aacboblnialcgohjdppjlimdifdibbehgkbdbempbe	FALSE
ajecidccgcjccabpcelgefhncneiehjecnnbjcinai	FALSE
bfgoicgnfkkckmheenndgafhnjoagichobkcdbedip	FALSE
caicldonomjmdojdlcnkendhpdpkpbdjchndkidelc	FALSE
cklnhfegbacifcckomkeboihigjheeaklggglpcbnd	FALSE
dgacagahpfahigobpkaockddpmapaljkmakjnchhih	FALSE
dokomaefddmoihckkgpdiikfchpacbflcandcinpjl	FALSE
eijhlkchdbejpgpflhkahjmihkeagfdmkjphpgdhog	FALSE
fdcifcdejmfofmknijhebofmamlmmpnkjfhcegiokk	FALSE
fnfjeahflnfpbcldmdfejjoefnaoaplfngbgaaklhm	FALSE
giplhbnfcbfkiionanndbfacpllhbglbcbaidjmbhk	FALSE
hdcakagmlhfdbjeehgfpaabcaneelgpkkhhcocdgkp	FALSE
honjiganeennijoklbmeleaijahnfafjpaojdknenb	FALSE
ijkhjchggalkipjphihadmnlfcjpcepaliachoijgh	FALSE
jdfijhaffphopnihkcnidicoknhndbbohjlofokobi	FALSE
jlgncpbpajlpcpnnhlnicdklgjaablojefaffkeecf	FALSE
kfhfddmhfbgcjihfcnolfanegiailnkejohgmifbbn	FALSE
kpihfpjpooniddnfiaipoejmkchbmjplgalhnkkjjf	FALSE
lkbijhbmfehhecnlhglpdajhfekkgonjfkkaehfpfc	FALSE
mdnfkgimabdkcdajbncgmhhnkdhfackmhjbhpkldnl	FALSE
mmohnhmdckpbmbfipimcjojgfgpnnnakmplhdcpemc	FALSE
nflbhfnhfhjpbggkpeanpbnaokngoahjghneahooae	FALSE
ocplljdjncjmbjfeijegkbcciicgnafmlbniljpfme	FALSE
omgcibmljdkkohgepafcgdbgiiapfkalmdoeebjnkn	FALSE
pfckdgkjjkmnffoepkgejpobmlnoldeahlepmdjkfe	FALSE
aaabdcgcgmdibjainppfljdofbkmihnfmjbdhfijmen	TRUE
aajafnhphmfkdgcpbjialnjpebaogailefmkbdgoaaj	TRUE
aemnpmfhoapphaedaholhifjmgpkapgcjjhihgfomhd	TRUE
ahimgogjaggemajmkpkjggbmofljpbdelbmleapfdgp	TRUE
akhammlfaoijpdfbaclbkabmmpfbobeikklicabaoae	TRUE
amopapeenkjipajjebbmkpffdcaciojcbkflmpklcbh	TRUE
apmhaoklnogehahmnebmobphbfglijmhchdkdamcnpd	TRUE
ejaampgiaemkbbjhojegldhhncgjkjmnopoblnofjno	TRUE
fanejpnmhkakanpejldjaidndkpmmoijjmfmfnoegmc	TRUE
fokmlihmajlalolafgdokpjckhpnhfigdielgleocio	TRUE
gjfjokjpalaeglmackaaamcjekcbgbokefokjllplhj	TRUE
hfegkfknoaekofekhfgefjanknfgppjljajjfhkilpf	TRUE
iaallmadkedhpcbjhnojpagnlkdlfpgnnmjeehjcjen	TRUE
ilfnfknhkjaiaeghkhhlakgdppeimnkaogccldckcid	TRUE
jempofajfeneeapappikmcoajkiodlnfiffpbeffjng	TRUE
jofpgnakeaiacneangbiofibdcfbikplddfibccecio	TRUE
kiafnmjplemghpfajeammeoicohjljffcdmkjdojagn	TRUE
lagmaacgalbinnbeompenpmaknfphbloaeokioofbdd	TRUE
lkkgglagjmafjapndfegkjcebjhcaomnohlnknkgcao	TRUE
mehpgkgaknjeeapemfajcacfakpfbigjmgipaenjgdm	TRUE
mokgahfiahimjabamgdaannhjndjfopombilnhaakab	TRUE
nijnpoajaeajihhmnomjdfnegojeondepnbdbaphbmo	TRUE
oejnjjamalnkmamlcjdanpcjeojbojbalgkbghkhagb	TRUE
omokomgapnahmpelkefapdmemgjbaohabdodjjkndpl	TRUE
pgkkehpmmjnopeaaieleeaklplhknihbleammpapncb	TRUE
aabdjkhjiidhnojpgenbdcginmgopgfchnkohdgbgbe	FALSE
amfkafdlccpgeaehdepkfihgakhcamildnhhecgkgih	FALSE
bhdecedghcmdijiaankbkcheikmiabeeicnahcdjahg	FALSE
cbodncmbofnnhdkhiihibkokbkalhknjfebloelcmch	FALSE
clemfhoiakikdbnnpjcgccmbbigakphjankmglgmoof	FALSE
dggjgbmgpekcamffnmbjcinenkncoopfkokicmibkfm	FALSE
eacknphkhajppeeekhhkppameeajcglpdooclmapohm	FALSE
elgbholapecaiblembgdlipdpgechgabpnlggilbljd	FALSE
fejcopdcgbdhonoldfhfgndgnepdpeffggdbnocgecj	FALSE
gbjmecpdcbfhdnohekofokjgkogefjojbglcfkaeabl	FALSE
gmaioegjopipakndkmhopgggfedccdbajmlcjljhmkk	FALSE
hfaahoefppnjpegegfjedpoigdpkhcmdmiabmhdbjjj	FALSE
homflpkagilpkpejgkpcbdlkcpfdbihhdlnkfflfmoo	FALSE
ijkkebjafibonmjiilifkfpfffmmpcccknpmdngncij	FALSE
jcmmgigdlcjmplbfcjhocolehhndmibcdngnlmigdob	FALSE
jmgejjahbbmajkclplgmmcacejpblhgpejegaifdkgh	FALSE
kgapcfkdmbdcdhkeggnpdmellfggdkccohbeeehhapo	FALSE
lakcbciohpoojoecaiondbjbedbifcbdjdfmdoefpgf	FALSE
lilddidamenljpeofckpkaeijnpjnejbeegbbmeaenp	FALSE
mbpdkihjhgapohokihdenkabekhbalplegfiffljooj	FALSE
mlnkioohlccknbdbblfjfodkankfaihipjgoiokjacc	FALSE
nhplkllddaindpebodlgijokjbdlicheojdhceilfmo	FALSE
obcpfhpmebnemjandkpgmjeflbnoalhgpejejdpcbbi	FALSE
olggehnnmjgghbbeggliipbjdcaagpioglkjakkpmpl	FALSE
pemnnoklmahmmaklepidalgnbhbgnlpgllimigplffp	FALSE
aaabdigdjkhfgbglfjoimgdgpneajcgmoghdieociilp	TRUE
aameahmnlepklmcfmlbopekhioamlclbhbfeoehmeccl	TRUE
afipjeagpiadoogfegbljcbgcohadabebcaefogomjab	TRUE
aihahacgllhhknffdaggnlfdjfilapcaeflcndejchpn	TRUE
alaofankkddkadbhbemaojndblnbocjhibpmenfmnfhi	TRUE
anojagimahpobkoljpbcejcabokhjfiigoecdljajakc	TRUE
apninoilinaaeeggpoccenfdpakeehignpldoibifopf	TRUE
eikfkiaagaidelkgohdmkjgamkjcilngjehbmjcnmebk	TRUE
faogfamakmmbdcdpeinkfpammohbedbiodlbffmcihhp	TRUE
foaaiaghbedmaciofbplgfmhmjfegckhpnbgbijnmjdp	TRUE
ggoeafnaabhnocgccjbaenhdohcaeipikjnoehpmnjmg	TRUE
haanoaiifpgkkcedollnkjajkcepcgoippjfjffokcba	TRUE
hmhkigkkoiohafifaamokhflglmcnfiiicnkmdbcngjn	TRUE
ihjaaoafpbpgenihjmcemhcffbniimmjdpgofkklhhid	TRUE
jaajfenhelaebljebmcnphonbemodjmehjdmlpjfdpnh	TRUE
jjkgangpeaagbbfhchbldhoofnngmpbngmnfhjelicac	TRUE
kanogmappemfkhofhliagocjfhoaaagkdefaeiebndjk	TRUE
klmaanmadpmebghmhnfmolpjoofhmheciickmhejkaao	TRUE
lgkanjangnandipfocpngmdaddkldinifghegekkpkpm	TRUE
maamoakeobnibblknlknlhcedndfkcofjicinhlknkpa	TRUE
mloaljnljfgpjaaglgdecnaeflmeiegljhenpebhjejd	TRUE
ngnoapfhopknnjgmoijaanojcpenkhdpgjchjonlbkid	TRUE
oaagiepaehpknkgcoadphhbejiaenilpnegpdpkmedai	TRUE
okgmaleaepnamdklffdgegdlihialpneaocdamlihlme	TRUE
pgeaaoenaepdnopbkjofldkihihkoijjdginmpidjahm	TRUE
aabephbgpfbhfmbfbkeccgmopnigkgmofimegmgolbje	FALSE
ajkgeahcgcgniaclomfclhpnefmnhkhmpfdfbblokgib	FALSE
bcgamhnohhiaeoglegmdaobgimikabohfmonodecgchi	FALSE
blmjliohcmbmidbdfbjpaagmleggkeabflmbdkgfcagp	FALSE
cgpelkhkkkmlbcahkcnhmndbdcdpmfchlledngdomakj	FALSE
dapbmhkdabkmdfoagcghicfgdalamjlnmlpkopdffhfa	FALSE
dkheechbkelembkpilobmpeebhjddkhhoehpclahgmoa	FALSE
efcidbjifbpleeilkdhjlfpdbdgjglfkgmnjeafkgpfp	FALSE
eojfbcabfcdcfoekhafeghjoplbffmccfmddgonoefge	FALSE
fidggekilcpgkaphigcfjdpajgbnccoceifjnkkpcgfb	FALSE
gckfonnggaabcpkacgbcemoeihmoanacffpdooenohke	FALSE
gmdjbapcoeecalfeehchmncjbhklnahlandmddmoihog	FALSE
hjakebefbbocbhaaeflnkdoecgfhaeinppnlfcmiifjj	FALSE
iegiadpnohpcgoofhcmjemocamanpgjkgohbjjmddjaj	FALSE
iogejebjaedmafbljdajkegbldemdgfbcgocdmobnede	FALSE
jikmbkpcfiicbbilgneekcianflelmgkibclfphkgfdb	FALSE
kdgkiffelfodjhijkhkndfnikieifhnljhbphikinhnh	FALSE
koihmljhlmkihkgoogahdgkaampnnanhkcmffceopjap	FALSE
lhnfnffjlgkkkgjignkjnibeembknmiaobkdfgifbkmh	FALSE
mcjnfadppnndalcjophgdmlgonkofkcldjjkpcgldoeo	FALSE
mnldlimaechmpcbglgfagfecchkfppbokfkaaddaeimk	FALSE
nhokjffogpdhilihlphlpglcppfidajflmdohlamcdka	FALSE
ochcgckoccggnfcnpoocoebopgnhfcmkmlihbhialnbo	FALSE
olkebndecodhlkgdnlelkojfomiiefjnmhfiakhkneei	FALSE
pgcaklceoaiikmfkgnjaeckhclckbejemjijcmghmono	FALSE
aaababjkadgpdjgfmejplibagjmjcbmokdpgiabhgcmjc	TRUE
aakamdcehcejeihiendpfabnempdjfdefnmadddeoehpk	TRUE
afhhiofohpjpjmienleopijhhmaghgjnjoepadieikkce	TRUE
aiafadmlnkmjghibopehlhddcnemmddgnejpielgckbem	TRUE
akakhnlghpaolgplkhkbmahgjdoejaaceffommnpgdpjl	TRUE
ammifimlkafjajgbmndfjccjpjbbeflclgkcjekfcbgjb	TRUE
aoppahppfhogapmmocbghpfmcpbhgebmcflodkdcecpop	TRUE
eeaiknjajaokdlflkbghlfadbmdopffoklnfggebnfgdg	TRUE
enkknpaaadkjagcjopabdbkancgcgeghedhgaijkgmija	TRUE
fjaapagcjfekffppccleklemogieodonfmgmlipieacof	TRUE
geiaglfmlpaipigolkeaglkefdinflkhdeabkmidceohe	TRUE
goempmeggafaefamfegmlbefkclhbciikefgipkjdbkhp	TRUE
higeffignfhnalnllaacgkofpjhkoggdchphckiabgnjl	TRUE
ianaofhnhadfafcojoingccbbpkdiegbkfjefmagnmoif	TRUE
inellpapanaijfpgopkkekokifimpemifljdkfoomankm	TRUE
jjaakeadpjjdpfdeiiipjbldninnakbjnahhllpkbbcjk	TRUE
kailailkahooklbbiolealeegkahlpdfgafdafljcffmh	TRUE
kmfainohhjaangcmjgadbogmhfloaopjkiamdljdllffk	TRUE
lgmgllpheagloefhloaafbgbbmcdegabfplkhhnhljmcj	TRUE
maganamoicakedeldfooagcjpnjodpemanpbcnjlamgab	TRUE
mnnjkmkehkngalmhaggelilknnffggajiigjcppfmpbgj	TRUE
nhanaeaedoghdhhpmanlknflfdihmodakcelhlfppdllb	TRUE
oafpagjnjoaekbllkeofijlgjicdnoibolagamhobnoda	TRUE
omeaanhmmaicpabmnhoekbkpoodhfbgdhmgbdanpoadnh	TRUE
phalamhnmamgofpnmndpnigbbijpbiakfhpcmokkjblca	TRUE
aaapgkoafboabhdfoedbnlkokdelfddanhbiigopabkdk	FALSE
akjcmmomjagdajkdoobkofbkgggfebocglaceiepgjnnd	FALSE
beeaaajlomahdpbkligfipgimeambomgjhceedaenjgfp	FALSE
bpojopaalmkngnmpgbihboahbbafiagbobikjdgajdhje	FALSE
ckmepkahladhgagjejfjljemehhdlomfmcfhpcmmecccb	FALSE
delemlkaeppgieadmdodogkjaeiaddjggkanpaoiohfkp	FALSE
dooifdckkakidbmgkcgajghdeomiifjlmbgdmdmkkmhmh	FALSE
ehlefpelkadifopabjljgocdmpkpjgplehfaenlcopfni	FALSE
fcakndgobbfpfmhjdgiobgfdngmempfmpleklebppalgd	FALSE
foajnfnjckgfleepoiinpidhdegmimnnfhoidmaoikopf	FALSE
ghlnbeomlalbkikoflkihlapjpcdlaipponmekndofhfl	FALSE
hdpeigmklpdbgiddmglppalckjifdbhoafnignmcabaho	FALSE
hpadoaddgfgfapcdbijnidbhpcmekiahpoehljlognknp	FALSE
ijinkdgnfaflhepmkpjoblnfapfkpjbknkddmahlcfgmj	FALSE
jciihghhbpbabghoebgejjjdcehhleodfilccjcmlkiog	FALSE
jkilgellfhhmbofaafjlcambpiocdnaleljchcbbklnpl	FALSE
kecnbklchpbdmedendimfbbedibdllodabplelhgpgpgo	FALSE
kpbpolahkacickfoheajjoldjiaicaekocphiojjgdplc	FALSE
lkemndkjmamegabodobbkhlkhkeolljneeeehannjfhnk	FALSE
menbkejimkbljmpnfkldnglebopplolkpidfnkelnijif	FALSE
mpamihkpdfndbhnoepcjckikalpbkngcbbkcofkmoalbn	FALSE
nkgffeendfjgokfbnligegljmiilhbgbbndakphlncila	FALSE
ocnkieijljhohbifamplblohpepmdogmkadbffffahalp	FALSE
okiccekkeepfiffnaigblgpbnaoamdfdblcnbkdkcnmlm	FALSE
pfkfmalmmboegjhgiijhiabmgecppacanfenhdcdldljf	FALSE
aaaccoemjfhkedhfencpleohaejoabahkglendphfhapgg	TRUE
aakjonmefomjnjifeapdhgkangkjchhgklnmgcknnjhben	TRUE
affeagjpafdodjofjefomjogppckbacoaobbobppodioga	TRUE
ahmajknabhdbelmmioambnhmnbndljchloppfokckobkem	TRUE
akhaoadlmfdaonghjjhmpahklndkdpaahglmbmpooojcgc	TRUE
anggknajeamjfkhipoocgaekhbhlnhndcmpndiefaomcal	TRUE
apppjankiallhdienjoinhnejnafbipkhlpciaejnccjkg	TRUE
eknkknaaakpdanheboihkaecggnbjlikfgmpgidbileejm	TRUE
ffhajlahoeljegabgdkdifpfjobghnbkmnachaboehgoko	TRUE
foolaaafnngihkeneeopnlpknofggkfjclgfemgboalfea	TRUE
gjfolaaehkhfkjahbbbdbibgliajbmmdfjjhliblfbggob	TRUE
heapaacabikkekdjecjoepjmjjebhoopcbamggjoonfnbp	TRUE
hnkaoigalagebkofkckaimceeiijcedpcmlgdealgghfdd	TRUE
ikafgnpeoklimkpanifoabgikeamkodalopoomkdahfohd	TRUE
jeaaiofapeeefblleglgddfbmikkecgfbiikemccmopnfa	TRUE
jonafjijakapjkhmccpbdjmbbpiejaklemcjfjfbegmpim	TRUE
kihmjhaeggfjggiahmnlapphbbhikhilgeobefodcmijpm	TRUE
laigookafofanileghihmlfbpfaemfjombenlgmdkpkgal	TRUE
llpnlmafanhagpmncpfmiahmpmfgiafongblbobmmgeide	TRUE
mgiomaihmajpnokapphlnckfojajkaoiclknmlaemdhgho	TRUE
naagfafkdoehpacannonendigcbjpmnnkbkgfaiokgejmk	TRUE
nkjlilagaagbhlhfapchnojindjmlifmlldeceaphnjcfp	TRUE
oeajagfehfaepjhnmcabfgmgeogcfknjhmgoonebnlaifo	TRUE
omlpaeollmlajlfadkomjlnaiogggddaciekdamhienmaj	TRUE
phaaggakjgplodohgbcfaldklgpmpbjenncjhkkdhdohef	TRUE
aacjcnoliogjbjdjahdhkjgbbeeomhipdhodcacnljfopb	FALSE
akjjagkfpoechcpedjcdpplfbjlgngcmbknjbmfahehfkp	FALSE
bcmijodkhkjpjihblligoeijmndpndflcjbeigmeoppnlg	FALSE
boknoppkkcpfkamkeihcpfbilhjkdaokmbnfpeekgnglgk	FALSE
chagngickbiaahedamnkielagkkcenmelldcmcidmbfjni	FALSE
cpkanglhkhmanogimbhefmbgmfgpgcpmfgnacifmncfgoi	FALSE
dkphicjdgnjkphigfjlhgecadfmimfdkkmhojpjoopabfb	FALSE
efenbmbblkdognbancamnpjbgfaofppcoodepekecbcghm	FALSE
eobpgfgjbcbbomfbgpkeclaaglogchpdhohfbagkjeddec	FALSE
fhjamajbibcjnhfgpppapnjhekfmeejhieemfofmcblcfp	FALSE
gckjomfhaeiihandcjbdgblpginpjamlggohfjboohjgdf	FALSE
gpakiaikjmdgfeplmhiioofcohdgbldgnadgikfbafinib	FALSE
hibmpoidmceoogoeapcajkphneppahiffnhjghdcbalnil	FALSE
ibepblblefnalmianiackgbbjpmhchobacgkiekkfnmmpo	FALSE
imlbkdchofkadaonkfccjcgjepkdneopdhilfiifopgeel	FALSE
jhblneffipfiadniohfelabdpdiobmdanbnkoeabmdfenk	FALSE
kbannoonlbhoghjjnidmjcjjpdipkemjdikllncdflkeed	FALSE
kmcoihapcllmochffcjpibdpeldgnhfbnfdcednmkopkia	FALSE
lghanplnhcjgaiecikghkdapmigogmbdbdgcpfgcbaliad	FALSE
lpjdallbnfnjfnhckmenjhfenalpdhofeapafnennjokci	FALSE
mkkameanjcgjjjbobggmikcdhcjgkampicodjbbmefgeik	FALSE
necjgpmolaphfncegajhldepaaebmgafnljinidhdjlndj	FALSE
npebchnailojbdbhaaldfnbefeikdcgpfiioebllnflkik	FALSE
okdigaempdmdkfjpdllpamjhplimbpfmfmdjfbmklpbckf	FALSE
pfoehikaiffooecpboapnlbhecddfdodhlngaddbbpjiep	FALSE
aaabmbnddfhaahagncckhlmiobgihffdnegnpkcccphgfji	TRUE
aaneljafggjmjcknglmjganogfanbjjdhpldgbjnpnpdjba	TRUE
aganahocinnkeaplkmekfgnmcganpmfnenblhajncbmeekg	TRUE
aikjaneipaocnffdbmlpmpdfjfkhbjogppigmclkijlkkbj	TRUE
akmllkikjoflanaiedajlpnggghfmlmancdikpdeajlfemf	TRUE
anfloaiialdgjngklmoaebidgiaojmiohdjphamplomhdkf	TRUE
eaapadjbahopghhbmfbnbfeaoohlhclmipopjgmpdoahiam	TRUE
ejnakpmkjamfhnajkcfghocdjpjdaofnifphfbddfbjbnea	TRUE
fffjkjoamejoaalbighkckceanmfgpkfacnhbfkfiegmpin	TRUE
fpnaaakckefgcjgnnbgngbbmllnnahjkpkcdgmkbgjpfogn	TRUE
gieagephnajiaepjbmabmmighhffcekfebiebbmcbpgoopc	TRUE
hajhkglamajbbghfogafjjnbjeohakccnnhhokfdegieglc	TRUE
hnafhamkpalepjcnfbleelocjedmlpncjdippkaejeifcen	TRUE
igpkmmjkkjanmipgojagaoibmafpekpkafmfgklbpoapjcf	TRUE
jaapflagdfbcnanjijffohilepedjiegjeebhphbcnlbkab	TRUE
jklpnmkapjafekabehhmkclkkjemnlceabgdlhpdndgkpan	TRUE
kemnfomaekinglogelhelfkahlinjmagkpemcpegljgedpf	TRUE
kooajfephfinahhjoalmbejejlneainlnllippmpgfgddgf	TRUE
lkgaajlihlanmgphdcjkohiciigjaapgghlifpdcceehcnb	TRUE
meolmoaiffahhiollabepmgcbkdflikhgmlogcpckihdgfb	TRUE
mpaanmakebalkandkaolmhmeopiagfdalhpnghmlhfaimle	TRUE
nikjaoaieabjhipofffigojmjkdlapkccleilonhjalndbc	TRUE
oajeapjfagmnpfbaikbafphfdimcniiclenaidbnggpmajc	TRUE
olpmlnilimmagjalfkaghmebebghoplodbjgcknhbbdaeji	TRUE
phaifaadnkkpkdkoibfdjlegbjcpmdadcophgkblhhhdgie	TRUE
aabnefhimaeidhcfidbdoopediclbgomnnaankgnkjdnjce	FALSE
amanfdodmpbajhlihfibimlbehedeeombfaljpibaakgenl	FALSE
bhcnlfionpjkpbdhdcailkecbmbblicijhiogmbokkealng	FALSE
ccedkmapijjljkgaeggioommmkdffkkmaocpmppcbaalilj	FALSE
clnohlhpammmjidladpodaifjjnlaahnmngfhgkdpojiebm	FALSE
ddopeimlgkdkhamifgmelnjnakebkaapheigbolibdgfcaj	FALSE
dpeiipfdlcdhnaflcfoiabkedgjkmkllcgfemnjglkmfpdb	FALSE
ejgiklbhimjcheponnicladgdcbeiijnniiipjfjnmdlgba	FALSE
fcmifpegkajpomjoihfdcabjmbmlmlfiggianmiipjbdkag	FALSE
fmepbbodeeidkajbembhgbpbjfhglpgainccfohjmeaollh	FALSE
gfoglfefpjalbdpiledmobjkdoamfjacmolobnnbhfjelhl	FALSE
gpcehnnjpjnljnkadgkliajmabfcajdmbnoancjgnilfkjc	FALSE
hjcmifaeboeelmhfppaaenmokdjpogadjjpgjfgoapobipj	FALSE
idknkecmonbggedccdneadojjglkbgdiabapigkjgjohbac	FALSE
inpfeolfhenfimpfihmepiakalpkokfppdaanjddmpbgfnl	FALSE
jjdcibpfbjflhofjgopigkbpbcbaomdcnkedpopcjjmiohp	FALSE
kecmkdklpocnbfclkbobjcmkpncidnjaifeddbmnjhnhbna	FALSE
knmggfcibleannnfafkonjnlpiddcgecfdfnbdmdgjpobpc	FALSE
lgomikmagdhggihlcpcikhcimjhokpoejafohfancbobnfd	FALSE
lpnibcejldnaldbcdogbbaighfidmebolmegdpkphmlodgn	FALSE
mklmgkikcpgpkhliimpkolnfjfaiaaekanhidmamjckkffp	FALSE
nfbifdiekgfpkmmpfllaicnddpjehgkaeejeaphfpldadga	FALSE
nooleoipejljeociiiilbclgjodekjbfbpihpdladhigplp	FALSE
oincoknkcklbhfenljomlfgkfhjghkgjgpindhaeohamgil	FALSE
pfgkkgmpdkcdafepkfinegciccmgckfbflnjekmicboahjc	FALSE
aaabbojfibloicliohgmddoiblegmdnebgbgacipaeomimif	TRUE
aakhhfekooonelnanicieonkgjhppdhnhalhgclpegdaeolg	TRUE
afaainobdconeilchknlekpedfjoabjgpbhlkggegjnkeehh	TRUE
ahknpiamkljilnacinicbhokjmcgcpdhhiikenamflmlgofe	TRUE
akhijegoaakfgdojnfjgnfdejdfibjlcbfipicknpemepaek	TRUE
amnfmfmgmkajfikkiopemaggbjpblinlocffjinmmjckcmpn	TRUE
apjekkilaahcbmhnglajfkmocmmahcocgfbffgeofhfdipdm	TRUE
eimnaeaimiaeicehpegpficckflbclppjpbamokelcjajlcp	TRUE
fehekikphfahohfamamnfdlopfkpgboakmjnpolkpplncbbf	TRUE
fonaaalhnbfadmeinjjecblljkfhmldacalppognohkjhbdo	TRUE
gkeelakjnikeihaapdcmgmemlfnnobhhgbjojmielfjooobn	TRUE
hanpillepmlpjfimaiapkdeeligmolnfimldlmnpagcnafnf	TRUE
hojhankaefnkahmcmjgaihojnjgekccmngookpkaopbpedpg	TRUE
ijenjgmanaefioacaaaihgjocfndabljleagejaiedbjomke	TRUE
jajaojnadnmajmgmffijjdlopnhiejahdidlfjhfleobekid	TRUE
jlnapiaihpafdlcbffellhphdjhapjnghjjjjbganpmabipg	TRUE
kfpklakomejaiacemcjniajinncodlfojioldbfhhlbkaajo	TRUE
kpeglmjlioemjkfaaabjboijajfiehejbfhpioioeeifcici	TRUE
ljaaanhgnpikdknlefbgbihbdjkpjjmdakofckonignickoj	TRUE
maogeljenaahhmncjhimdodkfcgeeamlenihlgnbgckpgekm	TRUE
mmegofligkggmoahakpnjmejahoikljkmnnldbdjnopnklno	TRUE
nfjjmaaeekoabdanehbdhcobpimnenlknkcpecbdimiiggdn	TRUE
npeaaabdjgjlpgpgfhkhlkkaioeanlklgechgdfhjjnmjmka	TRUE
omangnmgnpnghkfiafogkmlajcfgeaenmgcnommemdollbep	TRUE
pfoaoaffaepcgbapaafdmhelmaljggddfhjffliemiejenii	TRUE
aacmodhkdhcadgjjjdegdnbdbaocgoljaofbbmnjikacmdbl	FALSE
akeikhnffafileajadgnkglgjfakgbeijhjojkfnkhnijenj	FALSE
bdpfpgbchagoppmnkehginekcbpnepdjlkppdejgghiigfnb	FALSE
bojfgdjklopcgckdfcalkfbdaihamhmcaapecagainldoppo	FALSE
cjbkhdlgfhjgofckfpcidhbfikeomlobnpjddcncdapajogg	FALSE
dddiamiolnmkkjhfffbibpkgehhkpgdlknonplndgelpomhf	FALSE
dnjegbbdbbfpmbnadlopgjoplaeileagnimoaacimafegnek	FALSE
ehhhhabhobhefcpbmcjonpegkgmfbaccemnlpikhcmokcdig	FALSE
fcgkldipkfehcpbghfgcelmagloenngjdkmkommkadigfdgi	FALSE
flpijgdolchlphdampfopcjhakpopeccidohmdbihdocdden	FALSE
ggalfflemjdmlngigkokoomjepkijkedmmmncimjpmodcaja	FALSE
hbemdcfkejbhgdijnnbgmmlcemagdgpajncplacnlagbhmpl	FALSE
hjpaoghkjepcddpbhocjdapmppjeleaiflopdpkekfpjmjgc	FALSE
iddibcgalklbgacgbhabkkmlpajkkpjamlmocjbnafohgjhn	FALSE
jaicjbpibckediddolaapajngpbfiggihhjmhjlkhhkhflnh	FALSE
jklmcmegfpfaggaemglkegjpofpjaojlmikohgndhplibomh	FALSE
kccinigdjlcmboijcclgbihmgaijckebgbajfplpjdmffebi	FALSE
knahpkpbkjmlkhjakgdfajmbpnkaledlobfkjdildgmlhcgm	FALSE
lhbnedhjlimmnlhmknmlmejjkcncamjikhjkkldpjacoadeb	FALSE
malmlacodbdomalcmpiecmggdfnkphlhlenakbnbfojagipn	FALSE
mkomefhalmajognnjdeijmbdmbclnhnnhkbdcmjcclnafejg	FALSE
ngilmdmoaagjlledljppjipipelbgbadbgnoeohbaioieoml	FALSE
ociknbefccdhaiffggecangknececfnljlhbmpbmeckkdcbg	FALSE
oljhonjojdfockkengdjbfdloklnccmlomgefecgpkagjbbm	FALSE
phbnobbihicdkdcbifcldlpnjjncdlaoeojjjpabeeibhcfb	FALSE
aaabfbaajcknodmaidomimlbdlfcnkcjnocbdcbjbkgkienca	TRUE
aajieoamininemfhcdindkklegokehcoiocbklfdfbagliloj	TRUE
afaafgkclhfnmfonpfmhepbglabjlchodekaegpdljpkppbil	TRUE
ahfafkifjaehnidfnehdhnfbfkhdmfolbnppdajhalgaeeeep	TRUE
ajpeakhgabjpegmdapoloodlfcdbedppkookjcjhdlmacebma	TRUE
amakaeomljnbhnhigjenijdbdidhklhppfmkmokoiandlgfij	TRUE
apagafodcbgeibjcpjamekjddoaaoddhoknkjimloglkbenlm	TRUE
ehleaganaffdabjghlkphmlcdngahilbonkkcgadiaohhabhc	TRUE
faogheamagebgonpkcfhogblbipfbiajjdhnpieilgibcgdmo	TRUE
foepmefmilalpempaeaplknhkbemhgkjhnmdgmbbojledgmhc	TRUE
gioigagaajgmnhfddhphknphdpnggeimkaliajppncjfkcpdn	TRUE
hamfiaeffmfoinmeoaggmgcfgfadldlmfocbdhclbikhcbinf	TRUE
hmimffmkaoaaehfnhjdikcknhkpkbhgolfnlmgfeikdkajnoc	TRUE
ifhjaehflklanipmglkhagjfkhfnlhckpchjplcnbjjilhlje	TRUE
iomlgfhohaeepapppelljapemeioepjpkbojpfgidkmcdifhh	TRUE
jkainpgapogachekndpphfoihiclkpeipahmcagkfnkhhojnh	TRUE
keimapaglgacmbocaikaopcgpgfpdedfinjldpapgahghlkjl	TRUE
kpjfajfaapogfhgkngbomikndcimlhedhffefhdplbjlckfna	TRUE
ljooekaaacbjkpoacjjcfmlkopmonaaofcfkfkjodkmkllghc	TRUE
mannapabhhjlbdhpnkkkjfkoclcceegmbmckmngdoggjpfolo	TRUE
mnnhgaagpfjaicjmdclobgjffebflngdmoaffkgkbpkglikld	TRUE
njegenejjapnemgeaagoklejkjljegdjphjbjmdimicodijdi	TRUE
oalopgklfhpoalkmjahkkhpnplgbephkccekkkpalnomabook	TRUE
olfkaaahmbecinpclonodmbmigbcinoagnnboplmgdkpfefoi	TRUE
pffeinilanigafeaimioghdcbdhpegpmhfoghdalabiojgmfh	TRUE
aafliobjkefmdnebpijlgbokamdmmoendeldegkjjmbhhbbhi	FALSE
alfmkhhcckinobfjodfkllgdcbdlonajgioiifpiceallaogj	FALSE
bhgbefnpgdmmchgajeiemlkomcjdpggjjelfgcaaghdieigmo	FALSE
cbabokdmcgbhnijgcnoknpfhgadhcdchdcakdpihgaimeppgk	FALSE
ckpokcollaehalghcjdnmnjheamfnkfollpclndgobdicpidj	FALSE
ddhpkfnclfofaamnocpedlpojlgchmdmopicjbihlaigodmcp	FALSE
eaddjofhbfpoapjdekokbbmfmammegpdndgafnjpbkahckpic	FALSE
ekamgcbppldeedffolmjbegmjnjhmfldpannekkojlkenhock	FALSE
fflledonfihpogajahclaoiholpiedgjkadikppipopnghnhp	FALSE
fphndembkmhegkfnjgmbcbkdihkmjdeblellmobjmjpmcddee	FALSE
gjppglhijikdiiofbhkfkebbclajephighccmjgcfikabcodn	FALSE
hdofohakondjeaeafjlmninhnibblojdchdjedlckfibmaklo	FALSE
hnlgnaafopjecdigeoiejdlpdgcnekbecnepmbepcpgbnegej	FALSE
ihcckepbkjdlpgapmdeilogfjdfmbbdfadffibjpkijjjgfdm	FALSE
jamgeohokdfmalolboofiklioknbhbdjhanofjjijbbnlpadj	FALSE
jnaihmdomgjcdhodgfbimcjjipnhgimnncnejphgllaokfhjl	FALSE
khkkcpifhflkiebfdobebajkcigjehgoegmgleeengkcjmman	FALSE
lcghjedfoombonceokapjaenablonkenpbmeebggoompdmdpb	FALSE
lmnbpofgiejfdeghegkdfggfpfpllfabmjmcnbfefafhepdbd	FALSE
mheiingamonjdkgjchjmikipdondnkgbbdpokgihpakfkeiec	FALSE
mpeckokemkadnjnjaldggmmfbbdlljfaijmikaeakgjnpidhk	FALSE
nkeojkpmllijohlhihnchonifbpkmohnjijlhpmilkepmhplg	FALSE
ocijanhnphobabdaebhflccfnnmdgalcpfeccfbkcglmeppmi	FALSE
ombdecagmbifilafhhplaljgckjolipfkkkccefcoogmddcnf	FALSE
phdhepcbmcjlbjlgihiahdipagkhcpaackmobelbeodnbpgkl	FALSE
aaabbbhilkanimiejifgacaglbgkmkcfdoocnkfjikebjgdblb	TRUE
aakeanchihddihnkcgccandmmnnkmoabeplenjgbgcgbcoakmi	TRUE
affoialajbbojaiceopaoflbeebhkeaneniobhkakdejifegdo	TRUE
ahpijnaanjioibjhaklofffopkdagaikpikcfgcjegadblcfdn	TRUE
akipkaiinnkopalfgjnelmndcagkcccpplllnfngfnbjalfgbj	TRUE
amoklnaojnifhmopflganicaaeidpmeiabceojonpogkjeghbn	TRUE
apimkaacnlachdemelcjjaafhlpbenmbooiceepcaoffjocelp	TRUE
eilpmjeliimhffohaaahcehhecokibkghpocehcadiigljobdi	TRUE
faomanlhaheiocacokhdecllickhiommobcfcdjjllepmbdkic	TRUE
fnipfjpaaaidalogfgnlokfpckkpdbileaocpcinbaeeipdchm	TRUE
ghkhimkaaloabhohkloajmighhcpaopapkplflhbjehinimmba	TRUE
hafhaokjafjjgphinkdlpdkjfilaenimdefcbhibjikhhfbpco	TRUE
hkoaajajhiciiaclmnedjndacllggppdbiffodhmpamgeaedcm	TRUE
igpaeppajaphiojfbfidnchfgkhgilgchloicibcnphidklabp	TRUE
jafheminoniahpaoflmjjdcpbbiplacilofpanbecgncchigkb	TRUE
jjajkmmalahejcjghclakgnajeabdmhdcdfmgappiadljhmbfn	TRUE
kajoknnipoeaiadkacdkkjcfdjelibldikfjhjbkmpbdgpbmcc	TRUE
kmpemppapoeiahaocjmiidnmbjcoacnkbbljhabgiboinpcieg	TRUE
lghpjeiaggnljafnmnpgamgppbbealmmbccfpgfejojggchaml	TRUE
malijmmaejhlnnaolgkephpmmjpbkapnaffabglencccjbcpch	TRUE
mmafooliimneffgmmlaacoihfaeoonhjddpifmhkikdnekopbf	TRUE
niaejnjilnafagjelckmollicbohoalghbfmafjafjpookjhid	TRUE
oahifpaaicllifgggicjogdbhebhicfdeklfohpeffkmjjkcif	TRUE
oklogajnolonjafaedmldnjjbalbbogfpfoghkggpliocikhbi	TRUE
pemaemipkgolmpalkanihoijeipfjcnbdpahenjjpbikhibcmo	TRUE
aacdonokhgpklaachbglfinbodedkimbkojbmmdjaeoepojpje	FALSE
akiakggimndnjfoalplinolfilimiolkokphojgpooghfemcpm	FALSE
bejboboibdolfemiajjkdohmfimflpohkfbhnlclkddfnmepfp	FALSE
caifknjaabadcmhhpngjbbccngofjeidpbaaajjpjiookkeklm	FALSE
cjmocdopjngnigemkdpblhjlpnemphfkkbacflecbbidlegpij	FALSE
decbfjojoiklikemanjaljogfhmnpjlppghefijjpiekeidadk	FALSE
dpeedkdcjjiphfoacnbnjalhkjlfokhlfmmjnofgnimgpdnmfa	FALSE
ejahijfbgjibbpgbcpknielhdpggdmemgoeeiomanjkjcjehid	FALSE
fdbofgnakodddfbmodhimlgfiiijlcnaaocbplogfjihcpipjf	FALSE
fnbdccdocojfjajakbjbdnglogmaihmjidcihhhpgpdkobdokm	FALSE
ggcnlocpfghljjnfpiknkhmkmkihjpnampfbmapgifmdmobiba	FALSE
hbnilbpifpagligceiihceacpojkbceookdonbclfojbbiglkc	FALSE
hkkmbabamohdpkbipahmfmbkophjneollmaglbkobkldgdgkih	FALSE
iecdeknemhbpocoalbdjndggcjjkmlfoiecaoefbbbaeklfgng	FALSE
inlfiilppmloigmipchcacpfeffclbinmmmjoalefegoejieji	FALSE
jhdhjghppfhfkilbaocjnbaadapgeecklnkondhcjiblcalhpc	FALSE
kcakenifpedodjjhbdgefbncdimhoaoonielfbcloagmjncflm	FALSE
kohnbdkohlnadpnpmknepohmlopbddpanbdccpljciblngplmd	FALSE
ljibbeggidiglkdljclgmijljgnmglcjaobdibcbpijeolppeh	FALSE
mbnalbhapchmlbjpbfjoojbhhlmdbceeiafnojeigbnlckpdmf	FALSE
mmlnnnlbdpnaeaonmbfidfkolobdkfikakgmpbkikhhmiokllf	FALSE
nhecimkmpkbdakbjafbbopaihipjdjmchjjehideccajkkilnk	FALSE
npllnepcijgnbkobogcaahbgimhmlnjmgjleghlcofnhegkgkm	FALSE
olajidgaaldcnkcdlaffblapcbhbbbhmjkcpgiafkmdolfjmmp	FALSE
pfbgigmamnmmmkpdpconljmacmpgifkoeejmlhmblphjfohhhe	FALSE
