aaajcimfaaecaoljaimc	TRUE
aeddmclpnephiaaaaofo	TRUE
alolgmgceejaalaajnen	TRUE
bcbiaabiaadjkkpphpnk	TRUE
bfmfkbkocbcaaepaeeac	TRUE
bmbcnalmakdamalkeeap	TRUE
caamkcfgalealebholln	TRUE
cajmhnadajfakgakfllo	TRUE
cbfmfofanhpojnnalaja	TRUE
cdapnoanandmfaalgnpi	TRUE
ceianeikhcpanaaalain	TRUE
cgahahaaipaahaefldpl	TRUE
chlcpapeokfhaaeignak	TRUE
cjjkkaiafobahabefdnb	TRUE
clcananelnommdlbpama	TRUE
cmplombhjaaiaagjmfln	TRUE
comanalgfiaflilaaffh	TRUE
dbpccepigmefakjabcaa	TRUE
dgekibdpkfmcaanaakob	TRUE
dpefajcjaefneiapkaaa	TRUE
ecnbhfnpahoanbmaachp	TRUE
ekcdbggldjcaackamadj	TRUE
fbaibbgkgbkbmbbhkknl	TRUE
fekcilaaaffdljaalpnd	TRUE
fmcbjcmdelaafanjaidh	TRUE
gcgegiapalijhlajaaog	TRUE
gkcoagkajaiccnajhead	TRUE
hbijhcgaipkaaenailic	TRUE
hfogdcaiacmaapdbjamn	TRUE
hmgijhklnngcapanedaa	TRUE
icefppahjbobbpmaeaaa	TRUE
ihmlfdacccajaeaehgla	TRUE
jaicaaaancomnjjehgcl	TRUE
jffmpgcbnaodiafaaoam	TRUE
jnpngbcaaagoaddmpoeh	TRUE
kcllldhmipaaaagodcdk	TRUE
kjainndjclhkahadaaeg	TRUE
kpoebomeofcaaigmaanm	TRUE
lcnnlaoenaomdoalmapa	TRUE
ljpmcmojkjjjngjaajaa	TRUE
mbmcbahkianibecaamnl	TRUE
mfkcnagaghagabhofkne	TRUE
mnceaajmllpjanafacof	TRUE
nckmaaacakkadgbehhje	TRUE
nipafklapicaafoflaab	TRUE
oaacaehakffkjamkhmia	TRUE
ofcaakddbpahplfihacc	TRUE
onhkpejcapjjademkaal	TRUE
pchgobdapjaaaepofkna	TRUE
picpobgaapggiaanklna	TRUE
aaahlaokhjlabfiemdgf	FALSE
afhoccocjpkhjbbfibfg	FALSE
akpcajgpagnbbmeklkaf	FALSE
bakcojfmnfoniaifgkad	FALSE
bhjhdklliigchlgmnbkd	FALSE
bmhnpmkipkchcbkflgdm	FALSE
cbkelnfhdlghplajbmbf	FALSE
chegjepldhmjlmbmjamj	FALSE
cmbhfdfkhgemmakihkie	FALSE
damnjknmcjdnedcpnnde	FALSE
dgbaikodmfpahhckenmo	FALSE
dlhnekdchkpacpjbecol	FALSE
eafhflbcckbehjkfhdii	FALSE
efdggbghpbaegdibohib	FALSE
elcnphmfmehaledddcil	FALSE
fbbahbjofokfgclijlpk	FALSE
ffknpjaeflpicfbfdgno	FALSE
flbiaabkklpecfbbbbdf	FALSE
gadmmmahmbmflpobfhmn	FALSE
gdpohgccfpaopcikddch	FALSE
giefimdcekfibfhiijad	FALSE
gnbdgcajkonpcmmjdldk	FALSE
hcjbgbnmkoejbnbdanmn	FALSE
hhfgbdkocllogchodkif	FALSE
hmifeimmfgfhknldbkkb	FALSE
ibgjckjnmdnloanejpof	FALSE
igdfjimkjcbkfjlbpoed	FALSE
ikmcpdfkjadapadkcegi	FALSE
ipfgmnlcolfppjocnojc	FALSE
jemjonokdlnmebefogim	FALSE
jjfjkemdakodndolhcle	FALSE
johmbdkglkekkaapkaed	FALSE
kdpdfnnabeonlenlnonf	FALSE
kikchmdamiloaglkenbb	FALSE
kochellfeahhmljkfbcl	FALSE
lclmjbhfemdlmchgpldc	FALSE
lihbnndecaojgafdihhp	FALSE
lnkfjhifnlblimbpdnde	FALSE
mclenfofjmfcflpmhajg	FALSE
mhjbobcjlfibcajiajgl	FALSE
mmgnomlpeemmjkoaookl	FALSE
nbbpiejhdelfklidkiae	FALSE
nfhdgdjjjipefflechdd	FALSE
nkimmobngcccnkpfeojp	FALSE
npbhokjhdamdhnooomnk	FALSE
ofahdlidpbjdgnlggkhb	FALSE
okjobechmddhnpmficgm	FALSE
papknjjmhfoagjnclooj	FALSE
pgjemlpfbaljikdchlfi	FALSE
plnnejbjlgndebilaiic	FALSE
aaaapclimhakiaoeckaad	TRUE
aekcilmhpaalmepgaaacm	TRUE
alagbbicfaabhfheapoaf	TRUE
bbmibikkngbibmfbgplbi	TRUE
bhbbkbhjkbmbfdnpakhib	TRUE
blpmhfckfaagbkdddagoa	TRUE
cabjodahaaageliganinp	TRUE
camkbgnaalamghacmkkmk	TRUE
ccakaaafheenbkmplkhih	TRUE
cdhaalalalnaibfmgeped	TRUE
cfaemhnafeabhaacmmapb	TRUE
cgkdaeafchkjnnphaaaid	TRUE
cidmcjmkohakaapjabmjd	TRUE
ckbnjbfakjaiedjaambmc	TRUE
clokjcckmeaeikgaaafoc	TRUE
cniianafohhiodjaaidee	TRUE
cpcfjdmddaaknaoamkjpn	TRUE
dcgbdbgoncafnainaiiad	TRUE
diicaaealnlikoaahnmol	TRUE
eaggojchpaejjmhaaadki	TRUE
eeehpgcjamhpaheaancon	TRUE
ekmdckpaaponcaelaliam	TRUE
fbfpbbbbiblgeffjaleeo	TRUE
ffbecaadeeiheoagenlai	TRUE
fncenoiaafkahapbbjllb	TRUE
gcfienebmdamnioacaoaa	TRUE
ggnppncnaeapapiojhhak	TRUE
gonhednpecagmepajalga	TRUE
helcdgdamkfninkhenaaa	TRUE
hlhccgnolalglmaemiaan	TRUE
icbngbbnalbapnaahdaka	TRUE
igcaiabjbmedmlcaaoana	TRUE
imfhchamfikagoopdaoah	TRUE
jcdoammaeanoallbepnim	TRUE
jiapacpkaajjjlnfaakgk	TRUE
jofcefcfademaaagpgfap	TRUE
kcmpldajafaiamobnjajm	TRUE
kkolcjjnmjbbhlbgbgbbk	TRUE
lcggecanjmaejnfcpoaha	TRUE
ljbnhpcifgaafbfnnamma	TRUE
mbdohmhcmmfealkacmaja	TRUE
mfgmffccapabbnjjcaaia	TRUE
mnplojccaphacagllajpf	TRUE
nckpeebmagnkaiaajfopk	TRUE
njcalnjaoknogffigaapc	TRUE
oalbdcamabkkjdfofamai	TRUE
ogajjpbcgdkpaaaaipoib	TRUE
onhbfcjgapfacmaamndce	TRUE
pcgpdaaaampolknbbgeml	TRUE
pjalfkcfpocaaibjhahak	TRUE
aaadnmobhnndinbcocpek	FALSE
afdipfegahjockmcpgkdh	FALSE
ajkngmfdlnnhhegmeclno	FALSE
aoemafomiigbhjjnmcmac	FALSE
bdeljnaibjfcdhbcoobnp	FALSE
bimhbigfkjhljkedkokad	FALSE
bnpdlahmfjbjgckkjdjjj	FALSE
cdafbkmaeaiemejcebcce	FALSE
cijpaoagdmnjpapopkdcm	FALSE
comebdcjilcghfikhgdlo	FALSE
ddjbnjncfgaiekccfijia	FALSE
djhdfminilpinjdpojoga	FALSE
domckiegijefaaicamglp	FALSE
edfgfdaaidcmlcafallfg	FALSE
eielfdiijikigjdlikfog	FALSE
emkagdlpkmodhgcpjhfem	FALSE
fbkfgbgcbbfpghojkhegn	FALSE
fgolmgjgmkccgkjkjjhbl	FALSE
fmdkllbjoeocnalmkgkjl	FALSE
gallddhgkfiblahlamafe	FALSE
ggadgmdeddiegdddogmjb	FALSE
glbpkdhneckbagdnnpoeb	FALSE
hanolonldpijiglkgdccj	FALSE
hgkpimbmlmfljgmlbkfmj	FALSE
hkkcnbalbidffdnkhgncg	FALSE
iabekomfjapnegaghppmb	FALSE
ifkfnpggmmbgeacgbdnkn	FALSE
ilchggdlgkiglkccnjagd	FALSE
jaedocigndhechieofhbh	FALSE
jfklnbollajhomkmklpgm	FALSE
jlmdchjebfkaomkblgmik	FALSE
kbaehmcggblibcmjnnfak	FALSE
kflbcdejoegkbjaledcno	FALSE
kknekbjpicpobpijnbgic	FALSE
laaonieloijhbloflockm	FALSE
legphijbdmahgcjpdcgfc	FALSE
ljfjnkghbinfjendjpphp	FALSE
lobbmlefoidhocekppmml	FALSE
mdcmleiidmfijhnifeglj	FALSE
miieckjbkckebnffmnnkp	FALSE
mndnopiegfidpekhpojpm	FALSE
ndchigocllebojihkbfmp	FALSE
nifockmkkilobiojnknhi	FALSE
nnphnobfflbihbblcgpom	FALSE
odblfdniaegbgfnkjilek	FALSE
ohnpdlapnpkbfhdnnmifo	FALSE
omffnagellfjmpkpbfgpg	FALSE
pbfjpephikokkfalpmndf	FALSE
pgkocjdiipjhobbphjelj	FALSE
plcilomndpjikaaiigiep	FALSE
aabcjjbociainjeaaafhic	TRUE
acpjfdhhammnaanhadndik	TRUE
akchhpeokceaaoaolkgnac	TRUE
bcaaapabhcghkbgpmjbboa	TRUE
bghfckhapnaannhhgladhd	TRUE
bmdangcfpekbeliafgaala	TRUE
caeiakonbgdeddiaalpidh	TRUE
canjkogigpnanbjjaabafl	TRUE
ccbigcmnaagpaaaaghgbnk	TRUE
cealepiaagkaemblkaindo	TRUE
cgaamjbaakjcfmbjcemadm	TRUE
chimaiaenedcfpcgekeafa	TRUE
cjhnfpoaaaagcihbmdpcii	TRUE
clfcomhdhaehagphclkapa	TRUE
cnafaapnniplcebalmlnea	TRUE
cojapeajakahmfelllgngo	TRUE
dbccglpaaagacmklbfocja	TRUE
delmipkncjlpangacmbaak	TRUE
dmadcaffankfkfgapalocd	TRUE
eccbiaanccjfojpfpnjaja	TRUE
ehdncaghlaagnhlganinne	TRUE
enoagcioajohaccaapnhap	TRUE
fchaoimkpeameealagmdcf	TRUE
ficphbjgaoklmfaailfabn	TRUE
fpakcocbamfhpkaafadoph	TRUE
gcmffaalelgmagjgfehani	TRUE
gkpdalhmcloanaaklkapib	TRUE
hcaiaohmebaanmkndiccdk	TRUE
hgdngjclaghaodaaenamlh	TRUE
hoacegklgajaiokjdaaolg	TRUE
icogdaoaakgnjfkjeagmam	TRUE
ijgcdaohpfafpohafaogje	TRUE
jbmfclfhnaahgcaonakhdk	TRUE
jfbljbhgmleemngbjbhbbg	TRUE
jncamaalgeiliokhgamfla	TRUE
kcmiajpfanoeiahfinahfp	TRUE
kkkhcpgkokafaaabafbkbg	TRUE
lbdccielhhmfiplanaijaa	TRUE
lfchaanjoehblodfiaakai	TRUE
lmlcpaaedaoaneofaafdaj	TRUE
mcbbkbbeffgbkkggffobli	TRUE
mjcnlnjicaffaanmhamfpm	TRUE
nabhboncpaabohgggajkan	TRUE
neopdfmpcggaamhgaapgif	TRUE
nlcnoahiaccfiiajafljna	TRUE
ocagaeabaamkidmfpklian	TRUE
ohfajgiacaaeoafkekekaj	TRUE
ooclcahibafgfacoaakbgc	TRUE
pcnddaanilknlhaagjhple	TRUE
pjcamipaaoaklmljjfpcpa	TRUE
aaaoeinmhegcfghefpcppb	FALSE
afhkcgpameicofbdpdgcgl	FALSE
akidkakfehabhmdbpfgong	FALSE
aoncbkmekpnboifigcbbhd	FALSE
befkhoelnddmmomhhmnkab	FALSE
bijnhplfihnlocknbdkeja	FALSE
bocjcnofhlndienebpbpcp	FALSE
cdnoeilkdpfpbgmcflcdac	FALSE
cilnjmjbljkmeachhlnkjg	FALSE
cnpmlpppoocomemifbhiob	FALSE
dcjhpjebhojpgloeooanie	FALSE
dhjjmaefopgaapbchjhlma	FALSE
dmnffpdoekchfoikbghkcb	FALSE
ebphaejbealfneihnmbegf	FALSE
ehfhbodgeadbpmillodcee	FALSE
embjbijdcihbhodlhifhap	FALSE
fapchlgdkhlfoonaclhbib	FALSE
fhgbbniegmpffjiocnnojn	FALSE
fmepfenkhnndcbcpnhhcml	FALSE
gbcbnjaohinofplfolcbod	FALSE
gggoonajdhenhdjanjlllc	FALSE
glacnpflbnhacmdcdmoiha	FALSE
hacmbcclajajfmooalnmpl	FALSE
hflpmlkjpajpiboafjdplm	FALSE
hkfcjjnblgbdigknjbeehl	FALSE
hoodaipkalkepfhfgcggdd	FALSE
idmmnoikpbkadolailcfil	FALSE
iiggbffcalgfjjhdlgnoid	FALSE
innpbglmfjdipmmnikhehb	FALSE
jcmgkgffolkapdfhpboiij	FALSE
jiackoeodjnheljjjajjik	FALSE
joahiggchgmaohidhdgfkm	FALSE
kcjlconifojidgjpdfippa	FALSE
khlodppojjpenikhghfeom	FALSE
knlikccaaknnmhiecmmapb	FALSE
lckmejnbhmebcclhfjpela	FALSE
lgogjdhfhcjhbppgjcjnnb	FALSE
lmkejbojbibilnbkbjinmp	FALSE
mblkhgofmgmjepclicgejp	FALSE
mgogcijljlfjckenddogeh	FALSE
mlodedjmejfcoeicebcndf	FALSE
napgmjmhbblokekdafocgh	FALSE
nfpggfakfjhbfkdphheimd	FALSE
nkobiejmlejeboiffojjhd	FALSE
oaoomkedpcepkcaicdeokd	FALSE
ognhpnngkhcpdhnbgkdkjn	FALSE
omallmdfnoiapogcopfnfe	FALSE
paiiaeefpjgfobpjpgnhcn	FALSE
peohadhjpjmheapfodocgm	FALSE
pkhmpnmedacngjhjbcicol	FALSE
aabimlndgldfcfajaeapanb	TRUE
adcidchgdaohjjafgeolaaa	TRUE
alechbdnealbamoljeammaa	TRUE
bbmoocacedailaakimifoaa	TRUE
bfpochgpohcfmaeaapahfpa	TRUE
bllcmaneahnhaajkocenmen	TRUE
caalompngpcoaimopoaihoi	TRUE
camfalaabloappjchonbmek	TRUE
ccccnchjbaagmjnhhpealka	TRUE
cdpcjoejgajfpapdeagajdk	TRUE
cgaegnafpljnhlpajoaccfa	TRUE
chondaepapfgaamcjloiijg	TRUE
cjmlboclmaabhkofmjjpaab	TRUE
clkecepcaabaagccbilkmpk	TRUE
cneajfkmakpakhlfjbaaoma	TRUE
cpcocfaempemagcccaboaaf	TRUE
dcjdhlicnaianaoanfipeao	TRUE
dihapfcaianbpaoaldjoene	TRUE
dpcbeehnlfbmkbhllbbebgk	TRUE
ecmnimaaaildllahmmlhall	TRUE
eicngloaahidgdefbaekiah	TRUE
epifnkonncpaacfafiaimkg	TRUE
fdhckchihajiafagnamhklp	TRUE
flcmampamncajefbhakgjma	TRUE
gcefaaehehmbimphlpagaok	TRUE
gjccaijacpjclkajalnhbkj	TRUE
hbcelofgifmaeiamaageflb	TRUE
hfbepcnmaojknbaaaafmdjg	TRUE
hnlgnminccahpgapohapgpa	TRUE
icnbnhacioaaijbamiablhi	TRUE
ijiapcbainlipaanainifej	TRUE
jageiacccnhapakdamabnim	TRUE
jfaogfecnkpeaaaoikajglh	TRUE
jlhnhgcgbhebeaaalepiepa	TRUE
kbhdpidcodalanlmmoaoaec	TRUE
kgclkaeaagjhjmphgheafba	TRUE
kmcjndncioamalkdekkeaai	TRUE
lcdkpaafficcbafhpapicnb	TRUE
lgodlkbcidaaefnnanajhlo	TRUE
lnmglclfabdbbajaaacgkem	TRUE
mciabaaionaakdlfnlkijjn	TRUE
miegeomchcaablbdmlcemaa	TRUE
mpcppdfhahaojioapanipef	TRUE
ndkbnfjggdbfbpijlhbmbbb	TRUE
nmcpaaeeffjplfmlaajoghh	TRUE
ocfehaafnhhclbekhchiaea	TRUE
ohfmkkidbpobjbhkfglibbb	TRUE
opdjfgpkclafkigjdfapaaa	TRUE
pconhcmhnapaemaaohkbkpj	TRUE
phphcbanknkadalfhoalpfc	TRUE
aabgnpbkbdfgkjmjefaekil	FALSE
afpbhgekgcflgbjobngmhce	FALSE
akkfpobcmjgpjboecmpgijp	FALSE
bbjaaonioiogcembnefhlfk	FALSE
bganajcoefnndigincdgfpb	FALSE
blaeebcpejhlcpknonpnapd	FALSE
cafjkofogaokoedkjjjmmci	FALSE
cekkchppmepjepkppmjjjel	FALSE
ckfbllmefaoojbdclmoacji	FALSE
dacffobacjcbmcehhdmlkmd	FALSE
dfobhmoopiipbanajajgdan	FALSE
dklocigklhinbfjgcaoanhn	FALSE
dpfpnkmdimokhgbhlmaldpa	FALSE
eefcoaimbcgjjlnpoknfoba	FALSE
eiollcfjbfnpidanfgoaibh	FALSE
enaiheheebjbkoambelpnci	FALSE
fbhifejfelaoggeegeojifl	FALSE
fghmmeaaodnhiohkdalbnod	FALSE
flcpflhbbgaiabjhmjicopf	FALSE
gaabeghpcpoehoohiocbmon	FALSE
gfjegpdkbfeldpmfajggadd	FALSE
gkkkacegpmhfjbmnfkncajp	FALSE
gpopfflhbbdomebioodfbln	FALSE
hfagbfgchknnegfkhmpoipm	FALSE
hlckkkoacbakoegkglckkpa	FALSE
ibfiefnnffgckahkddgdpfd	FALSE
igkkkhihphdiflgkagfoncj	FALSE
ilmaecehllpohlfbbblmgip	FALSE
janlmcemimccleejngkoibj	FALSE
jgeoobckhbjdakkhlfbgljp	FALSE
jkplndnnhibjecgcobebgko	FALSE
kbfcohphjpfpmhdfkabgidd	FALSE
kgdoojkjjjbkgjfneaidcef	FALSE
klmnagohkhfalchlnjckpdi	FALSE
lagcfomdpjmeecjmdekmodi	FALSE
leomkppfkaoedijkbgegjpk	FALSE
ljdodepajplgcehigbgilpk	FALSE
logmoemhiolamfocpmcmkpe	FALSE
mdelheafkdhiealgjdeagia	FALSE
mhogjadagjiahdgifgckdmh	FALSE
mnkdmljjgimefmfbfgkeheg	FALSE
ncckjcmhjbafpfagipcajog	FALSE
nhojkkhijhkkpfkdhnoeccb	FALSE
nnfggjmclhppooaaojgnlip	FALSE
ocecgpiemjimpldgljpcgfd	FALSE
ohldjcpcndfkldabgpdbidf	FALSE
omiaknkdgboelakobpfonll	FALSE
pbkblhgbikfjlindmehjkdl	FALSE
pgpjeeajhdkohhhkolapmbl	FALSE
pliedppiogjpffeadagecfd	FALSE
aaamklgeobbmbpkbblkbebpk	TRUE
adijjphhcenlalnoaagifgap	TRUE
ajldcomkfigjmejpaiafbaan	TRUE
bakogndmbcfaahmjjafjlopa	TRUE
behchkoibejcahgajaiaienj	TRUE
bkcpfbamaaagfkdklpkjaell	TRUE
caaeoaoebhgbafifjhaelmli	TRUE
cakagkgmboahhgaoplnmalae	TRUE
cbmlfamepaehjmhpekaeokha	TRUE
cdohcokccekanabcaadejcea	TRUE
cflaekaekkfaeiimnegadppa	TRUE
chdanjplookmmdafeaibaack	TRUE
cjajcbkaaboimmfaoeohgnap	TRUE
ckkonldpfaaaeabgobphcdpa	TRUE
cmddaallbdiaaojpkpfkdnlb	TRUE
coengohkamoapkaoamocoled	TRUE
dbckchaacheamaigodkjajfn	TRUE
dfimcpbganapagfealdbhegm	TRUE
dmoafbghkphbigecaamaleag	TRUE
echlmfafonfkabaapkmaeoah	TRUE
einamccpchammaebaojaccgf	TRUE
epjcopgpkaabjbangeoaagbm	TRUE
fdpjhdlmpkcjnaaaacbjjgpf	TRUE
fjofhbaencaeiaeoaalaihoe	TRUE
gamkcmndljcapabaeafmpann	TRUE
gemigjbacdpaaljpdckaplfa	TRUE
gmggipclinjmakaoaoekfaed	TRUE
hchlmmaafhafhlagjjjamiip	TRUE
hhnnjhkdpcmbajflacalhanf	TRUE
hpbbmmbniebnbibdknabnnlp	TRUE
ickfeaaeficknaeipeajegcm	TRUE
ihcmjnaamijfajkmahcbdddh	TRUE
ipcciichafaoaaecalohfepg	TRUE
jdkichgajfhmagdakghahjmb	TRUE
jkplcalmalajhadpbggkhfbp	TRUE
kbicbdlafgmaeajkhhafbaam	TRUE
kgbelpfaciaaliaoolgeandn	TRUE
kngcibldpfppaeabagljaoef	TRUE
lcjkpoeakaamfhiaieapmhed	TRUE
ljdcofbaeajndkgfanapocng	TRUE
malchclajgkakcphcpmaaink	TRUE
mecglkeggpgfplnflaaaieaa	TRUE
mlhbcaockdpaamafokihaheh	TRUE
ncgjhlaghaamfhjpliadlpkh	TRUE
nidfhcbndphjjafpajaapcej	TRUE
nphcicikbagafmiallkiaphb	TRUE
odggcgaagajaeelabgiaphil	TRUE
omackhgobhiajphfeeaajakg	TRUE
pcididakeljnaimicajjahgk	TRUE
pjcgagaapklkagngfpcafaad	TRUE
aaaklombikpanegjljmklogi	FALSE
afandofalihfgjdfooiihhkp	FALSE
akienpkfmnlneknliemibahf	FALSE
apopfbdblahcinhmeiamkagn	FALSE
bepdldkdjpfbaglbhjhgdahg	FALSE
bjpmahmdncebankgjagnnlfg	FALSE
boiplbpfbdnfgalmfejffjmk	FALSE
cekgbopkoijhajmimfaibaef	FALSE
ckdaglophepknbgbcmafecdb	FALSE
cpacndgmakjpjfnelmoldmjm	FALSE
ddmambblokmcmbdfjgkdbmbb	FALSE
diffonnfbkjjdibghiblainm	FALSE
dmpjjdhiojeammdfjmablaeo	FALSE
ebnidbacphdimcbpmmlkkono	FALSE
egicnkfjpjejifgcjieajbcf	FALSE
emdggbabomajphfcinbfjcpf	FALSE
fbhkoljenncleblnhfannccc	FALSE
fghajfkffmaejjefnkmblogc	FALSE
fljcjinpgallhnffjblbabfj	FALSE
gaejkmmdhjmncjlkimnonklp	FALSE
genmmekdhbngmmjgochfignd	FALSE
gjmmibpfpldnafcobolefmep	FALSE
golgakioibgikjcnagplejjo	FALSE
hchceiehjemhfgbckolkklfd	FALSE
hgppdejoaoiopanhgameofop	FALSE
hmjddfeegednlbbdnflmhffd	FALSE
iceafmjkochingcjhpkmecbn	FALSE
ihebdjdmbfglmjfkepcbkehh	FALSE
imhfndmmpakeocdjbcigldpk	FALSE
jboajkhbojccbkofcgfamhme	FALSE
jgnkbajjlhhcnnpjdmlmndjb	FALSE
jmaebjlmlhlajmmcaeinkeec	FALSE
kbjjaggdocailgglkfnbpdkj	FALSE
kickngojfeagjpfphglelnip	FALSE
knagmppbpbgmdnnjjalkbabi	FALSE
lchogmbedjgfbaibpiphamid	FALSE
lhnbkgblbkoibaponeaakegm	FALSE
loaobbiminmbaihodfepmhpj	FALSE
mcmnbdefgifbcanfkggmpklg	FALSE
mhbfedebddbgoemkeljokbib	FALSE
mncilpnealljplifcbnjcjda	FALSE
ncdnlpcdpgoafemecalahocg	FALSE
nheneglopepnaailjamknbdn	FALSE
nmckmceapkdefhchpgmhfgfa	FALSE
obfjkmhldbagclkdokofmfhi	FALSE
oflpllebjkoekjljohpalidj	FALSE
okkogcnlfgonobomcalepngk	FALSE
oppjkncndnghhiflhipefngf	FALSE
pfipcbeljalhccpndinobpei	FALSE
pkmaihjfcolegpjfccjannfi	FALSE
aaacghemhhkbhjaeganaaafdf	TRUE
adnblgbhpmbblblbmfnhpgfbp	TRUE
akagjmglcfaaehmklepapglma	TRUE
babmgbllbngmbpbfbfnfgfkfp	TRUE
becceaablmiapjplabkkjppan	TRUE
bkphbincjmapjgaafhianfokf	TRUE
caaafdpecgeklecmloadnaakk	TRUE
camijgmoladnncimdnaemaaff	TRUE
ccgnaaibmjfncagjleoeeaiij	TRUE
cecbebmfdkgfdbcaaadfkamha	TRUE
cgfncgiaagklaaaackndbcpmo	TRUE
cihaamecaafgalkhpebcajopp	TRUE
ckekpbaaaepklanfkhemlpkoo	TRUE
cmckooaoapgaahmekjecfaege	TRUE
coagpahikjinbimageeofgila	TRUE
cpolnjaadilamipmiahpnbgch	TRUE
ddehplcalimagjfkiapgmgajl	TRUE
dklcohjnlhfagkhmkanaolmaf	TRUE
eaoekjcaadahfkiadijhdmhnb	TRUE
eellencfodfefaokjmkaifapa	TRUE
encadehbjamnaahbagnmajpjo	TRUE
fcdaaojkiaahdfmnpdadphlpk	TRUE
fhcajhplhoaanjnkafapeehik	TRUE
fohpicabkomhoagjakamgladl	TRUE
gcpgogceaajdlkfaallojilmf	TRUE
gjmalecefaoacajlopkpiapco	TRUE
hcbpfepfdajllkaaoekiajaif	TRUE
hhgcnaleadgegnajffgjmkooa	TRUE
hoecihdaajecogannfhhjfoac	TRUE
icmipalokealaanljoffklahk	TRUE
ijbmkhcicaagcggjaplanfgfj	TRUE
iomckaanhbmoaphmabmehmkba	TRUE
jdpgcbhinhbpanafhlaaalfoe	TRUE
jlbiccnaaahaccjhdminhfeoe	TRUE
kbfklckahcocajoaaaflihnco	TRUE
kfmlcdoaegackfifenkaknaip	TRUE
klnfbceodjleagfjgjlaojaha	TRUE
lcckaomjamfndmhjhafpjafpg	TRUE
lhdcdelajlaajaiogbnmheiap	TRUE
lpmdcjlkahhlfahcljakfkafe	TRUE
mehpcgiofkeahhakiagamdicg	TRUE
mkpphpkceiaejhkjandjniaan	TRUE
nbclpmneelaaoaeamjmehpodh	TRUE
nflkdokceomknpjhjkapnapaa	TRUE
nmcbogaleihkacaangimdjbok	TRUE
ocdillojfjnjfboaaamihnaba	TRUE
oglbaheocmlajeagmkcmcaame	TRUE
oojkjncialiajlhakahaocmoc	TRUE
pcllpigdgkbnlepgakacalaon	TRUE
pimpaighkdfcincaeiaagpmab	TRUE
aaaefkcmifcnngineegibdmgf	FALSE
aeoonjegndlnkbkgfifiiklfd	FALSE
akijlfcgieladniemidaldpfi	FALSE
apmabhdpnmfoglkkblbbgajgc	FALSE
bflnkmefnofeehgabhccpkhoi	FALSE
bjomjifbbompfokhknnhneofh	FALSE
bondhdkbedibcjmfioepmgpdk	FALSE
cehpagliehjlpkcafediedkhn	FALSE
cjbdodndbjhbeejmflcieobga	FALSE
cnkmakfemejkdjgodjdoenolm	FALSE
dckaeokadcfjkpnnofjckfgki	FALSE
dgpnelhkhdjbnhlonebanodcb	FALSE
dlonfnodinfefiahgkecfflog	FALSE
eajlcbclkpjlbadoahfakjcff	FALSE
efnampaakhkabiddkdiagkfkm	FALSE
elkgolibdgaolijhclabmbhjg	FALSE
faibpcdglmdjipaehehfblgbi	FALSE
fenjanldlnpmiainjdikemfbe	FALSE
fkdhibdkhhnceppfbhanadpie	FALSE
fpmbpfpedckndohcifajpjepf	FALSE
ggiijdggpfebkglglnpfedfol	FALSE
glhpgbhjngncabjglhplapkkp	FALSE
haklimldbdgfnpbjlojkacjbm	FALSE
hfpiadobkegaoijinadpkbnka	FALSE
hkakcipadfgchgfhngjbdlkbd	FALSE
hpbhpnhcfilhmfboclfikbpdl	FALSE
idohmoocoaanfjgingajbdhpj	FALSE
iigploaidjonnbilmknkeliko	FALSE
inepifghnifgfcdehcpcomaij	FALSE
jchjcombmecgapielefapiicp	FALSE
jiipbmnchccnmpjekbieenndo	FALSE
jnphfkfiinobgjifpblhodcfd	FALSE
kdecmkbepmlakmgabmjaklfeg	FALSE
kifjgpcadpegbmgkkhliiilig	FALSE
knpalnghkgkfccghgmmadpdik	FALSE
lchoagdlcdmnjgmoofcdocila	FALSE
lgokodohllaoaiaofhljjccjf	FALSE
lmakdjddckedoomeigcajljgh	FALSE
mbfnnjlfdndjcahcnkddgnfkp	FALSE
mhmpegohmmohnbljclpkapkco	FALSE
mmjdhhelpmndmnpbagjonlplk	FALSE
ncecmdggnenhmhidlcohiphpk	FALSE
nhjjobaepnjlbhbobdkbaalgg	FALSE
nnppcfcoejkelpnogfglkakak	FALSE
ocpclnndgbneeaajibcnckbcp	FALSE
ohlmbnoblinfllmbbidmppemf	FALSE
onbfaflicllongeahblbdaeph	FALSE
pccjkfkdjmmcoomebobdofbkp	FALSE
pgnoiecmlilfocfanpdmboind	FALSE
plgdkpcfkcofjecpjjgkjmnbk	FALSE
aaadjmannllpcagapfdfofaaeb	TRUE
afafcpiahcpmafaakadnjdoedi	TRUE
alobndchnnaliaaakedkflbemd	TRUE
bccamenlkhleifanalamgdmhim	TRUE
bhclodggkinjgaapieaamicbbn	TRUE
bneibcpfgkahagencjedainakl	TRUE
cagnacaklpgleialofbbaclkmm	TRUE
cbglbgilhalaeekbfgaabnafmp	TRUE
cdgggehaoggaaapmfelmigdnho	TRUE
cfipalakmjlgbamikgajnpgfhl	TRUE
chicaahkanoogankimecboanmg	TRUE
cjkkcmcdhomajfefnhjomiaaad	TRUE
clkaabeodeficbdkhlaahifnpp	TRUE
cnhmpgbahlgaficdkngkbobgaa	TRUE
cpgaaoegoapkancpjccdpaobmh	TRUE
dckiilgbkmaggfoeapfeaamojo	TRUE
dhfacdakiiambbjihgafiiokab	TRUE
dnfgbneabndmidejcnamaaeapp	TRUE
ecnekagajlbahpakimhcnmecpb	TRUE
ekcgmfaaigaoadkmohlmegeloc	TRUE
fajkjmefbbephnbbbobphnhoam	TRUE
fdiiflekkcahjgcaalmaphgadi	TRUE
flgipbclaaicfpjdjanfjhamnd	TRUE
gcaonegkpagjjgaemmaggocfek	TRUE
ggocaapnlblpibpfgameoanimh	TRUE
gnfjjfobkhkboobblfpblbnijn	TRUE
hcpmdgmakjanebkecakgifjpma	TRUE
hiollkcaeakbdfeakdlmalikam	TRUE
ibapkhghcopapgolamampnlkga	TRUE
ifejdcabfgoejaaajaojfhclfo	TRUE
ilfocjgfjlaoaapioapejpnpki	TRUE
jbpbbklbnfkbbbhnaaeippokop	TRUE
jghkjldeianpcahapahaeddldf	TRUE
jmhocicfpbcnhaalffanahfccc	TRUE
kcdamihmagelcgaaljfdmclmmm	TRUE
khnlhmhbkgjkhbbpbojbjfbocg	TRUE
koiocaklajafemggkdajadibph	TRUE
lcpdhpllndjddfgcajaecaakom	TRUE
ljgbhcdaahaacdcojlahibffkn	TRUE
mabfppncaafakjlhhleajkkakf	TRUE
mebhciogaaknlnmbdodjcfalaj	TRUE
mlfekjheicoiahafcafaeodied	TRUE
ncaaamppeggdifdpekfankmiha	TRUE
nhakofcjdajmjajcopanhagagb	TRUE
nngamgjpplbmkbbbbbjohgonef	TRUE
ocilchmgjaaiaoapknmoidbaap	TRUE
oikcgpdimahjalelcfoaiaohcp	TRUE
oplanocjajmopdcjglaaialagc	TRUE
pdkccbfmoammnkakoibpahapcl	TRUE
pjmihjgcoaphailmimblhkifaa	TRUE
aaajipdnngpnneggclcidlopfk	FALSE
affeeajngiodkcpkmogeppcgci	FALSE
akgicedandlhlkbafkhoilgamf	FALSE
apcohglbhanlbinmlckhldkaaf	FALSE
beoplegglbdjklgefegdkbpaki	FALSE
bjnmbcjobhhkdchpncibnhlnnb	FALSE
bpbpmplckdlafcpnhbkgdjkfhm	FALSE
ceoipcmikmjpkononoafcghlhb	FALSE
cjnmagjbmocbckeegjpphppbce	FALSE
cpnlihjejiepchgccbdpcldpek	FALSE
dfdcodoogkadhhghhcohlaemdg	FALSE
dlddiebndlefidiflfkjobkmfi	FALSE
eaealeahhbdeipiecmeonmgimg	FALSE
efkdmlgdpdjdaklglpbmpgblec	FALSE
ekajbgcfncceljodookoldpphe	FALSE
epfbbaihbeflgkikmlmlkmeafn	FALSE
ffcpjphmbgfbkofmmblajefgga	FALSE
fjolffjahdopigghppneopfmoe	FALSE
fpfdcibljkkbgilafocghicfli	FALSE
geknbognoibddghfibhfgakhhp	FALSE
gjgbkfmoblfdlinlkfmeblgilp	FALSE
goonpklkdndkokiccpakimecni	FALSE
heafcnglfackphlgidmglanhhg	FALSE
hidpkfggmeahielmcjehfhjcom	FALSE
hmopgpboiiimgpgdfnbdjlejlk	FALSE
iaocgmomlodagahllioabjicmc	FALSE
ifkfdjhnhlligpligkhgohgfoo	FALSE
ilcmoilelhmnhcgjpogmnkofmp	FALSE
jaibjfbgbpdfdoifhapngpaifp	FALSE
jepoalpgeljhglmjkfhlponkgo	FALSE
jkfpiofhggjcblgopeiaficago	FALSE
jpdpplbbghgbogcadnigehncpo	FALSE
kedeinkbdiidgfknebnekifikp	FALSE
kipfcdcbbkocnhnhgglhnppoom	FALSE
kokmpajofblanibieliiapdhep	FALSE
lecgphonocmnefjeeenhaebbap	FALSE
limnbjjlpkiakaffolepcincoo	FALSE
lnjbldclphlcbeandijkndchhe	FALSE
mcmebfbepidbagnjpmihmcmeoe	FALSE
miajhchklifeafkmpjaenkggpc	FALSE
mmognhdilodpjkkabddjpiohpf	FALSE
nbkojphkkdpjbnlejchbfeiaim	FALSE
ngnlhblcnckpcfapomhkpceklg	FALSE
nlkdopiidkcpcglnmmagigecfi	FALSE
oaoacbdjbkmkokeppkijhpfiem	FALSE
ofgfkpiekohiidfpggecnmkkjg	FALSE
oldifbfbbgdolcknieeokpogli	FALSE
pamafhbiojfkgfamhjgjpfgbdd	FALSE
pfldnmafmbmehneebjcgoggdbb	FALSE
pldbiohipaojdbioejemmpbngg	FALSE
aaajcbmohjaokoaogamammpkcio	TRUE
acpobpaoghajgaajlpjodppmhmp	TRUE
ajhogknjlciajnmlhikmpabajla	TRUE
apgkcpldnllfaakjgfkapjamggm	TRUE
bdcapadkmodajmmaofhenideame	TRUE
biieblebobobbpeokmhbgacfjjh	TRUE
bohlocbljpajgiipmgonapaaghm	TRUE
cajenfajobihomoogankkajkhag	TRUE
ccaaohipcepecadgkbjdaeoallp	TRUE
cecgjbfahpajammfbchpgahhakk	TRUE
cgdpldhpaaldeaofbaghaaffbln	TRUE
cilajoaefakeiokfaaadhafaiod	TRUE
ckgaoammnjmaafkfinfekgiafih	TRUE
cmigccanokamfpgeianlefnapcc	TRUE
coikpkibfokafabaajkjdeblmbi	TRUE
dcalaaonidieoapjapbkpigendk	TRUE
dggojddkjlmofmcdnjakjijakaa	TRUE
dmjacggclfaclkaggoahmaomaed	TRUE
echdhidalpofjlaoieggkamnanj	TRUE
eiedokhomdbcaekfnaelamejaha	TRUE
ephimgpiafgcnenpafoiaeaiano	TRUE
fdjomiocmaagmpcegkapamoiman	TRUE
fllnkjkdcaonpjpagbfjagioalk	TRUE
gcepdifelaaigbnanadmekeehpl	TRUE
ghblaejjbcjpmgmmogaadakjadf	TRUE
gnanblmkmcaaggnaahnoggmagmk	TRUE
hcefhhdnhgngbonbeiblbgflbpb	TRUE
hglilngciioajklhoadakmfnmfa	TRUE
hopjcfelakphahahfkabngefcai	TRUE
idfmbkdncoledjaahjejjaabegd	TRUE
ikcnjfaaniajghoookocaefaolf	TRUE
jbbjigbmebfbboahcbedfgkfeeb	TRUE
jgaidlenicomiebajeojliiaama	TRUE
jmbfmbcgnkhcaakoedapfgpanmk	TRUE
kcehfpoamagdgkgflgaafcidlip	TRUE
kheifcojgnnmaanndlfieaeloac	TRUE
kmlpmfmpppgeplhagmcaaddfaah	TRUE
lcakhieacmlggoggfaokafooego	TRUE
lfecckfoapacchfjpaoaokeojfo	TRUE
lmepjcmngpehnniaadddpbaafcl	TRUE
mcjefpmenloeamaakkaknplekkf	TRUE
mhpcaaimlebefnheonapalnajjd	TRUE
mocakpgpjnhjplpjdkheaeaiaag	TRUE
ncoagflaejnfgaamcokapcfajog	TRUE
njdgjmjjcdbokcdpaafljamglae	TRUE
obckeoeagaldlmalhflpiihacde	TRUE
oflmpicgajonkpnkhfaljmpahma	TRUE
omclndjkchlnanakhkagomahagp	TRUE
pcckpcfabanaeafjhedajiooaja	TRUE
picgocinehgmhmpaahfhdcnaiia	TRUE
aaaljigkngdbjhilkgnbdlddegc	FALSE
aelinpagimijafijbgiaejckhbj	FALSE
aijoiopcnchifeinhnpdkdkhcfo	FALSE
anlgibclmekmgolkpccdcmaegni	FALSE
bdmengmpggnepnnahneiibiaaeg	FALSE
bjaibilodjmkkcliglpdgbdknhi	FALSE
bnjmmdcgihplggnffkinfbbafjf	FALSE
cchlnhedljkfkkhmoghjemfjhlm	FALSE
chhdfmhnnecfjebhogfhlhjccpo	FALSE
cnbgimkhcgpfnogkfopojcapfoa	FALSE
dcdjmcecdkhgonladjliokblihb	FALSE
dhghfmcfcmaamkledbmnnpmffbm	FALSE
dmcnkoamdkjbnadbjkofkhiedid	FALSE
ebjocffcajgljdpoeomlblphehb	FALSE
ehahgmfmmcpfjagogelbamhimlo	FALSE
enapjafpmkpkdhlkhfndonfpkdc	FALSE
fcijhfinbeefemddnlbkbehobmc	FALSE
fhnfdanakdmgjapdnienjldmgea	FALSE
fmfjaggiijfmimcakfmjflplinb	FALSE
gbifdclfmjdmdhbfhfhcfbkeamj	FALSE
ggnkmfkhnheojlncbiodpbcggmi	FALSE
glckdnejgnmbojpghkjggcjedgp	FALSE
gpjoodbegdbkdfbhllcbfhhkpnc	FALSE
hfbioiedidhajoaalpiffoakhfh	FALSE
hknhkdbagecekfmbgaioahfbkpl	FALSE
iaipfooadoljncifcjldolbjkek	FALSE
iggadagdhepdofoidndmjccgbkh	FALSE
ilckbpkfaapmnllfckiddgefcac	FALSE
jaiakacgmbghdggpfingfnhnhng	FALSE
jeoddakjdibfefgeaehkkhohjon	FALSE
jkljjnhkbbloblhbaigkdmiplak	FALSE
jpfhoondehhbkannkobdmilmlhd	FALSE
keinhfgabdmejalefcajcmnfpln	FALSE
kjmjmloihmlkhlmfffllebhbkec	FALSE
kogmoliejjbhobjknfcflmjonlk	FALSE
ldofckjhadokjaphopmpbciifao	FALSE
limenopmomjnafbedokbdhbajhp	FALSE
lndlgkcophmakihlnofgdhepngj	FALSE
mbpjemijakcjjmpimipldplfabb	FALSE
mgoeeklheopmlkllmanifdiepop	FALSE
mljpgdpamcbdlobokdpckjhlmdo	FALSE
nbdebeggacnlljbjmoalcjfnkfn	FALSE
ngahpjephhhddeglaloeokdcken	FALSE
nmboaecamenaddcmcekabffbonc	FALSE
oaomafmngbcdmnlcfehoepfnglg	FALSE
oggkmakebhpchldckhoojmgdfaa	FALSE
olhjimdppkclcnfkiohoifbeagi	FALSE
pakmhlfefnilpgkaijkkaldohie	FALSE
pfnmmjngfdacfbckeofonekhanf	FALSE
pkpidjcdcokjcbkikonjokmlfoh	FALSE
aabhlgcmeblhcakagammadpgpegl	TRUE
aeecahibjjaahmhknkebjaliflah	TRUE
akkaamclmijcaafdomjcajkiapdd	TRUE
bbbijelkclagdpaoaakineamkeco	TRUE
bficlaafancbbakjokahdhlkmnhc	TRUE
bmahagmflcaefgaoopeajfhkjmal	TRUE
cabnndcfkmaaadekjgmobmaaidoc	TRUE
cbcppigkidfaaofcajakpcjdlhjm	TRUE
cdeafdbebceaaidlojnbdbaeifad	TRUE
cfkaanbpnhgcbfnbbgchedaeahdl	TRUE
chleplkafafaifikgnnahnekhidp	TRUE
cjjejcipcammnaaakfocjjbijbpe	TRUE
clmlflpkcahgageaaiecppaafbca	TRUE
coaaobgajacbcalkkppkdlgncoah	TRUE
cpokomfodpahgepmajamabknofko	TRUE
deciheahaljkanjdbkbaafnpagik	TRUE
dmcnafmfkanoeebddnagmjalbhck	TRUE
ecbmoaacedmhaeakhjeapblieljm	TRUE
egcechbccbpbjljaakaaajpdcbmf	TRUE
emocigdfdnaaahllahoonbjjiojp	TRUE
fcehkhcneajkpafbakaciioenlpe	TRUE
fhkkhccmihfnhaiaamiakffjodmd	TRUE
fpcaahmndnbacehkmnomallafimg	TRUE
gdkfaihecaljjjaeafjlaeedjnck	TRUE
glchokajbiapokokfnmmaclaalig	TRUE
hcahjoeaeckiaciioejoopdaogea	TRUE
hgecaacdcflibaioaiggapehfemd	TRUE
hnmifcaaihlnljpnpceecmeaknka	TRUE
icnjijeaacmaiapogcmffaefdodp	TRUE
ijcdaplmlaecmhfalpbbagfahnkf	TRUE
ipjcgancbhbejalnaajabdoaoecb	TRUE
jdojcgdoedahaamknkfclgoliaae	TRUE
jjghfaficaeacgaaiejdhmcheaeg	TRUE
jpbmckcdhaajoockdajeanhamidk	TRUE
kdcecfbnibkphbbhjgogofggmfbb	TRUE
kjpabcgaemaieccflklajkgeapnn	TRUE
lagnhkgciaalfpbknaoenmfhemad	TRUE
lfhmalolmfombcockclaaiogaanb	TRUE
lkjadndenajcjefhpioobgaaaahc	TRUE
mbfmebebmgjojbpljpebkjhilbak	TRUE
mgcfopmgokhhmelialnnkajahakk	TRUE
mmcaempilanjibabkmcanlbibaao	TRUE
ncheahkhacbeelkomfbmfafnakem	TRUE
nijomjjljikjcpjgcamnhgnopaaa	TRUE
noidnloamcmnmingfdfjpaagaaif	TRUE
odkdfklloecleaaahaealehccaji	TRUE
oioljaioacgigkafahekhlbnbaaa	TRUE
opbncifkjdaajniajdcbaakdfcic	TRUE
pdoiiodobfloomcdahaaoaikhjck	TRUE
pjkdlicmohfodamnjoabagmfhabe	TRUE
aaapblddigodkdmkpbhagfkljbkc	FALSE
aemclcaanicjmobbfobokbfgciml	FALSE
akefdpfmeljncpglhoiompafoeoo	FALSE
apdbnoncdlmaieobkblfmchoehkh	FALSE
beibhhgldlkiipijndioaicjlmkf	FALSE
bjkhjimoilbcgohkmpdaaignjejj	FALSE
boegdmigolllmkmajpneadmpglhi	FALSE
ccpkjjibckoandmmklfhkgfiekim	FALSE
chlkocnnnkdciiibfgobgabcamhi	FALSE
cneimlffoceeigpghjcdlakmabkg	FALSE
dcodifgclfokehhkfenopajneihc	FALSE
dilcdmjidahkobjoidfoohigidae	FALSE
docgbkcfpbaiafcfmmbklabnhiel	FALSE
eeaigbgieafibkcaneknfbholfbk	FALSE
einmocpnpiffkjjnacidiejiimko	FALSE
enijheihgeignhlfafiochlnkmfc	FALSE
fdafoladbcdgfpmoocnbgeindjle	FALSE
fiahogeoefndbpnkmenhhaomjgkh	FALSE
fnmpnkflojljpjhcmllgjojcecco	FALSE
gdkopeikkgeahfpkhojafdjjkmjh	FALSE
gifoepmdelmcgjmfaafpbebbkbof	FALSE
gmmjokmokginpkhkhedddlhmglak	FALSE
hcjfigmbjodmmhbndcpkgbdcokkf	FALSE
hhogofehhoifigkjlafpcfhghifp	FALSE
hmpciccfialmjcpjmjcmkfngpfkp	FALSE
ibbmepnmhggflioedoiohhabnkgb	FALSE
ifgbcpjamjiplmegaffhnppidggk	FALSE
ilamlifkchjemoeffleioldpiako	FALSE
ipigdmfbdjjecpiahaobakiddlng	FALSE
jeeoojmlbidmcpgfkdnbpjefmnep	FALSE
jkcpdmdkimcbegapljcmnhokdepa	FALSE
jpdilldfmmdojgmaolbjhfhobjdo	FALSE
kdpkadmidggcknljidbhffnfnged	FALSE
kjbahfcdnkbglcdflanmbofjpdlp	FALSE
kolaibidjmiiinkehpbnkhbpohan	FALSE
ldfbkijjalmdenopcdldgkkblhng	FALSE
likbnldhefnblcoookdkabocacea	FALSE
lnojloajjlpkoekgmbbmhnpnkgia	FALSE
mddpbjkgblcknpnfcdnnhmmdbebl	FALSE
migkpjhfapdjkkodhdgedicbkmpg	FALSE
mnhdennoklpllbaenbeocnfgpmio	FALSE
ndbeckbconiajbipbgcgbkjafedd	FALSE
nhmefcanbdpfjckpafckfocikcno	FALSE
nndideblbcnoapcaejhaolpkhknp	FALSE
ocilbaijoaoicdgnoohbmngljmnm	FALSE
ohijfbkbcccldcocngoebjafondn	FALSE
omhjpgipgbfdhlhmkphhchplikcb	FALSE
pbjmdihneacdkmdkpecniplplpcl	FALSE
pgebenogcaaejnjkemjmmebdhlfb	FALSE
pldepgghhmjhenidfgmjajjoknde	FALSE
aabfaaoilflhakicaieaieiapjadd	TRUE
aefmodocamfeabbnkkbdaanbhaafj	TRUE
akkecmfidaannlddjcaagiihekfag	TRUE
bacaipjehniefilfpkfangehfafma	TRUE
benkejocfibflmggaidgokaaaafoo	TRUE
bjoebikgdeceaabegidhlanpkojla	TRUE
bpebmhheoakjkndjcijmaakboaajm	TRUE
camnafhejmedajaddmhohncgcigja	TRUE
cckepehkflmoaahpaoiaecbegmgfi	TRUE
cfacdfelnfiilalagolpbaaagccep	TRUE
chaimakamhnklgmnanfkaidgekdoj	TRUE
cjalhachlimaafoffffminenfjfka	TRUE
clchaijigacfkijjocbkpkapackim	TRUE
cngodobliefjajifaaaifjlpcadld	TRUE
cpehonjfdagiglgagmcjagapafibh	TRUE
dcifnaaifjaoldeomhgegagamdfnn	TRUE
djecdjpgbeboemnaakhhpakannogl	TRUE
dpcahfaknefmonelmpaeadphllbhf	TRUE
ecpbcahfkhjggiaaeniekaiabcnoh	TRUE
ejjikoocphbmhapadmjjjmohaabca	TRUE
falanenmilfcccngaeganicakknja	TRUE
ffcahjiapmdfobdglbmaamjjblkie	TRUE
fkophkhfphidoapgcaafnakkekoan	TRUE
gbimnbcaapicmhohfoajiaikdmbcp	TRUE
gfjopgcibhefdghaadgepeaaijnki	TRUE
glhofjfoilagfcaphaigodoaleann	TRUE
hcaogamejikfgchbbnbbhijbhkbkb	TRUE
hgledgcbfnbainaeahhpmakdjfhnh	TRUE
hmldcpkdhdjncgglaijagaejnabmb	TRUE
icfmchagilaeodloalmahjinfbhpg	TRUE
ihmcagihnjfmajoipnbocbhanadjk	TRUE
incdphhfnmajolgagofcaajcnmehd	TRUE
jcghjihiiaaoiojbnphecajmnhapk	TRUE
jhobccahdjaaiafeolaofpdpcojgd	TRUE
jockdbnfbogfbkbiomiboplmlebbl	TRUE
kdijcaaokgkbnolaomaejiokphpig	TRUE
klgcipnbaaaajfnahfgmdmjlnpjpd	TRUE
lciahaaagneclpkelfmlcdpljppdb	TRUE
licbfdjialfdobaajpoaeaklmcjnn	TRUE
lojikiemdgdcdalpeabdbgfagfain	TRUE
mdnlfcmlaaocpediaolnfaaniiefe	TRUE
mjeecfhkakmhjhacdijaomgkoaiof	TRUE
mpoolmhbmdckgggaeafacdanalfpo	TRUE
nfccfjjgbalnknoaplljmmaakakng	TRUE
nlohgccjeaapmjiogeeeahddeaoea	TRUE
ocaakednoabiaeblhinapanmfpfjc	TRUE
ohceiealpiohnaidbjeeiecafiaph	TRUE
oolkbmmcagoaopofblaoieabmpaph	TRUE
pdlccppccgoklahflhlalalahaloi	TRUE
pkaagchaaemaafddhmokjdmnnmnde	TRUE
aaapkgppfldmgkgkkdimekcodifpj	FALSE
affafhkkhpkbbhjbabbaoblnbhenn	FALSE
akcpefhkjiekgccnmecpancgdgpga	FALSE
apdkfndocebgijkiodldmecfebfna	FALSE
begkaflgmpihnljohbdfggekedede	FALSE
bjjkhdakpjdmmdkklofmkhflfkfpj	FALSE
bohmloojohabakadfpjnnebnogjma	FALSE
cefpbbbkjlhflodbnjpkcffbjflik	FALSE
cjfkpbdpeelodiddfimepkhpppflc	FALSE
cpmbjfcillphcbhbfoeiogdlhgocb	FALSE
dehobicmdknoinofchcpmmfkceioe	FALSE
djjgdfehbjchlddmdbpdeeikcpbfi	FALSE
dolplediomgfpnnceokdmafdpedio	FALSE
edomkbinlmhpmpaobegjjpellbcon	FALSE
eihnijbgmogcdafmenipidcdjjnoa	FALSE
enhmokjcggfoinojjikdljildeona	FALSE
fcbenmkpmkkeidgmaibhfjkehfdal	FALSE
fhemabolhojcjgidmfplmeddmfofa	FALSE
fmmbljdgoljnjblhcechjmlibhnif	FALSE
gcbeoghnkmaeeenjenjdoadoggdmg	FALSE
ggjdfkdihfpjnhkbichkfmjkgjbfh	FALSE
gnaafmelijpjccifkijgoleapemca	FALSE
hdchhlniodnkndailafocmcleongi	FALSE
hinpanmohmkggkfjjojdghompfkdo	FALSE
hnnepdloiepabcmliikfcjphmccha	FALSE
ichaebkgckillhakdbhkajcnloada	FALSE
ihdpfbphmkedjlmgincgkfmljhlio	FALSE
ilpbahfpebabmcjboabmponnkoogb	FALSE
jcemlmojemibndhllmpcbaiacodan	FALSE
jhibnfgbpeflhegmkpgeeciggpfja	FALSE
jmgfdhhapijmkfpdajfiahgobkiad	FALSE
kbjcdkhocnjgfkmfpepnbheondlpo	FALSE
kgmjpihgbjdjhgkbjpdhlhfpakhbo	FALSE
klmomgphfelbheffajhgaknjdnlbl	FALSE
laeblcmfkmeagmccpombphkgiocfe	FALSE
lfgamccenhijibpdlnfoklkgeghmi	FALSE
ljolmgngdegmjjjpabkadojlnjjah	FALSE
lpijggckammojcdblpgmfnpojmmab	FALSE
mdnolfboacfmldilnhjecjmjooklb	FALSE
mjbfadlafigeooieeobiooljkaohk	FALSE
mnnjncfdhlicioinjiconfgegfpei	FALSE
ndhpaplpkhkjpgkamfekfcihacgdi	FALSE
nilfkanaiglpnnmojpljgcihhmlge	FALSE
nniakeclhocamkgeehcmiceehhdah	FALSE
ocgljcolnfjabbcbemhdoadhncfol	FALSE
ohfdpelebabmhfekjgngniohmklco	FALSE
omegalefiebgnoggndnbfkogbokpl	FALSE
pamglmjanachehoicioghoebnjgpf	FALSE
pgcgdbamdhkjcfkeanlelcgpcgagk	FALSE
plekhgjgcckenljdncognbinljlkg	FALSE
