aajkkjdmkllnlcgpmkdfdajaoajdmhp	FALSE
hafliloegdnhclalcdmfibfnpfcpglj	FALSE
npacjlhaoigbncdkfhepapgkekbeail	FALSE
aakchfbkdajenflcageoknfhmkhmkok	FALSE
akhjmapafkbohiafdndjlgagmmpbebi	FALSE
aokiocehlbkahmalmdokdaejhnlcaen	FALSE
aglffnbglonkknnaakfdpoclhiakkdj	FALSE
amhpgnocicclllkkhhnogdlnagekfil	FALSE
apilpoeihghhldmghbehibhbgdbgpkh	FALSE
adbkoldbdkkblnddfodnhagjchdhmlk	FALSE
hagklbcdfkfhdkebjjnghjeoljnhpcf	FALSE
hnjadpmlollldohcpfapaflfaelagbg	FALSE
iacnjejhlancllkcmnbhempmkhoghmg	FALSE
iphkmakjajmejemjljdffhojjplbold	FALSE
jilliadlklobgpdokdhhdcamioaffll	FALSE
kiajlhjcedhhelddmgajkgnilcibcbm	FALSE
kkoalecbjcpmjpljnmdnhahjpjgbial	FALSE
laijdeifjhjgmmacgaligbefnlbbhib	FALSE
loanofhnoaclggglakkfemkpdkffgoj	FALSE
milaiifaepahadfcchfodfnplhijpoj	FALSE
naolgkaddmdjniibfpljgaliadagokn	FALSE
njannioldpedkgplllomapfoepgioja	FALSE
oanajpjlgnjfjpkcolkfgellgjpeiog	FALSE
omladdhekcllbdplehdchehlbdnfhai	FALSE
papcbnicpjcngelgbmdifddlibbmlhd	FALSE
baajkkjdmkllnlcgpmkdfdajaoajdmhp	TRUE
dhafliloegdnhclalcdmfibfnpfcpglj	TRUE
fnpacjlhaoigbncdkfhepapgkekbeail	TRUE
aakchfbkdajenflcabgeoknfhmkhmkok	TRUE
akhjmapafkbohiafdndjlgammpbebi	TRUE
aokiocehlbkahmablmdokdaejhnlcaen	TRUE
aglffnbglonkknnaabkfdpoclhiakkdj	TRUE
bmhpgnocicclllkkhhnogdlnagekfil	TRUE
gpilpoeihghhldmghbehibhbgdbgpkh	TRUE
mdbkoldbdkkblnddfodnhagjchdhmlk	TRUE
hamklbcdfkfhdkebjjnghjeoljnhpcf	TRUE
hnjadpmlollldohcpfapaflfaelaibg	TRUE
igcnjejhlancllkcmnbhempmkhoghmg	TRUE
iphkmakjajmejemjljdfahojjplbold	TRUE
jilliadlalobgpdokdhhdcamioaffll	TRUE
kciajlhjcedhhelddmgajkgnilcibcbm	TRUE
kkdoalecbjcpmjpljnmdnhahjpjgbial	TRUE
laijdeifjhjgmmacgaligbefnlabhib	TRUE
ldanofhnoaclggglakkfemkpdkffgoj	TRUE
mildiifaepahadfcchfodfnplhijpoj	TRUE
faolgkaddmdjniibfpljgaliadagokn	TRUE
njnnioldpedkgplllomapfoepgioja	TRUE
oanajpjblgnjfjpkcolkfgellgjpeiog	TRUE
obladdhekcllbdplehdchehlbdnfhai	TRUE
papkbnicpjcngelgbmdifddlibbmlhd	TRUE
aagdokknoihngggklpaljgkapkoficfd	FALSE
agipaglfmhebecehbkedhfngnibebjcb	FALSE
lhnlaklfckgbgnofoijhgolaeghbaiip	FALSE
aacbidmmpihpfohhlephnlbdohlpbfga	FALSE
alpljdaemkingjdnnaemoolbomgdlnlf	FALSE
aonkchhlcfnikdkkpmfeimbedolidoco	FALSE
afmjbmnoahpmhlaafhjpbjooicddgcpg	FALSE
apnjpdiffnplhdbpfjhceibcminmjide	FALSE
ahcjcgkhkgpeaohjljmnlljnlkecmojp	FALSE
acckjfjmobohkaooalkgmfpnfiimpooh	FALSE
hhjaidhaaffodjeapfkimojjncghbbgi	FALSE
iijahihcgmiccaglmhadeeadijhlaihm	FALSE
ijnladmgmhiiceeobnhnjnomcadlhdja	FALSE
jamjjadejjpcijgpinkkpbbbbjdbcjie	FALSE
jjaejkncmlholkookbfooladpifiicac	FALSE
kagoeieoajdcjflhbkihdhkmnhhidpop	FALSE
kknpknaephhoaoagjgajgeedoafbhdkk	FALSE
laalnkmcheegkcogaehmipnaaafjinjb	FALSE
lmakpeljaegbnnnebncfacihgiijdkop	FALSE
macfobkkbklhoollhidhbogjpnfeepfn	FALSE
moaebfbldniilgdfjgchnmpbiifcopfi	FALSE
niadhphepaeglgmbkdnfeofjecppeccd	FALSE
oajepdbnfjidgclcncemalnndohajmhn	FALSE
omalhdkjmibcofdgagiepboifpnkhebe	FALSE
paffinmjjbkmijldkkdekeoeddoiefbi	FALSE
baagdokknoihngggklpaljgkapkoficfd	TRUE
dagipaglfmhebecehbkedhfngnibebjcb	TRUE
flhnlaklfckgbgnofoijhgolaeghbaiip	TRUE
aacbidmmpihpfohhlephnlbdahlpbfga	TRUE
albpljdaemkingjdnnaemoolbomgdlnlf	TRUE
aonkchhlcfnikdkkpmfeaimbedolidoco	TRUE
afmjbmnoahpmhlbafhjpbjooicddgcpg	TRUE
cpnjpdiffnplhdbpfjhceibcminmjide	TRUE
ihcjcgkhkgpeaohjljmnlljnlkecmojp	TRUE
occkjfjmobohkaooalkgmfpnfiimpooh	TRUE
hhjaidhaaffodjeapfkimojjncgahbbgi	TRUE
eijahihcgmiccaglmhadeeadijhlaihm	TRUE
ignladmgmhiiceeobnhnjnomcadlhdja	TRUE
jbamjjadejjpcijgpinkkpbbbbjdbcjie	TRUE
jjaejkncmlhoalkookbfooladpifiicac	TRUE
kcagoeieoajdcjflhbkihdhkmnhhidpop	TRUE
kknpkcnaephhoaoagjgajgeedoafbhdkk	TRUE
laalnkmcheegkcogaehmipnaaanjinjb	TRUE
lmakpbeljaegbnnnebncfacihgiijdkop	TRUE
macfoabkkbklhoollhidhbogjpnfeepfn	TRUE
mocaebfbldniilgdfjgchnmpbiifcopfi	TRUE
nikdhphepaeglgmbkdnfeofjecppeccd	TRUE
ojepdbnfjidgclcncemalnndohajmhn	TRUE
ommlhdkjmibcofdgagiepboifpnkhebe	TRUE
phffinmjjbkmijldkkdekeoeddoiefbi	TRUE
aaejcmllaejhojonhpiimeieohodcmgib	FALSE
hmknajomndmhinljpioibhebemcngcich	FALSE
miaeooiddpmbkebmcjgadhpfljfnhgnoc	FALSE
aalpkammcfcngidcibbphbcjlbjfeneda	FALSE
ajoeddgflefpcmanckkeobekhgpddgjkl	FALSE
andnnifhpdcbigcgmmcbcidcppagdoeli	FALSE
adhopaldkkhgoclcehgpoklnpplapkelb	FALSE
aifcdofphobiehpfmnppmjgkkmgndjlbp	FALSE
acdmnhgfddidoccgfojfiagllpjnajnhk	FALSE
aedobgjchlbdpfniedlmdefgmlmdccakg	FALSE
hacmofblchhllhfbccknhiggmnlolbcnf	FALSE
iaocllnkjpldlidhdemoeefklnoeekpib	FALSE
ikhmlaojgbbmhokpjdjjdgbjfbolelinn	FALSE
jomhaehgoebgpfglidccfcdainmhclmin	FALSE
jmjaepoblnikjojdngcfegkjhbpgcaegc	FALSE
kakfffgkhggbepipepkeonnpbcjnlmajl	FALSE
lhpangomadeipiilpoiifpboonnhkgajk	FALSE
ljiaamemfkdjdbnnbcnpfmbngdpgjlbcj	FALSE
makfapgijnkbappjpiemacmpkenocgoif	FALSE
mnnaaicjhbgaidaeapfjmhhnpmjelllnd	FALSE
nhijjkmacgfigdpkglojmkifibnfoppfp	FALSE
nophainndepnmoomkhpbpnlhgiomglflf	FALSE
oaglpgokaldjiieffddmcjgpihcfnfiin	FALSE
opnphandmeilclbhlihokocdlpijkhlgd	FALSE
piadiepjpcbhlienclagmlkcgjflbcjho	FALSE
baaejcmllaejhojonhpiimeieohodcmgib	TRUE
dhmknajomndmhinljpioibhebemcngcich	TRUE
fmiaeooiddpmbkebmcjgadhpfljfnhgnoc	TRUE
aalpkammcfcngidcibbphabcjlbjfeneda	TRUE
ajoeddgflefpcmanckkeoabekhgpddgjkl	TRUE
andnnifhpdcbigcgmmcbcidcppabgdoeli	TRUE
adhopaldkkhgoclcehgpoklnpplapkblb	TRUE
bifcdofphobiehpfmnppmjgkkmgndjlbp	TRUE
gcdmnhgfddidoccgfojfiagllpjnajnhk	TRUE
nedobgjchlbdpfniedlmdefgmlmdccakg	TRUE
hmcmofblchhllhfbccknhiggmnlolbcnf	TRUE
faocllnkjpldlidhdemoeefklnoeekpib	TRUE
ikhmlaojibbmhokpjdjjdgbjfbolelinn	TRUE
jgomhaehgoebgpfglidccfcdainmhclmin	TRUE
jmjappoblnikjojdngcfegkjhbpgcaegc	TRUE
kokfffgkhggbepipepkeonnpbcjnlmajl	TRUE
bhpangomadeipiilpoiifpboonnhkgajk	TRUE
ljbaamemfkdjdbnnbcnpfmbngdpgjlbcj	TRUE
makfapgajnkbappjpiemacmpkenocgoif	TRUE
mnnaaicahbgaidaeapfjmhhnpmjelllnd	TRUE
nhigjjkmacgfigdpkglojmkifibnfoppfp	TRUE
nofhainndepnmoomkhpbpnlhgiomglflf	TRUE
opglpgokaldjiieffddmcjgpihcfnfiin	TRUE
opnphandmeilcabhlihokocdlpijkhlgd	TRUE
pibadiepjpcbhlienclagmlkcgjflbcjho	TRUE
aaoiiihhcbgapaelojpocbdphmiljcapno	FALSE
ajogljpdmlipmlfghcnbnkhincioebaddj	FALSE
imiadldlmipijbijkcaejhkpihpcghcbhj	FALSE
apdhmpghjchniidmdeaphkndlgbmdepjlg	FALSE
ajnjggpniccndenliecgbpjcjioafkfgde	FALSE
ankdaajoipigodgbeahldohlaacibhlnne	FALSE
acbdandlcbndcadbjncnilgkfliegecnjb	FALSE
aggiaebcmceaamlnhhneadlkadjlkfmpek	FALSE
aolkjcbdelaekeipdhphokncnidllkjpod	FALSE
anihpjojkidneikcckdnmanfpinieenofo	FALSE
hahocaomdcjkkdiijcecejmoidlnkakcad	FALSE
hmakkhikkllnhhmndcingnjhnnembogfjo	FALSE
ihhhpaogkhfihekjolhpjlkcbnaeadbhbf	FALSE
jonlphahcpkooepbloaomipiafnelgknbo	FALSE
jioajiloioinamoajmfndikbnjknpehfhi	FALSE
kahijlkcagbejhcfeeibljdcpceahcbeia	FALSE
kmjijhaffjgbflicgkcngbiikdcdagbgpc	FALSE
lacbchapociinlbheiggemahoachjeoaeb	FALSE
lomaehbbhfgflpdbchglmdgokgdljgmaoc	FALSE
mhjkhhaaehmhdejmdaeanlglmfkheljbnh	FALSE
napkfbccgobhdlbfmcpogokpkhkajigkob	FALSE
nkjlhaefjaidajdaicmdjlmicjjbgpnblo	FALSE
oaapfgleflpggicofflbfbfgbckiohmphh	FALSE
omoaimhhcgoemfcdeajdpnoinblhddmbnp	FALSE
pacnfokpnogpmefmlgacjflgnlhgfillhe	FALSE
baaoiiihhcbgapaelojpocbdphmiljcapno	TRUE
dajogljpdmlipmlfghcnbnkhincioebaddj	TRUE
fimiadldlmipijbijkcaejhkpihpcghcbhj	TRUE
abpdhmpghjchniidmdeaphkndlgbmdepjlg	TRUE
ajnjggpniccndenliecgabpjcjioafkfgde	TRUE
ankdaajoipigodgbeahldohlaahibhlnne	TRUE
acbdanblcbndcadbjncnilgkfliegecnjb	TRUE
aggiaabcmceaamlnhhneadlkadjlkfmpek	TRUE
eolkjcbdelaekeipdhphokncnidllkjpod	TRUE
lnihpjojkidneikcckdnmanfpinieenofo	TRUE
hahocaobmdcjkkdiijcecejmoidlnkakcad	TRUE
hmkkkhikkllnhhmndcingnjhnnembogfjo	TRUE
ihhhpeogkhfihekjolhpjlkcbnaeadbhbf	TRUE
bonlphahcpkooepbloaomipiafnelgknbo	TRUE
jioajiloioinaboajmfndikbnjknpehfhi	TRUE
kahijlkcagbejhcfeeibljdcpceahkbeia	TRUE
kmjijhgaffjgbflicgkcngbiikdcdagbgpc	TRUE
lacbchapociinlbheiggemabhoachjeoaeb	TRUE
lofaehbbhfgflpdbchglmdgokgdljgmaoc	TRUE
mbjkhhaaehmhdejmdaeanlglmfkheljbnh	TRUE
eapkfbccgobhdlbfmcpogokpkhkajigkob	TRUE
nkjlhaefjaidajdaicmdjlmicjjbgpablo	TRUE
oaapfgleflpggicoffabfbfgbckiohmphh	TRUE
oboaimhhcgoemfcdeajdpnoinblhddmbnp	TRUE
pkcnfokpnogpmefmlgacjflgnlhgfillhe	TRUE
aanmjacjfnfnpifpdkblbkekjbjhfeikdfj	FALSE
adfakkaoojjjdejjlgagflhleocbimakmop	FALSE
algcjfkkmghhkmkojphlgmdgoilfkejcpkl	FALSE
ahagihipienadaciaohgokmggoapegajaho	FALSE
alickogpinidlhkilpimkiimhmdboblhfao	FALSE
aoeiadekiklkmmhfeocchigdhmgigcibnng	FALSE
aehpmpafdlbpkacboffjcbdkkohnmnjggmf	FALSE
aijmgpfcfdifkblpmmijappfkblbmipibhh	FALSE
aoloiebanhpkmhmjhjpnkjjfnhpmahlikpf	FALSE
aoncjkiaoifpmjnfofkfpbafcjpnfehokhf	FALSE
hhiafpefdbjmiknbibkkpgplbpbfcfobgpj	FALSE
iaacobncjieenfbplhhlcnlekdcnjbgdike	FALSE
ikaijckochnanpmejcghcfcjfjoenmlcokn	FALSE
jmjlagaihoajefaoidifpnmhmiakcngoomn	FALSE
jknlhmhmmagfblggegeebdpgdmgkfddjnil	FALSE
kaccaomjnlnflmhicpmjbiaaohkikodhilb	FALSE
koakpmlcdlhedlcahlmdaddneiajaefmpbc	FALSE
lihoahloidmihfkocmeijagpophgjioblpj	FALSE
mninpkjamghopjigbkmehijfcfgbgkcgpej	FALSE
mlanephglknjnnlloafpndlfmmojfiopobi	FALSE
naljlcaileonjlpibakhnpacfckgjolndla	FALSE
nmjaanooifmlbaelbpodgjdmdmlppkadedk	FALSE
oahcjpbplnligoigeengkilpppkkcpbhebd	FALSE
opjimkknnlackbehgaoipdmincdfilkbepk	FALSE
pimahfdmppiponichcfahpimcmcbdfpkfpm	FALSE
baanmjacjfnfnpifpdkblbkekjbjhfeikdfj	TRUE
dadfakkaoojjjdejjlgagflhleocbimakmop	TRUE
galgcjfkkmghhkmkojphlgmdgoilfkejcpkl	TRUE
ahagihipienadaciaohgokmggoapegabjaho	TRUE
alickogpinidlhkilpimkiimhmaboblhfao	TRUE
aoeiadekiklkmmhfeocchigdhmgigciabnng	TRUE
aehpmpafdlbpkaaboffjcbdkkohnmnjggmf	TRUE
dijmgpfcfdifkblpmmijappfkblbmipibhh	TRUE
ioloiebanhpkmhmjhjpnkjjfnhpmahlikpf	TRUE
poncjkiaoifpmjnfofkfpbafcjpnfehokhf	TRUE
hhinfpefdbjmiknbibkkpgplbpbfcfobgpj	TRUE
ibaacobncjieenfbplhhlcnlekdcnjbgdike	TRUE
ikaijckochnabnpmejcghcfcjfjoenmlcokn	TRUE
jdmjlagaihoajefaoidifpnmhmiakcngoomn	TRUE
jknlhmhbmagfblggegeebdpgdmgkfddjnil	TRUE
kaccaomjnlnflmhicpmjbiaaohbikodhilb	TRUE
koakbmlcdlhedlcahlmdaddneiajaefmpbc	TRUE
liheoahloidmihfkocmeijagpophgjioblpj	TRUE
mdninpkjamghopjigbkmehijfcfgbgkcgpej	TRUE
mdanephglknjnnlloafpndlfmmojfiopobi	TRUE
naljlcaileonjlpibakhnpbcfckgjolndla	TRUE
nmjeanooifmlbaelbpodgjdmdmlppkadedk	TRUE
onhcjpbplnligoigeengkilpppkkcpbhebd	TRUE
ogjimkknnlackbehgaoipdmincdfilkbepk	TRUE
pimahfdmppiponichcfahpimcmcabdfpkfpm	TRUE
aakfcmpiigcmfohclnepjkmegbkkgpbnfdkm	FALSE
agkgmncnkgdnlpddeicoeejacmhonihfgfjd	FALSE
kacchmpconamhhmagpmbemafniaeekjjhaao	FALSE
aalnmjigpndmaejkimaahfboahdlibfogiln	FALSE
ajnnaehjcolpdoiokfaghhfkgfkpkmfhlhce	FALSE
amphofdfdigkccgaeibpcgkfacpfjecfehbm	FALSE
acfnademkcalelhandlokpjdfjhgjleebefo	FALSE
addpfnjecjhgmojmpcnfcchkbkjdahanpebj	FALSE
anciinaogkndjoliadmbmdocmaepmffdchnp	FALSE
aemhicomognlihgkkepieebacapdijmpdmmb	FALSE
hajffnbckjfbbcjiaklgoklmmcmanoejekpf	FALSE
hmnjjiaehljpdppoocghgmlcgbdfbmldoaoc	FALSE
iahebmmpgdmojibedmfnknakpffihcdkchdf	FALSE
jmnagodenalmepipnaannhdonkmcgcdjbegg	FALSE
jkjioilhakcdjkealfjcopejenoljgaiegfk	FALSE
kaoknoalcpeianandiiokoenkkbkpoehobdg	FALSE
koaagdlagfcbmdohkilibdkddnmngilbfejo	FALSE
ladgbfckjbfafimghdljlgnckfeoneigbeal	FALSE
lpnkalpifkkaohcgpmldlnafecejpnnihfdo	FALSE
mhnacbhkpkkgeedbbdgbdcjdaiecmhfkfjjf	FALSE
nmloaocmonbkajclggcjpikngmcgbkjemmeb	FALSE
njlamgkkbfkmpppilmlnfcbigbmknfiobdcb	FALSE
oahlffcbneonmcangpflnmnkgjhephifdloc	FALSE
ooahanogkincfbjgpncfjdejdlmkkcbekklh	FALSE
pikafdbleecligmmdfooijgkdengdncocona	FALSE
baakfcmpiigcmfohclnepjkmegbkkgpbnfdkm	TRUE
dagkgmncnkgdnlpddeicoeejacmhonihfgfjd	TRUE
fkacchmpconamhhmagpmbemafniaeekjjhaao	TRUE
aalnmjbgpndmaejkimaahfboahdlibfogiln	TRUE
ajnbaehjcolpdoiokfaghhfkgfkpkmfhlhce	TRUE
amphofdfdigkccgabibpcgkfacpfjecfehbm	TRUE
acfnademkcalelhanblokpjdfjhgjleebefo	TRUE
addpfnjecjhgmojmpcnfccahkbkjdahanpebj	TRUE
fnciinaogkndjoliadmbmdocmaepmffdchnp	TRUE
lemhicomognlihgkkepieebacapdijmpdmmb	TRUE
hajffnbckjfbbcjiaklgoklmmcmanobjekpf	TRUE
hmndjjiaehljpdppoocghgmlcgbdfbmldoaoc	TRUE
idhebmmpgdmojibedmfnknakpffihcdkchdf	TRUE
cmnagodenalmepipnaannhdonkmcgcdjbegg	TRUE
jkjigilhakcdjkealfjcopejenoljgaiegfk	TRUE
kaoknoalbpeianandiiokoenkkbkpoehobdg	TRUE
kdaagdlagfcbmdohkilibdkddnmngilbfejo	TRUE
lldgbfckjbfafimghdljlgnckfeoneigbeal	TRUE
lpenkalpifkkaohcgpmldlnafecejpnnihfdo	TRUE
mhnaabhkpkkgeedbbdgbdcjdaiecmhfkfjjf	TRUE
emloaocmonbkajclggcjpikngmcgbkjemmeb	TRUE
njgamgkkbfkmpppilmlnfcbigbmknfiobdcb	TRUE
oablffcbneonmcangpflnmnkgjhephifdloc	TRUE
odahanogkincfbjgpncfjdejdlmkkcbekklh	TRUE
pbkafdbleecligmmdfooijgkdengdncocona	TRUE
ahndgcpljjniokbagfkimlneoanckikdibfmo	FALSE
halgepapcichjpahnmndhgmmgngnoagljghaf	FALSE
amckchdpcpahidclppjcempmbocddnffjbobi	FALSE
ahagdhhlpbfnocgefbonfdemfiikmcfgaikho	FALSE
alaahjnnlfbgfkdkappjeegpjpblcdpomjdln	FALSE
aopldgdnmkadokklbcgdkkdibbhhmfgigmnch	FALSE
aeefeboplhkibmkeekmikbdldegdncnlmjmoa	FALSE
aglbjpoifpkonbgipcecbkmbfcbjjijboceba	FALSE
apeknecfkkdgfaemkfjfgllfgmieemgimnhlo	FALSE
angekbmdbibhlkfehglelgbbaajmfondfkhce	FALSE
hhkaocimjpegfphgnlofcinnihgdjbfdbghef	FALSE
hpanpennjadjjcaeaappcbenhljccmoigggoo	FALSE
ijhkainmpogpdkehlekhlmpibnhimgdjcgdnl	FALSE
jjhjjmkiaofedldipkfeepjemfaoijcigfbdl	FALSE
jlialeofjmfhgkcnofogmamnmlgfjhjbhgaih	FALSE
kaomioflclgoepflfgcoakgdjianhidebjphg	FALSE
kpajnmkegmninkpmghknejeighcgbekmncfhj	FALSE
lhmlhhlahhhchefngjfgnilakklakcmifhckd	FALSE
lpafbbgaejdodiebnbpngcffnaeadhkaikpmd	FALSE
miadippfheomlmleahofeihpjibpihjdgndid	FALSE
niaggojelkbkbacmcmelclgoiebneikdmonme	FALSE
nladfcifapniphjmkdjhfbnickgehkcefnmoe	FALSE
oaoloflnpkckoihacbopebbmnibgfnbajcgcb	FALSE
omolagfdamdlohaajkdbmhobppcnfhcdheidh	FALSE
pagogiodafhnleinmgnjicffdpoeeohnbfehp	FALSE
bahndgcpljjniokbagfkimlneoanckikdibfmo	TRUE
dhalgepapcichjpahnmndhgmmgngnoagljghaf	TRUE
gamckchdpcpahidclppjcempmbocddnffjbobi	TRUE
ahagdhhlpbfnocgefbonfdemfiikmcfgaikhob	TRUE
alaahjnnlibgfkdkappjeegpjpblcdpomjdln	TRUE
aoplbdgdnmkadokklbcgdkkdibbhhmfgigmnch	TRUE
aeefeboplhkibmkeekmiakbdldegdncnlmjmoa	TRUE
bglbjpoifpkonbgipcecbkmbfcbjjijboceba	TRUE
hpeknecfkkdgfaemkfjfgllfgmieemgimnhlo	TRUE
ongekbmdbibhlkfehglelgbbaajmfondfkhce	TRUE
hhkkocimjpegfphgnlofcinnihgdjbfdbghef	TRUE
hpabpennjadjjcaeaappcbenhljccmoigggoo	TRUE
ijhkdinmpogpdkehlekhlmpibnhimgdjcgdnl	TRUE
jgjhjjmkiaofedldipkfeepjemfaoijcigfbdl	TRUE
jlialeofjmfhgkcnofogmamnmlgfajhjbhgaih	TRUE
koomioflclgoepflfgcoakgdjianhidebjphg	TRUE
kgajnmkegmninkpmghknejeighcgbekmncfhj	TRUE
lbmlhhlahhhchefngjfgnilakklakcmifhckd	TRUE
lpafbbgaejdodiabnbpngcffnaeadhkaikpmd	TRUE
micadippfheomlmleahofeihpjibpihjdgndid	TRUE
ndiaggojelkbkbacmcmelclgoiebneikdmonme	TRUE
nlldfcifapniphjmkdjhfbnickgehkcefnmoe	TRUE
oaoloflnpkckoihambopebbmnibgfnbajcgcb	TRUE
omolagfdamdlohaajkdbamhobppcnfhcdheidh	TRUE
plgogiodafhnleinmgnjicffdpoeeohnbfehp	TRUE
aaonldbldjdcepnjgjodckainmjhfplkplkogg	FALSE
agjdcpelodiongehipojjhpjkdjapmnpghdmbg	FALSE
apeekokjhddokadhfbejlbgmdojndikbhljopf	FALSE
ahjloocdlocejblnnhhmompmejgmaphebiajnh	FALSE
almjkadpmfljlkbilhcpejohhgdfmgbdlmnble	FALSE
aocfoocjmoibbilomgenaldgipkkldaeeojmde	FALSE
acpfignjigddgaocbkeahongbjpebhlgbongcl	FALSE
agkpfijggfcpibememacgkpnllbchgmllmbidd	FALSE
aagehkgeemhjckihbofnohhaoedpedpnmidnng	FALSE
apiddbfodcmefkifelhflijaafigomogmhknhf	FALSE
haoijpgnmmpbkehpfoiggipjcjjjnmgjgiajpo	FALSE
hnplomadbdiajokjjoofggpppplcnppbfjiojd	FALSE
ianhchcacnbhcilljjbdkffombkedfbgngmggi	FALSE
ipadmccoenecbmkgdbfeippaenhhfmjpdofjdl	FALSE
jhnkijkihpaiheccnbnflhnodggcjkgcdhgdap	FALSE
knijaclhofndbocpbkmicgjbmhdkanjngkmpem	FALSE
kjklahneajcbjafckfhlccnnahfapkaammpink	FALSE
lacgoeikafkeojhgaoogenpocapkecebcaifdj	FALSE
llkahefomihhonllkbnafhhcpchkbnohogdjkk	FALSE
mafkoegmhocdlifkadehfbidbgfbgmbobgaapn	FALSE
naefjnngmlcigbbajemgclpalpjcpfjocohokc	FALSE
nkkjjaccndeildclklhmblkfffkoaljlngaijl	FALSE
oahdbgohpcbepnmapaojjpgdobndjnokfhhdgo	FALSE
omaembnmpojenohdibhmgnfgcjmkofaaeebnbe	FALSE
paegjfkmacokclmokflejjjankidnijchiknfi	FALSE
baaonldbldjdcepnjgjodckainmjhfplkplkogg	TRUE
dagjdcpelodiongehipojjhpjkdjapmnpghdmbg	TRUE
gapeekokjhddokadhfbejlbgmdojndikbhljopf	TRUE
ahjbloocdlocejblnnhhmompmejgmaphebiajnh	TRUE
abmjkadpmfljlkbilhcpejohhgdfmgbdlmnble	TRUE
aobcfoocjmoibbilomgenaldgipkkldaeeojmde	TRUE
acpfignjigddgaocbkeahonhbjpebhlgbongcl	TRUE
abkpfijggfcpibememacgkpnllbchgmllmbidd	TRUE
gagehkgeemhjckihbofnohhaoedpedpnmidnng	TRUE
mpiddbfodcmefkifelhflijaafigomogmhknhf	TRUE
haoijpgnmampbkehpfoiggipjcjjjnmgjgiajpo	TRUE
hnplomddbdiajokjjoofggpppplcnppbfjiojd	TRUE
ilnhchcacnbhcilljjbdkffombkedfbgngmggi	TRUE
ipadmccoeneabmkgdbfeippaenhhfmjpdofjdl	TRUE
jhdnkijkihpaiheccnbnflhnodggcjkgcdhgdap	TRUE
bnijaclhofndbocpbkmicgjbmhdkanjngkmpem	TRUE
kjdlahneajcbjafckfhlccnnahfapkaammpink	TRUE
lcgoeikafkeojhgaoogenpocapkecebcaifdj	TRUE
llkahefomihhonllkbnabhhcpchkbnohogdjkk	TRUE
mhfkoegmhocdlifkadehfbidbgfbgmbobgaapn	TRUE
caefjnngmlcigbbajemgclpalpjcpfjocohokc	TRUE
nkgjjaccndeildclklhmblkfffkoaljlngaijl	TRUE
oahdbgohpcbepnmapaobjjpgdobndjnokfhhdgo	TRUE
omaembnmpojenohdiabhmgnfgcjmkofaaeebnbe	TRUE
pmegjfkmacokclmokflejjjankidnijchiknfi	TRUE
aagniffmdjecelbcmnpcdeckjimjeiiflhbogee	FALSE
aghhckigppkkghioibanelhnlmjclhfnjgfapkk	FALSE
moammhiagbjcmldhbnjgfnemcpjdfmkgkndknli	FALSE
ahokjdlaimookclkbmlmjooflfnijnhkggocbhg	FALSE
akeghifhilehmncnmahfhhoblcohehgndjmjnen	FALSE
angjhenieimljdollidekpconfkblmalienlbco	FALSE
afaommdhoemicjbolhlbknncikenjjjkegohmgi	FALSE
acjbkmgkeoalemokifdidopehaadgclghcanlnp	FALSE
afeacodogmhaddoojaidognlgbghhhelaccpnop	FALSE
afjpomnojlpjdcgimhfdomkkifjinckpfdmngon	FALSE
hahakddpbfenbcgcfhdeldibpclaedpccmmcgll	FALSE
hmpljmpoonamlmecmmgclhmcdgccbmpdmmgjkop	FALSE
iamonplcjpignhjbfhohbkdmjekchcnljlajcng	FALSE
ipkiloafpiijmeepnopebilfbkkjjbeggolkdhe	FALSE
jadlocogplajkofiimpmhhbljjekfiefigenfgj	FALSE
kalgnjacakelkkniekccalnnmgjdpkapoeokbjj	FALSE
kkpomlapogfnmpdmahkjjgcngahlcbbbdcfdlie	FALSE
lagnlhjnhokkniaipgcgfhklcflbmlhkaachaek	FALSE
lnaokomammlfmeogbcnoemjmddnmadnelihcblh	FALSE
mhiipajfdcncdionfhkjgpclindbgfjkfkmoifm	FALSE
nkaemhdeeiijclhjjeplkldbhogpcgfdmhpjhpb	FALSE
nkmaaanepgjnflcimgkmecgfokghbpmfhbbfbhe	FALSE
oanmikcpmfhgjemhgjajpahpnogakmmkckiodlg	FALSE
onpacfkeeejmepdpjpnadhhcihadffcnhpojlbn	FALSE
pajheaanelognmmlbinpmpbaangpmddnokhbfoh	FALSE
baagniffmdjecelbcmnpcdeckjimjeiiflhbogee	TRUE
daghhckigppkkghioibanelhnlmjclhfnjgfapkk	TRUE
fmoammhiagbjcmldhbnjgfnemcpjdfmkgkndknli	TRUE
ahokjdlaibmookclkbmlmjooflfnijnhkggocbhg	TRUE
akeghifhilehmncnmahihhoblcohehgndjmjnen	TRUE
angjhenieimljdollidekpconfakblmalienlbco	TRUE
afaommdhoemicjbolalbknncikenjjjkegohmgi	TRUE
acjbkmgkeoalemokifdidopehaadgclghcanbnp	TRUE
ffeacodogmhaddoojaidognlgbghhhelaccpnop	TRUE
lfjpomnojlpjdcgimhfdomkkifjinckpfdmngon	TRUE
hfahakddpbfenbcgcfhdeldibpclaedpccmmcgll	TRUE
hmpljmpoodnamlmecmmgclhmcdgccbmpdmmgjkop	TRUE
iamonpbcjpignhjbfhohbkdmjekchcnljlajcng	TRUE
ipfkiloafpiijmeepnopebilfbkkjjbeggolkdhe	TRUE
jodlocogplajkofiimpmhhbljjekfiefigenfgj	TRUE
dalgnjacakelkkniekccalnnmgjdpkapoeokbjj	TRUE
kkpomblapogfnmpdmahkjjgcngahlcbbbdcfdlie	TRUE
lagnlhjnhokkniaipgcgfhklcflbmlhkaachabek	TRUE
lnaokbmammlfmeogbcnoemjmddnmadnelihcblh	TRUE
mhfipajfdcncdionfhkjgpclindbgfjkfkmoifm	TRUE
fkaemhdeeiijclhjjeplkldbhogpcgfdmhpjhpb	TRUE
nkcaaanepgjnflcimgkmecgfokghbpmfhbbfbhe	TRUE
oabmikcpmfhgjemhgjajpahpnogakmmkckiodlg	TRUE
onbpacfkeeejmepdpjpnadhhcihadffcnhpojlbn	TRUE
pdjheaanelognmmlbinpmpbaangpmddnokhbfoh	TRUE
ahlhhnfgedpobdcnfpogioniolkodmpoifpmjjcb	FALSE
haebogognfnlmbemoakkcbmjbmcnjkbhncndodck	FALSE
nkhadpohndghnokbjefjeechakpmjlejndlanpjf	FALSE
ahfopipdceiemnkimmjjbkhonfmpgbgjimfhlkhl	FALSE
alakohcimicohekjnfjeoogmckaifjaekbbcdkpi	FALSE
andfigkgialoapdjlddackhoobpkjmncbeikcame	FALSE
acdikcahkdimigfohfbjaohinoehbgmjakhhhoak	FALSE
adnpajojcfeenojhbjppllanfmpoikjdicdgfooo	FALSE
ahlhjmncbbignicenlgphcknigegfhgpcnbhcmjf	FALSE
adlcggpiggbfnlaighghdpoljpiojnncnjbhgmfi	FALSE
hajpcolhjleobliaaemogenkgapcbjpmapegbflc	FALSE
hplladbiljdmjholglojdamnohjhfnobdknfbemn	FALSE
iiikpajjncapejfkcfbimedddjpeikefnjgddjoj	FALSE
jadfmeplkfpaooijhdgalikfikhhembgcdehinbe	FALSE
jllalgegnlaknmompfjbbdjnpdnjahiifbfedoib	FALSE
kacofilpijlcokjgdbcbckliaeeopebkngoidpin	FALSE
konjmhnjhackhijgkohfbmpjfdgcplbkbpjcaodp	FALSE
likoladpnopgbofgfhfijiflnomcgokgkkjgdona	FALSE
maaljpjpdoekijblkkccgcbnoaoodkakdkkdaale	FALSE
mmakliocoekmcngangcacmkkaimcpkadcjihkjhm	FALSE
nakpdbnchebbclgcjgcnkemgifkdeimkehmpdonk	FALSE
nmaoifmndimdoalhlgbnokpebandadbjbfkfkjma	FALSE
oakjdfchkhgnnafkcammmfailofbddcaccieopaf	FALSE
ooiaenfhapipldgjjknbkmkblfbliefmngobpfdh	FALSE
pimaccljkpfkckjobhbenfkmcbpegkaaoohpadak	FALSE
bahlhhnfgedpobdcnfpogioniolkodmpoifpmjjcb	TRUE
dhaebogognfnlmbemoakkcbmjbmcnjkbhncndodck	TRUE
fnkhadpohndghnokbjefjeechakpmjlejndlanpjf	TRUE
ahfopipdceiemnkimajjbkhonfmpgbgjimfhlkhl	TRUE
alakohcimicohekjnfjeoogmckaifjaeakbbcdkpi	TRUE
andfigkgialboapdjlddackhoobpkjmncbeikcame	TRUE
acdikcahkdimigfohfbjaohinoahbgmjakhhhoak	TRUE
abnpajojcfeenojhbjppllanfmpoikjdicdgfooo	TRUE
ghlhjmncbbignicenlgphcknigegfhgpcnbhcmjf	TRUE
mdlcggpiggbfnlaighghdpoljpiojnncnjbhgmfi	TRUE
hhjpcolhjleobliaaemogenkgapcbjpmapegbflc	TRUE
hpcladbiljdmjholglojdamnohjhfnobdknfbemn	TRUE
iiikcpajjncapejfkcfbimedddjpeikefnjgddjoj	TRUE
eadfmeplkfpaooijhdgalikfikhhembgcdehinbe	TRUE
jllalgegnlaknmobmpfjbbdjnpdnjahiifbfedoib	TRUE
kacofilpijlcokjgdbcbckliaeeopabkngoidpin	TRUE
kfnjmhnjhackhijgkohfbmpjfdgcplbkbpjcaodp	TRUE
likolhdpnopgbofgfhfijiflnomcgokgkkjgdona	TRUE
mgaaljpjpdoekijblkkccgcbnoaoodkakdkkdaale	TRUE
mmkliocoekmcngangcacmkkaimcpkadcjihkjhm	TRUE
nakpdbnchebabclgcjgcnkemgifkdeimkehmpdonk	TRUE
nmaoifmndimdoalhlgbnokpabandadbjbfkfkjma	TRUE
odkjdfchkhgnnafkcammmfailofbddcaccieopaf	TRUE
ooiaenfhapipldgjjknakmkblfbliefmngobpfdh	TRUE
pimaccljkpfkckajobhbenfkmcbpegkaaoohpadak	TRUE
aaigfeipipibackjjigdgkdpnkcdmleamdlamlaon	FALSE
aealpklfaiphlgkhooljhphoaebmlcaikifdlhpgj	FALSE
pjafllfgjfpmfmjeemhcganapngfmbbffmhglbfgb	FALSE
aaelcfjjihembcdkcdjbfclppgnnnkohhipppdfjb	FALSE
akpcdclpgmkdhngliclbcfpikpkpghcfkmfkakneb	FALSE
aomgnanamhfhdlkbadlfbnfhbflijneimnmgjfkmk	FALSE
aejmbjbklgiiblemneihfheinpomaloclahincknd	FALSE
aihcnhcnjnjicfbjehlfdecagdebjoalaoanamflm	FALSE
angahfmdkoinacjbpkeaaipjmjiekkonjnaehjfae	FALSE
aimfbooihhpbmmfccloapmejhohmkmbikdddepmjg	FALSE
hhjafeckhjpchiopafblnamlpffognbidobddfoop	FALSE
hpacbedkoaoneapangiknmibmcnmdnnloobcenpil	FALSE
iipmagjckhfgpjhbolddcodeieahkfmgonoeoahlc	FALSE
jplaeleahcfjmnmogkjdoihbkncbpadkalflfkbob	FALSE
jkhmiliakcdipajcpnlkofmdkgmafmkejbhcoibff	FALSE
kamhfjniofeepfgggknmieepeklhmhadakglilhgl	FALSE
knihanngopkcjcfnloopbomhpigphkoajglbahkpc	FALSE
lajhklpjcfkccdhkoglknkijiepgopmbihhkemglc	FALSE
lonlahjaciccjghbbngofcknmniobghpcpeffecbh	FALSE
mijaeiledmmgjonfnfbjmbipigkgmikeohlgekldi	FALSE
naehihnnnbjochmkcloninlhikcbhgnbcfmgnjeaf	FALSE
nkaefiilbbljphellalakdbcjcccbnfglneadgacn	FALSE
oalinangddbccdnciniaapdadfgknfmjjnfkhlgpk	FALSE
omaocfofbmmgcncomlnkegaadmkpfbagmchimpihd	FALSE
papckjkeaodaifmejmfaokpcjhkncgoghboicccbh	FALSE
baaigfeipipibackjjigdgkdpnkcdmleamdlamlaon	TRUE
daealpklfaiphlgkhooljhphoaebmlcaikifdlhpgj	TRUE
fpjafllfgjfpmfmjeemhcganapngfmbbffmhglbfgb	TRUE
aaelcfjjihembcdkcdjbfclppgnnnkohhipppdajb	TRUE
akpcdclpgmkdhnglicalbcfpikpkpghcfkmfkakneb	TRUE
aobmgnanamhfhdlkbadlfbnfhbflijneimnmgjfkmk	TRUE
aejmbjbklgiiblemneihfheinpomaboclahincknd	TRUE
bihcnhcnjnjicfbjehlfdecagdebjoalaoanamflm	TRUE
hngahfmdkoinacjbpkeaaipjmjiekkonjnaehjfae	TRUE
oimfbooihhpbmmfccloapmejhohmkmbikdddepmjg	TRUE
hhcafeckhjpchiopafblnamlpffognbidobddfoop	TRUE
hpacbedkoaboneapangiknmibmcnmdnnloobcenpil	TRUE
iipmagjckhfgpjhbolddcodeieahkfmgonoeoahlbc	TRUE
jcplaeleahcfjmnmogkjdoihbkncbpadkalflfkbob	TRUE
jkhmilgiakcdipajcpnlkofmdkgmafmkejbhcoibff	TRUE
kamhfjniofeepfgggknmieepeklhmhadakbglilhgl	TRUE
kncihanngopkcjcfnloopbomhpigphkoajglbahkpc	TRUE
lfjhklpjcfkccdhkoglknkijiepgopmbihhkemglc	TRUE
lonleahjaciccjghbbngofcknmniobghpcpeffecbh	TRUE
mijaeiledmmgjonfnfabjmbipigkgmikeohlgekldi	TRUE
ncaehihnnnbjochmkcloninlhikcbhgnbcfmgnjeaf	TRUE
nkaefaiilbbljphellalakdbcjcccbnfglneadgacn	TRUE
oalinanbgddbccdnciniaapdadfgknfmjjnfkhlgpk	TRUE
omgocfofbmmgcncomlnkegaadmkpfbagmchimpihd	TRUE
pppckjkeaodaifmejmfaokpcjhkncgoghboicccbh	TRUE
aamjjocbgdinjcnobeocfkljcpoooamfdgleagdlec	FALSE
hpilaaccbbjblbdhaoiklnojjeiojoopbhknkmfhip	FALSE
aikkpigcjccdkkmhminhkljpphimonfnbndoipdmea	FALSE
aagbkagdggjlbbeoaeoiaaadladkfpgigjhbdamkff	FALSE
ajgnedmpbfongdedlbbfibmbhmcdbchdihobhgmjpo	FALSE
anpnaegfmifkpjjjjfjjfklgmcopgmonggbnbimpnk	FALSE
agggdcodnianicbbeelncjfjenkhipbligkjaikahl	FALSE
aeebajicngidbenefifhcppamaopkeojjdkhjhnllj	FALSE
acpicbcklmblkddpikpeipanohfcfelnelblajdnpp	FALSE
akcghccjgheblcjikoibcjlhcmnfcbhdamkgfgkjfb	FALSE
hmajdmiijamaklclmpkdjnlgnelnlooialloamelbb	FALSE
hloaekhnjnljdnkmccidjcfkdnaeieiigjjbnjookh	FALSE
iaomdfnmgdkdpeahoekanndjldkfnffhmcebadmebc	FALSE
inaamdhpcklndadpkhdolmkaeelhgbodnkcbbpdogg	FALSE
janfdpkiljjacgmegeheomhdniojeoafldfkiieccd	FALSE
kanhjegleifcggljcbmeknnijikadnnepfaifpfphn	FALSE
kkmholmiaadmgfmiipcdnpdkkobbdnjbikopfpdgbi	FALSE
lainmpkieikkcgkbkfgflohiikgmhobgpebnnipgob	FALSE
lnanpelpdkjipcpgpbjbifknddcplhmipjmpdfnflf	FALSE
mafipdcfddicdalepedooekapdgooolnjdgiahnjif	FALSE
nokmophlagiecdjbnelehgoebinjkcmcmodcaegfhg	FALSE
nknhihmmlakccpifmpigbjchlnhlllmepbddgfgopd	FALSE
oanildnemcihppopehlmfhdjgleiibalfnfbbpbpmm	FALSE
ooapnljdgmncmbkhjeipgmlpgehhapfecgmpghgkfi	FALSE
pannoiplnifibdgpamafghkgnnnalnfmobenlbngig	FALSE
baamjjocbgdinjcnobeocfkljcpoooamfdgleagdlec	TRUE
dhpilaaccbbjblbdhaoiklnojjeiojoopbhknkmfhip	TRUE
gaikkpigcjccdkkmhminhkljpphimonfnbndoipdmea	TRUE
aagbkagdggjlbbeoaeoiaaadladkfpgigahbdamkff	TRUE
ajgnedmpbfongdedlbbfibmbhmcdbchdaihobhgmjpo	TRUE
anbpnaegfmifkpjjjjfjjfklgmcopgmonggbnbimpnk	TRUE
agggdcodniabicbbeelncjfjenkhipbligkjaikahl	TRUE
aeebajicngidbenefifhcppamabpkeojjdkhjhnllj	TRUE
dcpicbcklmblkddpikpeipanohfcfelnelblajdnpp	TRUE
jkcghccjgheblcjikoibcjlhcmnfcbhdamkgfgkjfb	TRUE
bmajdmiijamaklclmpkdjnlgnelnlooialloamelbb	TRUE
heoaekhnjnljdnkmccidjcfkdnaeieiigjjbnjookh	TRUE
iaomdfnmgdkdpeahoekabnndjldkfnffhmcebadmebc	TRUE
infaamdhpcklndadpkhdolmkaeelhgbodnkcbbpdogg	TRUE
jknfdpkiljjacgmegeheomhdniojeoafldfkiieccd	TRUE
canhjegleifcggljcbmeknnijikadnnepfaifpfphn	TRUE
kdmholmiaadmgfmiipcdnpdkkobbdnjbikopfpdgbi	TRUE
laibmpkieikkcgkbkfgflohiikgmhobgpebnnipgob	TRUE
lnonpelpdkjipcpgpbjbifknddcplhmipjmpdfnflf	TRUE
mdfipdcfddicdalepedooekapdgooolnjdgiahnjif	TRUE
bokmophlagiecdjbnelehgoebinjkcmcmodcaegfhg	TRUE
nknhihcmlakccpifmpigbjchlnhlllmepbddgfgopd	TRUE
oanildnemcihppopehlmfhdjgleiibalfnfabpbpmm	TRUE
ooapnljdgmncmbkhjeipgmlpgehhabpfecgmpghgkfi	TRUE
pinnoiplnifibdgpamafghkgnnnalnfmobenlbngig	TRUE
aangghpglcjhpoeclmgieceicfgbhcnkejalcbgeieo	FALSE
agppganchhbhnfbpnbhdafmoecmkbbmaaigkmcgkafh	FALSE
aafhekkmjggecikknjfklachldjdcjnfpiomhfignmd	FALSE
aagbobepbdlklcgpahnildbgbgfalnfnchlidafopbb	FALSE
ajfdmnggeponomdpppajnplkkmpckjjafcljfgamnka	FALSE
anhakenolncalmnppjnifmjidapiokgcbnjjhfiklaf	FALSE
agbbaiginadamgnjmbebgckenngcpkgjjpbkcdkhgmp	FALSE
apmiloeimgedjcnjpfbdndcghbchnlpnonkgfgaaijf	FALSE
aaebeohphpebbdegbahflhepgppbhhaogiemjinkpio	FALSE
ahlfpbkncngdkeapliodfkccibfjlkdkdfpaihfjojn	FALSE
haahanjocmgdoapakpfhfpjjhpcpgejjmnjbfflnknf	FALSE
ipnmmadgjcfdlefiiipcgpmcaekpbemccjefafkonih	FALSE
iipnhjomnmihhamjcdkggbbongmooggoociholhfljl	FALSE
jahkdnghbpjocgajhkleeaefceafpmhfmghmeoajijh	FALSE
jlniahocjkcolajclbppfgkjnnnocncchmbobpngkfn	FALSE
kaeieffkkahhffafljnbiegffjiibnldhbkcjpljlib	FALSE
koooacagdfbijoppleafmagooelacgeaaonpmffgdnc	FALSE
lappincimhgpcdenmppniagagcbgjffdeikcdaddpog	FALSE
lpapnjdbjlkkflihfepoodikjplkpainimdkhgdljpe	FALSE
mhinookamepopojlihohkheclmpnfmapnkgncapolco	FALSE
nokaijlgdblooacbaeffkpfmemchepeljogjdfhcdbc	FALSE
nkpakdjpbofkcjlgndefnfdobogdjgghlmjbnldmdff	FALSE
oaodpoefbhielaemonjndkmockmhiiefcbcijianinj	FALSE
oljinmamikaojicngljkgemoogellenkcjiikehgbha	FALSE
pacjjfmfladkgfggnelmnepocmdcnglcfidebhcodkg	FALSE
baangghpglcjhpoeclmgieceicfgbhcnkejalcbgeieo	TRUE
dagppganchhbhnfbpnbhdafmoecmkbbmaaigkmcgkafh	TRUE
gaafhekkmjggecikknjfklachldjdcjnfpiomhfignmd	TRUE
aagbobepbdlklcgpahnilhbgbgfalnfnchlidafopbb	TRUE
ajfdmnggeponomdpppajnplkkmpckjjafcljfgamnkab	TRUE
anhakenolncalmbppjnifmjidapiokgcbnjjhfiklaf	TRUE
agbbaiginadamnjmbebgckenngcpkgjjpbkcdkhgmp	TRUE
abmiloeimgedjcnjpfbdndcghbchnlpnonkgfgaaijf	TRUE
gaebeohphpebbdegbahflhepgppbhhaogiemjinkpio	TRUE
nhlfpbkncngdkeapliodfkccibfjlkdkdfpaihfjojn	TRUE
heahanjocmgdoapakpfhfpjjhpcpgejjmnjbfflnknf	TRUE
bpnmmadgjcfdlefiiipcgpmcaekpbemccjefafkonih	TRUE
iipndhjomnmihhamjcdkggbbongmooggoociholhfljl	TRUE
jahkdnghbpjocgajhbkleeaefceafpmhfmghmeoajijh	TRUE
jlniahocjkcolajalbppfgkjnnnocncchmbobpngkfn	TRUE
kaeieffkkahhffanljnbiegffjiibnldhbkcjpljlib	TRUE
kodooacagdfbijoppleafmagooelacgeaaonpmffgdnc	TRUE
leppincimhgpcdenmppniagagcbgjffdeikcdaddpog	TRUE
lpapnjnbjlkkflihfepoodikjplkpainimdkhgdljpe	TRUE
mhinookcmepopojlihohkheclmpnfmapnkgncapolco	TRUE
gokaijlgdblooacbaeffkpfmemchepeljogjdfhcdbc	TRUE
nkpbkdjpbofkcjlgndefnfdobogdjgghlmjbnldmdff	TRUE
oodpoefbhielaemonjndkmockmhiiefcbcijianinj	TRUE
oljidmamikaojicngljkgemoogellenkcjiikehgbha	TRUE
pncjjfmfladkgfggnelmnepocmdcnglcfidebhcodkg	TRUE
aanfmpidpdakdpcpfnmpeafnddpcbenjoikpeljfdmgb	FALSE
ijohahfgnineegeacfpobpojglcomgfhnpneajnkdfne	FALSE
afkddhgechemgdbfgcedbmeplfcdggoaghkgmdbfclnn	FALSE
ahekeinfaejbjdcommcdpibkahipihdlaenokocgoiha	FALSE
akdbbpfahljdmjfgoadifchlicogpeafdcfgjkikhcmn	FALSE
aoiloocimdfjpkjmlbfkjjjfidbdbdhelehmlmfnjbpo	FALSE
adicmdkkooehedpmfdhhmicccppjfbfoahfeklignbem	FALSE
admfkklifhlkoalkmdfbpeapacjiglcimpnppbchboph	FALSE
agmdoecoficakghpdcfimfphopdebmbajhmpmonkenec	FALSE
adjmpicifcihgddookdnkjncpdedappaccpfapojdcpi	FALSE
hhapkmiempaejahlhfbkajadbbbmeicggmjfioaadmcc	FALSE
ikapkifafiaehnhcjlglldbfefkfhenoibplgcbnibbc	FALSE
iiajcalnafbeeobjhgjajmfpcolkgpponmjlggbcccfe	FALSE
jhjijmaediaioipekjhjafnmopmdbadhinakcmhpbopn	FALSE
jlanjhhfgafophkcoodpfebmnlknalddepldacbknjdc	FALSE
kakegahleahnhmolfndfcojbbcdnnbiaimjfdejjhbnj	FALSE
kmacdpfbdeibeihocgbnkelpapkgdkjfjdjndgmjmcib	FALSE
lahnmfmpgocmblhmcmlfghpamlcmmmncknmggmoaehin	FALSE
lokiiamphejkcimhbjdcbegmcldjobcknmkmaaknhjpj	FALSE
mihanmjocldadaghajfdjfiffconohccknaeoiineape	FALSE
nahlmoaciddgmphjkdjopcenccdckplboiamiapommla	FALSE
nollamdlcmichkeklbcgjkjioaplnffjilolfjkoafia	FALSE
oihhjhijnpaejgcalofkihfnlidipfiinckhnlpaeled	FALSE
opphjnapmaoomooffgchhdijdnljdjfngcekpenlpjif	FALSE
padklpngghhhdbfeipohmiaebjdijpfcehibpndfjham	FALSE
baanfmpidpdakdpcpfnmpeafnddpcbenjoikpeljfdmgb	TRUE
dijohahfgnineegeacfpobpojglcomgfhnpneajnkdfne	TRUE
gafkddhgechemgdbfgcedbmeplfcdggoaghkgmdbfclnn	TRUE
ahekeinfaejabjdcommcdpibkahipihdlaenokocgoiha	TRUE
akdbabpfahljdmjfgoadifchlicogpeafdcfgjkikhcmn	TRUE
aoiloocimdfjpakjmlbfkjjjfidbdbdhelehmlmfnjbpo	TRUE
adicmdkkooehedpmfdhhmicccppjfbfoahfekliganbem	TRUE
abmfkklifhlkoalkmdfbpeapacjiglcimpnppbchboph	TRUE
ggmdoecoficakghpdcfimfphopdebmbajhmpmonkenec	TRUE
odjmpicifcihgddookdnkjncpdedappaccpfapojdcpi	TRUE
hhapkmibempaejahlhfbkajadbbbmeicggmjfioaadmcc	TRUE
ckapkifafiaehnhcjlglldbfefkfhenoibplgcbnibbc	TRUE
iiajcalnabfbeeobjhgjajmfpcolkgpponmjlggbcccfe	TRUE
fhjijmaediaioipekjhjafnmopmdbadhinakcmhpbopn	TRUE
jlgnjhhfgafophkcoodpfebmnlknalddepldacbknjdc	TRUE
kakegahleahbhmolfndfcojbbcdnnbiaimjfdejjhbnj	TRUE
kmjcdpfbdeibeihocgbnkelpapkgdkjfjdjndgmjmcib	TRUE
ldhnmfmpgocmblhmcmlfghpamlcmmmncknmggmoaehin	TRUE
lokifiamphejkcimhbjdcbegmcldjobcknmkmaaknhjpj	TRUE
mihganmjocldadaghajfdjfiffconohccknaeoiineape	TRUE
nahlmoaciddgmphjkdjopcenccdckplboiamiabpommla	TRUE
nollcamdlcmichkeklbcgjkjioaplnffjilolfjkoafia	TRUE
oihhgjhijnpaejgcalofkihfnlidipfiinckhnlpaeled	TRUE
opphjnapmaobmooffgchhdijdnljdjfngcekpenlpjif	TRUE
ppdklpngghhhdbfeipohmiaebjdijpfcehibpndfjham	TRUE
aaofdcdhnknbebkfagjmancmemejblfelnikflpgmlpbf	FALSE
mjknkaeihbbhjehbpimgpfgjfbbfgodohnommmbcbfbmm	FALSE
ampchikgbcffnjcaigofffkopgijlhcigdjplhmpmdmml	FALSE
aaflbkdkiebgimigepkdmlbahgdhcigaaiolphokgbkho	FALSE
akjdkgaffojllpcbjlbncgcemaedbjnppibjkkchepdop	FALSE
aoadogepgmpgecafadnedllppimoplpmacblgmjmhpkfn	FALSE
adhklieehhpkihmncajmidnmbcakjkihjkmfplglopgkp	FALSE
agmiejmhcgllbebjhcigemomegmbiglbjhhgkeaoeehfn	FALSE
apoangpgbcfeblcmdiebdlncbdpfmgnonapfbbpanmpej	FALSE
acpnobpenfjjinfgbmgpajpdapfjlmaoalncbodigmedp	FALSE
hjafjibdjogdnkldfacfomnmelmlfedgilgfedpddicnc	FALSE
hmmajdinnjclgjomjmpmnngahikkklafimnkllldmggdf	FALSE
iahkafpfjlcdfpbkdbkkcbgphljhgmoliiblkdipghaka	FALSE
jangoladnghbjpgicggoecchglfgdkjmlhhpldahmklia	FALSE
jjloadibbmpmjgnnccjcbgcobofbjbiajikhphijcgkhl	FALSE
kamgdlepbedlamadmbalcgggihmnbdfajffdilgphnfdm	FALSE
knaheachfhifhahahmkhgglhpgmgdcnnikpfdgpfpkoln	FALSE
ladcbcjnejepninoofpadbmcgippakcjjekacbaicfflg	FALSE
lohaedpglbfdemdcafanlpgmlidjjgbhfbjfgleloccgf	FALSE
mhkadpkokpdikeihjebjmlfpfaghncldicphomgncelob	FALSE
najgopjoikkekiebhmofdfoencnfngapfblhedjphkidf	FALSE
nijlimjafpiegibkffmbdifmdhdoneengfikgkbhhdaii	FALSE
oilacfgppmcicpoggmhmckddmkjglghhjcigaplceenmi	FALSE
olpaojnmeacdgamdoijmkhpdhgfbcmdncidjcdbooheoo	FALSE
padjbaagkphmceamaeejbjnhmljjjalngmamapebpjepp	FALSE
baaofdcdhnknbebkfagjmancmemejblfelnikflpgmlpbf	TRUE
dmjknkaeihbbhjehbpimgpfgjfbbfgodohnommmbcbfbmm	TRUE
gampchikgbcffnjcaigofffkopgijlhcigdjplhmpmdmml	TRUE
aajlbkdkiebgimigepkdmlbahgdhcigaaiolphokgbkho	TRUE
akjdkgaffojllpcbjlbncgcemaedbanppibjkkchepdop	TRUE
aoadogepgmpgecafadnedllppimoplpmanblgmjmhpkfn	TRUE
adhklieehhpkihmncajmidnmbcakjkihjkmbfplglopgkp	TRUE
agmiejmhcgllbabjhcigemomegmbiglbjhhgkeaoeehfn	TRUE
epoangpgbcfeblcmdiebdlncbdpfmgnonapfbbpanmpej	TRUE
kcpnobpenfjjinfgbmgpajpdapfjlmaoalncbodigmedp	TRUE
gjafjibdjogdnkldfacfomnmelmlfedgilgfedpddicnc	TRUE
hmmajdinnjclgjomjmpmnngahikkkbafimnkllldmggdf	TRUE
idhkafpfjlcdfpbkdbkkcbgphljhgmoliiblkdipghaka	TRUE
bangoladnghbjpgicggoecchglfgdkjmlhhpldahmklia	TRUE
jjloanibbmpmjgnnccjcbgcobofbjbiajikhphijcgkhl	TRUE
kamgdlepbedlamadmbalcgggaihmnbdfajffdilgphnfdm	TRUE
kneheachfhifhahahmkhgglhpgmgdcnnikpfdgpfpkoln	TRUE
ladcbcjnejepninoofpapbmcgippakcjjekacbaicfflg	TRUE
loheaedpglbfdemdcafanlpgmlidjjgbhfbjfgleloccgf	TRUE
mhekadpkokpdikeihjebjmlfpfaghncldicphomgncelob	TRUE
eajgopjoikkekiebhmofdfoencnfngapfblhedjphkidf	TRUE
niflimjafpiegibkffmbdifmdhdoneengfikgkbhhdaii	TRUE
odilacfgppmcicpoggmhmckddmkjglghhjcigaplceenmi	TRUE
olpaojnmeacdgambdoijmkhpdhgfbcmdncidjcdbooheoo	TRUE
padjbaagkphmceamaeejbjnhmljjjalbgmamapebpjepp	TRUE
ajpoeinghoejobdiheakkmldodbppccepjpmmkpoofafph	FALSE
omhhmaajoopfcloglmbolepffmhihhogibcgbhaeggdlen	FALSE
khaaakjckllkhflghacjecmegpeobbckcmjmlhmnaedapa	FALSE
aaeiepnpfmkjmiaiebfndemlhfbcpohnenpphcjjfdiocc	FALSE
akolanognpcdjliibhidclbecidaplkkhkgjhloepigpbg	FALSE
ankcelhbkmdfimcdkbbfmhhnpaadbahnfdgddlbdhfmkcd	FALSE
acnfmcbdiphbbbhcmopfopaigffhknaanmhjmcleghnpnp	FALSE
aenfaakecfkaagbhddnliehbkelbilcjgidjgbdjmjlpcj	FALSE
aheponiphdockmocifacnghgljacmepenfdgdadpjkajed	FALSE
aepaamgjdpbfioieggjbckoloagiblpahpgjkjffjlcmnn	FALSE
hhajiplfnidblljmboglodpjepdmnakidhjakjljpiefbd	FALSE
imlmhnlahoicbibfcnlfcokmgngbgemibcalegdknpgdji	FALSE
ikaeldflhggcbdhlgfndbbhfaamffladcobkkhojcehnce	FALSE
jafpjfjadedjglokpadmcflnehkiioibobjnkijibcmddd	FALSE
jnaolhieebkkoihodapceeglejnggpfbeoobknjebboipp	FALSE
kacombinahanmafjkmfbmiaaoekapadjnbhonhafdkmkhe	FALSE
kpaffhacejgjchblgboifnhbmphbblfhdnbfbdijnanhem	FALSE
limjjlnajkekghlikdchepebhbpjimckonmhakamkfiecj	FALSE
maegdempcbjhmkmnlgckgdpgdhidhobkammndpniidjelg	FALSE
mkiaplgebgbnibjeoemhdlhaniiijkonfbjneannclpefo	FALSE
naakaaipknienbnjionpjiilibodahfhglbmlgbmhgmnoj	FALSE
nlplaefjaocmedofeafciikhilaginhhppppdgogodjegb	FALSE
oaoilfmlmieagjnfklamlddkeddpjgbklbgniaoclmkjnm	FALSE
onaddjbhfhkjolngocbfonignhagonmamnejgglhpiefef	FALSE
phipphagjpldmibcjoackkfdnegodgfeipniibaoeemgpo	FALSE
bajpoeinghoejobdiheakkmldodbppccepjpmmkpoofafph	TRUE
domhhmaajoopfcloglmbolepffmhihhogibcgbhaeggdlen	TRUE
gkhaaakjckllkhflghacjecmegpeobbckcmjmlhmnaedapa	TRUE
aaeiepnpfmkjmiaikbfndemlhfbcpohnenpphcjjfdiocc	TRUE
abolanognpcdjliibhidclbecidaplkkhkgjhloepigpbg	TRUE
ankcelhbkmdfimcdkbabfmhhnpaadbahnfdgddlbdhfmkcd	TRUE
acnfmcbdiphbbbhcmopfopaigffhknabnmhjmcleghnpnp	TRUE
aenfaakecfkaapbhddnliehbkelbilcjgidjgbdjmjlpcj	TRUE
hheponiphdockmocifacnghgljacmepenfdgdadpjkajed	TRUE
nepaamgjdpbfioieggjbckoloagiblpahpgjkjffjlcmnn	TRUE
hhajiplfnidblljmboglodpjepdmnakidhjabkjljpiefbd	TRUE
ibmlmhnlahoicbibfcnlfcokmgngbgemibcalegdknpgdji	TRUE
ikgeldflhggcbdhlgfndbbhfaamffladcobkkhojcehnce	TRUE
jbafpjfjadedjglokpadmcflnehkiioibobjnkijibcmddd	TRUE
jeaolhieebkkoihodapceeglejnggpfbeoobknjebboipp	TRUE
kicombinahanmafjkmfbmiaaoekapadjnbhonhafdkmkhe	TRUE
kplffhacejgjchblgboifnhbmphbblfhdnbfbdijnanhem	TRUE
limjjlnajkekghlikdchepebhbpjimckonmhabamkfiecj	TRUE
eaegdempcbjhmkmnlgckgdpgdhidhobkammndpniidjelg	TRUE
mkilplgebgbnibjeoemhdlhaniiijkonfbjneannclpefo	TRUE
ncaakaaipknienbnjionpjiilibodahfhglbmlgbmhgmnoj	TRUE
nfplaefjaocmedofeafciikhilaginhhppppdgogodjegb	TRUE
oaobilfmlmieagjnfklamlddkeddpjgbklbgniaoclmkjnm	TRUE
onbddjbhfhkjolngocbfonignhagonmamnejgglhpiefef	TRUE
phipphcgjpldmibcjoackkfdnegodgfeipniibaoeemgpo	TRUE
ahlogmklhniiefjlphjlgfoamkpoenhkigleplnnhlkgcdg	FALSE
hajndlmhfifpikcbgfdnbbkhbbhjgnigfdldhilmhekmloo	FALSE
aifbnekmmchnohopadlecdcpogiaaihkpkaemojicniipge	FALSE
ahlaclkfgljbacclegpncenioinfjldppfknjcafbbeddhg	FALSE
akpebclbipdfejgfmnclgakgodhegkhhnjiemnkdicikdpf	FALSE
anflnhcahfmdfohcfeolkhjmbbanhpfgdggecnjopmpkoel	FALSE
agaeikamnknhicggijendgcaljiamegbmpjlmchbchokibl	FALSE
afghgmhpbcpbimfdlihpdbbogjcdmpccmmoahkdbgcmaoec	FALSE
akllediclhkamojghofahnmmdhnmdnbnfmmjllpbagijaci	FALSE
adomodhadehmlfmepaohpeigddjplboocglidkjiiecoebk	FALSE
hhaphlmofakgfndkdnepnlkpkghphhmgigfbenblbkdldkf	FALSE
iaodbcmcggmpiinaiaifmdheoajleacagmpcciiieflfame	FALSE
ilanmicjdkefpcancfhbjpadggnbcbejbejbpblcepkgekj	FALSE
jalnhopmmjcmngpcpoemfbogepipmoineegdoblfmddepoh	FALSE
jnaaiafpokkoofbeadgbkajikojocdpfgnlnbdlemepcmik	FALSE
khmkanlfolegdcbkbhdppgemmahhaeokcpboppilbdnkmfg	FALSE
linmacgmjnedcchhgjkpopfioijklmbbfoolbbagpfladfl	FALSE
ljagchpdjegpljdipjoakdjhboiojiclpighgdgphekbcmk	FALSE
maghlndmaielokclhbicmpeiijbadfdmnieafodnhlhbjlj	FALSE
mliahnhidmhlmmpbdoggaalkmmdfmkodamfbhgcokpppcna	FALSE
nahkmcekpfmfeelldlakehpmakjiamekoicilppodlbpmom	FALSE
nkiapdjoinmfnilmjbcmecdepbmjgjkhnekjnnjhpnpbbkp	FALSE
oafpcjjpdekonpjfdjnbiiikgbkmgikplpgmkhhkbbnkokm	FALSE
onojkiafbholcgbgjegomanepcpdjpcbknhcfohnjgbgchl	FALSE
paokjiffokebppeimnidehplfeeejjdgngkpdiphancajep	FALSE
bahlogmklhniiefjlphjlgfoamkpoenhkigleplnnhlkgcdg	TRUE
dhajndlmhfifpikcbgfdnbbkhbbhjgnigfdldhilmhekmloo	TRUE
gaifbnekmmchnohopadlecdcpogiaaihkpkaemojicniipge	TRUE
ahlaclkfgljbacclegpncenioinfjldppfknjcabfbbeddhg	TRUE
akpnbclbipdfejgfmnclgakgodhegkhhnjiemnkdicikdpf	TRUE
anflnhcahfmdfohcfeolkhjmbbanhpbgdggecnjopmpkoel	TRUE
agaeikabmnknhicggijendgcaljiamegbmpjlmchbchokibl	TRUE
afghgmhpbcpbimfdlihpdbbogjcdmpccmmoahkibgcmaoec	TRUE
gkllediclhkamojghofahnmmdhnmdnbnfmmjllpbagijaci	TRUE
odomodhadehmlfmepaohpeigddjplboocglidkjiiecoebk	TRUE
hhophlmofakgfndkdnepnlkpkghphhmgigfbenblbkdldkf	TRUE
daodbcmcggmpiinaiaifmdheoajleacagmpcciiieflfame	TRUE
ilanmbicjdkefpcancfhbjpadggnbcbejbejbpblcepkgekj	TRUE
jalnhopmbjcmngpcpoemfbogepipmoineegdoblfmddepoh	TRUE
jngaiafpokkoofbeadgbkajikojocdpfgnlnbdlemepcmik	TRUE
khmkcanlfolegdcbkbhdppgemmahhaeokcpboppilbdnkmfg	TRUE
finmacgmjnedcchhgjkpopfioijklmbbfoolbbagpfladfl	TRUE
ljagchpdjegpljdipjoakajhboiojiclpighgdgphekbcmk	TRUE
mghlndmaielokclhbicmpeiijbadfdmnieafodnhlhbjlj	TRUE
mlieahnhidmhlmmpbdoggaalkmmdfmkodamfbhgcokpppcna	TRUE
nahkmcekpfmfeelldlabehpmakjiamekoicilppodlbpmom	TRUE
nkiapdjoinmfnilmjbcmecdepbmjgjkhnekjnanjhpnpbbkp	TRUE
ofpcjjpdekonpjfdjnbiiikgbkmgikplpgmkhhkbbnkokm	TRUE
onojkilfbholcgbgjegomanepcpdjpcbknhcfohnjgbgchl	TRUE
pookjiffokebppeimnidehplfeeejjdgngkpdiphancajep	TRUE
ahecengdgmiikbbgaicdfplbdbjkddappllddiollmokjlbk	FALSE
lialjpdibdcachkielocllgaebdoejcagkjkpappdhnmjejm	FALSE
laipagfmdiilllfaljglfcofpnoilgijdnjemnhkllggoiel	FALSE
ahgboepkgaacgcnjpolkklhnjjnkebbomlpokiapihajcpol	FALSE
ajgkhkfkkplbkmpghimnbmkicdallgbbmiompmolbgnhbeli	FALSE
anaalijiljflpokmmboiilcieagdkoapcikbdaehflmedpbf	FALSE
achfhbfmlcodfgofadkgibodomkdaonhlekmnolggobdoacn	FALSE
aegliakajkhjcianhohanafpelkjmkfmhomdnjdoanfbcmig	FALSE
acmeiplbdajodlnoecdhmmmkmjeialemnhcodfmmjedccfka	FALSE
akgmngoopmehhoajiooacpihgfpiemgpjgehiofeehcnffek	FALSE
hahhijadblckglgikblgplockcamdaplijepdhjdeceoegcd	FALSE
hmplaenckelfeiblklljicddhgdeficaicafknkfbniacgof	FALSE
iafndpeackhpjhgcghfampkdhjmhbmpgmnbnbbkhmecdnggj	FALSE
iokaoflaeaccfinccmddkagainklelgalnifmhfolfeapdki	FALSE
jhpaefijlcnihbbpjfmgchiilfpfhmjkfbihonogekoajcai	FALSE
knllaedipghnbmbhnfbfacpbmjjfmfjicegpbpbbnoebckfo	FALSE
kljaocjgmibiihblekpjlomfhngeagholbmpbjlidfdhbamk	FALSE
laedchdlioloofbejijmejclnlgljepdlminbficgegofnch	FALSE
lonaldpmmkdhlgjbjdncflpeljppakckonfgnbpbgdcolnap	FALSE
mimalencdilakoapgbmfiedkegdcjgmencaflofhbhajgahi	FALSE
npnhnanldbndelnakpkappafhpjmcbgbcnenkcbbmkgkekmi	FALSE
njnjjnjamddnfdfkjaggjfdbgcemanngkgecakmgllneampf	FALSE
oaopplneeegecjngnbgcbajmdobdlmaegneplnclpidbafnl	FALSE
onanfbcchanoodmmhpbphknoghfecbneahelhcbnpjjioogh	FALSE
palgmmkcdebimlpbldpaanheeobjmckggjolfildjondkhfg	FALSE
bahecengdgmiikbbgaicdfplbdbjkddappllddiollmokjlbk	TRUE
dlialjpdibdcachkielocllgaebdoejcagkjkpappdhnmjejm	TRUE
flaipagfmdiilllfaljglfcofpnoilgijdnjemnhkllggoiel	TRUE
abgboepkgaacgcnjpolkklhnjjnkebbomlpokiapihajcpol	TRUE
ajgkhkfkkplbkmpghimnbmkicdallobbmiompmolbgnhbeli	TRUE
anaalijiljflpokmamboiilcieagdkoapcikbdaehflmedpbf	TRUE
achfhbfmlcodfgofadkgibodomkdaonhlbekmnolggobdoacn	TRUE
aegliakabkhjcianhohanafpelkjmkfmhomdnjdoanfbcmig	TRUE
dcmeiplbdajodlnoecdhmmmkmjeialemnhcodfmmjedccfka	TRUE
lkgmngoopmehhoajiooacpihgfpiemgpjgehiofeehcnffek	TRUE
hahhijadblckglgikblgplockcamdapblijepdhjdeceoegcd	TRUE
hmplaenckelfeiblklljicddhgdeficaicabfknkfbniacgof	TRUE
iafndpeackhpjhgcghfampbkdhjmhbmpgmnbnbbkhmecdnggj	TRUE
iokaoflaeaccfinccmddkagainklelgalbifmhfolfeapdki	TRUE
jhpaefijlcnihabbpjfmgchiilfpfhmjkfbihonogekoajcai	TRUE
dnllaedipghnbmbhnfbfacpbmjjfmfjicegpbpbbnoebckfo	TRUE
kljbocjgmibiihblekpjlomfhngeagholbmpbjlidfdhbamk	TRUE
laedchdlioloofbejijmejclnlgljepdlminabficgegofnch	TRUE
lonfldpmmkdhlgjbjdncflpeljppakckonfgnbpbgdcolnap	TRUE
midmalencdilakoapgbmfiedkegdcjgmencaflofhbhajgahi	TRUE
nbpnhnanldbndelnakpkappafhpjmcbgbcnenkcbbmkgkekmi	TRUE
njnjjfnjamddnfdfkjaggjfdbgcemanngkgecakmgllneampf	TRUE
oaopplneeegecjngnbgcbajmiobdlmaegneplnclpidbafnl	TRUE
onanfbcchanbodmmhpbphknoghfecbneahelhcbnpjjioogh	TRUE
pjlgmmkcdebimlpbldpaanheeobjmckggjolfildjondkhfg	TRUE
aaonfkhahflgooeekpmalnkglignjfifdkagcjnijcebibifk	FALSE
hjaldedmdadpmknfdhbokhmjaiaepfjajjmcjbddeonnfgjil	FALSE
jaikcijjondbijakceoahifdjbfnbhoncddjfokgnlcfnebbk	FALSE
ahpcmnefljnfldjkoagocbfkdkbogipflelknganpodeoiebl	FALSE
akooofmbholoebhkgoejnogpnjfnpldegkafcndgbdmmpijbn	FALSE
anjomefchefaebbanfnocoiobpcddpekohjdegojbphkooanf	FALSE
afhnpjfghbnmjgogplmjenlnaicojoeoebcbkgmmeojpkffad	FALSE
adkimlihphpokcbbajkkgkhlimmmmohpfijbijamjacgaoojj	FALSE
aomdpkfaekdahjpogjmkmnhdhkddpennkpbejbghdnflgipmm	FALSE
afdegnlcmcjocoibofaaodkcjfffpfedoobfdbjagcjpkbfbp	FALSE
hnapifogfakghmjnagdkmhbppdmjkgeicpomkdbllajgfmkfa	FALSE
hlacagcfbpcgfefbafhbonehdehjopdlggcmgiiekakdajohj	FALSE
iacmcagdkgfbjhohocedpaecjcpnnlkkkffimbebjcgcnpakd	FALSE
ipanhffofoacjhojmaehahlhhngaaagkcjfefjaagojconeom	FALSE
jikkloagehjbmfnfbceiplaiaebnphfgnejkghiobhnehhjll	FALSE
kakhkakgiamagacpoefgfikipejkfmeljjhbijbmapekkkgaj	FALSE
klajpjhjaoldgeocbmehgjdjnejngglibdjgeoclfkmfedind	FALSE
lagekggamhgjoiagmpkheehpkkplpkkkkbbjjnjnldpdpleei	FALSE
lpapeknckkkcafconlbcbfbognbgpgiodlpiinlnfnkedaagk	FALSE
miomankglkfhioecgnbipmfanacgnojogodoimnpdkcaoioah	FALSE
nplamcagpcfdehgdmlinfhjlooinlongfpfghgpnbghjkmifi	FALSE
nlmiaaldgdcghncobmmhblmhckpnceeiohcpmhigjipiicoke	FALSE
oacnmecdnpciapgopplhipdmmeaceaikjffnonmhdiliehkcd	FALSE
ophkioaafadedllpkfiiadflfjpgedhllippogjaneblajloo	FALSE
phpmhpahhlaadpjglhjigofnckiclanmmfbfikhmjplpiaond	FALSE
baaonfkhahflgooeekpmalnkglignjfifdkagcjnijcebibifk	TRUE
dhjaldedmdadpmknfdhbokhmjaiaepfjajjmcjbddeonnfgjil	TRUE
gjaikcijjondbijakceoahifdjbfnbhoncddjfokgnlcfnebbk	TRUE
ahpcmnefljnfldjkoagocbfkdkbogipflelknganpodeoiabl	TRUE
akooofmbholoebhkgoejnogpnjfnpldegkafcndgbdampijbn	TRUE
anjomefchefaebbanfnocoaobpcddpekohjdegojbphkooanf	TRUE
afhnpjfgahbnmjgogplmjenlnaicojoeoebcbkgmmeojpkffad	TRUE
adkimlihphpokcbbajkkgkhlimmmmohpfijbijamjacgaoojjb	TRUE
domdpkfaekdahjpogjmkmnhdhkddpennkpbejbghdnflgipmm	TRUE
kfdegnlcmcjocoibofaaodkcjfffpfedoobfdbjagcjpkbfbp	TRUE
hcnapifogfakghmjnagdkmhbppdmjkgeicpomkdbllajgfmkfa	TRUE
hlacagcfbpcgfefbafhbonehdehjopdlggcmgiiekabdajohj	TRUE
ijcmcagdkgfbjhohocedpaecjcpnnlkkkffimbebjcgcnpakd	TRUE
ipanhffofoacjhojmaehahlbhhngaaagkcjfefjaagojconeom	TRUE
jikkloagehjbmfnfbceiplaiaabnphfgnejkghiobhnehhjll	TRUE
kabkhkakgiamagacpoefgfikipejkfmeljjhbijbmapekkkgaj	TRUE
klbajpjhjaoldgeocbmehgjdjnejngglibdjgeoclfkmfedind	TRUE
lagekggamhgjoiagmpkheehpakkplpkkkkbbjjnjnldpdpleei	TRUE
lpbpeknckkkcafconlbcbfbognbgpgiodlpiinlnfnkedaagk	TRUE
miomnkglkfhioecgnbipmfanacgnojogodoimnpdkcaoioah	TRUE
ndplamcagpcfdehgdmlinfhjlooinlongfpfghgpnbghjkmifi	TRUE
nlmiaaldgdcghncoammhblmhckpnceeiohcpmhigjipiicoke	TRUE
oacnmecdnpciabgopplhipdmmeaceaikjffnonmhdiliehkcd	TRUE
ophkioaafabedllpkfiiadflfjpgedhllippogjaneblajloo	TRUE
phpmhpahhlaadpjglhjigofnckiclanmmpbfikhmjplpiaond	TRUE
aaiaoppdplhnfnidhcninppndgchklhbndamkelnlnaandangg	FALSE
mhjahmnmahfjbppmioobcjeeomdjkhdohjfomeibkecogakfdg	FALSE
adgikaofhldckilakicjmfdoemnoiclinjkkfhpmnidaaofbcc	FALSE
ahkcghggccighpdjgclpdmibenahaancgeaeedgjjochbnjoaf	FALSE
akmjnghcdinomdgkilbgngjcimgnmjpnhmbejjccnkgjlehala	FALSE
anhjejhhppdgbphfdigfhkeanoecledlefnggmpclladfolgjn	FALSE
adkcbgohepkgbfhpfjgipcjnpbliaonphoiohjecomaijpiaji	FALSE
aggajlhckpmllpcibackajgpcbdjacpoafmanfiokcjdeonnpk	FALSE
aogancnkeocdbdipdaaamheghijmkmbdpfkfjochcjjhpnlcjj	FALSE
amemaeebfmhdkkjpdlciffpdcchlmlipnnpdppdldbppomkdpo	FALSE
hipkokmiaeglocfdfimekhjhlbacedkliekkagmbnpafoejhjj	FALSE
hmagcpnipnpoaafjhkjagpodlihdojligkhcaebmhalmcibpib	FALSE
iammninghnjokomkjijgehipodafkpngggdlgihnjfgojhnnpc	FALSE
ipkkancfgnhdljigcbboggbbpcmnifkbboekhdlhnffdlnnaop	FALSE
jjklpaigdaafkjbjbppnghdbkmgenpkkafbhiobbcdpipklgmh	FALSE
kaaippmaoachbkhjbfdbcfniljboamkccchpacjincnafepbhh	FALSE
kmojihiapkopackhhkhlkipefnopgkpnfkbanhhpjlafcjkgop	FALSE
lakdjkademakeoagpkbfnplnlcmhecnclngdepcgoomgbhpcjp	FALSE
madefjjpkopjffceimoeccdleecbgjjcdoghjlikkcmndboicb	FALSE
mkaolefhfjflpcgfhmhcmaiffgjepfndjhhliebibonicnbjib	FALSE
naglemogjaeolnlikkhdohnbjjlgigkiakgbnjkcbliaophglp	FALSE
nmnoolioiacppgaheceamlfjianjlinniogapjiaeljjmnpodg	FALSE
oaehneecnlbmgagbmjepicflhmmhmjjhdmnjignnmlbniokngi	FALSE
onkpilnjapannhldlbndcflalcljdcgibkecjhojeonmoeeidb	FALSE
palmjelipddmoogfgkiheeaikaghmbkicnjonailjemlgbdfgl	FALSE
baaiaoppdplhnfnidhcninppndgchklhbndamkelnlnaandangg	TRUE
dmhjahmnmahfjbppmioobcjeeomdjkhdohjfomeibkecogakfdg	TRUE
gadgikaofhldckilakicjmfdoemnoiclinjkkfhpmnidaaofbcc	TRUE
ahkcghggccighpdjgclpdmibenahaancgeaeedgjjocabnjoaf	TRUE
akmjnghcdinomdgkilbgngjcimgnmjpnhmbejjccnkgjlehaba	TRUE
anhbjejhhppdgbphfdigfhkeanoecledlefnggmpclladfolgjn	TRUE
adkcbgohepkgbfhpfjgipcjnpbliaonphoiohjecomaijbiaji	TRUE
aggajlhckpmllpcibackajgpcbdjacpoabfmanfiokcjdeonnpk	TRUE
eogancnkeocdbdipdaaamheghijmkmbdpfkfjochcjjhpnlcjj	TRUE
kmemaeebfmhdkkjpdlciffpdcchlmlipnnpdppdldbppomkdpo	TRUE
hfipkokmiaeglocfdfimekhjhlbacedkliekkagmbnpafoejhjj	TRUE
hmagcpnipnpoaabjhkjagpodlihdojligkhcaebmhalmcibpib	TRUE
ihmmninghnjokomkjijgehipodafkpngggdlgihnjfgojhnnpc	TRUE
ipkkancfgnhdljigcaboggbbpcmnifkbboekhdlhnffdlnnaop	TRUE
jjklpaigdaafajbjbppnghdbkmgenpkkafbhiobbcdpipklgmh	TRUE
kaaippmaoachabkhjbfdbcfniljboamkccchpacjincnafepbhh	TRUE
kmojihiapkopackhhkhlkipefnopgkpnfkbanhhpjblafcjkgop	TRUE
lpkdjkademakeoagpkbfnplnlcmhecnclngdepcgoomgbhpcjp	TRUE
eadefjjpkopjffceimoeccdleecbgjjcdoghjlikkcmndboicb	TRUE
mkaolefhfjflpcgfhmhcmaibfgjepfndjhhliebibonicnbjib	TRUE
naglemogjaeolnlikkhdohnbjjlgigkiakgbnjkcbliaobphglp	TRUE
nmnfoolioiacppgaheceamlfjianjlinniogapjiaeljjmnpodg	TRUE
oaehneecnlbmgagabmjepicflhmmhmjjhdmnjignnmlbniokngi	TRUE
onkpildjapannhldlbndcflalcljdcgibkecjhojeonmoeeidb	TRUE
pllmjelipddmoogfgkiheeaikaghmbkicnjonailjemlgbdfgl	TRUE
