aabgfcalcpgcinehkogbjbmdbahhiii	FALSE
akldaopdfnaofofehhjbbeflhfiemnb	FALSE
bfgkepnalpjppkgafjkffapocdnleji	FALSE
bpfmbfmeheeggdlcdhlmjmdekobnmek	FALSE
cihcgfkfnfgionafnkikkgllccchiie	FALSE
ddmnioahnnoegdfcgficchcfiiaolmp	FALSE
dnkaadpfmfmdidcpfidfijhojcoiffk	FALSE
eigckjpemfeaaeddfbgghabphdepjon	FALSE
fbejeefacpjjdkchefheicffnpgfjao	FALSE
flajhkbnmocchhnkeoploikmnmibcjo	FALSE
gfbjjdnjbafomigkmnogbfolipmkmef	FALSE
hacofmopbhpiodcemocjjfbdcpdfnpf	FALSE
hhpgpoiodghfbjgohpjkdpifgljilif	FALSE
iddjnlbhljaplacgdnfkmcnfhgkfaga	FALSE
imgjeidinjmeehgigdhkkohphhaifjh	FALSE
jfahgfhijhgcbjcfnnmodijhhpgjdok	FALSE
kalcfklfocidbekbjopdhgmifjlbjdd	FALSE
kmpilencjdhibfoabgbfjlckdpdbhnc	FALSE
lglbechpledfbjmcpaoacneghjggkoc	FALSE
mblmiogilfmdlelpfcgalakgkdikcbf	FALSE
mlllghjhjhfljhignafdojkopilimbm	FALSE
nedffhoggnlmmdanmgjpklofalahnko	FALSE
oahbhgjlpdeejafpmapldobeegmohdo	FALSE
ojhiemcgaabffhgiodmjoochainnbak	FALSE
pegoagaagfhfigcpohmeaaabedakdcd	FALSE
aaenoljcmeodbdppecoakbaoobpjhjj	TRUE
aibhalpgmikgakbjjjhambfedainpfb	TRUE
apccehbalobkaemmnibgjloknbhjgmb	TRUE
bffhblliaobaleokekidclbplcemgbe	TRUE
bniaebpbagpahciphmfdbabafeagogh	TRUE
chpiakpbjhkapbliepjhkgkhinjilfc	TRUE
dchbpababmjnnebjcogkajimbiknemj	TRUE
dpkigegcdpjcggoclaehapbpabicgbh	TRUE
ejfjibieiohbcaepefbajomnhpbpiaj	TRUE
feoplnmkfbbanbnabiandegojakpjai	TRUE
gakbkoalbkecklnhmgbclgokjbphddg	TRUE
gmkoeiiahenkfbbfakpmjbabdbnffjn	TRUE
hhbjlnbjafeojbhlkhbfncaamkbmajb	TRUE
iboanbijlnaohdohjpkmaojjicdmhoc	TRUE
ilpfmdlinoppnahobohaiphlpbnheoe	TRUE
jhpcammmbjjabojphincdibbpcgaefi	TRUE
kcllanbmnaooiobmkbflceapfacbpif	TRUE
kogbhlnhappbnakolmmkiabfianpbgj	TRUE
lhgcialohgldgbdabajbldbclnkebkf	TRUE
mbeobiekbamjbaopgkncfpledjhclld	TRUE
mlmegkkllbpballhjbakandkfnhdgld	TRUE
ngbmapnbjijokappkhdlffgaafcgloa	TRUE
oakodnepghebfmfdoomakbaknojbdib	TRUE
okdmakbaibfommmoclnaannnideecla	TRUE
pfhcabdffkiibajbacpdkpilbijnkab	TRUE
aaaocoiadihllgbdddfggegefgadcgin	FALSE
ajeknadiplpljclnnnkcaccjphociiif	FALSE
bdfkihknbjfaaeffdkjnnjdopfbdmgga	FALSE
bmpbfobjkfgdchddfdlhophdocfkoine	FALSE
cgcgokojfipebklaehfhlhdbgfhlgkbe	FALSE
damlhflnolkedhfmoejaineokdmaflbk	FALSE
dkijdnffonjjjdahajphpehallpdjnme	FALSE
eeikgljpcgepamgklmiagbjcbiecbppl	FALSE
encncojhldhjdcgggnlikfdbhkbnedni	FALSE
fifmkkkkndlmmjigkhljlmjfkogfhneg	FALSE
gdkfddgjeehjhahlemmggiclepcgpcdd	FALSE
gmkbamealnnpoplbmgfgmbohijadolpm	FALSE
hgmnjbipijhfinninkcocmdhocbiekgp	FALSE
iaeejomgbchelncmcicolancejfadfgk	FALSE
iileamgnaicaadpmbbddanekglmkmhod	FALSE
jdeajoeomnidoiobkihbhajiahbkgbnn	FALSE
jpghjhdcbeckdnhhgeiapphmlmlmidgm	FALSE
kjijddcnbendaleiniajcaapejcijdpm	FALSE
ldflegaecbdonijiamljnfhphglckogc	FALSE
locmfepjpkkcfnkcelecapmidbjjeghh	FALSE
minncleipfoadbbjahkfankgeefcadjg	FALSE
ndonaceemlidplokcpgmnflemichkbom	FALSE
nohcmilipglckpkhgjdkkmlmndhcfaoi	FALSE
oknfpeijofajncinaioikbdkphknpgnn	FALSE
pehffaicohbhmngkgkimadbdooemdnoa	FALSE
aababipdcmgekmifngfoaehcdgggcmfa	TRUE
aieiibnmeabkkanihbbknaiicfjbkoef	TRUE
babjakkofemabghkeclemdcgibbfkfen	TRUE
bhlpjfgnffnpljhnndjjabolabgifoee	TRUE
bpmahmfeogdoocidobkpahbnahihjpmi	TRUE
cleoblabnnapkggpdjjplgncooligjnj	TRUE
dfakmcmababfglkdaadaldfdgbbecjcj	TRUE
ebaijbaoilkmgnbinlgbpclcdiobhihl	TRUE
emjeogbhogabdapnmkpnkbabdlcgkhma	TRUE
fhbinancpnchgkbebjkonbkanknbampo	TRUE
gbllabakjkifbijcapoecggbhkocljfl	TRUE
gnbaonbhaiamibmakleeeihljjcfgelk	TRUE
hgabahnbdodjlmdbaaokkfngdacmbhng	TRUE
ibhdobbodbogacfcdkpdaakbolnhabjf	TRUE
inonaddbapobalmkbgmognidegakhmck	TRUE
jhfdogcnjiidjlffpemgbaababaobpcj	TRUE
kcbjdgkkfnfabalbhjejpnpmpicjipfb	TRUE
klpnppbjpnbahboonamnnnnhcjhffgal	TRUE
lhmmkbfhiokoefmbampibjaffhkjkclc	TRUE
mcchfjkbfgpaboabehgbdlgnckghmlde	TRUE
mlddkjoejbpalbajcfpigokhbmdpiadf	TRUE
nfababmjmcalhfongppnjhlhhmleboeb	TRUE
nnndkdoeegailllmbganbiokkilaibmf	TRUE
ohhbdmnmpookkaofbaboangpaibpimgc	TRUE
pdeaggjeklplfmmfodcjcembbaobaebh	TRUE
aaagmjkeanlibkflcafcnladkikfphphi	FALSE
aklinkfflkcngcempanhmfjjlbfjoiook	FALSE
beckejakgekcgpnicgpcjmaglafjomopf	FALSE
bpcpjdpkobgckmlomalgnmhanhgaggkep	FALSE
cilibfjegpmlmglgbcmpljgmpdejmhehg	FALSE
ddhjgmclkgkaoaallcnpnkegemcpgiffi	FALSE
dngibgainkaikfgmankmjglppikcjffhm	FALSE
egnpnfjdelfonclbhamdokjobnjklpgba	FALSE
fbfcbpbgnddijckpjfbbokomkhfcpbdep	FALSE
fmoalmbpgpjfjjacdafdnoofckiioehhp	FALSE
ghhlfbjngjfjlnjanaacocdnlkoapacbd	FALSE
haknchaifbehaogcljamfdhppakhlmjdi	FALSE
hmgoaeedkpaojejhabogjimlfofknieae	FALSE
ifgkhdgagpdhcldlinkbfdljckjaigkfd	FALSE
ipbdomhkpbidmcllooinnldnicjdonjbd	FALSE
jjfmbdchkfkanjedangfjkedmijldakjb	FALSE
kcichgmekkiknaeokllhklnnmlmnbgnpd	FALSE
kncchaecpoehabhocgdfdlimndmnbkepl	FALSE
lgfmgfpafdnebenonamkfekbnpbblbodi	FALSE
lpmojibhhpbdbhndpjjblonlodjjalggo	FALSE
mkicihjeloldnohpkoolfpmcfmnliohhi	FALSE
ndphndefjgcokgiifpcjebaianjnainfd	FALSE
npehoibgfacemcdbabckdcgmchgagdicl	FALSE
okiekhmnalanpoggegediclnlbfmileif	FALSE
peciipgobcmeclffnkoagfiepcoiiiged	FALSE
aaajbikkmjapmhlbblgnkjohfgbgldidl	TRUE
ahchknnplabanimkniobchcbnjnhaimbg	TRUE
aoppomhlpjeibiahibajlbhobbidiifie	TRUE
bgmlldfindhnbabahnanlmoncbgjgbbcc	TRUE
bpnoafommmjhbmfcmpckljllnicbabano	TRUE
cmfkgdlkmodiimcfcmbnoaplbahicpnjo	TRUE
dfneohloldanhapnmgabaihblfbdcfbag	TRUE
dpaoblabphgpocecoiajhnhkbaloibegc	TRUE
elhflfobajliklbandejidhoeknnkmjon	TRUE
ffadebmkbionobkikgidhaabnabhacnom	TRUE
fpceafkinfkjgfblbohapbanpbfcgokoc	TRUE
gidnfnihdjdijhldacklaffbabagmccdj	TRUE
hcpaoilnjgaiobmabgpmblljikfindcml	TRUE
hnfkhodhomifkgmbalpbhjjalkenfacef	TRUE
iibdnmofppjkkcgdnbbkagdloabalbllk	TRUE
jealeblogbjabafmebamggdfapmlnbcka	TRUE
jobodpdnenmebgepjmkchbmaplbjklapa	TRUE
khljbppoklmlelaboakblcdkjijkhiofc	TRUE
lcichcgoibnlnnhgbpmaboaliihmekaoe	TRUE
locndnpkjeofaaldlibabadngbgjhobig	TRUE
mhjpcjjlgjaiedahkblhgcababflnkcga	TRUE
nbjnlljbakbaamehngidllpceoollbmpc	TRUE
nobgjpnjgnjmiolcippckdapbjonolabk	TRUE
oiicfflolgabbjojnnnlfhdjgablabmii	TRUE
peceablabjifapkaadoniplphopcdppcm	TRUE
aadcmpcccmkcmlnfclehikfnchmgcpfoae	FALSE
akfiinnemggajjofdgjollokbpnbljljdp	FALSE
beimkcfmnfbkpjhohfhaopgeijjhgkmfbo	FALSE
bobbhapcjiejldocpnockildmjkeafepfb	FALSE
cjhgmpkdfegnhbpikfjbleifijpnnpmgib	FALSE
ddheppcmgncmfcojeaffhgfcifmppohnko	FALSE
dnndkfoggmkgkhkgbahnmanddchnecoeda	FALSE
ehkikkbaoobemnnenddocgnpakjhdbkeil	FALSE
fbmjaijljbgnaebnimceiaepjkoojfdmdf	FALSE
fmpdcdpmahagfijboihnmggjlgkpdcnpei	FALSE
gijijipnopkbbfpaildikemklghhmamgnc	FALSE
hclklcnbjhkpocigapmkagjhfhghmgkmec	FALSE
hlechmkpohaeldghlbojbdapggaoclgfim	FALSE
ifedamfjmnhknjbaiemdngjndmdlnfbcjg	FALSE
iphfoonpjgfgmhngglimogiemhdiilgilf	FALSE
jjmaihooiacegokflbkcclhpgidmpjcbda	FALSE
kepecpjaolgbjolekpbajhahlbhafnhgnc	FALSE
kppgckebnbfcheamlpcjhijgmcipjgippi	FALSE
likoplmlcdlcioocgoladgkjnhkpggpfpa	FALSE
mbhceigampdddpnhokcpcibpnpbgelfdcl	FALSE
mnmbhiklmkboomjmhfogaiihnahdcjgcic	FALSE
nihmkofbbbfbldoofnljkodolbakhpkaij	FALSE
ockdmbolmgipijlnkolgjbidlhigihcbno	FALSE
olpmfpahccfaikfhibkfhcoaalllhnmkjl	FALSE
pgodlnfbfmhcpimkhegcpnimldkjcjpcej	FALSE
aabdgglbabikollmmahgnaocknfpnfdlje	TRUE
ajbajhbhbgkjanipnhifejdoinfcogeoge	TRUE
babnahhfphbofnldengcghppgpobccldgp	TRUE
bjbhkmpfdhaobmabpmliafeblekcpjimhm	TRUE
cbpjfgdbjahmkbapnpkchjejedblfjmeea	TRUE
cmhmhopihnbaokbkkiaolkjkaalneadonm	TRUE
dgnlefaobnjkabiljinkpmfciimifkegfm	TRUE
dpldbpjlakpbadjeflnfjdkhookjeabhld	TRUE
ekaibgmhppnkpddhciedcmlbeabajmbljd	TRUE
ffabaihkamblambphlgodgaejlcikjahki	TRUE
fplcdcfpmnodnmalnfbiaobkadkbacilll	TRUE
gjncehpcfcnldgebphjabniaboagnogmmk	TRUE
hdieehgbdbiapiplbjaallbhhggimldacd	TRUE
hnndbnodbdmieldemabakabahnbhmpcaon	TRUE
ignlggmmlkfbapdodoiegpobabaibojnkf	TRUE
jbgefejpobpnfjnlcbbjlajbnaeppdmklc	TRUE
jmogmmdkpgicbmlhabikaogigeompmlofi	TRUE
kjlfobmbhkaoblladcaebfpfobjpmpmgli	TRUE
lejdbkhbakkibajnikoemoilcflnojffhe	TRUE
malmiibmljiljiikmgbejolapbainbhinc	TRUE
mkocglpecfofocbfkmigpibamblhnhokaf	TRUE
nepmlhfnfenghmmfodjagaldapjlmpabab	TRUE
oakpmbkahbafoapkihlpgadabdfjaincec	TRUE
omhpcmlpfcnmdbdhecnjakiobojmaibkad	TRUE
pfpagjkfhaflpohklpganlbambgneembcb	TRUE
aabiibihggofljmpdomhmcjiihhhgpfebdn	FALSE
akakignjnhcgedieiajehdgkmemebecddgm	FALSE
bfilmfimpppeomlbibnokmngoibfojjnfbm	FALSE
bomhggnplnjbeiacibdpafcjiejpddclijp	FALSE
cjjnhcdjoaodnkhinajogcladmlglcaodcc	FALSE
dddapbfbclaopfkgclicekgbeoielagngnm	FALSE
doigkmggbmdekoppalenfacakilgocljijn	FALSE
eiojgboobglenmhonbadcmoojbdhjdmbako	FALSE
fcdjpjhffjafklbpbmmhhlneknbgnpjhcck	FALSE
fopiokmmldmpcjobkphkhhmkccenafmohec	FALSE
gihgmnkcfbpfbbpcfkjaomehkdgphjgmkgn	FALSE
hbohigdekbmfhcmhodkaiojahhaknhjnjjm	FALSE
hnghacnklogfieabamcihgjccflhnelcocm	FALSE
ighfpppkcoapfggacmjooloopbhjodngcie	FALSE
jceojbfpgjadopgkogkgfheodnncmimifnl	FALSE
jlkhcnfmdfjpcocmfnalbpncficgggpcook	FALSE
keccedciklmjnnjnpoiddjlkhifciikpdoe	FALSE
kpilfihoeepbpiabkdklncpkejaflkmfgpd	FALSE
ljdcfohmeelmoklcjkpodcbgmbcemahjghn	FALSE
mdohojnkeclpdcgfdkbgmkmpocflccillma	FALSE
mnfnekfikoofljblajbenegndmacjcomjbj	FALSE
nhndjallgiekopcglbkicahggoknogdiihl	FALSE
obpjclbiobbkhdnbkpmnekfjmgggfnhddlg	FALSE
omkmbpfaimagchloeiojlhbgmiipcnmkfle	FALSE
pfppjmecpdffgfedjocpfpacemhhlefncmi	FALSE
aaampiknebmohkamjphpbampejeedgollil	TRUE
aibhalbhbklbpglemjecamhddncihmeacjp	TRUE
bakinjjkibpihlhaedokacgjhhgifgjoedl	TRUE
blbdnmealpmlibcabanbcnoekffihccmhio	TRUE
cfhpbmhnahlmjpblknklagibckgcpdklffm	TRUE
cpijebhaicaeababknnemngaijgghpdpflf	TRUE
dkafjglnbbibcnehahobabaipojejjicicb	TRUE
efmbihkhalbannfelhebohcanidnjmegkpl	TRUE
fbjpgieolindkffmmdoeonajmpbkabicioc	TRUE
fnjngmllocpcplgfbalmibpoaomcbegdcno	TRUE
gicecpihdlbjlmgngfgjnefbnkpannbanbd	TRUE
heillaobahibcnhbcadpciacjckohboomje	TRUE
hnigngneljmpfegbklbjoaonbacnkaeimjj	TRUE
iijclgjbimchgooabljbffealgaohbiabio	TRUE
jcmbgnhecimjbjeailjhkbabagidpeilddl	TRUE
jocbgpacgjgoeacgnahbabffadneafijioe	TRUE
kimielkifbnamifclbmhkammkbinmmamacg	TRUE
lcggihffbpanblacnkahfaklpmadnpldagm	TRUE
lkncboapbnanbaodlhklibjipbnaonnlcgn	TRUE
mdnphgnnnnaecflajkjldjijdabiabemmop	TRUE
mpbgbkamgmbaopipmakonnejjbpjapmbjia	TRUE
nimlnphfhmgeofkjbaipkjbhnacnbchoejf	TRUE
oejociepaablahbddnpihepkhcnampkipcl	TRUE
omoloigofbhbenjeeeibpnakbaomdldhbdh	TRUE
pfmlcifinabmdjclglcglfcpdceaibaibao	TRUE
aaahbbflbmkmlbkakmojhffkdhingpoakngm	FALSE
ajbcdelbfkdalpcllhnlkebhmoeoncfgllif	FALSE
bdjojhmbjbiebcanlaeciacignmdchdbbakd	FALSE
bnlafchgmkjnecgmckdaaifiepcaihgbjkpl	FALSE
chammbeamcibdgnbpfgggjnplbpnkokbolcn	FALSE
dalhbcbnhlligjahnodofphfaehfihgfdfej	FALSE
dlhopbcaccpaibmiagkoggafccdldkaeloag	FALSE
eelopfafndjjalglngkndcjfccmaemkfpmbl	FALSE
epfhpoldkbggocgjboahkcedndjiioidjeod	FALSE
fldgaiiibifhbjbpclcpjmodokmfnmhgagcm	FALSE
gfmhkcbolfbofkhmenelidclnojpiobkkaei	FALSE
haanoegneaegblhgcggilmkaopcmiidohjhn	FALSE
hlljaldobflpkjghlhalmpibkjpioobfkbbp	FALSE
ifmfdbmagbldgpfehnangalbidapgbahnidj	FALSE
ipakdckagipnadijlfbgjpdglfeflolfpmgm	FALSE
jlhbfegiaogeandfkapfaflaemnokbcajlki	FALSE
kfdfbigebpgebaiojhpbfgppbbmicfhcnnhj	FALSE
kpebfmbmfaebiaimliepiaeicdkkediajijo	FALSE
llaedcmgkkindaknjhmkcefcogkdabibgcei	FALSE
mfehggcodmakmgkjpdpcmeecabggfnjbndod	FALSE
mogmocpbjmghkokdhdhpkgbnnacjmjmpemob	FALSE
nhndefjhmfmnpgdkegfkjpdggadlkjblajda	FALSE
obkmmbflaccjkedjnbfajadplelhaidgnhef	FALSE
olfbmiddhblkpfolaijfognbcpmcpkpojbig	FALSE
pgjelckklaccbibdgemchfflphpeekdeifoh	FALSE
aabipjambmihbgnmajieobihamlpjhhngcpk	TRUE
ahjihoaajkbhaibibgmepfcfkodlldcfephp	TRUE
babakkniagphjkklmapbcjekekfgnjmbefif	TRUE
biambcdbaioknnhboakdajnjempgfblfajfo	TRUE
bpkbhlaplkkbakobleoeabnmmnlcjooalfnb	TRUE
cjdblpabkhnagpomjhdjeggnkfnggbadcgeh	TRUE
ddmmhlnmmfpncgkeljlcmibmjaipboilpjia	TRUE
donmhgepoacabilanpkblmmcbbnjnfhdamjm	TRUE
egnnkpjndmhlhekjnabdeekhbabaanfmghmd	TRUE
fbiigdcbkaplbadajicjiaghkmmoibdfemdo	TRUE
fneoajbamhbajhkdibngcgoflednidbcbmai	TRUE
ggnmipghfknfbanghlbabagccijhcahaioaf	TRUE
haoppljfdbbomabnaapjeidkkobdjjnkekpl	TRUE
hoghfhpgflbanbaodohommibcoebiogiolgd	TRUE
ihfmpkiilibfofphlglhcbanmklbhamkkagn	TRUE
jbfkfcdgmacjcipabaohlbcchbldeopffeom	TRUE
jnbcmdganjppbcfefomnkpemjngapboalban	TRUE
kgellkliinebbdommomjbefgennfjaibabnd	TRUE
lbapkppbaflphknnpkflonejnpdldlplgfoc	TRUE
lneioclmpbaippbpahlapepbeledblkkbiko	TRUE
mjjlijccbkochpnedhnjkgkmmjabkkanbamg	TRUE
ngcobiamibnjabcmajfabndpbpjokboekchh	TRUE
obipkfchmjfalcmkjihbhhabaaobiidjofhj	TRUE
olkncahpbmpankbjinhpljdblgcmmanogpag	TRUE
pfejmmodgegdjodhckkblcidbaliopmboafj	TRUE
aadcdpjkkaljeccjjdgakpgcalnoilpegabbn	FALSE
akjnakmhgbclaiogiehmddpincacpchhpplbb	FALSE
bchenmgomkjekfebooldcjdmpdndilklahebd	FALSE
bmoifjhhpaenbgldnbfdcbfcclkdodnibndgc	FALSE
ceopiedegcgbbihpgdipgfhmhpoacengbnhem	FALSE
daodjjoclgklcflmdibbllcdglacdekelgjjh	FALSE
dkdjpacfkbmcjgingnhlajekiefcbaadnohlm	FALSE
edebfacdgnholkjflgheaoakfhnmnognkfkmh	FALSE
enliomjmnhicpelphmbfhggpohfpapaemkpjh	FALSE
fhgncjlhkkkimppdkngnbicodcheelmehmike	FALSE
gbnkfmbgemahcifhjlaibfimfpbgchadokcej	FALSE
gngpmgelaeblfokokgndjommhfgehoaghedkf	FALSE
hggjglnfnalpnlkhciclemelfipeogbeongda	FALSE
hpmgfpachofoipoamnakphjkofejoploiefna	FALSE
ikaamkacebgdfemgdepfhheljlfijpnjkiccm	FALSE
jfgchflkkhdacoalleipfiimhdpnlpldjfogg	FALSE
jphkpflgbfkbokfnnlcpajhpphighjkafcjde	FALSE
kjfmagnjfnablknebflpemoeafpipcbkbkiep	FALSE
ldadljglpkelemfobifbhhgccflhdfglopceb	FALSE
lpbcjblhhfanhbdpjdfibnjfbelakdkeomkfk	FALSE
mjcoojcocddghkgajniklcmamgimgjniepjia	FALSE
ndenddafdlabkkkkfaeokjchmjjnbmebjlgkd	FALSE
nphejpplnbijalkfmkjmfnhmbgclcaiondcek	FALSE
okiggkibfnjcgockcbeaohklchkglelplhjhc	FALSE
pfiklpoiohdnlomebhahnkddededbfblgcalf	FALSE
aaajeebnaneogaigajekkbabjafgamoncfmgk	TRUE
aibapbcokfoacnpaehjjkhnfjcciaefcjbajf	TRUE
apchpoopdbmifebcodhfkglkbmdchcgbabmaj	TRUE
bhjjbmkpmlfaaekapbmomabjddjepphepfnfa	TRUE
caijcgbmijpbamobaidbjkgmeeokdghjkbopj	TRUE
ckfoehahmaldoambiaomkmhpopbkkclkkpeec	TRUE
ddgajoccmblllfofhmcmblmopmdlakbaphpbl	TRUE
dopgmpjpmbiaibhfaabpippnokalbhgknljok	TRUE
ejgflfnjgpiiapolckmojgfmgabkaokkhbojl	TRUE
fdaemabmhabohliblaecodjjpkmlcnmfibngi	TRUE
foenfdocbmpdjmlnppbiabjkjjpiaggpkcapn	TRUE
gjbabkaaakeiomioeifgookfokachgpfikpaa	TRUE
hfbaapmfkhdijhnligjekhjefdjgaopbablpd	TRUE
icchjmlkbggibgejakaeianknppohkbmlabda	TRUE
immjflddmkmpnffmhaeiddbmamlbhlajdgkmm	TRUE
jhjmnkhbabpakgideafhlfmhhjjjlndooojcb	TRUE
kbdcflafaboholboiipbabahecjjhgjfpiecf	TRUE
kmajjcigphamiombfjdnalkiinhaamlhpbabg	TRUE
lggkinjibimepogalphpbaojnbjmnljdjnjdc	TRUE
mcgdlmokldhpmmbipaciopgocgjbmabagfhao	TRUE
mlmecceghbplonoopldhifhdljbgbajjhbakg	TRUE
ngcdkaamfbaibaegaekhoabllaebndlejjnod	TRUE
oanhecbdihcaefdciogbfaabhklniajkllbhp	TRUE
olcbgibpahimbhikhahflbdopphbllkmcaeao	TRUE
pfgholodkfighigcnabjabbmidjlckdfdbagh	TRUE
aaalkpeknjpmdliljkfeddfmjmlnehdankcneb	FALSE
ajnjgbongkokolhojpplgpjdicalobnolaefaj	FALSE
bbnhclghhjbnlmlefndjnmkmojkcenlelakcie	FALSE
bmjfapjodcgdpddgnpilejdfimajbonmnahgbi	FALSE
cfhfnjnbnhdkflcngbphfaaamafnihmiccjnce	FALSE
cpddbbfecfegmgocedglmlmeaaofgpjlifddij	FALSE
djnjpgceeoicppgibilfldljihpllnkjmpaojk	FALSE
edngndgoadmneaefacanmlbfgabkkifnpkchho	FALSE
endapnddjinlpieoejlciccmheaioncakpnfai	FALSE
fhjllaklbfhbndgngacflfcipdkighppebaiop	FALSE
gbagmpemoapflmiolngkaemimhdhlhihjinmdm	FALSE
gliehgkfcdkoodcglpioghingcpcmkhpinjamm	FALSE
hfjenehnbifojlgbajkbgjceinengnjijhkpdc	FALSE
hpaeniolkakicdhjmfhnociajkllpkplfeaaem	FALSE
ijbklcpiadljkdfjokbjpafppnkedhgfbpancj	FALSE
jfmchefdjpjcenebebklhjflhackpnfejgbmgh	FALSE
jppejiigngpkgdfhfcagjmbljobpdjofbdilgo	FALSE
klbnidpbmflcbgmlhbjiipmldmhepjgagkkjod	FALSE
lfilhpckokeoeipbbicoakpgjhnoejocpdkhfd	FALSE
lppffoihcmfcmkmjjoojkoomhpkcbagiclghje	FALSE
mldedclmkbdglflbodlbobbmgjngdlmhmgcljo	FALSE
nhfcohafcbfahkacnnjhmmlghbgeegjhgdlfii	FALSE
ocglccimccbigolalfcnnfenaohibjcfgdijep	FALSE
ommihbffigdedopdooemdapbflaklljciepnmf	FALSE
pgambbcdmmgfgaibcgnpknhfpfmekipgipdkjp	FALSE
aabnmabfboljegdodblohghhfgjmkiamgnmhgj	TRUE
ahemnemhnfcfobgjeldkbpaijbokagckkfplkg	TRUE
babapkfolfgigfkhfflafemngpdgpombohbbif	TRUE
biaphbaegkdiaoapkcaocjkgekdnpdimmjiboo	TRUE
cbfjlgeeckeejdpbmemlhfaonhggpaojbanpbd	TRUE
cjldmmngaodbihnalnbadendjcpffegphghkdl	TRUE
deocaceobpllhlajobmpakmaagjnggalachgpp	TRUE
eabaikbjapfhkpihplebnlfgfaoihhldglkccn	TRUE
ejophenabannolkjobecmndhohbpbncfcepldl	TRUE
fffdclpemenopilfojhbhkojafpabkpmmabjao	TRUE
gajioeookgakblabcpclenonjdaaecompckfko	TRUE
gmdcmibkjbledbbejhahnbpabbddlmnidbaoaj	TRUE
hhjomenfofakkbhimmalkobhkgiognmnidecbi	TRUE
iagffdjlaibmalbmefoamfiphlgjnepoofnjad	TRUE
ikaboabaahcnmjkpdmaoaaikojbobgmopiffhl	TRUE
jfmcojbnmanjbacoblpgapblcgocdneoljmjmc	TRUE
jphalndmboaobabfhajipffodopkddbbjpfofa	TRUE
kjemoeajhmpmkiibabebjbpmlgfdemibjfablk	TRUE
ldgilhhplfcfooafmiigijceabiaobgpjadbac	TRUE
lpkcdnkonpgknkfbnfjgabnalbanlijabljblh	TRUE
mkpeigokbnlkhfplcjknjblmababbnpjenpdjd	TRUE
nghgiagmhmenemlflmjbikabappoecggaehape	TRUE
oanbnjpfdikiefjonckanlhjkgalbanblhekod	TRUE
oldmhfpgljhbapbmaineipngnokeeijeeamchc	TRUE
peahjnamajhojbhdnahibajbmpkkdoleodfeop	TRUE
aacebibabpgmhnijomhcckhahhopjdblkljfibo	FALSE
akocmpihkoabpecadihflaegokmhflcjdidhgac	FALSE
bgofagjhonnmoamgbhbndcibdlmppjomhkmmmfo	FALSE
cbelomopfaobahlaohpkipamfikfcmleppmaeoo	FALSE
claphkodgkckeciplajapooljhlohgfkhbbapdh	FALSE
dekpeibghhplkdlmnalplaffonicjngcegipfip	FALSE
eabaalalodnfbfklfdlpmeeaoklleicnfpmkppg	FALSE
eknppongfdimhnmkiagocliegfmmdjdajkepace	FALSE
fggcojkddgdnnfigpihejoafglohknmhdakbilj	FALSE
gbeampldmabbhlbaehmacfcmdbfnepboljheaoo	FALSE
gjjlfhlohcdfgadingppjflkejdajonkfeegbei	FALSE
heeigiailmoejhhghgnfglejggbfiffmlpopoam	FALSE
hpegcbniknmaacdhehegdjnekkjekphmhplemaf	FALSE
iipaekkfjglknkhgenkaaadhlndehakcchgejpm	FALSE
jccimgkedgkafdinagmmplfbjkdnndnpcpeglba	FALSE
jllefncjcoocfllgpcfcdadpjpngmgielbhkgik	FALSE
khhmcfbhfgghkdkhjjglmdlpjlhodekofhcgglk	FALSE
lbedbooppnilpafimheoeogcpagenngfmooohpa	FALSE
llckdodpcfmmofcpgkagoompcnnehjhakapeaco	FALSE
mfllppbpjeimfbbdobppjjkcjdfmjphgflddkpg	FALSE
mphojfgddikagnmfkffgfkeikefmdknekhdalnf	FALSE
nikapcpkggbbcjefnadnocofinhggjkkoaacllb	FALSE
oajebcoonjhcnameeghhggjkmlmmjpmmmgagegb	FALSE
ojejmjgnakiecpeeoibdpiimkeebenllmoffkgi	FALSE
pfcpmjbikockmiianbfiffcfiioakchbkaakagk	FALSE
aabaijbpaibblfbdpdlfgleaolcidpcckihgmnk	TRUE
ajhjpbalnbafcfhkgiaabhpbmhkcaggljbhjjaj	TRUE
baiphmobainnnpkgddhfmobhihkmlhigpedpokl	TRUE
bjbhhljhailimldfogeklfnbbenodpclmnbabae	TRUE
cbllamdjpabgjejppbgoopedbfaoboaojbjafpi	TRUE
cnpbmlohapbiakgipjemddbnlicbbihcpblmmfo	TRUE
dinhldmpahpjklhniaddcefmdcfbojgbalbjoac	TRUE
ecpbnalbpaoooojganebfglbnkoebdpjgainbca	TRUE
emkplbhkehocbggkjmcmphnhmglbmeobbahbabf	TRUE
fhihhanbdjcmlifffmckjabppalobgohjjbefod	TRUE
gbjiadkmpookjbhfkjkbabacifnecoknbbmbmde	TRUE
gmhgffmgaibopdckdcemnlodhamjcjpkpabapbf	TRUE
hgnkdedbhnabkjakfaahhkcobmbgcbpchlpaplb	TRUE
idhopffpakbbenneildldfbohhbpkkaibnkhafm	TRUE
incjhomplobijofabcfnbnabmabcojdpljihlli	TRUE
jhhmlhlpjkinanfhpameieeddhpbahbiaeplblm	TRUE
kbjalbagmiefnbbdklpmajnbbklhppkgohdddhd	TRUE
klgghnghibppjcjkioedkoahbabhcikbhieegih	TRUE
lggblkabaiiekgaaogednjgjapnjmcfnbdgcpai	TRUE
mcafjnkmabablgaikomghnglnnnhghggledeiad	TRUE
mlbgkfoffcingdlkbanmijbaaaagfifgficpoap	TRUE
nekojmaaokpjbnaoibndipohbfanblneebioahk	TRUE
npkpoigbadhlmhckbkmlboannobhanfkpbnmplm	TRUE
olababhkgfllmmihbolgeaahdjmkhaehldkmcof	TRUE
pfcoaghojncmbfdggkamfnbjiabkoapnbogkboc	TRUE
aaabppbagnbmfknepmcpidlnibhgndkelladejpg	FALSE
akmicgoocaigeijkbfjjohjibjnojibipblapkae	FALSE
bfmfhihopilgdohffpcehmkpohnjgffkaccaljep	FALSE
bpohjaojlccldnddcgegfgbeicbgdebgnmjilgeb	FALSE
ckpfcdlhmpacknahhdldbgfnebjmlclokhgfaddm	FALSE
deggpjhgoicgjoimbodicnoonodfimgolgmiaded	FALSE
dnemlmcieakehapdccanohnoodolpgbgkmnkdndm	FALSE
efeaijjogokghglbginlanhlbapdaaecpejmljif	FALSE
fafimiipfcpdbkoflchlhlijeeilbnildchpkmjj	FALSE
fkgjdhdcliflngomhpempcjhallbagbaipjigben	FALSE
gggbpallhoacdhkeinaiedffldbkpbbfbakffpcg	FALSE
hccfcfbomknnnkhegkdkfjcopomnokdgiahnnhhf	FALSE
hljaoeooabofepdjajbjpfaijnblbbmihojpgdnp	FALSE
ielkmkjmfkbjeeghghjaefpidndmoebpgclljaek	FALSE
jaloflgiibcabebmffckkgbenmedcbfobgacdjfe	FALSE
jkgnenmbcjnicblkimdiokegffjfiiogchcecdlg	FALSE
kfidcmhncnoichjiccokklgohfmfoldobkefadff	FALSE
lanficgmohmogadflifnkjhipeafcobdogoibhnn	FALSE
lkhiflbeepbidejemgeabacicmahdkalfpemdmge	FALSE
mddiakioihfmleajebeddopngnokkoeplfplffjo	FALSE
mmkcomdkaeeokjbcfnhihbcmcoaikcdcmkpihhna	FALSE
ngolhdogjgmopfigmihkndkpkpgnhjaedoopemmf	FALSE
oamgclcjiefiifdlfbgkmbikpchmpolonapddgel	FALSE
omcoimigdjjdcfpodhnkhnfpkognilhggcajfpph	FALSE
phdekedffhcnnipnfeegfmbcipkgjgjmiaajklfe	FALSE
aababcgocnlklbigeaigoipbehlonepknibnconi	TRUE
aipmoncelagbmpgmpiabikliahjblopdkldedckk	TRUE
bamkcpbaobadmieldoaanbgdenhjeiipedpmoofk	TRUE
bkaohjjnipbjhklmaaednamniffmfeghcfipbfjn	TRUE
cbmcjdhjcejkmbkfnmppabmnabmliggfeeoehepc	TRUE
clhnnibnmmicpeaaibapbmjbgbpaplhnegododno	TRUE
dgbpmkabkaomacifgpdgllabkcdhmjllhigbocbg	TRUE
eanibckanbbkjenjiaphgnmmpffcdliafmboanba	TRUE
eljmnelhjagobcmhjhebfipajdfjlmabpapmjbdf	TRUE
fggeeciibabagihgkfcaggmeiakhahcjffdmlckm	TRUE
gcbmdgpbhpnaobaocgngabmhoghhjnpbhbcgfigj	TRUE
gmmceppmimaciekpknababedohghhjinmpkopmec	TRUE
hgknmncalpoobabobcgnioomnamknpkpofpageeo	TRUE
iamngfkepkbjiikobkdmncplafddfinfcmcabpab	TRUE
ilhohaainhljbeoiopjjlbbbolgdkmdblaobkagm	TRUE
jfnbabjnkiojaeipmggndiopjljbmlkbaopcplke	TRUE
jpnbmiablaoemkhnlicodfiknbmligjhipdmdikf	TRUE
kmambjimaihnbllpgndgppanjojikdkkhflndnip	TRUE
lggljoaekpfanjeebpaboajdbmickndmkpoeoeof	TRUE
mbjkbngkjplkegdkppedonnkpgibpakbadbhcjfm	TRUE
mlapaibkbbhifnanbakbommkiceeldfccpbpblad	TRUE
nfiabpaophnlbopedfjoemhkojnjdjmnjdobelll	TRUE
oabjabnamjnlfkigoccaflifclgicekaeeplbgkg	TRUE
ojijiikkeflekkjcegonhhmnnaoeaifablalbchc	TRUE
peggpffmopmoglincdkaicaobkanbjnanheoccal	TRUE
aaedhpokgmdhchiedgehhphappaalpggfpgfnenjd	FALSE
akncaoepceamfjgcakppkjegadbdeafknnojigjdl	FALSE
bfelfgjliancmkbgnmopnkdcgmnlcnldicognngac	FALSE
bnajemanebgipchhbklleipememnmccbfillgdcnc	FALSE
choohlighgjjddfagkpdkldclajfmpbcclihldigl	FALSE
dcimklcmeakeflpmedkmallffcdeklbighclllgpj	FALSE
dmeohocilbgjhjjngoemnpacfpjinaidmnnmdgdce	FALSE
egckpkgdigbfkhmaicjmhebmdhjdkpbjgaknkendp	FALSE
fahfbgiakldhbofplhpfkckhngldjgacmmpbagpij	FALSE
floknldbkdebgnchleajffnhbbkplobpepjnodhmg	FALSE
ggjhjgcghdkiihnmjcffmopjidepnahbghiaijkio	FALSE
hagoncndmhdfgnlmmdaephkalcipkclcpcoijdoel	FALSE
hknneboifiaaphhagllnonpcomhdfpdpjcmgbebpl	FALSE
igankbgdhggbdgmbgkknjibgfacdjgbcheahopcdm	FALSE
jaeaaniajlcfgnfekljoopnahhkkehmmnbkjfelhb	FALSE
jmakcioehaicejmhmbljaaaoejneihglkpkmkemln	FALSE
kelbgckhihkkhnmgfkekdifamhdamgloaalcalebb	FALSE
lbijilpbgfekmjppoggidioeeafkmhehbngjplbda	FALSE
llalmmlihljbpnbnnkbfbnddoploonmbgeildggbb	FALSE
mealkllcmoddmhnlgackkiakgnhnmocceajbjekki	FALSE
mojjeppgegjbgfaaamfdpgechjdggebhogigfglbn	FALSE
nhmjlmohcofhgjpphjlfpcfgemmlenkdodnldgpia	FALSE
oddeifbemplgajaaokemkaccdmlnhhfkppkjojmfk	FALSE
onhfljojleieipndmolhjemjaiaeanhgdfhgdbgfb	FALSE
pgefjlfpfkkdpcedffgjangfdojkjekjjljcijafb	FALSE
aaadfnafkcmbnjahpbagnoopidlclohicdbnbhnob	TRUE
ahjbjgcjamaombmdebgigbpmabnphaojapaffnjfa	TRUE
apbebnfabakbheopeeblfcoooggbhkaakfniphlhb	TRUE
bfpeeeheeibaefnoohfbcfbcmblammpbkllmkhaih	TRUE
bodjnabmijabeilnljelhbfjgmeoneaiapinandop	TRUE
cjkhifipcmnohkahklkbkjjhnnimmmjamblddfokl	TRUE
ddaggikicfppdameohdkcbimabahlomnmblpfnkhp	TRUE
dpccadaijfocbabillckmmgdnkkmcambabnkcejee	TRUE
ejndhaipiokobabdinohknfkmgogcokdccabplhme	TRUE
fdcdbmdnefcongfpmnacjlalbhmmoambkpdhlpiid	TRUE
fmdnlihaibaibbelipgchnhneelpallcllniljgoc	TRUE
gffabablpgmlhdocafpifimhhkophejhjojejhnin	TRUE
godoajpmmnjlljabjaibkeapinfidpijhiiijalah	TRUE
hkmpbhjalabahbnlmkjbeliakhkjaciddbajbgjom	TRUE
ifnelijogaabnlaopnjlbcjcmgknagnaaadbdgceg	TRUE
jalennkielhlabplhnalolpnbonpdfmnhhnngejgb	TRUE
jmcllcbepnpbkbdcbjapjhilbfbbanpmbanalmcao	TRUE
kgjjdnpdmfmaabebijebmlbdlbibakbaihjcpelkm	TRUE
lbkoaifbfmbabaolidbdeiipfofgedcgcdknmbpga	TRUE
loeehhigmcohjjbmhokgefcojkpeepcegabmjahbo	TRUE
miligfbabjnlijjaknpnhcdicdcpnfndpjfkodblc	TRUE
nefjphjpnbafdlehaegbhblkcdlbhahbmjlnlkanc	TRUE
nomibkdfiekkkgbpjaboadmfiaejfgnniblcipmbn	TRUE
ojjcpngfjbhgmhkekppakgabnhlalbkdhcfkehpab	TRUE
penfabogpnciaooblabgnjjaendhkmhmdheomebkc	TRUE
aaaliajikgiiofggnldflhhlcnmklhpjopomoblfoo	FALSE
aihieedmfilliclhcgbedpbblionpgfjdonpenppdc	FALSE
bdeboomibggaaabdfggbinlfeceihnmbahidomjndp	FALSE
bmnhaflgnbfkjbdbncigjilekgiokekmjenacnhdmd	FALSE
cgajaldgclljgojbbikcncdccjibiajgicpbhddcbe	FALSE
cofgfhhpmemafeeagcibaabhdbnhjlnklgiadbkcnf	FALSE
dkhiemdlikhjaingbookomjlikpaclolimlngafghn	FALSE
edomaiopafgemcdkekjgloddbjfgkkkpjanfelnfco	FALSE
eoepkieibmolnecldfcdjmlonfcbglohjphahipomn	FALSE
fjbhjiemhgccknefdddblpepomejdooaiefpapmemg	FALSE
gfmicnfendgkjpbnmdiafcinnfneckbagdgbjkdgph	FALSE
haclmiaochkcdgpnnahbehapjhpcicjaiilalfjohi	FALSE
hjiedjiaeamafcbdikodmllfggdblgjoohpaccodjl	FALSE
idmhenpegiiechlcafjgeillbhiaoalhiipceljcgl	FALSE
inbkpjfmenfgaaibpkbfdkoclibadnpncgflcbclan	FALSE
jhfnbleohmfenipdglojkmmachfmhpihpeingcdhmg	FALSE
kbfalipmdeimmpljgkklnahapplicllihaiokjmcih	FALSE
klgdmpbfjgoobmjikddnpibobgppmaokdlfehjfpdo	FALSE
leepojifacfpddibdbhmammhgnoifdjmdhbcdoiaco	FALSE
lpcafkeocjlbfncchojancmmgalbcmifihlcnnnilj	FALSE
miopifmmkigakpmaljfikonbdjngbfmiklbecinikh	FALSE
ndgdnebghicjhlfgcjgldeiljdgoeoobdbkdcepphf	FALSE
noafdedpmaedkepgamgmhkabjcoddahbjlcibofljj	FALSE
ojkkpinfkpmfnembaegmhaondcdelbdolbebjpolad	FALSE
pgkkchhhgkimgbjgfifbcaophaobemdjehjefbapbn	FALSE
aagchaldafgmhoebkdaadafoekoimlocaoibmkjamb	TRUE
ajndlefbmabhacmghhkjacgocmipjibolfpbclnoag	TRUE
bbidehfdoojcoefmlmhpokfkdmpaaacahbajpbfcjb	TRUE
bmabjnkadfncjgaldkghkgclpibecpigjkggjjmafn	TRUE
cgjdbgmjplhjjdglaibficdnabnaklmkkkbdbkgiho	TRUE
dbgndinohcgldcdjpfpmanppmeeaijnobnloniaolb	TRUE
dlfagpemjnflbfmbdomdieabaombefjceennhandjf	TRUE
ehgenjabipabgdpoebgfmcleljbeggehfilfifaomh	TRUE
fcgcdamloinmbabgghmlljokglggoefhdhncnmhjmo	TRUE
fmenlaogpllpiaakgkpejhpboefakdiegaobnjiaob	TRUE
ghlhdabonajbokhglmdidpjmppdkjclbgdbaoeofab	TRUE
hcgkfmhmkjchplgkkkcgjmplkgebboabmapegbnifa	TRUE
hmcapnodhmcibmaoonbloafdkkmekcjmgmmcpdfeai	TRUE
ihjabihpahjmhbmkkjnbjpgpapdbplepojmfjpmgba	TRUE
jaoofjcaiolhcopakelnoibafcbabmahmoepcbneje	TRUE
jleehbnpnpebkjkabaeimjhchgdkcmbndammklcpgp	TRUE
kekliibpmkfcngkipfinpkmgfbebakbanfekjeipoi	TRUE
knmmhhgmmhfppfadlpkclanpebakbhhhjpaghlhcke	TRUE
lgbcgkmedbphmbpmpapbhppnanfmcebgjckaaiegdp	TRUE
maodeohkahjiabfedemmbkgegcifenabpanbpdckfe	TRUE
mkojbiapfbbkabalnlbnkkjiikbgfdengchpmoelnn	TRUE
nfhbgmebaiifldhjjdanflemphabmaijbhdmcdiofn	TRUE
nonihmfnmdaclgpegphfgambaoknbmeomfiahmieki	TRUE
oknamkkjclhkldefgaecnnabaljblmipaobhjfakha	TRUE
pebcdajcgbaibaioooimjjjampmicfoeohhlgbcjlm	TRUE
aabohdhnnkhajdobkhlgiogdhidenjajjnilibghdji	FALSE
ajaomjeaphoamjcmagdlehcbfmmdoegphjfpanognae	FALSE
bemnkmhcjgejnlahllbbbfmabdjikjiffkjlmnbdade	FALSE
bpicckhddenjjjkfekblphmoibhbinmlegbmjncidpn	FALSE
clbomhbjkbjfjnhiendeiabofjeaecjpbkcpmeplncc	FALSE
dedeoinpknijoakmnioplefogllcehlijjbkoncgmbl	FALSE
domihpmhhgjolnocacgbhpelkhppbpaaflpdckpndlf	FALSE
ejjildioedcapbdffkjkljfiegfbkgeelidcplngjac	FALSE
fdommalimodpobcjlaneblebmkieaikgekhpcdebjgn	FALSE
fnhlpofnnkpjdghlgkkkhocffkafgljgkdfmjkgddnc	FALSE
ggpdgaokffbmdfdemmbdonadjejoamfljblopfbambl	FALSE
hboiejaplpiddcafecpgdfmbfhhoddmmeagejepajob	FALSE
hlkdabplnhkfhejphaakajagjcdiebccakfnenlhieb	FALSE
igdlgmmhpimdbbgckilkimlejhahjkolgelnnkbfghd	FALSE
jaabnjbbnhmdaiaphacdhfdlnjlkflenhecjicipldb	FALSE
jjeakcdlbmcglgnckfgdnbhjapbhdjejpmkidniiakb	FALSE
kejmfhfodgleihlaebaijplepjeiigpfkchenmpaiab	FALSE
knckoeikbopohicealjjogkfhhmifahnhpeaklbmfpi	FALSE
lhnbnemglfbgghdjpbafambigmbohonnfmcejkcdahc	FALSE
mbfmmecnmbojgegamepaapockedbmkkdaikndgheedl	FALSE
mlgmljoolejggjpecfkcfbjcoiejodpekfognokklic	FALSE
ngflffflcccbaegioinamcoifodpmjaleicclilgpfk	FALSE
oalnkgiikjmkacnbjigfkdefcbcphdjgeoobjdeijef	FALSE
ojikpdohpdooghlomeggnajkgfjlkdjjmjagbkhgnip	FALSE
pemeobbpgaicjbclhommkoohmoifhgabhllaeelhbng	FALSE
aaaphabbnahblojpagefcmkekldmhmdlknbedocjifa	TRUE
ajbafngicpjianelgmkkmnplllaaibmjbmabbaobaff	TRUE
balkbacjcbgincchenmnebmgbekfigdepbpjnpjfheh	TRUE
bjlbahjijbaiglimcpiplgoakfglacdacngipdjodbd	TRUE
cbneokaedhoddhihfpcepfebaboahcgojfcigfpjkak	TRUE
cogmojkfdbhabolmjjaoainkcgbofhekonhemljfhmo	TRUE
djnhfnmlpckbkobbicljhpfbjabhmakekgojbjeadpg	TRUE
eeiplcpaabapmbdogpiabdmjghmeheenecbhkpajmfc	TRUE
fakfnggcdnoljaemmgmjaoegfgpflgobjalmonlblak	TRUE
fmfbmlmpjigfbjdikpjhijmcanbabbhobhldlehofii	TRUE
ggiefabajbpdbnjihepjgddnmncieahngihmbekmgio	TRUE
hbbookcdabajbfdpcoeoogabbckjldddhdaaoceaeoc	TRUE
hogjlabijpejallbapphibfdihdfnlojmdeldpcaabl	TRUE
ijpampnjhkapiclagelnlgaahmbahpmbohfmkmidjao	TRUE
jeljhpdcbabmpmajhpbpmodllljhlaienclpemalbnh	TRUE
jpjdllpoaiajkblabgnmoeldlejajpmdflgccdkgihp	TRUE
kinbefncpdjigimlecibgkkoicdnngnookdakjbahjb	TRUE
lcenlalehbjgladmhakpkkkbjhoakioinmhbclidkac	TRUE
lncomfjnfhkcailobgkljakbiabkhgahjbiioelnncf	TRUE
mhminpkbiabiahgpbigjgeilmodonfnaplfkgaonkjo	TRUE
nbbgobabajhohdmklmhbdljgibamnlieicamfgmhkbg	TRUE
nliecaepdfioacbmjnhknijaokbaplfhmkmdejfmmnb	TRUE
ofpphlljadmniaapalhmmegbahophjpnbjanidhkgch	TRUE
ookmcoekhcpbjnpomcpbnljljpoakjbpafiiccdficm	TRUE
phbfppoojloefmjfjhbklhpcnoemgabaolbdbcpjfli	TRUE
aaakamagkbjmodfeoddldmcgmandgdmljakkcnmckacm	FALSE
alhcognoaadknnnckdlomdpfbnkhcljlklelcpcpkfhd	FALSE
bffeecnfldieklijcbjnjjelneinibipmkichaiblfib	FALSE
bnlecinabiaaejhbhibmaobbghfpifkkjckoceiiilpn	FALSE
chmgaflmjhaockafcoiemmcmenlgmpkelahnnpkkgkel	FALSE
dbkdgjfdkhkonpbjcphacobcgfpoofhholdionnmacea	FALSE
dlkpijilefpchoooefffjnmaphahcojdeoabkloakcjg	FALSE
egijhenadnkpapdkpkljfmgbcejmlijcefiglhdnglcj	FALSE
faejokoefhpopeepfkgfbbjdoglhbbaocgmbfohcmjfc	FALSE
fkoilnikjfkmaakkcfdelabpdfgoapiggngpabnphclj	FALSE
ggcadioedmnpbbiicmlepfmnhmkakepaccoapjfipbpn	FALSE
hbnpfjjlmeomeonmkakpmhfjeelchbmkaakgipdpgnfg	FALSE
hmjpecfpljcmpkljeokkhiegleheohekefebicmkaofp	FALSE
iggfaegkgjnidflmflldpapfcbpajkfbhkdllgjfacgd	FALSE
jbidfljhkmhphbfpameoiejnaklicgijfbhbhhpmigfj	FALSE
jlneoffcfpofechpfmgldlaiogojibcgcfgnnbnhilln	FALSE
kfbogjmjknmphajcnbklbdlbcnfpdkgipocpkklncegd	FALSE
lajapkeaapmgbfhhnhommlgpdkahlmkehlmepiepaadi	FALSE
llnbaenocpidocoagnbncadehdhccaghnijljgffklpg	FALSE
mggdmmdeemkppinfdnnhoddhnbbhifnmolnlpjfmnalp	FALSE
mpgcabhjkkhkipjbjimjkcgaeijhhfaakfcldfnipdjd	FALSE
nhigianfeldmanociepjighjkgffnapfnieinahbdphg	FALSE
oapbeglnonjicmkkbajajomplgbcpljmgaefbpihpnbj	FALSE
olhkedigelkblcbelblhmjgilalcffdnfdeaogoclhmh	FALSE
pgmhhnkfjiihoigohmdfdglaklfbdklkhggjfehodibi	FALSE
aaaogonfncjbdipababaijpcfdojikefigbdbdalflgo	TRUE
ahkfnaibpalbfldhehdokfkfbndmgbmjdijpgojceaha	TRUE
balhbmoahkmfbmphjcicaeafpcldbcnmnlhmbolhnopo	TRUE
bjidglgkddadicpnfhmimbopaepimimabhlanibnccbh	TRUE
cdgifgejjoghbabdhpdejbilaembekbkabkaiobnaihb	TRUE
cogcehanblniappmmbccfahhogihniplkpamgmfjcclb	TRUE
djekelbkigalcajloilnabalcfjeafjfaknnonbhkabg	TRUE
ecpddeeaedeengcblcgfpfadeecodecfemablpablibb	TRUE
embkfcpjhenpdnefcaibjanlbefojoonihlkccgpmlkj	TRUE
fgcpelcnoookkgfookeljjogniigclfalaibakmbghbc	TRUE
gcaplfmohaafecpdfdiohdpcldgknmbllabnanmeghhn	TRUE
gmlepfpmpibpcjgkiamhickjmlbabaffkofhiigbhnmk	TRUE
hhbfnajfhbhajbahgbdpafiieilmnfannfhhfkpkjpma	TRUE
icofoklhgbijjlcjghkkobkjfinlcjgkkankjklnobab	TRUE
ilcpgkmdifgkcidabmanipmbamoehhpcjfbknkekacjo	TRUE
jhibjmacbabojaggahnojfpmmajacfmalpihpdjchkdf	TRUE
kbkhkmoabagkfafgalbkmilhkpeplgaojlecakdokmpa	TRUE
kmpdpnmjpagibbmcdinpigapkbaibbdbolcgdmhhlehd	TRUE
lhgkhbahbmlaejpjdbdimlcenbnmddlmboocnnaldahg	TRUE
mcdhdadejjfhlnmhbbibflidoleeoafcbkajhblahoej	TRUE
mmgeaannlnjjbapbnljfoflipipalnhpefoccimefplo	TRUE
ngnhmhehfdnagdbakipaobabifaeejhekfmffmeolnio	TRUE
obblfaobhambcnfbkoffgckkcocfmkkbpifgjegbojdj	TRUE
olmddchckbmpdloakgajdbldhjfacajkogcbabnlmnaa	TRUE
peeeeagkklanieamobakbfbjgepjaimkgaonlbjelllb	TRUE
aaamamjkhohgcimiiijedpagobcofgbcphfomcglfmlfj	FALSE
akjcgjnamfdkjggmphpdjdibbndmofedoaimjejhapklc	FALSE
bfpmafgcifdbfbcjiofadhjpcgologdfcanjahbobmhjk	FALSE
cbmibifcfcnclcdlmjfgfcnfmnckpagbkhgoghdgocbdj	FALSE
clndloagedbcaihjlcjfimnjbigemmcfbfkcnihjdbgfj	FALSE
dfjmljknomkjglhhojjdkojonbbipmikijpgkfjnfhddi	FALSE
dpglapolbaejdbggpdbpidinfgpmpgdiaoifbjjdafflf	FALSE
ekcklaakjlplhamghfbcdknjojafcmjpekgfmnijjcine	FALSE
fdllpplkpkoondaibfeknbdbiomhjiomcjijeiiepjedn	FALSE
gaipjniaebkgimckjcaejpeiafloneekoehigdklecmjd	FALSE
gjmlpncmcpmihgdefcoipaaeggbljoikjcngikcjcfgei	FALSE
hdjppkignnibekpidcenojeekhloffnpkfkpagmjeljpl	FALSE
hmdnppleabkgdpchcbbnfdlicijkiiighjedolamfofej	FALSE
ihjobkngobdbopdcffegenkjbhcifmpnbnffkgmecolkg	FALSE
jdnfpmcoinanhmkianekbiliajbeangndbbmigihobill	FALSE
jnpcojeinfkmhellnkdahhcddfpjlmpdgippacodomeob	FALSE
kgfmandnanlngelccnoolcmaelimmkikaglfikhhajkce	FALSE
knnokablolbedabhejpecmoacpbckphikdebllcieemin	FALSE
lkaclmlfejgnolmehekmmpmdomgmllknpllhnnpofnpaf	FALSE
mcndifhmloapaffehmlniicfelmodhebiokjfjaeieigg	FALSE
mmkjgahgcjibmklchdjodecaoklnpebliioipahmolpnp	FALSE
ngdhjapohiiblahgpgbcfjelnmeddpgejffdcbmndcchb	FALSE
obiigaihibnjpidlpdojgfehojbpkkacbdodmodepophn	FALSE
olankofgkajohpfnkdgikepdfadngdehdppljclmmfcan	FALSE
pfbciodldekihdadcmgdplhbijifkkibacknmalaikelj	FALSE
aacpclhalbpabocjooghhdpppfmndacimpikpdnfooaeg	TRUE
aiohlnobkkoabbnddlpflmbfdgcjjcpdbcikdneiofake	TRUE
babimaeflfjbpjbdaopmhdecfnhlfglmhoklaghdmkipp	TRUE
bjenpfncodmbmnjahbnilekidijgapnabianplkhmobie	TRUE
cekllmgedkpngjchgnlabihlabmcgbhhiilphdmfmhonk	TRUE
cniockahldpgilphjmficllinnhgplngibimmalpmkbpa	TRUE
djdlgikmefkhcoombedplefpnpiaeglmaoijbkmkhabfk	TRUE
edjbdnikfagllpdlcipghaobkhpggogcaafhacbabjapj	TRUE
eoamnldpljfhdkaenkfapnfbminabooacdpdopfiigoke	TRUE
fkhdlkgkmpljcekfidolhgpdikkieidabaokbiaannaoj	TRUE
gdejjcabmjlphcgogkhodbnbaakbjabdbehjedikcnefh	TRUE
gogddjbeghdjdfoaanopjfmeohnboajmbamdakkbjdagh	TRUE
hjcpefjfohpicebcocjmlbanjhodjibbhleabakpbjlke	TRUE
iemlnmdlalibopmoaollbnidgdnaacigobdhjgpdepojj	TRUE
iolnnbcjcpgejlgbbnhhnfbooflibianbamfcdnlampdh	TRUE
jjbemjoboabandnkbfnhkekidkloicdmnnblbdbplnhai	TRUE
kdklffjjjfkfjljjfnmknmkhnlgbiadehmjalbaibfjma	TRUE
knafggdkamcmillhchcahookbablgildpagehahaelaha	TRUE
ljhfmedcbaopnonjbjipkalghpphmciialbcmonjecbod	TRUE
mdglbambmabpocafojiffaamabgaeklamiaccjhnlekfm	TRUE
mocdafecpbgobbpljjjoabpaldgoplljiodfdfipdjckc	TRUE
nikdmphikamjodneibgfpkohkkpcbokbnbmpjabampaak	TRUE
ocodngkdknbbklmdhmkiaibakhbbhliaelejfkeghacci	TRUE
olkjapbinfobealkebabdjndnmfdakopldcabpabdkobg	TRUE
pfoenabmceellacbaebpammbacdanhaffefdnhjopcibm	TRUE
aaahlikanmgbnjflomfocaclflagnjamaakgibjdndappo	FALSE
akcnihnkhlcbhmjefhlkgchmmllaogieiifmbnfnckngge	FALSE
bfbgcdlodiiliaciljgmdinlkkipgkklcfjcnghflglgai	FALSE
cbkcpkpmdfhannjinpanneaiopgfcgpdhagfhophbilmkc	FALSE
ckpaebddcloikhonpphhbogajgcpcfnoaldmmpibbfejok	FALSE
dfccgcponodgojalljnkpdgafhlbdodlemffabhhnkohbo	FALSE
ebjoiablkloeapddlaaedchpphglhanjafdnbihpmjbfde	FALSE
embcpghkmmmljdmolcbbfjfjacfkcdklmicjclopimfjog	FALSE
fglbmffjcpogbndmlfpbahfekkjphobgohnkdhmfjggfnf	FALSE
gbiipfhppoffepchmhlappeigngohboajlighkkeeceoge	FALSE
gjlhhahgffanohobmlnjijfcdilogpmkghdlpigfbnmbjg	FALSE
hfbpicncopgaemoehhaejbbiengcbainhlmdhbgnklncmg	FALSE
hpgjanjbhmkbdcppghaikgonmhgpbnhnpnhfbkklmcoedh	FALSE
ijnhmjcgfcdiflikkakiiegogcgnfagbkpfgedajjlhnpi	FALSE
jcpfplpjinhjcjbmopokpdddgmcpaiglfccpkfdnfkohbb	FALSE
jnlpdnhlmakinikncnbmeipbigjkihocepemcgoplolmfi	FALSE
kgpfbehmflkgbcdodmolgmbbohbbbbpjmpebmdpkopjbib	FALSE
ladlcilemdaooodhhlekmbjgcihnockgnfmakgkmlbmopb	FALSE
lkfmdlnemcmiadboaeaaggdhjjkoaapfhnfpemjkgeoaco	FALSE
mfgngohpnapobmmmfoegimgegplmeofjloeibphkefkflf	FALSE
namndainlgnnonabnnbkffcdnihejchhapapoleocppkch	FALSE
njcclojmfcccofmjafikbhlogpeaapohcigonkodbhnmbi	FALSE
odgbghemkkgcgbpaikjodcngpgcbejedglgdebhdmgmnec	FALSE
olbeneoedobdaeelngecdhgkgphjflaimcgomnbpopdkkh	FALSE
pgidkiblpbgbkpgllfkhlpnimalkaoccnjlllddlliaoih	FALSE
aabkmlpmlajkllnkpjmljibelhkkdbmdlkoikgcpfljbio	TRUE
aimchbikbabnabegadnlejbggcobggfcjepgjemkofekke	TRUE
baolkbaojjgmalidibaokfcnbhnmabcpbinplgcgdfonkj	TRUE
bjinfcfejkacanbamiibakdbfepmdihglbehaccninahjp	TRUE
cbkbeohnijgobheoeeplppmabiaknbeiplnpdkmgjgefil	TRUE
clnlghdmpnjhgeggmoamjkbncaeoabamhjhnbhcfjokokg	TRUE
dhoooolpeihionnmkgcbabpoamnhbpdaplbkeaalniehip	TRUE
edeaocdahlmdmieahoagkfilgglhbpmabaljjgmcpahkec	TRUE
ennkoncmcgplichcglangokpkhfmjfapaabablccmeodkd	TRUE
fhihbpkkaflgilfljmihbabakekhogjjaeiiknekcoebkd	TRUE
gakbkabneoedhhkpehikffdcejliijepnmfgnjhpcknnih	TRUE
glkhekkofoogfllpgnaobcnaljbhakbfchlbiaokhckome	TRUE
hgfbdekejekmfnecmalhcdbdnebaobiacokbidngoebefh	TRUE
iajlppbnabnkgdifpfdodcmbbmgknibcnbenjdmdghhpcb	TRUE
ijeieobaibahemomelhlclldofamooipnapkfahlnbapcd	TRUE
jehfighjakjhfidimcnekfaebdaplckbojjppabadhadmp	TRUE
kablabgcmdmjlljamajodbkdlglplnpaebgfgbangcmece	TRUE
kjkjnfpmepgjcgpdonppbilnannmboaceaichlbohcbkcb	TRUE
lejebnkeajikhaohddaemljmceoonicbaehlaobabmjcfg	TRUE
looeceahdnbemcdaoomdcchbampbabllfiklfdkmngapac	TRUE
mjgfpijllbegojnnlggnkfkegdhdcageohoachigbabagk	TRUE
nehbjbdihpcehjfahdpabonjhlambiiakacjbfoojlkicd	TRUE
oanbphiabjidnoaebeodmhlojbfljapgdjofkncoedcnlb	TRUE
oklbmbmhnknfidlppfabmalbkchmceckcfhkgdfpbkpioa	TRUE
pfoiogakfiaokocicmbfkkpifkkelbgfcmanbanbnbhifg	TRUE
aaciffjecfehblgmbgmhbhljkbcnoodlpheenabojoblmpb	FALSE
alknpgbghfnckgbfbpicioojgghbjicnbephnnnocggjock	FALSE
bgfhoammgnkacooafefcffmceipbbdckkmkkiogcigegkgb	FALSE
cbibahlmpdcpomabcmfklpamcdecbdchajfmgacokccmajd	FALSE
cjncjfikjkgliekkikgpakeegbeijdlbkelgfkomlfijiop	FALSE
dclkidfgaifgjilphpjjnbclnfffgmpbgflgeplccfhliie	FALSE
dngoiaeoeahlmgiafjjmmfegecdcinopegjnfhcjhmfjehc	FALSE
ehfbfjkcbiajoccinjhpmhgdelgoalajdignidnmmlaglol	FALSE
fcanioalocacfkimnnjjhifofdhppphmcdohncpnlegahee	FALSE
flmcgpmmonfonkjmgkpnbbfhhehomjbjjkalclcjnmbdpdm	FALSE
gfndpgcodgghfojpidoihgjkcnjkefggneoehnjgepgjfmp	FALSE
hbehbekndhndeioiicmgdlnlfcmlaejepjkknjjjojiljec	FALSE
hjbiamlfhipdcdojnnanpifaogekndphneeilbpofkmgpbl	FALSE
idnkodnmmclnhjfmhogjmecchkkkocenifmipdnpakaifli	FALSE
inegmkppihdeffabehgmifkdgpickeckpcboiijehdnbjmf	FALSE
jiejeknglilbfcoodckcjkjngnoophkgdejjpcojppcakih	FALSE
kcnaoljhpghemocfibeknoiglofcnboadphkcbpheedmpcl	FALSE
knopkbcogolihakhickkjadliljlijonjidjomoknmpnpie	FALSE
lhlanaahkjkanmbgfmjmpbfnigpmfhaohpjnklkeobicdme	FALSE
mcijakcfacppendobjhofkpcihjpkiinfeeganpnecennjg	FALSE
mmjcfpbfhllmmfglanlneoamffgleplpndbccchopchplib	FALSE
nghpnpokhjcgcimfcfdpikieacomkaabidnegaocaechocd	FALSE
oagkokbnlleclpjdhbjggkeamjaogdgmlajkfoopoogmpic	FALSE
olmiihphidipdmnpgloggihkipkpanfocngmalfakkgkdho	FALSE
pfmehkcgfhabndjebhcelkimolkincooagekjdihijgjeel	FALSE
aacnaedlgmlkmlkneeglcbfpanjbajblofbmjfejepliahj	TRUE
aibalblgohikocgdlockimehcbkdnmhhcijfgglbkhfeicm	TRUE
baieffpcneegmdbdaoiifecgeoefabaihjhlnbegjfmfaof	TRUE
biokangkaahbeoebjkgachfcbdpbkcddfmbmailbiaakdjc	TRUE
cbhhclcfngngcogecalockeoheedknmbkpoobabajgklenl	TRUE
cneaipnboapobmlahfablghfancbnkpdaiddilabdllfnbo	TRUE
dicmmdpadgdndlgegbjadkaoikbaikbphilkkceonebekbe	TRUE
ebomnkpjcnkcbmhdfgenicahplafabakbgngdphjljjhmfe	TRUE
elnambnhoabehhakhddpceaalkblgclllnlokgdaincillb	TRUE
fgmliaabahopbpgempclgkdjojpaojdojnbpobkbihflafh	TRUE
gabohhmnbmacdhdagbbbkmliogkbjabladooiconjhcfddh	TRUE
gkbcogpbaibpaldggbmnmmhlelcmjbojnmmnkpmphoebdkd	TRUE
heeaamakmljnnhofnekamcmcfeebflihhhpboabaibfjgfj	TRUE
hodinampcjgbliaobnlahfjgjcdakklddimiobjehiafbgg	TRUE
ijhnabhaljpiblldhopadbdenlplkilclclkjgocjdmcmof	TRUE
jeenmeejnhjbohakkbhahfmggbgjafkponmkbbifcbdjggb	TRUE
jpcbpehakcncalbkaibkfiodmembplleaolegpgfjjogbgb	TRUE
kkkekbkplfafckogalbhkkiabjkpajkkipkdoeceeeffcpa	TRUE
lfpehpegpnaobcbpjpanabchfmngeniidbmmdabolabehai	TRUE
mampneboednnlnchdldfkhbbdbjeeceocldciobnokapboa	TRUE
mjmailphdeghhjohicnjbepjaoobaobjcllgghojfkikhkm	TRUE
nddjmfbkaklpbkaehkiidohgjjdkkdeidpnchllmfifgohe	TRUE
npndnhgncmpbabkaplehcjmieghmpmapijieciajcihgokf	TRUE
oipjgnbfipfmicoejejhafgjidfnngnpjgbbahpbkabjkcg	TRUE
pfjbpknabaakbbckpamfepbolmphnijoddknenlgahmenig	TRUE
aabjjcjnaaamakfdmafkmhnmaflfnggbhjbjfabkppbdfcak	FALSE
ajehdlldjbbmghgkedllldmonooaihlpbhmemichbopojjch	FALSE
bbmjjpojaijnenokofdfjabafkeoefcbpmlbhdcgeejdjgnl	FALSE
bnncdjmkojokbfijgpecagldbbdabpoohpolhfnflnhohgab	FALSE
checfgfahjgjcdpolooflihoackgpghiebmdppkladmbnfif	FALSE
dapngbhibhajhmlkkgmojjdfoplcdoaeinlcenmbdeohkhcn	FALSE
dlalefanbpmkhijejaffbkmcopcpgemeedgoppcbekaobkek	FALSE
efbmnkegedmaeaanhbloafeobajgblojblgglknnjkphaeck	FALSE
epaiehbeopngcahpcddhnefglgppdikfeecghojcjimonghd	FALSE
fjodklifcgcfnegdggnhdlppimmembimffodlcoaaedekkgg	FALSE
gfhehagnkcapignmgifcghkdmlkdgbbkbdcmlcclnkofkaoh	FALSE
habkglemilojanlnoignhohkmhpnnofocipgdjdlddlpnido	FALSE
hlcogkfgclpndpdkmnpfhpdoleabndjpbackeaokejcggnff	FALSE
iehmobodmhphkecddjllmjfmajogmmaklpfmfijpokjccmmd	FALSE
ipanbhkjmceeclnhjjlnencfgdanpinkkdhdapdabnkolonk	FALSE
jimapnbogdonapjppojnjcbnfimbnjeiandjkenibjannhfi	FALSE
kcchjmkopcjhkoahhidlmedkbokdnbhlciljjdoejnedeiho	FALSE
kmnbjlbboemnlmpegempjfbgfphbiaahffamcpgaankkiane	FALSE
lhjlahkoabjmbmfikcdeoijbbcceebhjfkiphfommeiagddk	FALSE
mbcmpabicnhbihdappmliplhlakgijpkpennjcdnmogdgben	FALSE
mnadnfeemafhbfcndgjjkilfhdlfdifgaemlfjcdkdeeaglm	FALSE
nibkddejbfmlimknachceppgmffliahlobieeoohhbdlkhpd	FALSE
oceldpkbklhdnpebgoalkafdjajkgadfhiobinkiipjijjfp	FALSE
omecaagcknlljkjfgoapfhmipnjmobopdgjniggobmpjmind	FALSE
pgigacielnbgkikceijmcgdpcebpahdjflgacieekihgfego	FALSE
aaamdajnfceeaaboabngnjihemgfabehogkekpacflmdeonc	TRUE
ajmamiphjacfklncfoiclfdmgobhpdfebmlapbjaejgfinpg	TRUE
bbfhecmfkepmbhabiaffkaoheigndijnbmfgbmpilflkhcpg	TRUE
bkdfojafcllpdfclbbifgbjajdifcoombjabmaekhgaoecdl	TRUE
ccekilbjmknoihlcddgloabcpkmllcmgonmbanbadakdfnnk	TRUE
cncnfmmndccbeicphdbijgbjlgbahblpapimagomobejimjo	TRUE
djnaocdgpcncipmnpdphplcfodpfmebhabablkeicfbbkdib	TRUE
eeaedmjjfjonbaccdnedmnlkfiefbkhjjmmhalbmajoghomi	TRUE
emnbiphocaglnjfoefgoalbagkodicfaknakboabopjmknbl	TRUE
fglidbakmemnpocpmodglfillmcckdangbkabiapjfcmfjlj	TRUE
gaiadmlgajombiablbhpgckhpifnndbjjfneejfjdlnmfdmb	TRUE
gioebecfblppjklgganbkjbabafbhlfiogmmplakidbjabkb	TRUE
hempidbpemjljdlnapjfaaabkhlkkhfomnaffehbablnahml	TRUE
iaopkibmaijbingjfeoaklmjbijlbfbbedbckbilagnmfidi	TRUE
ikjdhfkmehinbimdiajjjhfknapmijboabknpcmalpndjfnk	TRUE
jfcjklmpjhdnnfbabanohipchlfkehokpldgcjlbnbooocpm	TRUE
jnpgdloncihfehijlbbnebbjjoknkimoaobapcnkbfcjenfh	TRUE
khnajgoccbaaaienjagohgmjlpambmmmjaobblefmfpponic	TRUE
lemdldfcnliibohhclgcgphfodobapjnbakcgpmjkpophlnp	TRUE
mbhggellccijabbeabjcbambabmdknddphelnlidkhfigbod	TRUE
mleliffbpmnegpkmcfcpkbekmkcpgplefalcabpgmeanbhab	TRUE
ndpofbaobaoifkcocldjmdfdciogogcagebdpfdhmpchcokh	TRUE
nndedimhjimobpgchhjjcjembaaepiikmhanpnnklbkabcab	TRUE
ojaligcgmibapgglpbjbpjgcaeimcphnmpphlajhmkbjabcc	TRUE
penobpimgemcdbchognhifedaffpahnacoagodmlebabjabj	TRUE
aaaidfajpcnbghoddcigcoejcdccdjelbidmccggaefhfldkk	FALSE
akijfclmljkmfgcakecjchncpgkjpdkbjgoedbpknafphdjdc	FALSE
bdklhichcofiibfbcdlmifijafjpebpophdbfephmaobiipmn	FALSE
boalcihjoelfkfafdbploilehhfhjfnoebicdlancphggpfgi	FALSE
chglgmnfkobpfecnjfpbcianindibfnhfifdlehfhafimbbgn	FALSE
dbcmmoehnnllimfdmneclbiamjegjdohgdehncalgcpgdamag	FALSE
dkocjfhmdmlkfnkjoacgcpbonehkncgcajgangglpjblabfhc	FALSE
eeoinplcgpgibndlomjpcilebkeekanbbbnkmaemgpfkobmci	FALSE
eooehjkmihjnoojnoemimkikphhhkgngpnebkaajdneomfnbc	FALSE
fikohhgckkpnbdelcefeefbppkfjeiboheedghnllchgncklb	FALSE
gcpjjoccplohgifejkhhilmgahjpnbihlmefclkaniffdpfhi	FALSE
gnhimlhjjmmcpacihpojbkbpbhngijikbcpdipclcdjoihehp	FALSE
hfkcnnikfoefajocbhapdplldpgjdnaedpoaccdedockkfdhe	FALSE
ianaoiafmnhjihmigmmjacgjgcgckmajbcgphaoohnemhnlaf	FALSE
imofailadmkfkfncemambihmcpkpdmpabihphjnmibeolpbfc	FALSE
jgehpilgkhekbbafkblophbgggbaeflihmjchjceplcnegepl	FALSE
kcegpaljjnffioenkiekagiabglplbkndffcmdkbflemflemf	FALSE
kmifapbgdgfihoeimpjfhkjpohcdddhobnmeobfmjfepdmfpi	FALSE
lfmicongbahlobhjijpjbpljienkpfpccefbobnjmgmnfeepd	FALSE
mbnlpnifkdgofiifcndiddfmncmmmpdaconlndgkmgnfcjgpi	FALSE
mlnblldjpheccanclhflbjpdhpijmlnekihlemgpankdefcoj	FALSE
nflcdafcfkkbpdbignlceglhfhiihiallibajcdeepkocnnfn	FALSE
obehpeghcjaieefokohnaoagobjpnjfjifbkikfgmgnnagjml	FALSE
olocghphmladlogjjbdobinfjapiajoichlnpefgdpmimmeop	FALSE
pghomodhkmoaldchdpedhlmdekhcbakkhppfgmopkpbdkmhlo	FALSE
aaakbhgijhcpbejcogbjjlfgcmapjnkdfnjcahnnpjpmbhamb	TRUE
ainklnnoagjfaclnpopojeijfakboajpkjbbdgghbooinakeo	TRUE
bajojbacgeecgbblhjkfgnokcfabiaichebfgbblkfhaagpjf	TRUE
bkojnobmiljcnkdgppkpefnijnfbdedagangjcmgmbabknall	TRUE
chakhmopjbambffgjlpokiehiajnnnbcnmcjcpgaknjflnbca	TRUE
dbebjaboaedncmmkkbgjcggfhiopnnaafmkabkgcfpanbinmi	TRUE
dlfbhegonjghdflfnkkidbkabihiacolpjefngiaadnpmfnbd	TRUE
edhhahlojkleojjcnkeeffohahiakjadhlldajjeloffibaba	TRUE
emphmnhhkdncgmbbmnkdpfjkeaecikpmifmhdhmmahbakkbgc	TRUE
ficfoenenoggomdiemocebiiigaenomcnffkllakbojpabibf	TRUE
gepidbnkooplpabkkadbpjmefieockeibmgldpjgjenknmjhj	TRUE
hajbabhjjcodoipeigagilhagjejebbceblgmfneddlhgpkgm	TRUE
hlebkabanmamekaaplkfcjicoikfjgadilijhhbcoodkpmhmb	TRUE
igehdimfbhkepamobhplnabbeegidajdboopmmgiehnejlkck	TRUE
ioiijiholbmoihioiljlepihjbhalbpafaghaejpmlohmcllf	TRUE
jjpkbjicmijngabakjjjbddjedbooflngcnhlbnfhmjnknbcp	TRUE
keiaambbijpmaoiknbalhmblidjfjplfbnohfebmfleeajmkc	TRUE
kogajngbigdcmajpllbonmhlabkjgibibchkjmkohkinflano	TRUE
lhomgbnejlgfbalepfjdlgjfpaaajbalhbpiaacacjdajcjbb	TRUE
mbnibbfogddmlmaledoemogcmgnbcpjnemhhjdabpmaboaamp	TRUE
mmnaddnbppaocllnnfbddoejnplcabplijabieimkhbphpbij	TRUE
nfakddpkabakbflmkcleaegjmljfdhohmohiooefidbkjlhmh	TRUE
npfkbhficcienkncekcpooegfaooobabjogjlaabdmnheifgp	TRUE
oklffkecadepbcbljmbhanbahamdoionfmcjennflmmdhaahf	TRUE
pfnjmblamibojajlooofdkcljmifpaoghnjeofpilpjfbcjll	TRUE
aaalmncgldlghddcgcmcijidggoadcfnlapkpljimjaicnploa	FALSE
ajcmfcoojjfaijoeijohkladmdilpobigcfhdefnlofhfafaen	FALSE
bcgaakkfmgfljpphppgifoncfmcfpfbhjjlgcognldaafgdeje	FALSE
blmdcnfdcjpdidjpabiinblnnfgapanljpialpohjeclldejjg	FALSE
cgkojbodgmbnkcdbcpffajplohmdfkkafjlbmeapckmojghahb	FALSE
dbjdabjbmgfcbnjcilefnbpijcipobgdbaglpmkflkhkplkmbk	FALSE
dlemggfeglcehednlegmbhgjkkmkafkbapbgpmjaiegbjjileo	FALSE
egneochjffljeefhobogidjcblkdckghcfijmmjeliidpapdgb	FALSE
fcdhaonlhjlacpmhljmeboogijodiioddckpabhcnpcakionif	FALSE
fledpjcmmekbhgfajlhhbmpiakaajdcfcmlleplbjfcegbpgao	FALSE
ggicnjaicmpjoincdplfkhmofakddlmcbkeldlljaomejjnicf	FALSE
hbllcjecipfibdgdkoeocmkpknhhgcjffccggiikaaibmgnfob	FALSE
hlghdegbfoeffpaiolnejepmbhfifmbolbnjmmibagpgohphoa	FALSE
ifaompnbcneaihfkmifchpjhglcbleikomikddpildeflcmddp	FALSE
iomdjhddpeioimpeicggfciokoocinepopdkeoiikknajdbkpc	FALSE
jhjdoacpgoiboboegpmbjpmmcdkocpfcmpgjpmhhnkopjhgbdn	FALSE
kdefcfopjehkglidkamedjmkpndomnkajepkglpfhepbmineca	FALSE
kmfbpapaoacanbbkifddanjfenaindcnkjpejmjogdbdidomfj	FALSE
lgedoopfccgcahgacccplecmnpddfjlihojkjciicheohhfkkg	FALSE
mbmjgbbkmnchhieaaodmodkiahbnceapggddblhiggplmhoagg	FALSE
mlbnoahaelfdbkdhmkjddpggompfinohbebbchnkkggoocjkpe	FALSE
nfdgobajoogkapmpepbhfhdnaajhkgebfmnppffdgkmnoghcph	FALSE
oaaaidmgmdmieanfojfcmjdkolcldccjpimimaholkajbnfpln	FALSE
oldkbcbmecmlifibpcgeaeammiadcgehigodfobajhdanilcco	FALSE
pgjapggjkeaamoebidgbjfpnbpbnakhobfgniedbcjlagceioh	FALSE
aaamjmnjmhkdfhcdpnlbknfmnolfkkhfjijababebdemmnmahi	TRUE
ahnabjkghlnkgaplmkgdmknnmpjlempbfpbpjajjbmagddpdhb	TRUE
apmihoohfkioikejiolajnnanbalbnfgeellelcmchoboakbep	TRUE
biabjnkakagjgkhefpakehmhopepfohkkafocpodljpkphjhhh	TRUE
cbpfkakknbnabaiknjcddjjhcaleoceohepcdimjfcpnhebonn	TRUE
cofhjpedalnmkpbabnjfampidjefdoldflfplancmoemkehbhb	TRUE
dkdaacleoplnlfapnbkifffibdmpoiheaamblmiamojkkjlbii	TRUE
edlpnkgcejlnlmpalbfhgpjoogkpanlkbhjabbjfefemnmahce	TRUE
enofhnifmociibgjkgohmpdijbafcgeejedgabanipmbjmakac	TRUE
fgnjblnlahnblaipfbabalfediegpejklpicoeknhiaikldeof	TRUE
gaaabjcdjgjkpimhgcjfdpbagbpifeafbcaobakobdbjldciif	TRUE
glhbbikegaocipghhbajbaleoobacjfhhgimiknnkpibiikahi	TRUE
hfacbpgfdhiohhkhdjnchlbabjahbhnigeciknmafbahmblfcn	TRUE
hpeiapnbdambmmaeolinolpcgdhobkmjlpdnlbcbibbiajbkam	TRUE
ijeelmajjmdabmpkcgliebiejcbkoobihammbajobahlmdlojc	TRUE
jdpgndcepiajpbmiladjhcgdaclahhnpmboabcmeemacbbdefg	TRUE
jpncndanibpgoaccchnhdefmhbbajlpmnhbmaiihdhmcapifhm	TRUE
kmafdhooaoiacpjmencbeckmkhoiammbjabfacjbjcnbnkdjca	TRUE
lfdfchanbaonbcgocdpaenbijaljoflnmpimbbfhhgeoolnmcb	TRUE
mbcdhmkajpbobpalhlbhiakcgnoenlkndibbemppgkpmelckdg	TRUE
mloghdijjlbpoihakhjnbaielbadnegepfgaodbhbhgilhnbhe	TRUE
neknmdbappebdkepanbajnpbicfljkjohgdncmhfilfpaongnf	TRUE
npapnjbhhajgdpmdnpbflgngocjpdgnbbnabakjhddhmaihcfn	TRUE
okcghpcjbhpgojcdembajbambebcgmighajipckheaeppjfgdc	TRUE
pelnoikjmojmigdacclpeoldlckbhmlgbabmoaagjcomiidogi	TRUE
