aaaaaabfpajddjeidibodhigcopeloi	TRUE
aaakiaalaffflkpcpmflcmpjpglmbka	TRUE
aaialoijjlakalaballgklonpmhgmfn	TRUE
aalpahklaaaebmendhjnbpmnnffgnbm	TRUE
aapjoaapajalbnklnnlfikemhpakhcb	TRUE
aialajpkaamhpkjkmlaojndmjapigog	TRUE
ajoaakaiaaedlaaacabeebdacadmogn	TRUE
alaoaajnamhaijagcdciglhljofppka	TRUE
amkjakmhjajaaopahgfimhdlhmkdifj	TRUE
aoaalajalafdkgbiolnfdclpbcmmpjm	TRUE
aplampaaaadkkjmnfiebciknnaphacg	TRUE
hihkphpaajjaonaaonphaopanmipjad	TRUE
iaahaimhkjaaafkcanpncmdblgjhadm	TRUE
ilmiljanahainlkkpaaaigjlbjgapfh	TRUE
jhaajhaajmnknmjjliilaiacjkajhgh	TRUE
jpnklnaknaaklamnmhlaadnpnkngkjb	TRUE
kjkpjlaoaanaohkhoakhalkchchocek	TRUE
lajjaaakaaecpelepolhoaaobhendmb	TRUE
lnhmaaiaaooalalcmmjlkmgleahaegj	TRUE
manmaaaaappbcfnnepdhecinmpjommg	TRUE
mpiaipanlopoaahnailanfghpngmmeh	TRUE
njaakaaaadiieodjhcolblobcihgjpp	TRUE
oaakmhoaaaijhhphpanjfejbekimpnc	TRUE
olamanapjamkiaabdokgiiompcjpcll	TRUE
panapmakaaioikipaccmcihakbfljpl	TRUE
aagaaaabfpajddjeidibodhigcopeloi	FALSE
aaakfiaalaffflkpcpmflcmpjpglmbka	FALSE
aaialoijjllkalaballgklonpmhgmfn	FALSE
aalpahkldaaebmendhjnbpmnnffgnbm	FALSE
aapjoaapajelbnklnnlfikemhpakhcb	FALSE
aialajepkaamhpkjkmlaojndmjapigog	FALSE
ajoaakaijaedlaaacabeebdacadmogn	FALSE
alaobajnamhaijagcdciglhljofppka	FALSE
amkjakmhjjjaaopahgfimhdlhmkdifj	FALSE
aoaalajllafdkgbiolnfdclpbcmmpjm	FALSE
aplabmpaaaadkkjmnfiebciknnaphacg	FALSE
hihkphepaajjaonaaonphaopanmipjad	FALSE
iaahaeimhkjaaafkcanpncmdblgjhadm	FALSE
ilmiljanahainlkcpaaaigjlbjgapfh	FALSE
jchaajhaajmnknmjjliilaiacjkajhgh	FALSE
jpnklnaknaaklamnfmhlaadnpnkngkjb	FALSE
kjkpjlaoaanaohkhogakhalkchchocek	FALSE
lajjaaakamecpelepolhoaaobhendmb	FALSE
lnhmaaihaooalalcmmjlkmgleahaegj	FALSE
emanmaaaaappbcfnnepdhecinmpjommg	FALSE
mpiaipanlopoaohnailanfghpngmmeh	FALSE
njaakaaafdiieodjhcolblobcihgjpp	FALSE
oaakmhodaaijhhphpanjfejbekimpnc	FALSE
oglamanapjamkiaabdokgiiompcjpcll	FALSE
panapmakacaioikipaccmcihakbfljpl	FALSE
aaaaaabangkbgpfjopkjkaahcpcidijb	TRUE
aaakoaakafclpoonndekpcfhnplchbab	TRUE
aaikmjlhaahkaoomihnlalhngoapfjhe	TRUE
aamjahalaaljcipfmgoolfeapenilepb	TRUE
ahaiaaopmkihikalnaphfggldgkbempd	TRUE
ainnajojlahmkpiaahadmlpldhoapbfc	TRUE
akakpiomajaaanabfifbgejlckogdkjg	TRUE
alkmkhaahjaaambpjgmaijobigccngch	TRUE
anaakknphaiaagjcfljdfglinjhhhilc	TRUE
aojaaalaapacenmgkngiilakgiloeofh	TRUE
apnmailljijjpiaplalmhnalmjajhdng	TRUE
hioojamkamlapipoilhaalpaopigjmon	TRUE
iajnpahaapmakafamndgmbifdjneidji	TRUE
inalpiahoaakakmaiefmbgmhbnakidka	TRUE
jhphnanmpkmpipkhamaahioajimopjae	TRUE
kaaahnaalakalkkojpbblifgcolfhhjb	TRUE
kjalioaalkaaaciafmeakcnggkkdahlm	TRUE
lahpapojonajamlaoimalhklgllfodem	TRUE
lojkaaloaaojjhaadijmkofjjjjiliaj	TRUE
mjahaoamaailakfpjljaifighjccpcmd	TRUE
naaaaapmhakalfoogecijglnjheicdda	TRUE
nkmhpmhjhnnpkiohpamjnaakammlaoap	TRUE
oaiiaiaaalihoaaknhlnepglgdohmhec	TRUE
onappamlnnhapaapabfgamcmmpmlnjeh	TRUE
papaplomaplahamajcdffoeaonacdkeb	TRUE
abaaaaabangkbgpfjopkjkaahcpcidijb	FALSE
aaakoagkafclpoonndekpcfhnplchbab	FALSE
aaikmjlhaahkbaoomihnlalhngoapfjhe	FALSE
aambahalaaljcipfmgoolfeapenilepb	FALSE
ahaiaaopmkidikalnaphfggldgkbempd	FALSE
ainnajojflahmkpiaahadmlpldhoapbfc	FALSE
akakpiomajabaanabfifbgejlckogdkjg	FALSE
alkmkhakhjaaambpjgmaijobigccngch	FALSE
anadakknphaiaagjcfljdfglinjhhhilc	FALSE
aojaaaladpacenmgkngiilakgiloeofh	FALSE
apnmailljijjpiaplacmhnalmjajhdng	FALSE
hioojamkamlapipoilhbaalpaopigjmon	FALSE
iajnpahalpmakafamndgmbifdjneidji	FALSE
inalpiahohakakmaiefmbgmhbnakidka	FALSE
fjhphnanmpkmpipkhamaahioajimopjae	FALSE
kaaaheaalakalkkojpbblifgcolfhhjb	FALSE
kjalioalkaaaciafmeakcnggkkdahlm	FALSE
lahpapofonajamlaoimalhklgllfodem	FALSE
lojkabloaaojjhaadijmkofjjjjiliaj	FALSE
mjaeaoamaailakfpjljaifighjccpcmd	FALSE
naaaaapmehakalfoogecijglnjheicdda	FALSE
nkmhpmhjhnnpkiohpamjnaakammlacap	FALSE
oaidaiaaalihoaaknhlnepglgdohmhec	FALSE
onappamlnnfapaapabfgamcmmpmlnjeh	FALSE
papaplomaplahaemajcdffoeaonacdkeb	FALSE
aaaaaacmbnkiacopnleofjlpfghkaacbc	TRUE
aaakapplaaeclibjfpofiaajiglafjnjk	TRUE
aaiaaoaliakakbjbfhneemmjjjdbljmhc	TRUE
aaloaallaokahfafoheoadkepdkgfhpkl	TRUE
aapmaaamacnbgcigpljackkijidhbhjim	TRUE
aialhpojjahoamjoannmacfenolfhajci	TRUE
ajhoojanioanpikanaippadklhfkbpkaj	TRUE
alamamanikkpmhamikpkahaageggcjbad	TRUE
amjpihajoajjaalilojhnianbcpfpbokc	TRUE
aoaapjhapmlaaigojmpfghenmjdpfcjkm	TRUE
apnamaaaamimmncfnbnfpjmjgbngehgia	TRUE
hhllhlanmiaaakaafijbljpbphgccnnne	TRUE
iaakahaohaaeacmikinieloagdkncjgnc	TRUE
ilkjmakiaaaaadieafkbgemnhmbjijceg	TRUE
japiiaannaophmjlaikjhkajjhhddhmlc	TRUE
jolaoaajaljiaakfclabebnallmngbkkj	TRUE
khnoaahajjklapaapdlofckcflocbfnoh	TRUE
laalooalnnjplnjoajpanabncddjoaejd	TRUE
lllihkaaahjmialpimpallllacdpkiehl	TRUE
malaaaaabaacmnehcalhlmamkpnnjmeha	TRUE
mpanpaoajakpaadnbmgdhkgdkgphamlkp	TRUE
nkjppkhmmjaolmjaaajamjmpaaffcibjj	TRUE
oahamijaoapaaaegegnjcegdioocblabg	TRUE
olapappalajjnpahacccldpobjgobgcom	TRUE
paonahlmomanhjaanaepdljocggnmiaac	TRUE
amaaaacmbnkiacopnleofjlpfghkaacbc	FALSE
faakapplaaeclibjfpofiaajiglafjnjk	FALSE
aaiaaoaligakakbjbfhneemmjjjdbljmhc	FALSE
aaloaellaokahfafoheoadkepdkgfhpkl	FALSE
aapcmaaamacnbgcigpljackkijidhbhjim	FALSE
aialhpojjahoamjocnnmacfenolfhajci	FALSE
ajghoojanioanpikanaippadklhfkbpkaj	FALSE
alamamanikkpmhadikpkahaageggcjbad	FALSE
amjpihajoajfjaalilojhnianbcpfpbokc	FALSE
aoahpjhapmlaaigojmpfghenmjdpfcjkm	FALSE
hpnamaaaamimmncfnbnfpjmjgbngehgia	FALSE
hhlflhlanmiaaakaafijbljpbphgccnnne	FALSE
ieaakahaohaaeacmikinieloagdkncjgnc	FALSE
ilkjmakiaaagadieafkbgemnhmbjijceg	FALSE
japiiaannaophmjlaidjhkajjhhddhmlc	FALSE
jolaoaajkljiaakfclabebnallmngbkkj	FALSE
khnoaahajcjklapaapdlofckcflocbfnoh	FALSE
laalofalnnjplnjoajpanabncddjoaejd	FALSE
lllihkaaohjmialpimpallllacdpkiehl	FALSE
malgaaaabaacmnehcalhlmamkpnnjmeha	FALSE
mpangpaoajakpaadnbmgdhkgdkgphamlkp	FALSE
nkcppkhmmjaolmjaaajamjmpaaffcibjj	FALSE
oahamijaogpaaaegegnjcegdioocblabg	FALSE
folapappalajjnpahacccldpobjgobgcom	FALSE
paonahlmomanhjdanaepdljocggnmiaac	FALSE
aaaaaaajbegbnhocdjcnolkpcdhdfelaic	TRUE
aaakkakakmialgeabffbmiidihmkkldcnd	TRUE
aaijamalahjagkoghmcedadnebkedgncpf	TRUE
aamaanpiiahjagpjloknagilbdemjogopf	TRUE
aaplppmaajipaandhedlknffgcoealefpo	TRUE
aiamaaaacldgdfaieonokapokihnegilfe	TRUE
ajnahoaalapjoanifdelgaffkdiodakelp	TRUE
alakaaaafcnodpbmpipdpbmfbcpblmdcfe	TRUE
amojaoajnpapoakiajgnlbmkbhpiibcnio	TRUE
aoiahoaiaaklaigcacnfbhnfgnllkmbchi	TRUE
appaljpanppjhanlaijkhniamdlioohhao	TRUE
hjlmamllknjajaomapahakpcbhjbdlmcmm	TRUE
iaomaahlllaaoaofdmgmdkeeaimhgonnof	TRUE
iojhaakmapkmjiakaaomcbiibcfhbpmkap	TRUE
jiahnoapaakpphaaldfakllpibknjgmgno	TRUE
kaamkhaajaaaielhopgelhecanlfiamdfh	TRUE
kmkpohaanjaahaikpaclinehnehclpeogh	TRUE
lanaloaajlaimafdmbbkjledkpplcpkchb	TRUE
loomaamaiajamhkahhilaponcjfcgehiki	TRUE
mjhkaaanhaaahgnhankaooiikgaegjaido	TRUE
naiapajapamalpkbcjcbgjbafjkkeehndg	TRUE
nmaiaaamalainadflcplhbbegjgcikjllb	TRUE
oaojjkaookhiiaahaancklflcmngmjnoml	TRUE
ooklaaaonoliamkooknanaehjobpkmfdab	TRUE
piapkjjnoljaaoohjaaanjfmofdmojikim	TRUE
aaeaaaajbegbnhocdjcnolkpcdhdfelaic	FALSE
aaakkakakmiglgeabffbmiidihmkkldcnd	FALSE
aaijamadahjagkoghmcedadnebkedgncpf	FALSE
aamaanpiiahjbgpjloknagilbdemjogopf	FALSE
aaplppmapjipaandhedlknffgcoealefpo	FALSE
aiimaaaacldgdfaieonokapokihnegilfe	FALSE
ajnaheoaalapjoanifdelgaffkdiodakelp	FALSE
llakaaaafcnodpbmpipdpbmfbcpblmdcfe	FALSE
admojaoajnpapoakiajgnlbmkbhpiibcnio	FALSE
aoiahoaeaaklaigcacnfbhnfgnllkmbchi	FALSE
appaljpanppjheanlaijkhniamdlioohhao	FALSE
hjlmamlcknjajaomapahakpcbhjbdlmcmm	FALSE
iaomaahlllmaoaofdmgmdkeeaimhgonnof	FALSE
iojhaakmapkmjiagaaomcbiibcfhbpmkap	FALSE
jiahnoapaakpphdaaldfakllpibknjgmgno	FALSE
kaamgkhaajaaaielhopgelhecanlfiamdfh	FALSE
gkmkpohaanjaahaikpaclinehnehclpeogh	FALSE
lanaloafajlaimafdmbbkjledkpplcpkchb	FALSE
loomagamaiajamhkahhilaponcjfcgehiki	FALSE
mjhkaganhaaahgnhankaooiikgaegjaido	FALSE
nniapajapamalpkbcjcbgjbafjkkeehndg	FALSE
nmaiabamalainadflcplhbbegjgcikjllb	FALSE
oaojjkaookhiiaahapncklflcmngmjnoml	FALSE
ooklaaaonoliamkookbnanaehjobpkmfdab	FALSE
piapfkjjnoljaaoohjaaanjfmofdmojikim	FALSE
aaaaaaaeojfjialicjambbkhpbijbgkpafd	TRUE
aaalaakoacacomppeekenibbhieenekpdif	TRUE
aaikaohjphpilnjaaacdfjnfndaebfoamao	TRUE
aalpapaaalknnniglmmfldccjpeimpnnaia	TRUE
aapakhiainnkoliljpaagdopabpoeleboen	TRUE
aiahhijajajamaamjhbflecgfgmgdpnhhnl	TRUE
ajhlhpphhanjoimaoaahaeimlkjodhjckkd	TRUE
akmoaaaohaafnnmekglljfifinflaimnnel	TRUE
amakjahanjaniandhgkbbmpbiapanhmgeek	TRUE
ankkaaamjnijaaccjomimnohamglnjcbonc	TRUE
apalmllilpnmjnnhanakaapccgbgakfalcl	TRUE
hapkphaaaaaepnghccmnhlpjonkjligkhof	TRUE
hpnamaakailioaagfclpmkjpcpkakeceild	TRUE
ikonmapjjamaaoammioiaeflmokdlconefd	TRUE
jaiiahpipaamajpapbaejijcpaefmmofknp	TRUE
jmmapaoilaaaapheffkkpebodlkbjangbho	TRUE
khlppmjlkaoonhmaaamapahlihdkbkjckbo	TRUE
laahajkjjlapaolapfplpbfinocbfnddfcn	TRUE
llnlmpamojanaiplaaacghmkfpjfnldjcaj	TRUE
maoplapolanpakiiahacikhigmhmbejnkca	TRUE
monhjaojhajhajhaiiopaadclenpkmmekfe	TRUE
njakpaoppakpikamaaeghjddbdkmpnkpgcb	TRUE
oaiapaaaaohejnlmbgcgihehcjoofhpmikb	TRUE
omaiklajamlkapljakabmpomejnlapfmlhn	TRUE
papaajmlphiajaoioilmlkinlnkmjiiaakf	TRUE
abaaaaaaeojfjialicjambbkhpbijbgkpafd	FALSE
aailaakoacacomppeekenibbhieenekpdif	FALSE
aaikaohjphcpilnjaaacdfjnfndaebfoamao	FALSE
jalpapaaalknnniglmmfldccjpeimpnnaia	FALSE
aapakhiainckoliljpaagdopabpoeleboen	FALSE
giahhijajajamaamjhbflecgfgmgdpnhhnl	FALSE
ajhlhgphhanjoimaoaahaeimlkjodhjckkd	FALSE
akmoaadaohaafnnmekglljfifinflaimnnel	FALSE
amakjahanjlniandhgkbbmpbiapanhmgeek	FALSE
ankkoaamjnijaaccjomimnohamglnjcbonc	FALSE
hpalmllilpnmjnnhanakaapccgbgakfalcl	FALSE
hapkphapaaaepnghccmnhlpjonkjligkhof	FALSE
hpnamabakailioaagfclpmkjpcpkakeceild	FALSE
ikonmapjjamaaocmmioiaeflmokdlconefd	FALSE
jaiiahpipdamajpapbaejijcpaefmmofknp	FALSE
jmmapaoilaakapheffkkpebodlkbjangbho	FALSE
khlppmjlkoonhmaaamapahlihdkbkjckbo	FALSE
laahajkjjlapaodapfplpbfinocbfnddfcn	FALSE
llnlmpimojanaiplaaacghmkfpjfnldjcaj	FALSE
maoplapolagpakiiahacikhigmhmbejnkca	FALSE
monhjaojhcajhajhaiiopaadclenpkmmekfe	FALSE
njakdpaoppakpikamaaeghjddbdkmpnkpgcb	FALSE
oaiepaaaaohejnlmbgcgihehcjoofhpmikb	FALSE
omaiklajamlkapljaekabmpomejnlapfmlhn	FALSE
papaajmlphiajaoioflmlkinlnkmjiiaakf	FALSE
aaaaaacjaomcbbcjpagmmbghibdofmanjbjp	TRUE
aaamhamhaabkeblaallfahglajeijfkagdbf	TRUE
aajaaaipokacinfnokoledlidimpkffakfcp	TRUE
aamjjlamajhlinoaabhningifneempjmennk	TRUE
ahaaaoanjaieielookplaocdmciaocncfmin	TRUE
aialaahalpaalhncabikelmcfmfklmcgffob	TRUE
ajmijapaiaaagekoapinjeagphlbjchjinmb	TRUE
aliajjnaaaljabcjpijedombnghimgggnhbk	TRUE
anaahhkahpmaanffigpngpndjikooemjnmmg	TRUE
aomajaapkmaalplmipanflnhmdokljjgionn	TRUE
haalaailaafakehhppmppbhkobfjbgnbafja	TRUE
hlaiokmjlphiahaionahnaaaclgpifpjpgan	TRUE
ihalanipljaikjloaahajdkpblkbgkgnpakf	TRUE
ipanajnopiaahaafjdbebdgbhcakocnnclbp	TRUE
jjajamhploakkalpaahpnnoegnahjdninnec	TRUE
kahhaknaijoikoanaabeebdebbhidbaambck	TRUE
kjnkmjanoamoajoaaandnfmennfcpamhhlmp	TRUE
lahiooaikkaanahapecdlbkgaajenfhneaco	TRUE
lpipaoaamanapahllgojlbommhjjlpnlmhll	TRUE
miommhjnpalijmjonajjpaanoamkahggajgm	TRUE
naaajpiahaaphjncjdjdjdipfcaajcljfhac	TRUE
nipajohklhalaaanmalcbdooepinegabbcbd	TRUE
oaiaaaajmpaoffobikggmjpgkgaponfajmfg	TRUE
olokaaanaoiankiaildmegkoebdiooklpbop	TRUE
paoaionaahlakjhiahplogdghdckomcnhldl	TRUE
aaaaabacjaomcbbcjpagmmbghibdofmanjbjp	FALSE
aaamhamhabkeblaallfahglajeijfkagdbf	FALSE
aajaaaipokfacinfnokoledlidimpkffakfcp	FALSE
aamjjlamajhleinoaabhningifneempjmennk	FALSE
ahaadaoanjaieielookplaocdmciaocncfmin	FALSE
aialadhalpaalhncabikelmcfmfklmcgffob	FALSE
ajmicapaiaaagekoapinjeagphlbjchjinmb	FALSE
hliajjnaaaljabcjpijedombnghimgggnhbk	FALSE
ananhhkahpmaanffigpngpndjikooemjnmmg	FALSE
aomaeaapkmaalplmipanflnhmdokljjgionn	FALSE
haalaablaafakehhppmppbhkobfjbgnbafja	FALSE
hlaiokmjlphiahaiobahnaaaclgpifpjpgan	FALSE
ihalanipljaikjloaahijdkpblkbgkgnpakf	FALSE
ipanajnopiaghaafjdbebdgbhcakocnnclbp	FALSE
jjajkmhploakkalpaahpnnoegnahjdninnec	FALSE
kahhaknaijoikoacnaabeebdebbhidbaambck	FALSE
kjnkmjanoamobajoaaandnfmennfcpamhhlmp	FALSE
lahiooaikkaeanahapecdlbkgaajenfhneaco	FALSE
lpipaoaamanapehllgojlbommhjjlpnlmhll	FALSE
miommhjbnpalijmjonajjpaanoamkahggajgm	FALSE
naaajpiafhaaphjncjdjdjdipfcaajcljfhac	FALSE
nipajohkflhalaaanmalcbdooepinegabbcbd	FALSE
doaiaaaajmpaoffobikggmjpgkgaponfajmfg	FALSE
olokaaancoiankiaildmegkoebdiooklpbop	FALSE
paoaionaahlakjhiihplogdghdckomcnhldl	FALSE
aaaaaaafeoecbcodnefhnholkmboogaomimmn	TRUE
aaakamohpaappinmgoajionegleffnhaimlih	TRUE
aailaklnapaadmignpmiicfncolhdpeelbbil	TRUE
aamapanmmooapakokfbjgailjjodolmjnblnj	TRUE
ahaaljjaanaejclanifpgciccemddcblggoid	TRUE
aihiaahojamanadimoidnkeckahkhjhkbfigh	TRUE
ajnkjoimhnlaaaijpkkijaafmfoepdccgecde	TRUE
akpaamiaaaojdfmppdajapehjjgomdmlecneo	TRUE
amalliaaiaagjcdcpnaffaajeipopbjdnchgd	TRUE
annkhaholnaaaajmdhkniojigjloldbmmbpdm	TRUE
aplllkahaplmalajiijknmnnahapiipjiljfa	TRUE
hiojonnolhkpnopnaaakiiolaliohakacchai	TRUE
iaaipammaiamamggbhhhkmkfnpghfoppdholp	TRUE
ilmhilanaaaaiamaljnfgnfihakohfkjaaeeg	TRUE
jamalialpaaahddpnfknhijfchcfmhimnnkpf	TRUE
joimaljaaamiahnknpammichiojmlfmgeeoio	TRUE
kjhaanajmakakajcdmcogdpipdalmkfjmogem	TRUE
laakkoiakohjaaahahkkmmdmjjbnamlffccbc	TRUE
llaapkkhaaiaahmbkhnbjlhhdhdkhibdhbbcg	TRUE
mamlaaollnlaalafaleimininjdihebkdjcga	TRUE
mohkaalkjmaajajhadaajipnjbnhifhhllaaa	TRUE
nihnaalkomajaaohjhmajmknednfgipdhildj	TRUE
oaaakkaailaphpdchfjaknfaigkplobnjjdil	TRUE
olaaakaaiadcjggfphmgdhhkkmkpejabhgclc	TRUE
paopaaalahjladiojlodkghiijclhbblgcioi	TRUE
faaaaaaafeoecbcodnefhnholkmboogaomimmn	FALSE
aaakamohpaippinmgoajionegleffnhaimlih	FALSE
agilaklnapaadmignpmiicfncolhdpeelbbil	FALSE
aamapanmmoeapakokfbjgailjjodolmjnblnj	FALSE
cahaaljjaanaejclanifpgciccemddcblggoid	FALSE
aiheaahojamanadimoidnkeckahkhjhkbfigh	FALSE
ajnkjoimhnlgaaaijpkkijaafmfoepdccgecde	FALSE
akpadamiaaaojdfmppdajapehjjgomdmlecneo	FALSE
amalliaaimagjcdcpnaffaajeipopbjdnchgd	FALSE
annkhaholnaaadjmdhkniojigjloldbmmbpdm	FALSE
aplllkahaplmalajiijknmgnahapiipjiljfa	FALSE
hiojonnolhkpnopnmaakiiolaliohakacchai	FALSE
iaaipammafiamamggbhhhkmkfnpghfoppdholp	FALSE
ilmhilanaeaaiamaljnfgnfihakohfkjaaeeg	FALSE
jamalialpaaeahddpnfknhijfchcfmhimnnkpf	FALSE
bjoimaljaaamiahnknpammichiojmlfmgeeoio	FALSE
fjhaanajmakakajcdmcogdpipdalmkfjmogem	FALSE
laakkoigakohjaaahahkkmmdmjjbnamlffccbc	FALSE
llagpkkhaaiaahmbkhnbjlhhdhdkhibdhbbcg	FALSE
mamlaaollnlaalcafaleimininjdihebkdjcga	FALSE
mohkaalkjmeaajajhadaajipnjbnhifhhllaaa	FALSE
nihnaflkomajaaohjhmajmknednfgipdhildj	FALSE
obaaakkaailaphpdchfjaknfaigkplobnjjdil	FALSE
olaadakaaiadcjggfphmgdhhkkmkpejabhgclc	FALSE
paopaaalahjleadiojlodkghiijclhbblgcioi	FALSE
aaaaaabnkllghhedcfbolnlnkelgjbcocjngnm	TRUE
aaakhajkpaapeliijgdiogclojciddgijmcich	TRUE
aahoahoaaaofbahcbbkfceogopkdagonbpiaea	TRUE
aalaoallaoaibphcpndlmmjnkodjigjckdbmlj	TRUE
aapmjiaoaaaoieedofjjnokedfljlemmilhope	TRUE
aiamaaamkapegilbhdkicaleckjdafcapaimef	TRUE
ajoaakalakapjejedhgedeijlmaakobmogjgba	TRUE
alaoaaahkaifmogaodcgainkfpbkbfodlmfink	TRUE
amkahpaalaajlcbjjlpphldjidponjnogfjdlh	TRUE
aoahahhajaplafdhpbdjmfojphepkdmnlidhnb	TRUE
apkhloahjaailaahpcjlmbnnpfempgaeajhdob	TRUE
hjalljiokappamjapapaihefjaocahfaiidcln	TRUE
iaahjoahjpnaaphpagdeebbnfgpepcnbknkjpg	TRUE
ilkojajakanalaaebcobokhohckpmebdalcnla	TRUE
janoaankpaapkaddogjohcicejdbbecofcggbj	TRUE
jpamjaoalmaaohihappighicehkphcbncaaiag	TRUE
kjknapojmjamahpaamafggobkbbajbclphepom	TRUE
lakakopliaiapamaadenmlfpaeickdmlfplfpb	TRUE
lnamaoaalakhkakemokoljiablmmiglhjmdmnd	TRUE
mhjiaahjaanlohnknaajcbkbbihkcpgoljekoh	TRUE
naajalhajaaombggjekjacmbggoebaecbjmjnl	TRUE
nkkjpamapkapaaijadhhnekkjaaenmacincgoa	TRUE
oajonmhahhahonoaknnaaboldmbmgfagemgkmi	TRUE
onahpjmhamjljaahaaflgdfaffjhnfofhlmekg	TRUE
phoakijlaanjlaaoialeodoffggebogjphleff	TRUE
aaaaafabnkllghhedcfbolnlnkelgjbcocjngnm	FALSE
aakhajkpaapeliijgdiogclojciddgijmcich	FALSE
aahoahoaacaofbahcbbkfceogopkdagonbpiaea	FALSE
aalaoallaobibphcpndlmmjnkodjigjckdbmlj	FALSE
aapmjiboaaaoieedofjjnokedfljlemmilhope	FALSE
aiomaaamkapegilbhdkicaleckjdafcapaimef	FALSE
ajboaakalakapjejedhgedeijlmaakobmogjgba	FALSE
alhoaaahkaifmogaodcgainkfpbkbfodlmfink	FALSE
emkahpaalaajlcbjjlpphldjidponjnogfjdlh	FALSE
aoahachhajaplafdhpbdjmfojphepkdmnlidhnb	FALSE
apkhloahjacilaahpcjlmbnnpfempgaeajhdob	FALSE
hjalljiokappamjapapeaihefjaocahfaiidcln	FALSE
iaahjfahjpnaaphpagdeebbnfgpepcnbknkjpg	FALSE
ilkojojakanalaaebcobokhohckpmebdalcnla	FALSE
janobankpaapkaddogjohcicejdbbecofcggbj	FALSE
jpamjaoalmaagohihappighicehkphcbncaaiag	FALSE
kjknapojmjamahpaimafggobkbbajbclphepom	FALSE
lakakogpliaiapamaadenmlfpaeickdmlfplfpb	FALSE
lnamaoaaldakhkakemokoljiablmmiglhjmdmnd	FALSE
mhjiaahjaanlohnkbnaajcbkbbihkcpgoljekoh	FALSE
naajalhajagaombggjekjacmbggoebaecbjmjnl	FALSE
nkkjdpamapkapaaijadhhnekkjaaenmacincgoa	FALSE
odjonmhahhahonoaknnaaboldmbmgfagemgkmi	FALSE
onbhpjmhamjljaahaaflgdfaffjhnfofhlmekg	FALSE
phoakijlaanjgaaoialeodoffggebogjphleff	FALSE
aaaaaadkdcheinnnggjfadnahkdggbhgkeelnnf	TRUE
aaajmanmiaaoenkfnclcllfkojndgbhfcdgkopd	TRUE
aahkapiaanaeecoekiigjjopncokdojbofbibgc	TRUE
aaklanllnljaamamlbkbkjjiaidpnpheacemloj	TRUE
aaoiapanlilnanniajdffilpjmeodlhakblehod	TRUE
aiaaaaolipackjgefnedkimbehfmoopollhfgfe	TRUE
ajjlanmpaaljaamfaoiojahpinkghnjhdnchafo	TRUE
aknmpaajapajagdjclefdinipghcglfkpahndnd	TRUE
amalijillmjpoknjlikolanhaianaeijenlodgd	TRUE
anloolaaahpaamblcaojahpddfjojklclchleaf	TRUE
apanamioojaonaijhkpkajebhgcggmlnnaocjef	TRUE
hapnaapjpaoanakaldlhinepfkganmageebikdf	TRUE
hpaonaikoanhjhahjihaadahkibhleacdkhjffk	TRUE
ikkhlllokhiamakaaalmpjmipmljmabhplgoddk	TRUE
jaoahakaoaakddeccffiapcfebeknpkaiohbgao	TRUE
jomajnplhijlaalaaalipgkcblhebkkjnpaiofg	TRUE
kkaakoaajakhnnamcnfaogngmkhghihpjmenmon	TRUE
lanamoanmkaiooaajfapkaglopcncjklioonjpo	TRUE
lnaoohkaampapaolminaljmccdgombglannccaj	TRUE
miajajkahhamappacjcipmbpfbmlopdekjahlhm	TRUE
naalahioaalabigjdajcliafdgpffjjcooojjdg	TRUE
nknkaahahnmjlamaadjifjbcneimggaobpjcbip	TRUE
oamajhammajahaoekjgedalenbcemhknpkoeklp	TRUE
onohaaajaalpmafcbhkjemfbidodiddpjbbnbko	TRUE
pianaoamoakahahliiomneffnlpojndahbgdnlm	TRUE
aagaaadkdcheinnnggjfadnahkdggbhgkeelnnf	FALSE
aaajmanmibaoenkfnclcllfkojndgbhfcdgkopd	FALSE
aghkapiaanaeecoekiigjjopncokdojbofbibgc	FALSE
aaklanllnljeamamlbkbkjjiaidpnpheacemloj	FALSE
aaoiapabnlilnanniajdffilpjmeodlhakblehod	FALSE
aifaaaaolipackjgefnedkimbehfmoopollhfgfe	FALSE
gajjlanmpaaljaamfaoiojahpinkghnjhdnchafo	FALSE
akdmpaajapajagdjclefdinipghcglfkpahndnd	FALSE
amalijillmjpoknjlikdlanhaianaeijenlodgd	FALSE
anloolaaahpdamblcaojahpddfjojklclchleaf	FALSE
apanamioojnonaijhkpkajebhgcggmlnnaocjef	FALSE
hapnaapjcpaoanakaldlhinepfkganmageebikdf	FALSE
hpaoncaikoanhjhahjihaadahkibhleacdkhjffk	FALSE
ikkhlllokhiadmakaaalmpjmipmljmabhplgoddk	FALSE
jaoahakaoaokddeccffiapcfebeknpkaiohbgao	FALSE
jeomajnplhijlaalaaalipgkcblhebkkjnpaiofg	FALSE
kkaakoacjakhnnamcnfaogngmkhghihpjmenmon	FALSE
elanamoanmkaiooaajfapkaglopcncjklioonjpo	FALSE
lnaoohkaampapaolmifaljmccdgombglannccaj	FALSE
miajajkahhadmappacjcipmbpfbmlopdekjahlhm	FALSE
naalafhioaalabigjdajcliafdgpffjjcooojjdg	FALSE
nknkaahahnfjlamaadjifjbcneimggaobpjcbip	FALSE
oamajhgmmajahaoekjgedalenbcemhknpkoeklp	FALSE
onohaaaeaalpmafcbhkjemfbidodiddpjbbnbko	FALSE
pianaocmoakahahliiomneffnlpojndahbgdnlm	FALSE
aaaaaabiahciamenldchghjiachagjppnbifeein	TRUE
aaakiaaoakpehpfipgilfobpaefbakdedkmpjndj	TRUE
aaiaoaiajalfhehggcakahladlmjcjcbnogjikej	TRUE
aalpimaoaijnklokmanplaoomabogfenoeeghoof	TRUE
aaplknnlapmimlnaaaokefpfbbfdhmhgjgnbkaaf	TRUE
aiaoikhoamiaajaeglkeagbjdhclmeaakjiphkbc	TRUE
ajnlaaalaloaklhcfjbmeaoemklgmnhklgmnglnn	TRUE
alipnnpanlaahaacjnndddpfgjonjkchfaenodpj	TRUE
anaanaaipmojhmaghcbhlgdhlhkiklcpljkbcodl	TRUE
aokiaahjnmaailajapgbklahcjgomjdkjcblkoii	TRUE
haaajaaabnjkjhgcingacogkbldnccnpfolmgmjl	TRUE
hjpjaaahahnlpoapafnppchjccbhpgipkcboebek	TRUE
iaanahpnpaljaafdkjpcpkanfcignphofdfapica	TRUE
imoaaaoaaahhibapinbnmjmhenfbbgicnkjmdjfe	TRUE
jaohahijlajjlamnimamalfpkojbllhbgnbobjac	TRUE
jonaopoamlaknkoianaalefaflgmdkeffepkomme	TRUE
kiaaaapphaplphiafkkelgagffnhllkehddklppn	TRUE
kpjalkahoankahaaojnnbhdekdpncnnhodbabpek	TRUE
lkaakaakkaaoflhioflahabehcjkbhkkkjneneid	TRUE
malamakihaimjkkjkjiaaifbhkdafpbmipmdopoo	TRUE
molahnakaaijlomolpnaaajgndgkajghgjefjbif	TRUE
nkaiijjoaapkjlinlaahonnnjaclajadjoicmlbk	TRUE
oaikjalmkainjapamhihaepibbliffgeggeclhle	TRUE
omanajploajmakajalfaoiejnjpambjcbdkfpoin	TRUE
panhakoihhjanmaahmacongncnefplbddfcbjiii	TRUE
aaaaahbiahciamenldchghjiachagjppnbifeein	FALSE
aaakiaaofkpehpfipgilfobpaefbakdedkmpjndj	FALSE
aaiaoaiajilfhehggcakahladlmjcjcbnogjikej	FALSE
aalpimaoaijnkblokmanplaoomabogfenoeeghoof	FALSE
aaplknnlabmimlnaaaokefpfbbfdhmhgjgnbkaaf	FALSE
aiaoikhokmiaajaeglkeagbjdhclmeaakjiphkbc	FALSE
ajnladaalaloaklhcfjbmeaoemklgmnhklgmnglnn	FALSE
alipnnpanlaahadacjnndddpfgjonjkchfaenodpj	FALSE
anaanaaipmojhbmaghcbhlgdhlhkiklcpljkbcodl	FALSE
aokiaahjnmaaileajapgbklahcjgomjdkjcblkoii	FALSE
haaajnaabnjkjhgcingacogkbldnccnpfolmgmjl	FALSE
hjpjaaahahblpoapafnppchjccbhpgipkcboebek	FALSE
ibaanahpnpaljaafdkjpcpkanfcignphofdfapica	FALSE
imoafaoaaahhibapinbnmjmhenfbbgicnkjmdjfe	FALSE
jaofhahijlajjlamnimamalfpkojbllhbgnbobjac	FALSE
jonaofpoamlaknkoianaalefaflgmdkeffepkomme	FALSE
kibaaapphaplphiafkkelgagffnhllkehddklppn	FALSE
kpjalkahoankbhaaojnnbhdekdpncnnhodbabpek	FALSE
lkeaakaakkaaoflhioflahabehcjkbhkkkjneneid	FALSE
malamakihaimjfkkjkjiaaifbhkdafpbmipmdopoo	FALSE
molahnakaaijlobolpnaaajgndgkajghgjefjbif	FALSE
nkaiijjoahpkjlinlaahonnnjaclajadjoicmlbk	FALSE
oaikjalmkainjapamdhihaepibbliffgeggeclhle	FALSE
ocmanajploajmakajalfaoiejnjpambjcbdkfpoin	FALSE
pnhakoihhjanmaahmacongncnefplbddfcbjiii	FALSE
aaaaaabhepmhphjldifhifeodphiklokjiollefpp	TRUE
aaakmlamiaolafbobjblbcbcafipcmanilpbmlgne	TRUE
aaiokampljahaaamcmnhibnpifcpajblbkpahdodf	TRUE
aamolaljmajaajcpdhaogiedaijmdibmiahfbpaej	TRUE
ahahloaaiaacdneoeaepdnnbklfkfifbegphjkjjn	TRUE
aimajkpiaijlkaaagiadfcdahinaccibhglncfobn	TRUE
akahaajjajhajephobmdajdhefjadifdcmohdoomi	TRUE
alljkonoahnmmajlplapaapemecgjhaebipogejod	TRUE
anaaaoiniinoamaiigpgfinficedjodnhndpjcgpa	TRUE
aoaoolapnaaadcfnghdabafdeehgnphejongknbek	TRUE
apnajlanaiaaipmindbkdplbgmdnobnoehidfkanb	TRUE
hipnhapaohnlaiinjaaapaohfcpemcehomplmamha	TRUE
iaaalanaabdbljacpmdhhejeknfbncohaolfbfnek	TRUE
ijkmaamhaaphaaalnecegdfghfoganaglodckckfi	TRUE
jajaaamomhaomhmaihehfibaniapddambjfdeabjh	TRUE
jnaaaaaajbgmnlnpiogankaghlmkgfbacnjheleba	TRUE
kaphokaaaalaldfmjaekdbdfhfjcicedjfilnbkfe	TRUE
laajalpjkaonnamahgphfhciimnobnphnopancdko	TRUE
llalaakhnhaaipabmkgjidkejfpglnkfancegfilj	TRUE
mappookapjamaaaiclhlhnnabcdeialjljogjmehg	TRUE
mpkaaniapaaabbmehpclijccncpgpmicenldjflda	TRUE
nilnappkhlapaajnaabahbikcngdekbgibkehdfeg	TRUE
oaamaoioaaiakolnkhejjfbgibepclgkaacionhnh	TRUE
olahanaaapmmpaiagifbgopihplaemphaenlkeiio	TRUE
pamaaaanhjpkkmniladgdkllhcijmngleodnklekb	TRUE
aaeaaaabhepmhphjldifhifeodphiklokjiollefpp	FALSE
aaakmlamipolafbobjblbcbcafipcmanilpbmlgne	FALSE
aaiokamplejahaaamcmnhibnpifcpajblbkpahdodf	FALSE
anmolaljmajaajcpdhaogiedaijmdibmiahfbpaej	FALSE
ahahloaaiabacdneoeaepdnnbklfkfifbegphjkjjn	FALSE
aimajkpiaijlkkaagiadfcdahinaccibhglncfobn	FALSE
akahagajjajhajephobmdajdhefjadifdcmohdoomi	FALSE
alljkonoahnmmajlpgapaapemecgjhaebipogejod	FALSE
anaaaoiniinodamaiigpgfinficedjodnhndpjcgpa	FALSE
aoaoolapnaeaadcfnghdabafdeehgnphejongknbek	FALSE
apfnajlanaiaaipmindbkdplbgmdnobnoehidfkanb	FALSE
hipnhapaohnleiinjaaapaohfcpemcehomplmamha	FALSE
iaaalfanaabdbljacpmdhhejeknfbncohaolfbfnek	FALSE
ijkmaamhacphaaalnecegdfghfoganaglodckckfi	FALSE
jajaaamoemhaomhmaihehfibaniapddambjfdeabjh	FALSE
jnaaacaajbgmnlnpiogankaghlmkgfbacnjheleba	FALSE
kaphokaaaolaldfmjaekdbdfhfjcicedjfilnbkfe	FALSE
laajalpjkaonnafahgphfhciimnobnphnopancdko	FALSE
llaclaakhnhaaipabmkgjidkejfpglnkfancegfilj	FALSE
mappookapjamaamiclhlhnnabcdeialjljogjmehg	FALSE
mpkaaniepaaabbmehpclijccncpgpmicenldjflda	FALSE
nilnfppkhlapaajnaabahbikcngdekbgibkehdfeg	FALSE
oaamaoieaaiakolnkhejjfbgibepclgkaacionhnh	FALSE
olahanaacapmmpaiagifbgopihplaemphaenlkeiio	FALSE
pamaadanhjpkkmniladgdkllhcijmngleodnklekb	FALSE
aaaaaabhlcbicmamgmmhaeefnhmlkogkgcanfjgchc	TRUE
aaakmaoahlpaokdklfncnggpbplkafijedhadacepi	TRUE
aailajaanaaeljeolgjlodonmedmepefnhcoegocha	TRUE
aamaamhaakokdgpagkfcgdgdhodnmcffcecdmggaap	TRUE
aapmmaaaoafjmpieccklmjfgcllmbaifjkpemekkii	TRUE
aianpakapamppjopamddbdhjlhkigjpghpfkpmdpgl	TRUE
akakjamkaaajjobekgijhmkidgalcjphjallkffeop	TRUE
alhalampaahhaohjhbedeipfnhddfejgimcblfglfp	TRUE
amopaaaamnnapdehldchfdphelbmcegdejcaoeepcc	TRUE
aohaamaaabdjcddchkfnfmjbkbajobhfbkfepdkicc	TRUE
apljaalamkmklkaamdhoiekipacakmgphbiedpjefh	TRUE
hiaalaannpphokjlaajfceholnilkamhnhfahekjpb	TRUE
iaaaopoahaaeelioedcedhlaenjcbhpgnmaioalldp	TRUE
ilajahaoaiaakmmnpjbdjhiafgplnnglpdiaigpglm	TRUE
jaapjnaamajkloiandahbejapobaolflpcnndnpdcg	TRUE
jnaaamahnmlphpiainjmlhniinakgaakddapndhcjk	TRUE
kaoillihahamakahakijdploiippglgjiceoedaoom	TRUE
laaamhpamjlppaalhiaioncegcolfofdembhmdncmf	TRUE
lkkjnjaaoaaajakilamopenoaphffnfnboonbefjkm	TRUE
mamaoaplaianmakcgjjblapfbfepfdbgjmcdaghajc	TRUE
mnliaooannnaahlinhanjajfkobomjneamghkbaomk	TRUE
njaaaaaalkjgmdecbegflfjhehecbeagibdmkomamp	TRUE
oajhanaalilahalmailjekkoofljnpoohandkgaplh	TRUE
omnmpmaamkijajamaafogmlfiiekbfiamjalhmlinn	TRUE
papaalaimhlainiomagpcdobkhkmdkblgkkiopnich	TRUE
aaaeaabhlcbicmamgmmhaeefnhmlkogkgcanfjgchc	FALSE
aaakgmaoahlpaokdklfncnggpbplkafijedhadacepi	FALSE
aailajacnaaeljeolgjlodonmedmepefnhcoegocha	FALSE
aamaamhakokdgpagkfcgdgdhodnmcffcecdmggaap	FALSE
aapmmaaaohfjmpieccklmjfgcllmbaifjkpemekkii	FALSE
aiadnpakapamppjopamddbdhjlhkigjpghpfkpmdpgl	FALSE
eakakjamkaaajjobekgijhmkidgalcjphjallkffeop	FALSE
albalampaahhaohjhbedeipfnhddfejgimcblfglfp	FALSE
ambpaaaamnnapdehldchfdphelbmcegdejcaoeepcc	FALSE
aohaamaeabdjcddchkfnfmjbkbajobhfbkfepdkicc	FALSE
apljaalamkmklkbaamdhoiekipacakmgphbiedpjefh	FALSE
hiaalaandpphokjlaajfceholnilkamhnhfahekjpb	FALSE
iaafopoahaaeelioedcedhlaenjcbhpgnmaioalldp	FALSE
ilajcahaoaiaakmmnpjbdjhiafgplnnglpdiaigpglm	FALSE
jaapjnaamajdkloiandahbejapobaolflpcnndnpdcg	FALSE
jnaaamnhnmlphpiainjmlhniinakgaakddapndhcjk	FALSE
kaoillihahamakahgakijdploiippglgjiceoedaoom	FALSE
laaamhpamjlpbpaalhiaioncegcolfofdembhmdncmf	FALSE
lkkjnjgaaoaaajakilamopenoaphffnfnboonbefjkm	FALSE
mamaoaplaifanmakcgjjblapfbfepfdbgjmcdaghajc	FALSE
mnliaooannndaahlinhanjajfkobomjneamghkbaomk	FALSE
njjaaaaalkjgmdecbegflfjhehecbeagibdmkomamp	FALSE
oajhafaalilahalmailjekkoofljnpoohandkgaplh	FALSE
omnmpmaamkijajadaafogmlfiiekbfiamjalhmlinn	FALSE
papaalaimhdainiomagpcdobkhkmdkblgkkiopnich	FALSE
aaaaaabiemopkiacdgjelffcmeklmjjjglchpjaneij	TRUE
aaajaaapfkijjoalcfhbdpdbfpcobmcfmklhhkdkhap	TRUE
aaiajmhimajmnaoaidlakblgjghajpcdkopjgopgekc	TRUE
aalkoplaopjaaacijliokmhmeilmfnpalojeikkifjf	TRUE
aapjjapaaeaolgcnhbogkddalggjmadkhhoknababab	TRUE
aiaanmoimaahpkjaopnfdehmpnklgoadnbdadkpecha	TRUE
ajmaaahaoajedeeflmklenolniccmmkdmjfeemgkgfc	TRUE
alappmjkaaaanpmdpjikgdgehmmdknekiepmcannpmo	TRUE
amohaakpanmpooahokabiognnoeenangbdaabpadddf	TRUE
aoikajiilkoaonjnkliapajnalcjihnbleblgiklhbd	TRUE
haaamaiiamianlkjloofjebimoiimohobbgbhnnaiib	TRUE
hklnmanlhlaplhpholhaajmipahiladjhjiaibnmddk	TRUE
iamaalhnhkaapafbmddcjcabmoohkoljlmepkelhmcc	TRUE
imnhojnaklniaahloaamabmleaedfbdndliibmbibim	TRUE
jammlhaapanhnoiaipakdpfdbpohnhlgmpnfefbnmcd	TRUE
jolnaioaoplaailaaghcngiekbflnegjnmalnimiiba	TRUE
kkikaoahlmaanpajaiojijapbblkcddjkgbbjpbblle	TRUE
laimmnaikahjaalpacmohnjamlelmelicnlkamdedli	TRUE
lnlkahhjajnaajjalaclacgjgfpjaepnpmdhjmdckkh	TRUE
maonlnakaiahaoamdbfhmpofommpgidffdmhgigcjhn	TRUE
naaahaaiajbklmhpjfnfecofghgabdclfmdbcmhbpil	TRUE
nlakmanampaaahjfkkejjjlcnnobbhieadniaomedmh	TRUE
oajimjailankaapphjaghfhdgahohnplckgfmpfombj	TRUE
onanaammajaoamhfeefppgmiklpnejfeceinffjihcj	TRUE
phliaohaaaanmiaagkloahnlombbggpoojeklalifkj	TRUE
aaahaabiemopkiacdgjelffcmeklmjjjglchpjaneij	FALSE
aaajaadapfkijjoalcfhbdpdbfpcobmcfmklhhkdkhap	FALSE
aaiajmhimajmnaocidlakblgjghajpcdkopjgopgekc	FALSE
aalkoplaopjjaacijliokmhmeilmfnpalojeikkifjf	FALSE
aapjjapaaeaolgcnhbogkddalggjmadkhhoknhbabab	FALSE
aiaanmoimaahpkcjaopnfdehmpnklgoadnbdadkpecha	FALSE
ajfaaahaoajedeeflmklenolniccmmkdmjfeemgkgfc	FALSE
alappmjkfaaaanpmdpjikgdgehmmdknekiepmcannpmo	FALSE
amohaakpanmpooahdkabiognnoeenangbdaabpadddf	FALSE
aoikajiilkoaonjnfliapajnalcjihnbleblgiklhbd	FALSE
haaamaiiamilnlkjloofjebimoiimohobbgbhnnaiib	FALSE
hklnmanlhlaplhpholhajmipahiladjhjiaibnmddk	FALSE
ciamaalhnhkaapafbmddcjcabmoohkoljlmepkelhmcc	FALSE
imnhojnhklniaahloaamabmleaedfbdndliibmbibim	FALSE
jammlhaapanhnoiipakdpfdbpohnhlgmpnfefbnmcd	FALSE
jolnaioaopliailaaghcngiekbflnegjnmalnimiiba	FALSE
kkikaoahlmaanpfjaiojijapbblkcddjkgbbjpbblle	FALSE
laimmnaikahjaaflpacmohnjamlelmelicnlkamdedli	FALSE
lnlkfhhjajnaajjalaclacgjgfpjaepnpmdhjmdckkh	FALSE
mabnlnakaiahaoamdbfhmpofommpgidffdmhgigcjhn	FALSE
naaaeaaiajbklmhpjfnfecofghgabdclfmdbcmhbpil	FALSE
nleakmanampaaahjfkkejjjlcnnobbhieadniaomedmh	FALSE
oajimjailankaappchjaghfhdgahohnplckgfmpfombj	FALSE
onanaammabaoamhfeefppgmiklpnejfeceinffjihcj	FALSE
phliafhaaaanmiaagkloahnlombbggpoojeklalifkj	FALSE
aaaaaafcfjbmfandfdjcfphibflkpplfofefbhifkoca	TRUE
aaakalpjhaikllaibhlalfcekjdjkajkkhfhjjplhghd	TRUE
aajaahaahhgkalgiiokjecligeoplabkeoaonodindai	TRUE
aamjkahmaokihkpopaladjgkiedciijacikghcpcbcea	TRUE
aapnnhphaojpmhlmaiahangnipolmjaefdfbcgjoflko	TRUE
aiiinapiaajakagdhfacildgimobmflonlmgpbnnfchm	TRUE
akaanaanalgfgohikjidjphgagolbbeaonjmbnjcllal	TRUE
allnhapkljaomahhaabcjpdehdklgmknohmfpegobfbn	TRUE
anaaoaaabjgkfngamdnppejclpfnibpdckkgodcbdige	TRUE
aonaannaamabibegekpdbbipikeabdngijpaddhbelfo	TRUE
halaamkalnaadbolkanldhhiaadchoppbgnhkpkdfoec	TRUE
hokaapakpoakpjjaphnahjomlgcbiofnbhiegkeahhjn	TRUE
iiamoakaaokajlaflpfmomjgiedeanlkoehlchnbbaah	TRUE
jaaaoaaaomolgmmkdkgaecabcbebfelahgkffdfhbcja	TRUE
jlmkankoilajlannhaapnojojaaakmpcpjoffdlfaanp	TRUE
kainnpanakaanaokpoafkimdcpfkjcfglpleecjmbfid	TRUE
knhaonhhmlonimaialpmaaianemgkijjedlkpgnalgfp	TRUE
lamaaajoahlacoilffljajilogpopinhhleodocdflgf	TRUE
lohmmjanjhajahinapppaaeemlbbfkginndgjnngkdeh	TRUE
mhkaalhaomajaapklpioklcbboinlnochllhcfahondc	TRUE
mpkkijjaaaomnikoaiokaohmagoffiaeinphbfcancoo	TRUE
nkananalaklmmhhlaaacbmdlefbkkkndkmegdjphjjof	TRUE
oajoaolaaikapanbhbbompjafjmmodflhihfhcjcinok	TRUE
onipnlaaamoakmajjpaolkgcfbpobnjnpengcjbkknmi	TRUE
paplahakmjijmaaahpoddmgeepmaljillajippdfmfdp	TRUE
aaaajafcfjbmfandfdjcfphibflkpplfofefbhifkoca	FALSE
aaakagpjhaikllaibhlalfcekjdjkajkkhfhjjplhghd	FALSE
abajaahaahhgkalgiiokjecligeoplabkeoaonodindai	FALSE
aamjkahmaokihkpopfladjgkiedciijacikghcpcbcea	FALSE
aapnnhphfojpmhlmaiahangnipolmjaefdfbcgjoflko	FALSE
aiidnapiaajakagdhfacildgimobmflonlmgpbnnfchm	FALSE
akaanaabnalgfgohikjidjphgagolbbeaonjmbnjcllal	FALSE
allnhhpkljaomahhaabcjpdehdklgmknohmfpegobfbn	FALSE
jnaaoaaabjgkfngamdnppejclpfnibpdckkgodcbdige	FALSE
aonaannaeamabibegekpdbbipikeabdngijpaddhbelfo	FALSE
halfaamkalnaadbolkanldhhiaadchoppbgnhkpkdfoec	FALSE
hokgaapakpoakpjjaphnahjomlgcbiofnbhiegkeahhjn	FALSE
igiamoakaaokajlaflpfmomjgiedeanlkoehlchnbbaah	FALSE
jaaaoaiaomolgmmkdkgaecabcbebfelahgkffdfhbcja	FALSE
jlmkankoilajlannhabapnojojaaakmpcpjoffdlfaanp	FALSE
kainnpanakaanbaokpoafkimdcpfkjcfglpleecjmbfid	FALSE
knhaonhhmlonimainlpmaaianemgkijjedlkpgnalgfp	FALSE
lamaaajoahlicoilffljajilogpopinhhleodocdflgf	FALSE
lohmmjanjhaeahinapppaaeemlbbfkginndgjnngkdeh	FALSE
mhkaaflhaomajaapklpioklcbboinlnochllhcfahondc	FALSE
mpkkijjaaeomnikoaiokaohmagoffiaeinphbfcancoo	FALSE
nkananalaklmmhhelaaacbmdlefbkkkndkmegdjphjjof	FALSE
oajofaolaaikapanbhbbompjafjmmodflhihfhcjcinok	FALSE
onipnlaaamdoakmajjpaolkgcfbpobnjnpengcjbkknmi	FALSE
peplahakmjijmaaahpoddmgeepmaljillajippdfmfdp	FALSE
aaaaaaalelkadobjdnplcmibdpkfgckdpmmmhfkjklkfl	TRUE
aaajopoapaakbnihdapobchchjehlcjpohjhfhfhjfofl	TRUE
aaiijnaaakabimhahincikfeikoildmbjfpiobjahkoln	TRUE
aamailaooalhanpbccbppkaecpmmbbnpcgggobljeeclc	TRUE
aapmklhpiaaaaljbdlcocifghgblhipcedjkaohbfbaap	TRUE
aiiaaoklaaiajbdihbllohplihmenegbdapoaklfiandj	TRUE
ajjhaialahlaapobphbdlmlalilmdmbcliklmkncdnkig	TRUE
akpjkmaphaoiananaopfpdlplchicdbbifpdndcfdllia	TRUE
amjiapjmhaaoaacaecmiflmopdacdnofkkjdkimbboejf	TRUE
aoaahoamoaiaphddpclpkfbhmnhimjcodmnclfaiicmji	TRUE
apjoaaalhhjjpppamiakkklfdocnjlaibjccmagabhcmi	TRUE
haniahaaaacggfgagomigjpddafenaiclgmbbpmdpiebj	TRUE
hphaphamaiapaabdmjfjaacodjnmfgnffcighpdcmdihg	TRUE
ikakknakammiijaalaipfjagdpnigglnikehoiigdclhd	TRUE
jakajkklajanajnlacmpnpimbnjjpojkellnjnieiipoc	TRUE
jomakjalmaoaaafegapaflcoleaajfppiahgnoijmibdj	TRUE
kijlhpaakikamhnakaambliibnnihpioebhkpmjfckocj	TRUE
laioaaaakpnahcolijojbbacnnpekmbpmiopicnajdpee	TRUE
llnaaakaialhpamkeoiljlcflaobpnhomnpmciengcfem	TRUE
mamnaaniimhhaoaohakmnbbbehmohlcmhoehbfheeekkb	TRUE
mpknaoalmahaamlaeiikpcikgnnfelingknejaikcfcnj	TRUE
njolhanhnjhhoakhknakaiaanfiiphlpoakhjdgmhjeai	TRUE
oaanohpklaaakabdakmnhilecdbichijpebdnnflpfleb	TRUE
olajknlmkaoanmhaaahognjdjhkdimngegfnfhadogpae	TRUE
paoaipaalaablgegacejdeploocpcbchnddginnncgnnm	TRUE
aaabaaaalelkadobjdnplcmibdpkfgckdpmmmhfkjklkfl	FALSE
gaaajopoapaakbnihdapobchchjehlcjpohjhfhfhjfofl	FALSE
aeaiijnaaakabimhahincikfeikoildmbjfpiobjahkoln	FALSE
aamailaooalhhnpbccbppkaecpmmbbnpcgggobljeeclc	FALSE
aapmklhpieaaaljbdlcocifghgblhipcedjkaohbfbaap	FALSE
aiilaoklaaiajbdihbllohplihmenegbdapoaklfiandj	FALSE
ajjhaialahlanpobphbdlmlalilmdmbcliklmkncdnkig	FALSE
akpjkmaphaoianonaopfpdlplchicdbbifpdndcfdllia	FALSE
amjiapjmhaaoagacaecmiflmopdacdnofkkjdkimbboejf	FALSE
aoaahoamfaiaphddpclpkfbhmnhimjcodmnclfaiicmji	FALSE
apjoaaalhfjjpppamiakkklfdocnjlaibjccmagabhcmi	FALSE
haniahaamacggfgagomigjpddafenaiclgmbbpmdpiebj	FALSE
fhphaphamaiapaabdmjfjaacodjnmfgnffcighpdcmdihg	FALSE
ikakknakjmmiijaalaipfjagdpnigglnikehoiigdclhd	FALSE
jhkajkklajanajnlacmpnpimbnjjpojkellnjnieiipoc	FALSE
jomakfalmaoaaafegapaflcoleaajfppiahgnoijmibdj	FALSE
kijlhpaakikjmhnakaambliibnnihpioebhkpmjfckocj	FALSE
laioaabaakpnahcolijojbbacnnpekmbpmiopicnajdpee	FALSE
llnaaafaialhpamkeoiljlcflaobpnhomnpmciengcfem	FALSE
mamnapniimhhaoaohakmnbbbehmohlcmhoehbfheeekkb	FALSE
mpknaoalmadaamlaeiikpcikgnnfelingknejaikcfcnj	FALSE
njolhanhnjfhhoakhknakaiaanfiiphlpoakhjdgmhjeai	FALSE
oafnohpklaaakabdakmnhilecdbichijpebdnnflpfleb	FALSE
olajknlekaoanmhaaahognjdjhkdimngegfnfhadogpae	FALSE
paojipaalaablgegacejdeploocpcbchnddginnncgnnm	FALSE
aaaaaabbhgegcohanaoleibidgofcbdicdibhpfngigakb	TRUE
aaakjaaaabohjokdaemnijofeknbhdfcnncbalhhihnijm	TRUE
aajahaapacddbjjapijnpgjjioeakoppjbfegegihomhnh	TRUE
aamjahjnoamialopanhpkmfphomoalebaolbdekhkkkeci	TRUE
aaponakhahiaaomcgifpddapfglpkpdohogbkpfphkfkbd	TRUE
aiapanimajpkpklojlhahpjacidcgjdedbpnlecojceokk	TRUE
ajmamanhammhkpnjkimoanalfcdhifofmapcenobfgfjll	TRUE
alamaaapajceghcibmilffcikpggnhmnpldhheklcoljne	TRUE
amoanphapakoapbenkioaadkabmalhhlohikbabhialcnc	TRUE
aohlaaaaiafdhchfkdaekoiogjfcdmhalfnjifoblfknip	TRUE
apmlakjooallaljhaoaipdfdgdfepoeiooojmnokfokohe	TRUE
hjajnnaaaikajhppaaccpmglkcejlidieeoljbmdbjbfao	TRUE
iaahaalljkpkahajgngibcfackbhaommmhekllkdjpogid	TRUE
imhohajllajoaaaacjiejaekhcimbdgnepdpfjfkbcpjhc	TRUE
janmmaamaaladlbnmhfoehpmpmopojphaaikcnofonjnhp	TRUE
joanajlplalinnmaakliohlopmmkiokaamoknncfcjplbj	TRUE
kihaaaanahaagfdfecpllmobpigijkclfckkhmgipcjbdp	TRUE
laapajiaajlnlmimpoikamaolcpicceepgmncejjfdddab	TRUE
lmmaapaaankoalnocldhdgfacenoejhjfmpilpfmfdgmag	TRUE
maoialajmalnaafdnfggjndgaejieheoabdpcclamninhg	TRUE
mpkmakknaaaomhaahhdcjhpjkcpdhboeljjomkbbklihpd	TRUE
nkkhhaaaoaakacfnpcloggafnjppbkaifkfjcmnbbjkhdg	TRUE
oakiphnapaaahabececadhmhckciicimdenekildoelfbf	TRUE
omaaanhiaahmiafgoihniajapjlnpofkiipelliiphcjpk	TRUE
phaaajhjlaaljadfgoghebcmalclpomefkhjakfjndcboa	TRUE
aaaaacabbhgegcohanaoleibidgofcbdicdibhpfngigakb	FALSE
aaakjcaaaabohjokdaemnijofeknbhdfcnncbalhhihnijm	FALSE
aafjahaapacddbjjapijnpgjjioeakoppjbfegegihomhnh	FALSE
aamjahjnoamcalopanhpkmfphomoalebaolbdekhkkkeci	FALSE
haponakhahiaaomcgifpddapfglpkpdohogbkpfphkfkbd	FALSE
aiapanimajpkpklojlhahpdjacidcgjdedbpnlecojceokk	FALSE
ajfamanhammhkpnjkimoanalfcdhifofmapcenobfgfjll	FALSE
alamaaadajceghcibmilffcikpggnhmnpldhheklcoljne	FALSE
omoanphapakoapbenkioaadkabmalhhlohikbabhialcnc	FALSE
afhlaaaaiafdhchfkdaekoiogjfcdmhalfnjifoblfknip	FALSE
apglakjooallaljhaoaipdfdgdfepoeiooojmnokfokohe	FALSE
hjajnnaaacikajhppaaccpmglkcejlidieeoljbmdbjbfao	FALSE
iaahaallfkpkahajgngibcfackbhaommmhekllkdjpogid	FALSE
imhohajllaeoaaaacjiejaekhcimbdgnepdpfjfkbcpjhc	FALSE
eanmmaamaaladlbnmhfoehpmpmopojphaaikcnofonjnhp	FALSE
joanajlplalinnmaakliohlopmmkgokaamoknncfcjplbj	FALSE
kihaacaanahaagfdfecpllmobpigijkclfckkhmgipcjbdp	FALSE
laapajbiaajlnlmimpoikamaolcpicceepgmncejjfdddab	FALSE
lmmaapaacankoalnocldhdgfacenoejhjfmpilpfmfdgmag	FALSE
maoigalajmalnaafdnfggjndgaejieheoabdpcclamninhg	FALSE
mpkmakknadaomhaahhdcjhpjkcpdhboeljjomkbbklihpd	FALSE
nkkhhaaaoaadkacfnpcloggafnjppbkaifkfjcmnbbjkhdg	FALSE
oakiphnbpaaahabececadhmhckciicimdenekildoelfbf	FALSE
omaaanhiaahmciafgoihniajapjlnpofkiipelliiphcjpk	FALSE
phaafajhjlaaljadfgoghebcmalclpomefkhjakfjndcboa	FALSE
aaaaaacfgnjgalgkaahhmkmmokmnjmlhbclindohcnkhdpj	TRUE
aaakanpaagmoblkioachdcakbfdnnjkbgaimkhdjhcfnifp	TRUE
aajalanphaambfngeanpkglmilhlhijlolmfmdpekhhhjll	TRUE
aammalahjaiabilgchdgblmajgndgmghdjjeoggmnpelgmf	TRUE
ahaklniklnaimaonnapjalemlpobaonoiphhcpoebcflbmj	TRUE
aioakoimamlaannhokaoakcciencmdakaaimhjiddgccioc	TRUE
akhjlaiaaaabojjcnoekbelgldabpolkdifmeafolgocccf	TRUE
allkaaapamaifbgmobhdgiciegncllpcnkpbonnnclained	TRUE
anaaiaaapbjhjjaeegegchkdfjgfgabciggmoebpjgggnab	TRUE
aohmajnkahlpaphmolahaaenjfbjocllfngdedihpdleppg	TRUE
appajiiaamiaahcmblcgjjhacmlpapmabmhjconcgfgflmm	TRUE
hikapaiiaiakapaboagmldbelcdngjooegngenhljeoifkp	TRUE
iaamaaaapejmalobciehbgfngbennghkaebddnglkhagoad	TRUE
imahapajajnpkajadjmblogcejlmaledndlphhibicdhcpn	TRUE
jamooaaillaalnpijlakbdekbmocilhjnkennphhoeigpkc	TRUE
jpjaajmmmkaamnlliapjlnhnoonjabjimngjeglngfgmkod	TRUE
kjmjakmaaajnmalllachingaenegfcbegknofpjknpmefak	TRUE
laiaiajahahijaloghdnaianbcjjnekclkjcchiiaegcbpn	TRUE
lnaalhmaoliaaoamiiimafajfbffioagdfldpnekghgjgli	TRUE
mapahkamajmajhacmnpemooepcaebelhfnmfkahmldjigdd	TRUE
naaahamnhhoalaphliinjndebbohmilcigeldhdopobnghi	TRUE
njaolaiaaaolapblfijmmagapaoikedfiojecgeombpkdgo	TRUE
oaapnaohnapaikknhllpakilpejhgmlgolaeanpcdkjenff	TRUE
omloaaiaaaahphbdiggjffloodcjjbohkbakcdhbbnginen	TRUE
phaaloaaaiiabfbgdhoeimadapknoapfcobdibmcpjgclmf	TRUE
daaaaaacfgnjgalgkaahhmkmmokmnjmlhbclindohcnkhdpj	FALSE
aaakanppagmoblkioachdcakbfdnnjkbgaimkhdjhcfnifp	FALSE
abjalanphaambfngeanpkglmilhlhijlolmfmdpekhhhjll	FALSE
aaemalahjaiabilgchdgblmajgndgmghdjjeoggmnpelgmf	FALSE
ahaklniklnaimaonnacjalemlpobaonoiphhcpoebcflbmj	FALSE
daioakoimamlaannhokaoakcciencmdakaaimhjiddgccioc	FALSE
akhjlaigaaabojjcnoekbelgldabpolkdifmeafolgocccf	FALSE
allkgaapamaifbgmobhdgiciegncllpcnkpbonnnclained	FALSE
adaaiaaapbjhjjaeegegchkdfjgfgabciggmoebpjgggnab	FALSE
aohmajnbkahlpaphmolahaaenjfbjocllfngdedihpdleppg	FALSE
gppajiiaamiaahcmblcgjjhacmlpapmabmhjconcgfgflmm	FALSE
hdkapaiiaiakapaboagmldbelcdngjooegngenhljeoifkp	FALSE
caamaaaapejmalobciehbgfngbennghkaebddnglkhagoad	FALSE
icahapajajnpkajadjmblogcejlmaledndlphhibicdhcpn	FALSE
jamooaaillaaenpijlakbdekbmocilhjnkennphhoeigpkc	FALSE
jpjaajmmmkaamnlliapjlnhneoonjabjimngjeglngfgmkod	FALSE
kjmjakmabajnmalllachingaenegfcbegknofpjknpmefak	FALSE
laeaiajahahijaloghdnaianbcjjnekclkjcchiiaegcbpn	FALSE
enaalhmaoliaaoamiiimafajfbffioagdfldpnekghgjgli	FALSE
madpahkamajmajhacmnpemooepcaebelhfnmfkahmldjigdd	FALSE
naaahamnhehoalaphliinjndebbohmilcigeldhdopobnghi	FALSE
njaobaiaaaolapblfijmmagapaoikedfiojecgeombpkdgo	FALSE
oaapnaohnapaikbknhllpakilpejhgmlgolaeanpcdkjenff	FALSE
omloaaiaaakhphbdiggjffloodcjjbohkbakcdhbbnginen	FALSE
phaaloaajiiabfbgdhoeimadapknoapfcobdibmcpjgclmf	FALSE
aaaaaaafjolclnmgngelkmdfedkdpcgmgoilhoofdceaigjb	TRUE
aaajmaaakgbaaeompomgnmcipinbodfikmbkdhahhfbhlchg	TRUE
aaiaapaamihceheccphlclppppcogfemafhhpgjmojfkacbl	TRUE
aalomhnmajnmmaaahkmpdnckoikemmcackokhfihlahlgpkj	TRUE
ahaaaahainpepohldelimmidobfmbfloabihlgebjhlhbmoa	TRUE
aihnpakjaoajaooiangcokpppkikoblicckphiiijlibjomi	TRUE
akaaaakaimldbefjkkekckdifbldfhfmaemkkpmbhfhaoajk	TRUE
alkhajaaaihmnmkagecjlcpemlpjkgkhlicbjhdkapdedpod	TRUE
anaaamojaaidifnhhpjeokhcppmhcpnfafcolkhjkkegaioc	TRUE
aoapapnhaphhaklnpaipjjjofjffajngfkpacbhfkdcmomch	TRUE
apnaojnhhaiaahahmmkaffklkkecalfmenmdceblkighdikb	TRUE
hjoiaaaajamacciehfgplpohbimickipjdaiogkkncbjgbom	TRUE
iahakomhnaammaamiolbmambkgogbgpldnodmlpnmgaepdmp	TRUE
ilaopaoaamlakljabdpilifdpedjahobjhgimkaffhiopiko	TRUE
jakahaakhioahaognfojkdhodkbojgkgcjcajfhckffnbmop	TRUE
jpamiaanoaaoaadbihnambnkabclnlhkidibckooacpgpjgn	TRUE
kiaakaanmaadbojckgkbfmkledkjhlhgohpnimpmadbifaof	TRUE
laahoallmpmilaamafdmjmbbgnpefbjlogcjacpbppenjdae	TRUE
llaamhnnhpkkoaaapamfopdkhpfmajnhgepfngmoodighffj	TRUE
majjaaonajaaddleailmdjpinjaaiechifppbfmeaadaceek	TRUE
mnmopanalajaaalddgeibpgikaahjcjnhhnidajbfaedfcbg	TRUE
njhoamaaainaaekccldphmmlbhhoecmmnbploadhnkeoelpf	TRUE
oailjaaampaacacgafdophpkjaelhefglhnpcmhefiamkfcj	TRUE
omjaaoapalhaafamnioiagceoihmajoaffnfgmdmabkbeckd	TRUE
papalphhikhaajaaiblallalaglnbddngipeplkjpmknbloo	TRUE
gaaaaaaafjolclnmgngelkmdfedkdpcgmgoilhoofdceaigjb	FALSE
aaajmaaeakgbaaeompomgnmcipinbodfikmbkdhahhfbhlchg	FALSE
aaiaapaeamihceheccphlclppppcogfemafhhpgjmojfkacbl	FALSE
aalomhnmajnmmaaohkmpdnckoikemmcackokhfihlahlgpkj	FALSE
ahaaaaghainpepohldelimmidobfmbfloabihlgebjhlhbmoa	FALSE
aihnpakjgoajaooiangcokpppkikoblicckphiiijlibjomi	FALSE
aekaaaakaimldbefjkkekckdifbldfhfmaemkkpmbhfhaoajk	FALSE
alkhajaaaihmnmgagecjlcpemlpjkgkhlicbjhdkapdedpod	FALSE
anaaamojafidifnhhpjeokhcppmhcpnfafcolkhjkkegaioc	FALSE
aoapapnhapbhhaklnpaipjjjofjffajngfkpacbhfkdcmomch	FALSE
apnaojnhhaiaafahmmkaffklkkecalfmenmdceblkighdikb	FALSE
hjoiaaoajamacciehfgplpohbimickipjdaiogkkncbjgbom	FALSE
iahakomhnaammanmiolbmambkgogbgpldnodmlpnmgaepdmp	FALSE
ilaopaoaafmlakljabdpilifdpedjahobjhgimkaffhiopiko	FALSE
jakahaabhioahaognfojkdhodkbojgkgcjcajfhckffnbmop	FALSE
jpamiaadnoaaoaadbihnambnkabclnlhkidibckooacpgpjgn	FALSE
kiaakaanmaldbojckgkbfmkledkjhlhgohpnimpmadbifaof	FALSE
laahoallmpmiloamafdmjmbbgnpefbjlogcjacpbppenjdae	FALSE
llaamhnnhpkgoaaapamfopdkhpfmajnhgepfngmoodighffj	FALSE
majjaaonajfaddleailmdjpinjaaiechifppbfmeaadaceek	FALSE
mndopanalajaaalddgeibpgikaahjcjnhhnidajbfaedfcbg	FALSE
njhoamaabinaaekccldphmmlbhhoecmmnbploadhnkeoelpf	FALSE
ocailjaaampaacacgafdophpkjaelhefglhnpcmhefiamkfcj	FALSE
odmjaaoapalhaafamnioiagceoihmajoaffnfgmdmabkbeckd	FALSE
paealphhikhaajaaiblallalaglnbddngipeplkjpmknbloo	FALSE
aaaaaabomkdglfemjapokofmecenkcamecghokenickcjmoad	TRUE
aaalajhjaaahjpeobbnflakjbkajhbpcjgonpoopbnhicnhmk	TRUE
aaiiaaajkkakjejljcjcfjkmfjdanjfdhibaihgkomkbenjod	TRUE
aalllammhaaaddkemoiniehooabeckokomihnccjnjnkbccfo	TRUE
aapapnjjiimlpnmaliiakhaaogjbokgobcadbgcgmcpbpcgkj	TRUE
aiankijlmajjommaaalhmgilhgidllhdgpmehehepjbilbane	TRUE
ajlanaaaoagjegfbokjnmlihlbhimeoomnmpollgbceoioaih	TRUE
alalkaiaaadafikfepfoihmjlcedfdoajaflhoombkdmmhaph	TRUE
amnhmahmaaaiiojalkeppgmhlhnmbhbbllfbbjkjolaekjhei	TRUE
aoaoaaahadpdjapjkdibjfelonloaancpiagbnkecnkonnbnn	TRUE
haaaaaabfibhmfobafmffgedkfhlnfhkdbjhoeeabpoemkjog	TRUE
hkpnialinjmpaapkpaanadpbcfmpefmfakfkfcmpnehpbmbod	TRUE
iajnpnaahhpnmljjhalklhlahafajecbpcbdeapilkhpabjkj	TRUE
iokaoaaaaafhpdnjlibfnjmmknconnkddliocppiiinejaoik	TRUE
jhjaajlaioimimkaioomjiakafbanakkaeiejgdjabhnonlie	TRUE
kaaaanaadcodafgjonealfihieonolnidplhoknbeagpffdah	TRUE
kjilmaaaamkanafkfjlnkkhjlbinpbbmjjpgmignialcgffae	TRUE
laiaomjaaaafemhfbbejphnjmngkecemigphjaopcoeienjhk	TRUE
lnoaaapmjhomakpojlnniijlpjoaaiohgngfjnmadelponhdj	TRUE
mhlanaaoikljpaaapbebfgjpdimaddpankmgennijdbpkdkfc	TRUE
naaiaamlijpoakagelbebblcneopkobihdkhjhbpikibjkmpp	TRUE
nljljaaanokjaiolilniaajmnlghfiodmllhlohmkobomdnnd	TRUE
oaliaaaalllaeghocjonfhlcoaghemachjdhkfpeegbjfafko	TRUE
ooahhapaknijhpaaoklkabddglmamhibdbdgjefdgfggedbaa	TRUE
phaajmnakaaijnoaahojfbbmdclelfhiefjpmgbeallcegagi	TRUE
gaaaaaabomkdglfemjapokofmecenkcamecghokenickcjmoad	FALSE
gaalajhjaaahjpeobbnflakjbkajhbpcjgonpoopbnhicnhmk	FALSE
aaiiaaajkkikjejljcjcfjkmfjdanjfdhibaihgkomkbenjod	FALSE
aalllammhabaaddkemoiniehooabeckokomihnccjnjnkbccfo	FALSE
aapgapnjjiimlpnmaliiakhaaogjbokgobcadbgcgmcpbpcgkj	FALSE
liankijlmajjommaaalhmgilhgidllhdgpmehehepjbilbane	FALSE
ajlanaaloagjegfbokjnmlihlbhimeoomnmpollgbceoioaih	FALSE
alablkaiaaadafikfepfoihmjlcedfdoajaflhoombkdmmhaph	FALSE
amnhmahmaaaigojalkeppgmhlhnmbhbbllfbbjkjolaekjhei	FALSE
aodaoaaahadpdjapjkdibjfelonloaancpiagbnkecnkonnbnn	FALSE
hahaaaabfibhmfobafmffgedkfhlnfhkdbjhoeeabpoemkjog	FALSE
hkpnialibjmpaapkpaanadpbcfmpefmfakfkfcmpnehpbmbod	FALSE
iajnpnaahhpnbmljjhalklhlahafajecbpcbdeapilkhpabjkj	FALSE
iokaoaaaalfhpdnjlibfnjmmknconnkddliocppiiinejaoik	FALSE
jhjaajlaieimimkaioomjiakafbanakkaeiejgdjabhnonlie	FALSE
kgaaanaadcodafgjonealfihieonolnidplhoknbeagpffdah	FALSE
kjilmaaaamkfnafkfjlnkkhjlbinpbbmjjpgmignialcgffae	FALSE
leaiaomjaaaafemhfbbejphnjmngkecemigphjaopcoeienjhk	FALSE
lnoaaapmjhomakpojlnniijlpfjoaaiohgngfjnmadelponhdj	FALSE
mhlagaaoikljpaaapbebfgjpdimaddpankmgennijdbpkdkfc	FALSE
naaianmlijpoakagelbebblcneopkobihdkhjhbpikibjkmpp	FALSE
nljljaaanokjagolilniaajmnlghfiodmllhlohmkobomdnnd	FALSE
oaliaaaalllbaeghocjonfhlcoaghemachjdhkfpeegbjfafko	FALSE
ooahhapaknijhpjaoklkabddglmamhibdbdgjefdgfggedbaa	FALSE
phaafmnakaaijnoaahojfbbmdclelfhiefjpmgbeallcegagi	FALSE
aaaaaadaoibpcjlmnblgjbbmlnnliknpkjaejbeajkndjogebe	TRUE
aaakajmjhahnapfcomapkfeeilpfdmehjplinhhhaaeoaalddp	TRUE
aailpnapipanaanbdileiidlfjanhjloaomdjedobokinfemfa	TRUE
aamhllaaiknakknmnlopajdicdjbekjohldjblgiohippidmlh	TRUE
aapmaaijalkaodhibikjkjdicagncfbohdpnblnlkehcbaoinl	TRUE
aiikalkhianknmalkajhakofecgbmifdjmeddgdibbglddjfba	TRUE
akaaaailkjialgalkhgcdmcgnpklhcfojbphhgcongdebijalc	TRUE
aljakaaoalafkjleladnhjkhkfdibpicfpbblkbeieoojnpbgm	TRUE
anannaoaplnlapompaheneimdglbnokieljekginafbjadgdjj	TRUE
aojaplmapaaaadojeghemhagekhmlkjmlcdigpoojcopcjmbim	TRUE
haaanapjkapkadeembpibdoljmnjbhmjopkepgnbncoikciing	TRUE
hlaajnaajmhaagaliddpgaddkidaaddmnelpbcopnmijagnoib	TRUE
iahmkmalmajjljpahhaalbooobenmpmdgfjcpcneoaiiaihfmc	TRUE
iolaaialphaaaelcjamhlmcfondeeodimmnpeipohpglomnebo	TRUE
jioaoaoaijkkkaaaegiaoodfceimfacnmllknopmbcopmbbgef	TRUE
kaaomaloomioaapannmoiganemchgnnphmkdlnjdifaejckjok	TRUE
knmhakomjaanmajalabenekcjkmoiakhopcefgmgidehdhapll	TRUE
lapmnhnkaiijaimmajlajainiohfflnkkcnplbdinljngmadno	TRUE
lpalnaahalaanmcchjehhkcegpcdbmjckbjgpoliobhnafokal	TRUE
mijlmpnpliaiiaonkiaaiaafamoleodcpnmdkllodjfhmlkbpc	TRUE
naaaoahnhahhhanembomeehccaelaemanmllmfpjonbnhldplb	TRUE
nkaohlaamjkihmhnpkhaajalplbkkepelaegenpehokibojklc	TRUE
oajjimnaaiaaakajeablkgmgknejnjlhiofejjejeemmaplhmj	TRUE
olmmlajoinaaaioiajhadhibeopbdgpfabaaajmdbeajaimema	TRUE
pamilknkhhaaakaiadfbdkfbigdiiefejnkbgiaokdohpkiknn	TRUE
aaaaadaoibpcjlmnblgjbbmlnnliknpkjaejbeajkndjogebe	FALSE
aaakajmjhahbnapfcomapkfeeilpfdmehjplinhhhaaeoaalddp	FALSE
jailpnapipanaanbdileiidlfjanhjloaomdjedobokinfemfa	FALSE
aamhlloaiknakknmnlopajdicdjbekjohldjblgiohippidmlh	FALSE
aopmaaijalkaodhibikjkjdicagncfbohdpnblnlkehcbaoinl	FALSE
aiikalkhiabknmalkajhakofecgbmifdjmeddgdibbglddjfba	FALSE
akaaaaildjialgalkhgcdmcgnpklhcfojbphhgcongdebijalc	FALSE
albjakaaoalafkjleladnhjkhkfdibpicfpbblkbeieoojnpbgm	FALSE
dnannaoaplnlapompaheneimdglbnokieljekginafbjadgdjj	FALSE
aojaplmapeaaadojeghemhagekhmlkjmlcdigpoojcopcjmbim	FALSE
haaanppjkapkadeembpibdoljmnjbhmjopkepgnbncoikciing	FALSE
hlaajnabajmhaagaliddpgaddkidaaddmnelpbcopnmijagnoib	FALSE
iahmkmalmajjljpaheaalbooobenmpmdgfjcpcneoaiiaihfmc	FALSE
iolaaialphfaaelcjamhlmcfondeeodimmnpeipohpglomnebo	FALSE
jiopoaoaijkkkaaaegiaoodfceimfacnmllknopmbcopmbbgef	FALSE
kaaomaloomioaapeannmoiganemchgnnphmkdlnjdifaejckjok	FALSE
knmhakomjajnmajalabenekcjkmoiakhopcefgmgidehdhapll	FALSE
lapmnhnkaiijaimmdjlajainiohfflnkkcnplbdinljngmadno	FALSE
lpalnaahalcanmcchjehhkcegpcdbmjckbjgpoliobhnafokal	FALSE
migjlmpnpliaiiaonkiaaiaafamoleodcpnmdkllodjfhmlkbpc	FALSE
naaaoahenhahhhanembomeehccaelaemanmllmfpjonbnhldplb	FALSE
nkaohlcaamjkihmhnpkhaajalplbkkepelaegenpehokibojklc	FALSE
oajjimnaaieaaakajeablkgmgknejnjlhiofejjejeemmaplhmj	FALSE
olmmlajoindaaioiajhadhibeopbdgpfabaaajmdbeajaimema	FALSE
pamilknkhhaapkaiadfbdkfbigdiiefejnkbgiaokdohpkiknn	FALSE
