aabkccliobinlbflggjh	TRUE
aefbeolojnkahebejnpf	TRUE
ajcicdognonlppelomjp	TRUE
anpmcjipgpkjbjlcncol	TRUE
bdiemgdpgmdoeoipleem	TRUE
bipnfbbnamnblilfkflf	TRUE
bpbdjfjeajmjjnmfmpda	TRUE
cekohoehbhgpdkkangnh	TRUE
ckkiebpooeiohakgokio	TRUE
cpcgpgccnfphkjhkoaij	TRUE
delpbgaennmgalnpfffk	TRUE
dipphbalffnmphofiadh	TRUE
dodjkciamhhkceaffeeb	TRUE
ecjekgacpaieiolopnbe	TRUE
ehiebbfhiiflibddhphn	TRUE
emohpmkkfnoejcjimlac	TRUE
fcjacjfnknbccbjmmoik	TRUE
fhopcealjecedopoebdf	TRUE
foangapbdjdkmhfmccel	TRUE
gdcjfonfklgklhicegcm	TRUE
gienfkkmkhlopffidnoe	TRUE
gnlljemnjbaloghnfamg	TRUE
hcjokifannmhpebagnmh	TRUE
hhhjcnaombjoddlnpamd	TRUE
hncepebbmbmacmommpja	TRUE
ibnhbcmgaidefkkagmei	TRUE
igfmckcfhnbmadddmfnl	TRUE
ileaopbomdjondphjaem	TRUE
ipodmpbnglkgpagdgcej	TRUE
jeonamejdeopmmhpfodi	TRUE
jjlonegchlohdopnimol	TRUE
joaejehhphdfnckbnngk	TRUE
kdfoikcjkmhfjgmepkoc	TRUE
kinmlopphmnaifadfipm	TRUE
knghhdehapnpekclbnfe	TRUE
lcllnoocliiakmfkgkmc	TRUE
lhnghmohfjnnlaghelbc	TRUE
lnfdfolgbafngpnhmenm	TRUE
mcjlgmbmbhbdbidndmfc	TRUE
mhidjmfflgiijgckdgdf	TRUE
mmhhdobefoonnndbdnlc	TRUE
nckhkgggpbghpjingimk	TRUE
nhjkgbmaffockcnopgln	TRUE
nmmebdmffapfgipjngoa	TRUE
oboefjmmmnmepapffjec	TRUE
ogmnkkjkeohcmfdkmlcf	TRUE
olnbmflckdpmhhpgoinc	TRUE
pbbfgmdapepcfmdjfelc	TRUE
pgcbdgbcedpmmnipnmli	TRUE
pkplciehpdillhdpeagm	TRUE
aaabhanbaboiablcfnnp	FALSE
ababijjabaljbgljcael	FALSE
abhhkoabpabjnoanbjpm	FALSE
abnmapbajbanbfjnlddd	FALSE
aejaobabogkkjfambaib	FALSE
aicdcmoljdochjjdcdaf	FALSE
alaiibahbhbjgcdcoldj	FALSE
anbabgoipfbnockdcdbi	FALSE
apbpakmbhabambkkkppi	FALSE
bchdcmddpaaibpmomabj	FALSE
bkbpoabnapbimleapbab	FALSE
cccnncnjcdcddcjdpcdj	FALSE
cdcdkkhjmnababgbmmeb	FALSE
cdhcddplaphmcdcdlaop	FALSE
cdncldabjalhmbgmnkjc	FALSE
chgapmbablbkolcmldcd	FALSE
ckcdcdnggaofdediabab	FALSE
cmdcndknclplmdcdbcje	FALSE
coghdbcdckdfbncdcmnd	FALSE
dccldhcmjpldoambmabo	FALSE
dimlababddigabjopabh	FALSE
eajkaaobjababmaolhnb	FALSE
ehaalbabjpmcfpababoa	FALSE
epjaljnbajmbakmfcdcd	FALSE
fdlmbeicaijbabanibab	FALSE
flmcdlcmdncdmcodjeek	FALSE
gbalkjbabbliabnaibfh	FALSE
giiojcdcdkbjammlbabl	FALSE
hababkachecdcomdpggj	FALSE
hdabambenceabknmakob	FALSE
hknlaihbabcneddcdcdp	FALSE
iaobikaobefcdcdcpadp	FALSE
ifomgmdababneacdocdj	FALSE
infabiabpjcdchmdjfkn	FALSE
jcdgcdpcdjgabaioblbp	FALSE
jkikablmanbkcdcdikok	FALSE
kbabkabacmdpjcdplakg	FALSE
kgcndcdkngnfmcdncodn	FALSE
kpaihababfmfnkalbabk	FALSE
ldabjajnbbabpakbbdbd	FALSE
llablapnjbjakakacdcd	FALSE
mcdcjkdmlkabanjbijlb	FALSE
mjkglnababgkaaboabhj	FALSE
nahbabpcaajabmhabpkg	FALSE
nfpcchclcdncdfahpbab	FALSE
noabnhabakkobaibjanh	FALSE
ocjdcjdkcdcdhegpmlcf	FALSE
okgahmbanohjbjaobabl	FALSE
panbkakbhnleabhaohbj	FALSE
pgaaobabbocaobfcdcpd	FALSE
aabanefghlajokcnkaddg	TRUE
afjcilmkigcaiaaiooldk	TRUE
aklafiikgholnjmdopcdk	TRUE
baaogkneajiefadneclap	TRUE
behioieokabchdafnnnig	TRUE
bjnbdkhnonfagoaalgeph	TRUE
bobkeldkiociebancoech	TRUE
cdjgamdkhklifpfabkkpi	TRUE
cinjboommakdlbhfaehml	TRUE
cnnihpgpcmocpgaahfdhd	TRUE
ddfjjedpgenpoodhldamd	TRUE
diomajpefnikfplppmoac	TRUE
dnmjjacleccabiiiigoaj	TRUE
edhdadfolccmcfmifkbbj	TRUE
eihelaigighnpkgphondj	TRUE
eobalnmmcjnccfdifched	TRUE
fcophnfcggjkebienkpdj	TRUE
fihgielmhdfbcclipifhg	TRUE
fnehhnmbakmokdjkflmgc	TRUE
gcdnlafejjjhmaipfanpb	TRUE
ghmcblkgdaomdfokilimi	TRUE
gmnnegcmlmikccjhfdhbd	TRUE
hbiipabicfmadpjhoedek	TRUE
hghhlkdeepkgdhmhdcilc	TRUE
hljoedcedecnkbodmbghi	TRUE
iahckiodnbebmohdiibna	TRUE
ifjiihiajfpkfghabkjip	TRUE
ikgdpcgmonellhabkoboe	TRUE
iplabeenglamllmcgcada	TRUE
jekmhhakdglaedbgocgkk	TRUE
jjigkfehaalkdogdpmcfa	TRUE
jokfkfhdaalchlcpkebpp	TRUE
kefikmaeneggopkfeabai	TRUE
kingiagfanhhajheoaobb	TRUE
knpkhljhkljohdkioihpd	TRUE
lchifohbbklmdmljknban	TRUE
lhglckpkpgjnoplpecagd	TRUE
lmgmokgncppghdmikooic	TRUE
mbammdfnmkonagbemlkag	TRUE
mfdnnliibipllbaonpbbi	TRUE
mkmmbmefillbenhbnhplo	TRUE
mpkipbkhbmhjbflpainij	TRUE
nffepblnabnmjgadhcahm	TRUE
nklcaokanehbfodcfnbic	TRUE
nponlnkgdhceibgoafjlm	TRUE
ofcijendbmlafnjnpijgn	TRUE
okdodgcpdepnmckkdielf	TRUE
opmddenlmefgplkgmnbkd	TRUE
pfocchkbieidajlnjlnol	TRUE
pkkfklppgggmpcgbghkfk	TRUE
aaalphjbaobngdanpbabh	FALSE
ababnpniecdcdkbincfkl	FALSE
abhohajibgaojobjkabdl	FALSE
abnjaplnbmlmahnjblabf	FALSE
aflhcndicdcnjjdlcddna	FALSE
ajbabbepflngjamcdcdep	FALSE
alobmabjkobgpabpnabhc	FALSE
aobabmocdcmdogjoadmaj	FALSE
baipbiamonbbambkablha	FALSE
bgcdkjcdboijgiccdpcmd	FALSE
bojdncpndhcdchjodcdad	FALSE
ccfangnababicidockdic	FALSE
cdcdpoechekabahobabdn	FALSE
cdjambmmanbmabiabcpfi	FALSE
cdpkcikdlcdicmndaaihn	FALSE
cijmhdckldjihabmoioab	FALSE
ckpamhbhjkjabdnidcdcd	FALSE
cndcdldjpenikdiablabn	FALSE
dababaimabpjaobngbake	FALSE
ddjeffpopababnehcdcde	FALSE
dnalbabpfgfkmgccdmcmd	FALSE
ecdhimjicodmlkcdcodfg	FALSE
ejfnmaibahmjobambaibn	FALSE
fachkjdcddflhklcdcdek	FALSE
ffheabalkkbpababdmfkb	FALSE
fngbllaboomabfabamlkb	FALSE
gcljdlcklldahjlbklabj	FALSE
gkgfcdcnddcdlkchdndbk	FALSE
hanmbambepfdjbabiabak	FALSE
heiiaobabonabiakbkelb	FALSE
hlaibakbcaabjjlnabgen	FALSE
iapbanopbcdcpkjpdagmc	FALSE
igabajonmbcabanhbaahj	FALSE
ipnjcjhdfajbhnaibabab	FALSE
jdcdcddcdchpdmfjilbfo	FALSE
jmncodojcmndncdcddhgi	FALSE
kbkcodikmcdjgkabahmbg	FALSE
kjababkfababamdegipnl	FALSE
lamijglcdhcdomablambo	FALSE
lgaahababmbohjccmdcdh	FALSE
lnmnmfffnccidcjdgabab	FALSE
mcdcpmjidipoabiapbhdn	FALSE
micfdcndhcdabalpmbjno	FALSE
nacdohcdfapnjbanbccgi	FALSE
nenemcdcodalihohbhalb	FALSE
nnalbakbndiccodimcjdc	FALSE
ocidcldhjohcnjpdcdkoc	FALSE
olailbablocdcdndmknim	FALSE
pbajcdcdncjdiclplhddo	FALSE
phjlgbcdcpdcabaljblfm	FALSE
aaajghjhngcidpkgiacbcf	TRUE
aflonohaclhiljgiikpjij	TRUE
akncbgpkehljhngdcijjgo	TRUE
aonghligddojcfcbojgngk	TRUE
beefkkcdpjlkiopdjgjkem	TRUE
bjbnoffolnfakbppflfadj	TRUE
boecboohpopmoobpdcoapb	TRUE
cdofecibldamcoagphaakf	TRUE
cilooiiahnchibdoikffnc	TRUE
cnoihgnpfndopocibcdipe	TRUE
dddjfplhgojhbmbbjhdcbh	TRUE
dihifdlhabibljghclnona	TRUE
dnkpbkefnbbbibonopjiba	TRUE
ecfjdcccnoaafonmpdgpfl	TRUE
egokidkoamhhjifmlofhmg	TRUE
eljoihoalkflghmgnffddn	TRUE
faihbaahbgdlagdpgndmpp	TRUE
fflmahiehankloifanhepg	TRUE
fjphlimhgclbpifdgbgpma	TRUE
fonkiodfhlgggidgkeling	TRUE
geddakolhkhpbomojkofhj	TRUE
gikodklfhipgojglaconco	TRUE
gnogoohglbebfijjegklbc	TRUE
hcnkkfijlncdeiahidfoll	TRUE
hifkgnooenaoooejhedeih	TRUE
hoejmhkpkhjhppohkpmpom	TRUE
iebcfaoemdccihececedjf	TRUE
ijohbilkkbelhcocambkci	TRUE
ipbacpoihljkkfcibmlkpk	TRUE
jeaehlhbfjkkeckkpmcoef	TRUE
jjnlfepmdgjhokinaneclg	TRUE
jpfpgmkgdbnjemmfinngni	TRUE
kgeegiebfiahmifcmjjejd	TRUE
kkhjdabajmhpgfmkmomknb	TRUE
koohaeodkojpoflpibhdcg	TRUE
lecbbaipnchkbalheipgcn	TRUE
lkcgjdpaehhgjjdnbidoke	TRUE
mabkmhkopidhnhmhddmhbl	TRUE
mejnifebhclehalceaamcf	TRUE
mjjgiehaebhjmfclicggbl	TRUE
mogboeaegmobilmmcfpeph	TRUE
ndlnapepjgdanfhflngdnh	TRUE
njfeeffoffbaecapajoglc	TRUE
nogmpknijgcclbnghmmgpg	TRUE
odhlghncimkeenalhojldk	TRUE
oidhggdnmgmbgnfjonabbh	TRUE
oodcaffeamlbjkdgohngdf	TRUE
pcgomadmboggegopenjpfk	TRUE
phjjajodgbkdmmadicdiek	TRUE
plnppkdodlldlnhcgfichg	TRUE
aaadkmkkcdjcddmcdlpcod	FALSE
ababmpccjdmlgeaonbabdf	FALSE
abjabcidfkkambjlakbfph	FALSE
abpabcjdpmjcddmcomalde	FALSE
agecgcjdcmdabikjakpbej	FALSE
ajbabohjbfbgabapbhgmng	FALSE
almjobjlabmcodcjdfdbae	FALSE
aoecdkcdbcmaiiibknoamb	FALSE
bbapbemiacabnabcdncdoh	FALSE
bgeabanhkiblchdlcdplcc	FALSE
boanddnakkbabmocdcidgk	FALSE
ccdlcdbldmdkahbabikbpn	FALSE
cdcipdlgimjncipmkdhcdk	FALSE
cdiojmcmdgabpabhbhkmhm	FALSE
cdpcdmoikfgicdcpindcdl	FALSE
cidchdpknoabkiaibcdpnc	FALSE
clbchnikdocdcdcdjkadjo	FALSE
cnpdcldbcdocpphmdbbkhb	FALSE
daballkbjbdlaandcdocdb	FALSE
dehnlpgcbcdcidebcdcpdo	FALSE
dloggabnambpoaokabajbn	FALSE
ebablhaoojnlblcedcdocd	FALSE
egjcoekhmabkiioabcdcld	FALSE
epnccdlcdbilapbnabpgod	FALSE
fdmgfecnlpdcdbcdcdafja	FALSE
fmjghgajbijiabcpdcdkpl	FALSE
gcdlmicdabopambjiogjfi	FALSE
gjlhiabmkabcpdcdebjdlm	FALSE
hbjiaboablkdgcdplckhld	FALSE
hhhjgbchdcdjahbakjjbkl	FALSE
iababkghjehbicdchdnaij	FALSE
ifoacdcodcifnpahbapklb	FALSE
ioabmmoabbdjapoiiobiab	FALSE
jcgnaedabmabijalibahbf	FALSE
jlabaloboaehjakohbiabo	FALSE
kalblabbepfdjcdclndpnc	FALSE
keblhabiabcidocdibbjmi	FALSE
klpgpanhbhabnaababgfjn	FALSE
lcdcdfhnbialkbalmhhbfe	FALSE
licllapjbanhbdcpdcdgca	FALSE
mabamnbobnicaanfoaboab	FALSE
mecmclapkklbabckdcndin	FALSE
mmmdcodcpdabahbojmpjca	FALSE
ncdhkocmldmpjbneababic	FALSE
nilcdciddammjpdapbabdl	FALSE
oaboajmbaakmblalbfbcoi	FALSE
oemapajbjiabkcdcldpbnf	FALSE
omikiahbahkblocdchkddp	FALSE
pchdcjldcnigababbbmplo	FALSE
pjcdcipondabambifiicag	FALSE
aafnpdolgbhjmjkffoalohe	TRUE
afhdckcljofkkemfpnbpdek	TRUE
aknemijllekejgjcjklnbno	TRUE
babchecelimiocfecngfcco	TRUE
bfbihlnoanknbmacpmobcmo	TRUE
bjkndkpfgbddpapnifjpcik	TRUE
bofdgljoofkkfebiamjdaib	TRUE
cdonpgflpcgepmblacccflm	TRUE
cjohnechjehgejcfeignjij	TRUE
comgjapkhhigheclajgcfde	TRUE
ddofnemmkagndppclbllepl	TRUE
djdjlhibhbcdaijpflhcjdo	TRUE
doemlkkfpfejmlngjocgddp	TRUE
efgefplmniecbapakdlbgip	TRUE
elclhdaodgoanahgkmjaeap	TRUE
fagiagncfijhekdcnndbllf	TRUE
ffhabhadgnfaelifaalpigo	TRUE
fkfbcpplmoeoenomncmdcge	TRUE
foplkaiclgidlahhdjpbgia	TRUE
gdoeijmpgiahafdmgilkbij	TRUE
gijneagbbbmdkbdpgbhgeko	TRUE
gnmopmecacaohfkadmcknlm	TRUE
hdgaejnncdgglkcdlfjmgjl	TRUE
hijhgedeibhlbjmpkoopdke	TRUE
hnjphjcioejgfmhpdjifalj	TRUE
icefhjmgdjkiaimcbkomngc	TRUE
ihfccklmjbedhbpbkbocgph	TRUE
imeodjgfjpckchgmocgcden	TRUE
jcfcnkjpcnmmpdmjkkdodoh	TRUE
jgillhganbkpimbaedkjgda	TRUE
jlfmjaobodiboicbaajhdkp	TRUE
jpknlmgebfkhcmfemdoomdi	TRUE
kebkbjcgbgpchfimljckljg	TRUE
kiidclholpokghpnjelmmma	TRUE
kncefcjhopcolmmhjmfjabd	TRUE
lbopdaocdimlpeocldodpba	TRUE
lgkbipjclpcbdglidblbheh	TRUE
llkgpfakmajgdimelemggkc	TRUE
mbmbapehconfcdlkpllbffp	TRUE
mgkceceebdabhbjdkgoffaj	TRUE
mlomfpikgojfpihjmmbcjbi	TRUE
nbifmkjamppgoniimgnpdok	TRUE
ngpphahphelfakabdjgbcjg	TRUE
nncdeeaifkbhhcnpkldmmpe	TRUE
ocdfhpchichoefcbchbfkpe	TRUE
ogpmhkcbodhbiaafmgbjpgk	TRUE
olhdihghmbfgohmiijllhbd	TRUE
pajdomllaoniefoiehkifci	TRUE
pglcdnpapchlafjojlpblmb	TRUE
plckcbnhjckmgofjoehojlf	TRUE
aaapbabgicdjchdnfphlili	FALSE
ababmjedelciabalbkanhhk	FALSE
abihkiaibhgababclngagfo	FALSE
abphabbhcdlmlpknpcjddlm	FALSE
ahajbppabaicmoabhabfcil	FALSE
akbabjejheajbaboghligag	FALSE
anbabfpkmmfdhfcdpmjcdco	FALSE
apnpbnkamnkbjdhnfkabnab	FALSE
bcondknpomhcdebabhkoabp	FALSE
bkinocdcdfmahcdjcdodcjh	FALSE
cbanbakbiccikkcdoclddmg	FALSE
cdcdljmgcodcodahljcalcb	FALSE
cdjcidocdcjdppojidolcdp	FALSE
cdpcdepkdapohkkkbjanhbg	FALSE
cidhpcpmdlabmakobfpgljf	FALSE
ckopnhhijdmmcodabalnbao	FALSE
cnepanodmaklblabcldlcdk	FALSE
cpndcdakobabnkndbaiajpe	FALSE
dedkaijabahbllopabanbdn	FALSE
dlnhfccmdnchdpepcpdkchd	FALSE
ebhncdmjcnddcldcdmajhnd	FALSE
egfplifgcdcdaikbabdlipm	FALSE
eodaganbaplmblbababpioa	FALSE
fcmjdkicdompcdcohplpild	FALSE
fkfkcpechdcideaabaoobnm	FALSE
gajhpbajbiaabknihabmbbc	FALSE
ggaobkoahjbckdcodnddkdj	FALSE
gnljajbplahbbngjecdicdo	FALSE
hcbjcjnpndcdimmecdcmdpb	FALSE
himdccicdcdngefcjaibpab	FALSE
iaihgacdcdegfdpagakbpab	FALSE
iegnabnabllpckdocmidgmk	FALSE
imhkoambkabiicdcpidnfff	FALSE
jbpaababcdcodhaokfcnpdf	FALSE
jhmabmabjdaiefnkabaobmo	FALSE
jpojambkabgcdhfcdcdmpng	FALSE
kekfcmjacdjkocodfamibab	FALSE
kmmklelfmhcnjodlcdjcdcd	FALSE
lcdocdmmenljfacdnocdibm	FALSE
lipoknabiabgjfldpcdpcdn	FALSE
mbceaboamjmbkejmababhmb	FALSE
mhahpbahlomnohbcdjmncdl	FALSE
mpkpbamhiplbmabbabhahbk	FALSE
nddilchpdocdckhcdcpnddo	FALSE
nkhkajhbknapbabjjkabpil	FALSE
oagamokmgbabooabnbcdpcd	FALSE
ogcodcdpfhjcolldcdblicp	FALSE
ooaepoohcabkcpdcdaababa	FALSE
pckdcljndejdbcfabanlbfi	FALSE
pjfpgalbmlabkckdkjcdecd	FALSE
aacedglegnaliiadgaapookk	TRUE
afcidcpfdboainkpcdlcelbi	TRUE
ajlkhgkioafechielkfknkip	TRUE
aokfccpggmjgmdkbcniaiefm	TRUE
beehhjfkncidepmbopcokbie	TRUE
bildpjghonpkleepgnngihba	TRUE
bnlfpjickkildcnegabkfghb	TRUE
cdeobjoeigndppofmleobdbe	TRUE
cigghmbmaomajcbphnhpmada	TRUE
coaipbcjapplbblljnadgbio	TRUE
dcopaaifeoamangnmkjdpaah	TRUE
dhdkdcolkaogafghdapimmcm	TRUE
dlpdchgmjjjcehohghndkmmo	TRUE
ebiajgabmmdajlpfgebjjdlh	TRUE
efomegngidpmlcdniocjppfg	TRUE
ekkbdgdneheffjkekknmknhl	TRUE
epenhijbjghnfgmabcmgnagc	TRUE
fghcmfekmlilifkafdolgfil	TRUE
flpfdpfmooblhgobbjclhdfi	TRUE
gbgenmhbjdampnmajgkmohgb	TRUE
ggekbhjhbcadgclklipbehbm	TRUE
glhcmmilcpkkpopjleijgond	TRUE
gpljlgmmplgppfekfggnddik	TRUE
heopbcpaeaaokhojodmdcnga	TRUE
hjglgekellpmgnnblpegdpik	TRUE
hohjcgfihjfmbjfbojbgbgmj	TRUE
ideickcpdaoobmjnkkiflboo	TRUE
iiejfabbpgabeikmncioifdi	TRUE
inmlecephacmkbnmafakmefl	TRUE
jcfhgcpdfbejekmocaknapld	TRUE
jhdcjicdnccegeofdgjjpfdl	TRUE
jnnpjmmnkoehbhnlobffmjde	TRUE
kcipngocjahonagbcojhlgkh	TRUE
kiahjgdgckjaegihjnpmkchl	TRUE
knaobjaghbjmnfogefnjjigm	TRUE
lcjillopfoiagaefnnmlnelf	TRUE
lhpdjkfaokcilfhnnngcjlib	TRUE
lnjleihmhanclglcdpiljmam	TRUE
mdljmopbjndgnjlegdemhmem	TRUE
minjemnijbnkbpdffeehggee	TRUE
mnjgadiklfebhiaokbkoobjg	TRUE
ndjnhifpfhonnpnhoiciikcb	TRUE
niconjmpnfjdekgpjihbkkaf	TRUE
nmbiofjbfhlmkoagffnjfjga	TRUE
obdcnkaaohhdhdmpncabbncp	TRUE
ogegjjinkjfmgiafjkicmfan	TRUE
olinpppodddgephebgknchje	TRUE
pakndcehggcglgbeommmhbol	TRUE
pfnjjimagcnfbhcleajlclpc	TRUE
pkeohpjiggfiijhgbbmcikpe	TRUE
aaabmojlababhoabidlbjfod	FALSE
abakbibnoceafmabakonbima	FALSE
ablapmpbnhijibdaljmbpabi	FALSE
acopopdckdcdcjkdhnbnjnim	FALSE
ahkmpbpapbmljgjckohdicpd	FALSE
ajoihcpljdcdjnnkoambambf	FALSE
amlalkbjiapljjbljajobakb	FALSE
apcdoonhnckdigcpdocmdlpl	FALSE
bdcabpabgcpmpdcpoijndaoe	FALSE
bjmngaolaojbabjggaobabcj	FALSE
cabmhnabehpallaibabmfgni	FALSE
cdcdlnjbfffobamhjbnabmle	FALSE
cdlcdcljgnkbolpecdlcdfpi	FALSE
chbdcdmcldedhhfjmcjodcda	FALSE
ckdcdckbnicfhcnlidcddcij	FALSE
cndlcdicpjdkchhdbmdkgndl	FALSE
daggaoobiainbjcdhjpcdfll	FALSE
dfcndhchjpodkflcndncdmbl	FALSE
dnccdcjdihaokbknklpahobo	FALSE
eckodcdjafoiokocohodcndp	FALSE
ejdohfpfccoajbajbababkio	FALSE
facdnipnpncdlpbjmcdcdabh	FALSE
ffmkgmpgecfkcdicdcdcddig	FALSE
foakbahkbfgocakbaboodgnf	FALSE
gcpldcjidialbhaaiobapobi	FALSE
gkljceajobabaabkpkhakhbj	FALSE
haphpipkbmoanbcdmcldhlmm	FALSE
hgiejlmcphhdcdaikbapjobk	FALSE
hnabhabamlbikanbejbkojag	FALSE
iccjldciokdalccpdcdmilbd	FALSE
ihcidcdlcodfabhabigdnmko	FALSE
ioieopkkkalmababldcdcdfa	FALSE
jcidhcdajeopcciahmbalkjb	FALSE
jjbahhjlabpahilbeoabakbg	FALSE
kajjohgmgcodncnddgbabkab	FALSE
kgccdciidmblkankibabchgm	FALSE
kmpoblimchdcodhinocdcdmb	FALSE
lcapkbanbpanjjbhabplkdkh	FALSE
lgoabahbaddgeojcmlkdcdkh	FALSE
lokfpbanbabceoanboakllbj	FALSE
mcpdcinpidphaajbkjppmanb	FALSE
mjnbmabalnibiccldmomclmd	FALSE
mpchodcdmaahbalpbpofnein	FALSE
ncpihdicidlojcdlchkdpmhm	FALSE
njabpkabmchccmokdcodbejb	FALSE
oabpiabodjpemndkabailbej	FALSE
ogapcdcpdinpabojmjamjmib	FALSE
onbipapbaboggcdcdgepdmmh	FALSE
pcdcjdeiahbllabgnkjgpmej	FALSE
piehpnecjdcdeigeoincdcdj	FALSE
aaambaedjiknnmfjhohofcojf	TRUE
afgbkmjmbkhcghnlejfepoifm	TRUE
akacplmljeecmgoagpgkmcohi	TRUE
aonogplbegnnhlbiichbjhgie	TRUE
behchmjdlomdehojojjfimijl	TRUE
bjcpadnchhhkmolegicneilkm	TRUE
bobghdpdnahonpajcnipdmoda	TRUE
cdmkfilgkdlidjalniaklnmll	TRUE
cjcbknbdfeojejeolfolhdceb	TRUE
codhkdiboneefkoekbpdifhkj	TRUE
ddhlehpogcoflpkijpakpldnl	TRUE
dilcpihogpjobpdjpcjjffldm	TRUE
dokkdnnnjgdnpocdmjfpbbhbj	TRUE
edoeolcojkoebffjibkpnbljg	TRUE
ejjkogbflahlkpmkdaphgjehh	TRUE
epdiahhfonlenmkmimmooecii	TRUE
ffeamccphbpmeipjfecpeeoij	TRUE
fjnolijifdnoelpmidkklinok	TRUE
fokammbagkdfhdoiilngongjc	TRUE
gdjckfkoepgnpfplmgcblojgn	TRUE
giihbeelpmmpphahgngaphjpj	TRUE
gnnlllckdcmbileldfhjbfhbc	TRUE
hciiaiijakncinjbimofomjjn	TRUE
higiimppaeafhcamnpmhojneh	TRUE
hnpmdbiooajbfedjihelehhfd	TRUE
icondfdfdgbipjakglkmoihbl	TRUE
iihehdfipokkncglhnclofopk	TRUE
ioebebmhnhkbmfbkgkhjgcjaf	TRUE
jdkegolfhgflofihmgcieidog	TRUE
jienegipffdpaikgcfakpodka	TRUE
jnfdohfnjcafiankldinpmlhh	TRUE
kcdioggfjfakkhfoleaebepea	TRUE
khlcdnpocomgflohdjeanhoik	TRUE
kmadjaebdeamgppeabakllgli	TRUE
lbmophllceejogekhmihcdbkc	TRUE
lhhiemglfgdeplahpchcabinh	TRUE
lmhdocppanegaifjaegkcljni	TRUE
mbpngggphgcojdchppgkhbifj	TRUE
mgfinbbkfmgebpeggnblljhgd	TRUE
mlhfhpliekjggobpkmaliggjb	TRUE
mplcmeioonjfniajpmmjebjjc	TRUE
nehmcallkknibiolkkbjbceja	TRUE
nionbfjcgdjjgemgibbdbjpac	TRUE
noaegdiajhddgnodlpnbpgooe	TRUE
ocieaemkflpiknhljfmhlpbfm	TRUE
ohifcgepeejjmlkkeidilfaga	TRUE
omeeipenmgiommjgpepldfagg	TRUE
paokilcjepjffdbiebbbjabhh	TRUE
pfmjbljncehkjbglmmaeipcha	TRUE
pldcdhkmmhgbkjnigejddjnod	TRUE
aaaaobabfcdoicioidmodakmh	FALSE
abakobilmlhgcdckdhjnekpki	FALSE
abmhabjihhapdpmcnljdcdfjh	FALSE
affcokndcddabioiappbniigd	FALSE
ajbajjkpbpjhiogfaboalibbh	FALSE
amdpiapkbaibochgcclhkdcdj	FALSE
apbnabjjoaldjcdcpdbmpglgi	FALSE
bdckdcijddbnhcdcnkmdikllc	FALSE
bioegaojabmakklnmbbchodcd	FALSE
cababkkjihoofaibabjglldfe	FALSE
cdcdgclpeonfhphfcnihodcod	FALSE
cdickdpgldlaglababmpkaicn	FALSE
cenhaicdjckhmdhcphndlcdfe	FALSE
cihndocmodhhakjpokcdacdcd	FALSE
cldkcjmpndajbonalbhheocke	FALSE
coidmckdbfmcdhamnblabmoap	FALSE
dcdckomdcdcambnooabglblbk	FALSE
dhmipfhmcndcdfbabakbpehmg	FALSE
dpgjcchhdphcmdenpabajbbnp	FALSE
ecpcdjncdnklcdcdpidclfihc	FALSE
ejcmhdmnjncdpadngcdcdebpm	FALSE
epgnidfcdpcmhkkddcjabaoob	FALSE
fdpbcabaoobngdgagaboabjgn	FALSE
fkilgmgnnabgablanbmbcdmcd	FALSE
gbkggjababnagokpidamkblab	FALSE
ggfcpdneifnleicdcdeeabalb	FALSE
gmkklccdiiijhcddoeidabapb	FALSE
hcibjcmdlcpdjmgabjiikanbj	FALSE
hicdjcjkjdaflfpfoabkabjbo	FALSE
hpacogbclpdcjdjcmjdncnhdl	FALSE
iegocelhcjdcnhdjadcabpoab	FALSE
ilecdpcdamecdpcndhmncblkd	FALSE
jahphbabjalbabccdpkadmdjh	FALSE
jfcdpncdfafpicdnjhcdmifid	FALSE
jncdmcdmgadghalhljbanjmbe	FALSE
kchdmpcdidjnjcmmedcdcdjpm	FALSE
kihgnoijnpdambaibacdcondi	FALSE
kpdaboabcoocjpjodcdjlgnge	FALSE
lcipmndimcdmdhokfahbahipb	FALSE
ljlegkalkhbalbdifiopababj	FALSE
maclimcidlcjdjkbfcpdickdf	FALSE
mflocdkcdljoccodajbalbgda	FALSE
mmcpldjpjkcdmoamkbpaijjhb	FALSE
ncjcdcnhdjaabmabnkdobkdhf	FALSE
nilgabiamopboembaibhkoabd	FALSE
oabjhnkabdbfimakbaionnbpc	FALSE
ofehjhaioobjmababkambapgf	FALSE
ommabiiabclpikdcdacnegfng	FALSE
pcgababldmlojjbanjbanjbja	FALSE
pipfbgjabkabhaolilmbpaban	FALSE
aacdbdlfgdjkffhcpcngifcben	TRUE
afkndcdllbiphccmjlcplcbgjg	TRUE
akpahdjifpmhnhjclmnkalpjkp	TRUE
baiooajpaafmlhbillkppobdei	TRUE
bgggjhodjlnlkgdmlbplldibfg	TRUE
blhijbfhdnhmdamckolnfkfnkd	TRUE
caenfekfpbajdbccmnnfaphkbe	TRUE
cgdefekooknbcingpemagddana	TRUE
clfccamheahdnlmpilnodfkmci	TRUE
cpnjlegcclooffknamfakbmpkc	TRUE
dfhenlfcjgogjeahhbiimplbpp	TRUE
dkngekcdafpegiopakhoacjnep	TRUE
dpgjjnbnfpcgkkoflkopipdnko	TRUE
eebjnodailmekedgmccobaalib	TRUE
eikhlochnhflfphgenccbobpcf	TRUE
eocoenboohdmibidncicghdccg	TRUE
fdhpnfejiaboakgmiheebmamld	TRUE
fjhkejnkedlmdalmkipeeggdig	TRUE
fnooofocklgiimfmjglbmaenei	TRUE
gdbhhngnonioplanhcabnajidm	TRUE
ghkkcgffebbdlcdiccamkgnfjk	TRUE
gnbifkfidloodoedihccgpanpj	TRUE
hcadpfehpmnnejncnadbbjbelg	TRUE
hhhlfiijbnnpojajljfmbkobjc	TRUE
hmfaaecobhedgiaignjfbjfhaj	TRUE
ibgiikooppnpffninojcdlmcch	TRUE
iggplhekbgcpbfgnpfiodekokf	TRUE
ilnpofagoodiinopkomlpmkmek	TRUE
jbfmmmemcgahpgakgpgoalpoeg	TRUE
jfnkilikmhfccmcpchnbcghcao	TRUE
jlbdgmefokbdjjmalenmafeibp	TRUE
jpibcgpbekcncddokfhfkccdoh	TRUE
keakegbaobinialkggddmmlmog	TRUE
kjbecfaebbhbkbomlceocoibpa	TRUE
kniiadiofoeabdlmhpadehipfi	TRUE
ldgmfabepiikighhhfjmfnlped	TRUE
ljfgggejkigjjapimicnjkhepf	TRUE
loaljjohiogekikppelmdgnfnp	TRUE
mdifnghfejclbciicemencpjdl	TRUE
mimoknppimglhecnbopbmbkiaa	TRUE
mndkhennpogpbmhnbeeljmaija	TRUE
nbhdbflmiijeikikgbblhmbijd	TRUE
nhahiomkdpeehinahmfmnmheaa	TRUE
nmiamjpoiddojpkmagnioiaimh	TRUE
obhhpkkgelkonbjpimpgckobbe	TRUE
ofpmaenhhojnjjfhaoefchgjfa	TRUE
okngledkgnlcjdahladjgddofp	TRUE
padcoafojnejcbeoapanechpfi	TRUE
pggmajgibdcpehofljddikgapa	TRUE
plahlldiefjngkemicgeiadgmm	TRUE
aaahpobnanbceciccdhkcldgno	FALSE
abaombaodjofabhabgalhngmjb	FALSE
abpabhendgihndcimdnpolcdom	FALSE
ahabioabfkeohjfbamgiloabab	FALSE
ajmbnaikmlbcjhldohcnodkdhg	FALSE
ambjbjcoblbcdcjdaimbaobala	FALSE
apabalkbnehhghjgikahboabgi	FALSE
bcfjkocdcodnohcldcddminhcn	FALSE
bihcmkhijdcihdncdkhpcdhcic	FALSE
cabjpnmmammbfpleomcndpcdmp	FALSE
cdcdmhocllmfncnkdcdgadglae	FALSE
cdlhclhdeabaibpigklnacdkhg	FALSE
cgnfgigjabnabdhnoabahmbkjd	FALSE
cjdphhpnpcdhfdnbeaababoebj	FALSE
cmleppeablabjcgggmahbmpnab	FALSE
cpdcldijahgccfocldkplcmdhl	FALSE
ddamibabjfllljcnhfabjhabdl	FALSE
djjcgabjakbdmjeeppicdochjd	FALSE
dpakbnmaplojbdfhbcanibpabf	FALSE
edamnblannbkdjicmjdjhclldh	FALSE
einaboapblcdchdmgebfcpanne	FALSE
epcndcdaiblhabdmfomiaijddl	FALSE
fdmngpcidcdkjinpanblijalpb	FALSE
fknjahncpdphcdajbabefejicn	FALSE
gaolibabhingbhjgababaccnop	FALSE
ghahbilabncjlolndjmhjcdfck	FALSE
gnicmhokpahobaokbcmdcdjpgh	FALSE
hckhdjdcaaababcdhcpindpmdg	FALSE
hjifbaaajjfabkabgecdclodhp	FALSE
iabalblbbegccidlhcdcfcncae	FALSE
ifacnekpfmjmabaijlnbdanbab	FALSE
imejcdcooldejcgfnncomdcdip	FALSE
jbmkfgabahbecdcnokdjdebjai	FALSE
jimdkfahigabambgbojcabahbo	FALSE
jpjabmhamobcjnnbkjabakhhlb	FALSE
kdmehcodmcdiladehajlbakonb	FALSE
klllcchpdlcdjeojabanblfjfh	FALSE
lblababkianifahaljkbmkoabn	FALSE
lgcdiohcddibmnaajbanombkam	FALSE
lnkamlbjaobabamlobhakoohde	FALSE
mcidicpjndjicdcnjkmdjmammf	FALSE
miiccodcddipmjgfabmabkfobk	FALSE
mocjodmcdiahmokbojabnljmfm	FALSE
nebodlcindnmkllcdgahbjlabe	FALSE
nkcdpcdfolpfcmiocdcdmoicme	FALSE
oamojbabojmcnlljgaabkkabbj	FALSE
oghmjllajbaibbpgcdcdkhcefn	FALSE
onldphpncldclomldbncdocjda	FALSE
pcidcdonifoekefbcmdcmhodbk	FALSE
piaapbaibemanonjmblabhkkhf	FALSE
aaaeocbmpmknpbjgaagemakiogk	TRUE
afhbelkejbnciipacmcoclbbbbf	TRUE
ajggnckgkhnpjillmfhhmpacedd	TRUE
aonbcjbolghlfoiggnldfemnggl	TRUE
bdkgbgaljeofobadcmoppbkgelo	TRUE
biockpkjnkocploonjcjleaifig	TRUE
boeigbfdniddpcbgncdfpiegchm	TRUE
cchpjdidoohcgdigniiljmifjbl	TRUE
chlojmphdigabdaokegncldcnfg	TRUE
cnbjijchpplfioiiimneclocdnm	TRUE
ddghfieipfmgmlhceicbbblgfdd	TRUE
dijomegijahbjcldejbkdcljokm	TRUE
dnimcnoapcdfjlablgamhmaeilm	TRUE
ecoonjdabeojgjnbldpcponomnd	TRUE
ehmglkilhgmncebafjppplmhjib	TRUE
enfhccophpbjldefhbnidbofook	TRUE
fdaaoaiciidgcllnkbghgnjceog	TRUE
fjdbnablhhgnagpfenkfgaedbmj	TRUE
foccjcmgfkiekchaaabiemjcemm	TRUE
gedgmoamkciambnhfbllocjjofa	TRUE
gjfhkobkeanmcfhcmjghpoagckd	TRUE
goocadofjgoappocdmffbjbelag	TRUE
hdljbmblhjekpcacdlhacibdefe	TRUE
hjeaembnpofmejcnggnhbhlmpdo	TRUE
hokcjljkjdefjnaggijbfjaiomn	TRUE
ieadpbbjahaoadjpljacefobehh	TRUE
iidingmfkbkffhogaoagcphhekf	TRUE
inbpndbcoeoaefjnbdkagdaehnd	TRUE
jbklifejicihmnenfgcmefcpaeo	TRUE
jgkojlhadnadhambbkiffjploen	TRUE
jlmpmomipaljoafmgmbfcfmdeod	TRUE
kaikoddjjmhlknkhohcidnologc	TRUE
kelnfjojhajcnfihdjfpakjlcdb	TRUE
kjmigbokhddjbheahikgcjaheca	TRUE
kpcljdfkplggoidigkoahbepplg	TRUE
lehgbojebjpikjeokmighahgnan	TRUE
ljkhaenjcmjjfhlhjkigcikgmkn	TRUE
loejolkliledjkdighiibgmbkik	TRUE
mdohdbnkdhgahphdkpdlmiaefdp	TRUE
miakmocgnpmmmdlbkfnfjbkbijj	TRUE
mnkfcfkghonfmabeppgfkaeccca	TRUE
nccibghdgfgdckamklchjiecple	TRUE
ngpjphngimokaaonfbnnmpgoggh	TRUE
nmfklbiboaeblffbhmgoafehhbn	TRUE
obkpfnmholmofjkimlglmjgeifj	TRUE
ofmnofcmicmlinkmlhbbmemaogb	TRUE
okoibijhpafglhdbgjpffpbiapm	TRUE
opoldkhfmepmfcefjoiaimabdhl	TRUE
pfglccghbjklidehfnmadffpnea	TRUE
pkdloeadakniolabohimpfhpbbl	TRUE
aaaabaikbceabaobbofgbbncjee	FALSE
abaobcmnldpoacdcijjpdjlgbhh	FALSE
abpjnhajbcgpoclnjhlpdcdmecf	FALSE
ahlchdcdjkpldabahohhbeffdke	FALSE
akncgiabalohbfpeacdcdeacmpf	FALSE
anhcikidlocdaejfapijbalbkif	FALSE
bajjjabpjabkeoljeonachdlcmd	FALSE
bgegmcdckkkdcahkngdcnmdcdhf	FALSE
bneocjdcdjmegljabaonppblimb	FALSE
cchdkhcdniabomiaeaippbinabj	FALSE
cdhcdclggbcmdcldpbdodpnpade	FALSE
ceijcpdjicmddecidcoimkmpdib	FALSE
cihlmidchdobinhaobabnpddmom	FALSE
cldcidifjfikhikegpanbkambmb	FALSE
cnocdcojidijcdnmicijdeifjkl	FALSE
daoebeaiolhbaibccndjcndjkcj	FALSE
dgmcpndclloidnablaoonbcdakf	FALSE
dnfjahbkabildclamoobabekhaj	FALSE
ecgcdcmidnjbclbcebcdabajbkf	FALSE
eifilcdnlcmdgcmdcdnnidpfcjp	FALSE
epkcdiocdnjakbmjpjahpbgkgop	FALSE
fdbcnndcdabijnoahiobhhlaofd	FALSE
fkcckgoicncdcdgcdcpdgakidlo	FALSE
gaimhbabbbgfmcdcdedapfplgce	FALSE
gfghkjafonfancnodpcdabambah	FALSE
gmlocdcldhojioedfabapljihbg	FALSE
hcdpcdkdcpdhcdgkolgmahlonbc	FALSE
hhkjgdpgmiabapbpgbhacdcdkig	FALSE
hpcndkcidbannlmaimikjbnahbb	FALSE
idjkemcbippdnabajkbocdcjodj	FALSE
ikbjjcidkhkmcpdfiakcpidcpdi	FALSE
jaicjlababmmcnpdipkcdmhfcnh	FALSE
jgmecdkopcdmabhabpnbmbjhddc	FALSE
jnkalaoinmbajbcdcmndjihjpok	FALSE
kckdpicmdpgenkhfeakkbahlbka	FALSE
kifgcdocdhokepmcababjehkifi	FALSE
lababjdlbjlicmdbachdicipdfg	FALSE
lfcdcdbifgpdabhcabnamomblpb	FALSE
lkhplecoijekcdcmpdlhoflcdcd	FALSE
maobampbmdcfmcdmlcdompciimp	FALSE
mgalommbnaobcaababjfaogeifl	FALSE
mmlcmjdcndbbapbmaboajhnjhbh	FALSE
ncgaaobmhainjbmfmcdnkkmcmdl	FALSE
nickidokociilihdbfpgmcdcokd	FALSE
npgedcnocdchdmdolcgccdpncdl	FALSE
odgaojkpbakhboapbabepnljmoh	FALSE
ojkhnajhbajblpkojgfanhbakbh	FALSE
ooomhcdcnnomndgmhoichdcjnmd	FALSE
pdbcdclkldogcbljllacidcmdkn	FALSE
pjlpnnncgpkabokapbgcndcdbed	FALSE
aaagiffafgjjmanljjkodnfpjego	TRUE
afapmajnceibjdgjhmkkebfefbdk	TRUE
ajkoliklecfgeenfaookodcnclif	TRUE
apjehoeoicdpillfabbkibnmcgdj	TRUE
bdjfgjklaadmllafkajijcdnabmi	TRUE
biplliikicfbfcpknbbcdpaaacdh	TRUE
bnlojmbnbpjlbidkkbnhdgpggnhb	TRUE
ccjplkiffoiidlgfdkjnlmidkhjf	TRUE
cheampdpcnfpjhdelgcmopdekjbn	TRUE
cnbmommmilamgnfpdabkeepjdphk	TRUE
dccibaijaokgclnniocedakjhodc	TRUE
dhbanikknnfbcaifpehjfkfminld	TRUE
dmnhmmmigalhoaepnddedfnofedp	TRUE
ecdjgnakdfphdbbnmnjmamilolkm	TRUE
ehgpdkdckbgllclgfnpokoginifl	TRUE
enenadjcpdkkmbpdndjmphofnkpd	TRUE
fcaeifckgfkgoadkljjfejlcenmi	TRUE
fgioblhelmccnclklkhcggnbibaf	TRUE
flneapdhfpkjblenhjkhpfoenhlb	TRUE
gbdngpedcpdkenffdjejjdphldeb	TRUE
ggahihnkphdmnbojlamaeghilojg	TRUE
glkgcjhcclpoomfmckeihnnkbaap	TRUE
gpojniicohipbmpdkaiabmchfcog	TRUE
hgjhcidlphbbkcnophnpjafppkdc	TRUE
hlmjdblmklfaijajhmgfgflnngde	TRUE
ibhajomnaigokcllfpefmgdkeaaf	TRUE
igemehmnklhbnfiobfmddmklljkp	TRUE
ilfofcamblakcecddbjemjgjffpl	TRUE
jajpijmbjfjlbpgmhoejgpckibak	TRUE
jfobbdagbfboaoafbgidmkgfoicm	TRUE
jmbofmllfbhkmlkojkdepacofhmj	TRUE
kaojkpocgekjplcmadheiamclobg	TRUE
kgebpmicfjlmnjafcbldkglhhhfd	TRUE
kkmcalgciplkmimpmoaiblhkfcjj	TRUE
kplgjlnbkkfgmebnmmnkidcjahif	TRUE
lenhidiknkdhkgajeopbmjnjdfhc	TRUE
ljlkjbdfkmododealmhfpnjanoie	TRUE
loicdkbfdlennceeakgbpofhgbfd	TRUE
mcoanhlbpjffglhgponlonolpico	TRUE
mjdbicbbhmgbnmmklljbckofpcej	TRUE
mnplndocbkadajemkdlbnemmhaee	TRUE
ncficbfkbokocbdafdkpndhgodan	TRUE
nhcchohkkeigpgbkofnbmcnbhjjj	TRUE
nlgbbakhjnjdjggbklfljnhlfgkd	TRUE
npjnhceehjhhkolhgpcimefambgp	TRUE
oehjaogeljffmahbehlokfekghng	TRUE
ojoljhbdjiiidbdjbffippchgmip	TRUE
opgkafmhnelpdkienocaliggcgnf	TRUE
pfdoojkjgkpmdehdffdhpoonbkpe	TRUE
pkkhamaniadmkiceflpnjjjmhokj	TRUE
aabaibpgjmcaibabodkgmoilgncp	FALSE
abaobhifljnimhpmiepapbapbkda	FALSE
acbnabmmkiaobcdpcdnphcppdkll	FALSE
agfoomneohokokabajkbabanbodj	FALSE
ajhlbabiepaolbppaobjplockhda	FALSE
amoeiaabhlamibaoknjbkoabokho	FALSE
apjkeiacmbjflcaipbabababfeji	FALSE
bdonabahmjbchjmipoidkcdkodlf	FALSE
blcdolfkejabahmmbeiccacdjncd	FALSE
cakbalbooababigkpnbnllioeaep	FALSE
cdckhdgklgmgjkfckjlojiondcda	FALSE
cdpcdfgmfapckdcdamnlipndigfo	FALSE
chonmhdkhcdganaboankopnmobcd	FALSE
claeankbpabpdadijdjabkabehed	FALSE
coapbhpkahobhncdcdldhpdgnemh	FALSE
dbcnmoalbannhbgabaphnbkammfk	FALSE
dhcdncdjjfldkcdmlhojcjdmnkeh	FALSE
dnjpeljcdcondkijgpkmambabgjm	FALSE
ecdemjbdapbabameoochdcmkdkin	FALSE
ehlapbabmcohnipopcnkjlpdicdj	FALSE
eoilbmlecdkcdifpapijbabfjdhe	FALSE
fdcdaefibigncjohnabapbkocdcd	FALSE
fjpchohdmcnodkaojjhnoiabanib	FALSE
fpjhgajlbooabdmcndchdmcjjahg	FALSE
gekdldcabnoabickbcjdnlolchkd	FALSE
glcjmdjonjcdnfalakpbhoaobhid	FALSE
hajiijbabggginhdecmidcdadgek	FALSE
hgemkabaojbhfhcdhicnhlilpmjd	FALSE
hnepadnhgcjdcdmkabjaklnjinbp	FALSE
icdlcdfcmbnagenponpcdchdjpmo	FALSE
ijemcdnimcdnkcpndichnndpffbi	FALSE
jakabaobpbemhapbpabeimkmbnln	FALSE
jfkapkkbanbcdhcddiabfboepljo	FALSE
jmdolbdplkbjajmkbabancidcdef	FALSE
kbgognbbhcdcijodjecplcdcldpo	FALSE
khjoimkchopdhcdcpofkgiabalbc	FALSE
konabmiabpfhiialblhabfkdgcnp	FALSE
lcolkeokbkcpldcpodgcjcdcdaeh	FALSE
lkbkejajboalnbeloolncdcdlhpf	FALSE
majbablelmbiijfcopdkolkcodhg	FALSE
mfceakcdcdelajlbiabjmldaeble	FALSE
mmdhambabiajohjpoljbajbodbbd	FALSE
ncdcdailbjaibcibpifpdfofoaec	FALSE
nifnicdckdhjallmddababmmolfp	FALSE
npalifbnlmkjhababiambabapkof	FALSE
ocjnghakigamjmbakbchdcdaebaa	FALSE
okachgabnhabdbmfjgcdkcdejlgf	FALSE
paepbeebmapkbhabdnacdmcdffdk	FALSE
peecldincdbpcpfldbcdcnddbcgl	FALSE
pkdcnmlkpcpplmdcmdjgppncdcdc	FALSE
aaagjibhdppmfekmmgokmhokipdgn	TRUE
afhjpijndelcghkbkolcbmclcbpjd	TRUE
aljkbnnlfkajhdlnkgmibpaooajcl	TRUE
bamldlmfmljjhndkalnbaehehbjab	TRUE
bgglfomglppndbbjmapibnanmdgkg	TRUE
blkbicblocnhnejopkifoomfkncna	TRUE
caoibafhgkgimjdckghjdpbekggbm	TRUE
cgimmcjihpghhenaogkdjmikbadld	TRUE
cmhjioopbkhmhldknipgjklbopoee	TRUE
dbpcoogckclmccoibpppcmhoijfmn	TRUE
dhefbhbhccjpgcehkkjcpbhhbnkgn	TRUE
dmbdfinlpghdbkjpnaofjjbbjfnnn	TRUE
ebldkhhncmedjcjefkabpebbemifh	TRUE
egcbppcljohdeifnkafcdbipcjhle	TRUE
eledjdlnjaajeclnfmedlfeidndgo	TRUE
fajmbnhdaggoajhibhjoagpcncnpd	TRUE
fgaijoceemiekhpgecakbafgbmlem	TRUE
flmlnkabdighngegaahjbfkmibpcb	TRUE
gabopbpgafbdlfpalcmklemclilij	TRUE
gedlibabkodkcpjnncdlenfgeaang	TRUE
gjfcipfccgplgmojmfbimflhmdamb	TRUE
goknjkbidkejolioikebhgnlfpgll	TRUE
hchdegnhngbdaajkeldmjecgaoill	TRUE
hhgedkifnoppijaanljnnjkefpeio	TRUE
hndbdcaegjpmaiadeeadhcfaeanjl	TRUE
iccnehpdfoaijdbnkcipmagncfafl	TRUE
ihfaegankoclpclhlgcinjbmmfcfi	TRUE
imfmoojmjmjnekjnjhndomlbfojdn	TRUE
janlckhgimkdpafknjfhmhnlclhdj	TRUE
jfjfmhaghlkjokdkmlfifcggnijbc	TRUE
jlaeiecggljffddelcbliiejdbfhn	TRUE
jpgpeaafnhahjhckjjcbmjhjcaofe	TRUE
kejeocjhjfpdfjikpkcmcghikhdbb	TRUE
kjahmoponkmaloaeigofikodeegpd	TRUE
kobhcopkjoamgihppngpkjobdhfek	TRUE
ldjkibhnihnnedfhafjidpocemilh	TRUE
ljbfkhpgomkiaoplcfaaenkldlbae	TRUE
locdnfgbgldfilkhlenbfcgikkeah	TRUE
mdkpfljhicmehffdockjnhimkmoln	TRUE
mimmfmbkcggojgbpppkmajpalpelo	TRUE
mnnkfaagakdfnbbcbhglfdipnoakn	TRUE
ncgbiogacbcibihfpheajadmnkdkb	TRUE
nijbomdngneadppkfnjofmldhifaj	TRUE
nnlfmhelgdolfgbjilbfojhapnhij	TRUE
odbjkbhibhcdoikjocddkogbnjbgd	TRUE
oifigfnknmeofajgkgbefmkonifek	TRUE
onemjjmkcngjmkijdgnlnaiohigae	TRUE
pcdlmifjplkfjaejiponinecfjpeo	TRUE
pgjokchkkedollmddelneblmminkb	TRUE
plamaafcemjjlggbplgjfbfhfbcme	TRUE
aaacmdkbpbalabahnbbkabapmkjmb	FALSE
abamnbfcldnihckhdgnfmehpokaeo	FALSE
aboaokbohmcfchcimdocidcplaaod	FALSE
agonidecpogijchcdcdjabhhjabik	FALSE
akabablbfhikbbmoccfhcabaobbdc	FALSE
anbapjnloiolmbhbafaeabajbnfmc	FALSE
bacnodicdmcljklidkppcdmjilhbf	FALSE
bfenmakclohdplocdhjpababjbikb	FALSE
blmddoabiajhibkefjacbababilgb	FALSE
cbhhdhapdhckdcoppdomhfaboolab	FALSE
cdckdjddpcmbhcaababcogpedlcjn	FALSE
cdmcopdaeonoedmdcmdoocdedbokg	FALSE
cijdcdbofdjepnnbgpkiaabhiabga	FALSE
clnnhhdpocjldencbfahimiobabnm	FALSE
cokpinpcidcdeocdkjcdlbgklaehg	FALSE
dcdcdbbfalmibabfkocgbeejoimld	FALSE
dgkfachdipaccjdnjcmndacdcodgo	FALSE
dnjonioabmablkgdkgdkkcjpidcjd	FALSE
ecdcpdjckdhojcndjhdpjngfekknf	FALSE
eifmkababoaokbkkabencpjjkgdka	FALSE
eoigpncndmpkncdkobaiijbabenin	FALSE
fdchbdabiabimbkbcdkhlincodbac	FALSE
fipfhgnemgabmababjahbonbpmoff	FALSE
fpccphdohlcndpabhhmmiabkpcgio	FALSE
geapmegjckcdcdibohdecdcdbaigl	FALSE
gnfmjfpacjcdchkdfdaambaibemcc	FALSE
hcpeopdkdpbcdokcnhdalkjbajbjo	FALSE
hkkocdmcidcebngcnjlpocpdcldlb	FALSE
iadjlfaihjapbabcjdckdofgiglka	FALSE
ieinoiabaibammcldpocpidkpalbg	FALSE
ikiogbhkllicbihalbhahbaecdhcd	FALSE
jbodcpopdcndhbjpgnnfjcdciidok	FALSE
jhabahlbpcalphfdkddpcdcjdknpb	FALSE
jopbpeabkabgbpkblcjcdcdjikjhb	FALSE
kcnecdcdcodncipdklldmijnimlgl	FALSE
kihajhnbkabmnboklfclndmcdlghe	FALSE
kpfgnjccdipnhcoidoaahibabppjg	FALSE
lenaiboahpbainhkkbalhbilpgbem	FALSE
llcjdcdicnmabaohkbpbpchednapd	FALSE
malgneepghkiiabaobfeabppkllab	FALSE
mgegmcpcmpcmjkdcdnoababkfdnlm	FALSE
mnhbabapbcgcipkdnolcpdnbeognb	FALSE
ncbdmcdkkcdjkmaijapbkhpanhbmi	FALSE
nicdcpidimphbmapjapbiapkkikbg	FALSE
nockojdocmdecpohdlcmopdhegpnk	FALSE
oceidahkaijbokanbncccjdijcdch	FALSE
oijanacjmojldchndocodiomcdeig	FALSE
opbgfaaabaobnffncdnkcdfadpngf	FALSE
pdejklakcjbkmoaabaphbgbcmdcdh	FALSE
pjajmbpabdcplcnkdhkhckohpndic	FALSE
