aaaodpkaojfiejaggcidpmhfhkkiepd	TRUE
akgnigpbglhhlddckceafhmeblcjkkm	TRUE
beghjchgepfgfccgpihnpepjjmpkjca	TRUE
bobkjncjhmhbkdpgbmlhkjfkjbmioem	TRUE
cikfkjkcamelpojafpagfmmegmpeaok	TRUE
deifmgbhcemcfmhbjefggphlfjfeijp	TRUE
dofoglhblocakdjnooacbfehimpaccd	TRUE
ejibdikdipdijmgglcoopcnjnpkkdch	TRUE
fbnhlapefofpmodiglgadpohoocckdn	TRUE
fmlblplhlkblamonglcglikkinnihed	TRUE
gjdfeineipcjipdijidmpamjgpookpj	TRUE
hcndihghknogcmbidbcnpbokligegcf	TRUE
hlnijlegdiiadhiccajhahljeakpnnm	TRUE
igonkgjogngacgjijdhnilfonojfinc	TRUE
jafncipllenfkijjdaeoekcjjkilcea	TRUE
jklimlgmbcghfcjgohcmmobiigdeodd	TRUE
kgnbdfdlnehpcmfclifblikiigfgphd	TRUE
lbcbhiaboghbmjgheijkfmhmcgconmn	TRUE
ljfpnehlmfapmemiipihoghafkdaafl	TRUE
mdipoccbgjfkjomjcmomgpegpnbjaad	TRUE
mpopblbbologhadpcjdffmjmpikiffc	TRUE
nikffjeblmkohnghjfhbpmmalnnppln	TRUE
odcaepcnkhhbhcaalaanigkgdebkoho	TRUE
oneemkiipdjnfhbcaioalecbkllipbh	TRUE
phdjbcdlikhcplhdcjgnjkemphhfdef	TRUE
aabcjlefpblmhhabiplhlpafaolgiph	FALSE
abnojhcooojffpjfliblbpbmakhobab	FALSE
ajbpmkapadbkjapkipopbaokmdgljgf	FALSE
aobpbhablhmaipdkbhiahhdghhobghg	FALSE
bgbjgjlgbmndgaphibdejblabafkpmc	FALSE
cahbhgcekajljikkkbjlabamlbelmae	FALSE
ckhbcpibaboeglmbedckigehnhbabai	FALSE
dfcanlbpeickbjjppajbaldgnbgcmnf	FALSE
dpjilfpambmgdgklkkbajbjknkjafne	FALSE
elejjambjbpajmjbiainnpmdocconej	FALSE
fecnnmdeabfbnhaobjkabmbknfijfcm	FALSE
gabafaamlmfiimfbdnflbabklnnabeg	FALSE
glbjmfbpihdpalpnodihabmdbaobnla	FALSE
hhaldikmdfmhfgabobhoabalbkjmhka	FALSE
ibfjinmmiaobogbaklbkhjnaobhlnnc	FALSE
ioapbjnckiemmbmcjhbabmagijkilno	FALSE
jkehgahbpabajmbabfgbgddejcnanpo	FALSE
kgdaghlabdhfflogkpblldbjajbakge	FALSE
lahibgpfjhgababnmapleofckalnplk	FALSE
llfiiglgbiecgmkpajbgcfbabpabfjc	FALSE
mhnammiobopjpdbabponkmhjamimifp	FALSE
ndfamabfbahbadnbminbmfbbmpjohld	FALSE
npdabnebdfklgnenboipaobhinalffh	FALSE
olpbcppgbahgoochafabenmbmabpjad	FALSE
pfabilhgafcpaakaobfonbahbagklle	FALSE
aaaghmmjgmlboojnijnmpnhgghdmhdjc	TRUE
ajmbcgnmddpkelbeimkkcecnllcnphji	TRUE
bedhilpcpcjembhfofgikbpimdifnbni	TRUE
boamlkgmfpmppfacpgghhofgkljjfjlk	TRUE
cibnnjipmjkehlceakfhaijhggkhgbgb	TRUE
dbneniolghcjmnmnbfogjhacgbhllcgk	TRUE
dmdekbefldaoidjejllfdimdhnddenic	TRUE
efhidgmagnmofiibdihljfgkonhohlcb	TRUE
fajigamocbcalhhofijkmehihioipcfm	TRUE
fmbmafnbecmphhlcbfmiboecapdiiihn	TRUE
gfiifkhdfafkhgblaeoogcfljgclmhnn	TRUE
haahlnknkeakbjobaedhijcccacamjhl	TRUE
hjkjdfcnkdaljhkoamnfoeoamjflojke	TRUE
ieeelaloafbkjhajbfnenninceeodkfc	TRUE
iodeigmecdaaaddlkcligfloifbodlon	TRUE
jgjlflaghlojfmnjkefioanbminenjki	TRUE
kbdhhhiedddfgdjlleaahjnkjaejacfa	TRUE
kkmoabhkonfgjlbholmenmmofkndcgpp	TRUE
leaibaphejjdmbmehobkpefnoieiekam	TRUE
mbalbfamkjgefigncfindaepmjajcgjf	TRUE
mmblaegppmdfnhcpiaknokkpbdblonlj	TRUE
nikkpfhgkfdlfkiklakjpocddpgnofdj	TRUE
objhciophofihhnijkckhnnjccnjlgie	TRUE
okmcljepjimjidfnlilgphooenkdgbmm	TRUE
peolpfaadjanboikkjfimbdljaaefpej	TRUE
aaankjplianddhjblfjlaababpakmbae	FALSE
abmbolnajhhbojaoodkknlhpjncnbppk	FALSE
aipiogpbjkbhlgbaibbpkjabadmnfkpo	FALSE
anhghjdcphelabdjmlcbalmbaggofkoa	FALSE
bdjdegoakpbbaboolpaljkhkiaafmmhh	FALSE
boibfelbambbabaibahnkemfigbfondb	FALSE
cidcelljapbidpfblpabmambalmbpaio	FALSE
dcbaaibcmgephbhbagegiblplnphaban	FALSE
dmnakjkbabobpmkamkjmbalgmgcoddni	FALSE
eiopflhognghabpogigebebajlkbmagf	FALSE
fekkegbflngeedmeapomobmbalnbiian	FALSE
fpajbfpekblbgbaibnoahkboihimmohh	FALSE
gkghkkanbkgdbebpabllhlhaecednelc	FALSE
hffmnlafbfdiabkbkiabanpokeldadge	FALSE
iabkagnlmjbabokmamkkfmkehpcdlgkc	FALSE
illhblfpbomahlbdokbmlabinajnpbec	FALSE
jflomahhnbbicbopccokbahnbjajogfm	FALSE
kdicjablpgjjmanbfbabammefpjddhkn	FALSE
kpkcmoemaiinbkfjbokmmohabagiepgj	FALSE
lmfmgldmgnhglkgmeeokakbogkcbabak	FALSE
mggfnabmfnnlccljkbipabahgdgdpfee	FALSE
naoenjgoapblflfnjihbahbamdidffbb	FALSE
nocfnlhpoapobmbabmjmmmahmmgcjpcn	FALSE
okeefnbfcehoajblpcabakobipaaaglc	FALSE
pedmcgapipmpbdbceobabmadiphafopd	FALSE
aabibmogalnpmgkhfaenifocalhnefadk	TRUE
akglgcohemclfoakjbdlpnfgheiodbbje	TRUE
bganhanafmeokpfcpjofhmkiniemgegbe	TRUE
caakkpnahaeifibnjokpafkhammfhhldo	TRUE
cjddnfmpdlnbpbnahocfloedilnodbbcj	TRUE
ddgfojdanknphlojmlekkjbccaiocdoae	TRUE
dnokijpafeomeboicdlffikpdoobnaamj	TRUE
ehljigefjbamigppbnpblopfknhadkine	TRUE
fbjlidganmkingfopoibfomgklkmnlkbp	TRUE
fkiaaaafohbcojnecggifnehnjgmcglfm	TRUE
gejanhciiepieinglmnkmnjpgkhdllekk	TRUE
hbadafnbjcjfdikghppbhgedegdbkjgah	TRUE
hlkklgkojdjemcaicolecgnkchgikfjni	TRUE
igpagejfbkdblndjmnnhnedbjgbdbemap	TRUE
jbccockioflmlikkkehimogmpmfeklbde	TRUE
jjkjobfkpfnnoknbnfhfcdphnlnbafmhj	TRUE
kfcecpghmopckjalinnphbfgifhgcpadb	TRUE
kpkijooolfgnilicgbipenmoohmehppkj	TRUE
lhjpibiabginpaoiciphioaimjnfbpahj	TRUE
mcekopafhjjhpaomihnjllhcjdfjledai	TRUE
mmgmkcljmhmhkfaiefkoahhbigjnnplke	TRUE
nhhbepdifkfnbggnoapgogfbhbkbaghma	TRUE
obiggmihdihncgechpcagnllggjkaklka	TRUE
ompoakkgigagomkpfcoidgjjdnokbaije	TRUE
phegbopkdimjgpgmcfldfmchkdffoajdl	TRUE
aaabmeidfaaahnogjbabamggpaofeblaf	FALSE
abneoflhpjadblomhpabiaigeckglpfoo	FALSE
ajbnbimpaboopialjllkgjjejfnejijnb	FALSE
aobigdjegbapoboanhoamolibdfekpdci	FALSE
bgabfpelpdclflobdhfnioeblolabpagk	FALSE
bpnghlnalbaodebabajdepnakeehefldc	FALSE
ckbajbfelhjgcgcbhanibiphafkhepekl	FALSE
dfekadoahdhjabokbboaplbagendoence	FALSE
eaojmomgllkhabhcnnlbjakbhadiafgpf	FALSE
emiecokgnelofalenobpapbfigpbbabna	FALSE
ffonhdnabhcebbmniabiambhcflkfkjmj	FALSE
fpegehoakllakjpbhimiibaillboakldp	FALSE
ginadbnohmabbaobakalflaeodoepckdb	FALSE
hdahnjeelbckdoabjhdgnpbpjnkabaemh	FALSE
hpepmdmbfpiiaijabclbioadgbahbhadk	FALSE
ikplhbdghkbgakbmflnkfbaibjhiahlhl	FALSE
jgahbfnipeeihiopomdddibnabaafenna	FALSE
kbbodcaopmlbmdbmaebklajbladcopeep	FALSE
kokpofpehkabnmnelckfpdmoadbabmaob	FALSE
ljlllpjamlbfhihbmaikbpagfndfkecgg	FALSE
mfjpnknabljkiebnlabiafidodedmhmof	FALSE
nakbhlbijechfljbplajhibiloiadlakk	FALSE
nnhccfnjkngmpckbbdabbabahhbpjinhl	FALSE
oimcakjbmhicbnpkjplanbpphnanlhkag	FALSE
peankobgbakbnallelgfegflnenolmlon	FALSE
aaagkafgpphciipkgfggmmfgbllplbokjf	TRUE
ajfkfocamdeijabdjamnlfbinbfcdeelpc	TRUE
bekinaiinndcfnjoaejekbapnglpmdkgeb	TRUE
bpgcbfcamlkadblbdddhgppjjbidamofko	TRUE
ckmddcfflkjmlnjdcmbffkppcaanbfmpde	TRUE
demnclbcgjpgnhmcgklofmidbahikncmli	TRUE
eaceagmhmjnihmdmjabajpngkclkbfiilm	TRUE
ekgbofhmjbbfojgbnanjeamlncckpdcijd	TRUE
fcgbiolekedlhahaagbimfhkjmdbjjjhdh	TRUE
fnmlkiichdaialgakijjdkpmabbkdopmof	TRUE
gjbmghcgdbppkppgjeomibfacooncebhdn	TRUE
hdcigamcjjjkkhlinmopbnaenfjeblcmgo	TRUE
hnidbkfiekmmjkibbopefnomlobchpepna	TRUE
iichojhfcgiglfdopnlhkjbjoidkklkhgl	TRUE
jcbbinidnakmfammdilnpfjdllmjedlmch	TRUE
jlpnnhflbkjadnhdgdojemmcppgfpjngpe	TRUE
kggjgknhmjhfaghnpomnmbemjbdpfiloil	TRUE
lapfdlalnlfnajfdjblhplfjicgpbadocd	TRUE
llakbimidngaflgjnmfjlhpfjihhhfeonl	TRUE
mgjddkoodjedpioalbmbnoblkgleamlkco	TRUE
nbihafjdfkfdcmmknhnhghcdmkjanbgdde	TRUE
nllfnpgpjoplgdoffiafifpcbijmidgbco	TRUE
ofncoodankpmdnnhefobfophieobojofna	TRUE
omoinoopjdoicibkfldnfglciekbpgdeom	TRUE
pgkigckeaennbdhcpjjhohmpcmkbhnpdif	TRUE
aabifgfibjlknapibhiakafhcamlkipdin	FALSE
abpjoaijbalbpaadcloiiejmpmhlpobhlp	FALSE
ajkhhfjahdeabmhkemlhhibkjalbmaioml	FALSE
apbncjekjocbopajlmbmaloiiolnjhffme	FALSE
bjbabljblpiidhlnjgidbehbiaplbaphdc	FALSE
cdkdifggmilmnfnmbdcfhpabbghbjhahba	FALSE
cpabelbnooeddechgicmhkkbahbiimiagp	FALSE
djlambhhgkkibamblnkamfghbecbkmolfd	FALSE
edcojifcnbambffchbkhabapnopbdecalf	FALSE
enflkeginpaapjbbakbiangdjojjblfehk	FALSE
fihikhiabfnhnbakmbamodiahmlfkcddfa	FALSE
geagnpclioccanbbbabanggnhnilnojcjd	FALSE
gpdcebimfeabhpoaofbbplabadoleicngj	FALSE
hkdapbghkameibbalbiiokahbfmlfafpgp	FALSE
ifnganhmoibgfpohlkhobhmlabjpakgjhd	FALSE
ipkkjhinkgnngmnjonfgkjfjiahbbajbma	FALSE
jkjjgffpeocdifannaibebapbnaffnjmhh	FALSE
kgjociogllomajjobdbljjabopkadgeffe	FALSE
ldnalhbmkbaomnbahmablaenmbfpelpnpm	FALSE
lpeboeepfeabhmclpcedbabminamamjpim	FALSE
mkippngnpfakbpcmbibaepnbhbaohmboak	FALSE
neenahklbneapbopbmbabljajifflkdcbi	FALSE
nphhnajplobjgmllkepkbbaibanipanghf	FALSE
okdfdodfakmdpecdammblpdbiahbajngbk	FALSE
pfajbmigndglnbabhmpikaghgfikihkonp	FALSE
aabhmdcnlagloabbnhnjlpallgcpgdbehji	TRUE
ajhakohajpfciigomojkjblflpbbkaohnlk	TRUE
bdcibfimmbmbackebbnkjicohcljncockid	TRUE
bnfffoacmehjookmhlpbdjeaofilmjdhdan	TRUE
cjbdbgjbdkagnkcofdiekjdnjlcmhjeolfd	TRUE
dedjeemegjgdhckfcidomoeeaejhpkgeiam	TRUE
dmomcahbhmpoopapcbofpfhciblmikncjdn	TRUE
egbfbbggnklbembmgjogfbbbpkimnjkghme	TRUE
fajjjdhjljbbfliocdofnfoilbodpdhinko	TRUE
fldplfpnhcodhammmgccmnkcpgijkepobfm	TRUE
gfbnnpkblkedjbifhpaajjelkehikfgjdlj	TRUE
gpfkkjggnjnbadhafnlckickjbiibmipehf	TRUE
hkamkhmbncodblbinnhkifgcmgiiijpfjdn	TRUE
idaniipecklddbbfpekjollefopceimgflf	TRUE
inhlccjeoaijfedjnmmpoldknkfkmbggame	TRUE
jgoicjkmbjhgiplhdpaiggogcidbhgmecjb	TRUE
kcafgflldggpehmhelakmnnpjilddihgaag	TRUE
kmdapokdjklikigpekpholeicbpknkgadfc	TRUE
lfogdnnpdpajjgmmochmnoekgmaendealpo	TRUE
lppimmpgnjakoepahnpdooohcidnajobndl	TRUE
mkjenpcfagbdidglmdkmdpjjcbdpenbogfj	TRUE
nflapkdfcppeahobhdiapdkoajkcjhellaa	TRUE
nolepfgggbehognogaoilnjhcapakadcfjj	TRUE
ohpmbcjfclbgjllbfefgghblpiobmgpogkk	TRUE
pdmgalhldmkiilgjhckljfonhmagcjeigjl	TRUE
aabbanmomkbhpankeaoobhgdnnmpapbiehb	FALSE
adfeidoabmnmaibhilejccpabejcbaibadc	FALSE
akibdnbkimaijbapglfjlnbpcfbaoiamgoj	FALSE
balobablmaeebmjmahbhajmaglhekbaagif	FALSE
blkbailbbjkinjmdciafdhiknlbaipbnafd	FALSE
cgamopnilbfhglmfdcambiabjapogcekjoc	FALSE
dcaibdldcblajbkmhhaimgimafkojofhnnn	FALSE
dlnodpcmfgjiagheaobmbiebabahngolijc	FALSE
eigmbeklpabmfdbabkaafdkcebbkpkllhnb	FALSE
fdekggaibiehpocikbnigmagembabamdmif	FALSE
fnpnkaefkaabfobaombialflehjlgkmpjja	FALSE
gifchakpimhkbcoiidgdbambkamekabnbfc	FALSE
hdhbkiffmodlnabafjmjcbjpjiailbagkmi	FALSE
iakmbecadikfbabahoifleieienabfgolkd	FALSE
imbfcilapobhaibaobalbllamedjmmapobg	FALSE
jgmlhomnoaageaibokjmjhmpclhkeeboaba	FALSE
kakjbhdcpnblnanmnblaopakgncfjfjldlb	FALSE
klamhhbdbapbhoaoplojlmmemhhmnkgbkfn	FALSE
lfgbcodablpnbmfahibondhklbbhannpbae	FALSE
maemkabhnbnbmoambhabndkpmhoobokghke	FALSE
mjbdibalfdlejifojfanhpljeakjbbabadh	FALSE
ncfomkkjallbbkkdeecjiecomhliibakpba	FALSE
nnnoalbnfaejcjmoeakadlbiaboapmopepe	FALSE
ojgijmkebencnilaoiobgccehbablnaoekn	FALSE
pdhabhgefiobaobkkapfdjjjcgkmdaldiie	FALSE
aabnlelolngmdoemanpeepbmolmekccdhihg	TRUE
akfcdajajknbchmkephmkjgogknbgmlhpipk	TRUE
bcejhoiaclfkieelfbcnjjpmbjjcedoelhke	TRUE
bnhcmlpojnocnekeonbgaccdckgbiemgbgfo	TRUE
chpfaeccflfddjoekjhffdincjmggkcocoml	TRUE
dandpjjimimmfeioljgfebgcgaooblhpjbbk	TRUE
dklpgdbbdepghhdiaecgpmnceghgajjajknc	TRUE
efohkehgkfnhdoagmkneehnhhkgljkjiokfn	TRUE
fafmkabcbldjdmedlgajgbjigfpdckhjfofc	TRUE
fldnakbhhfiinlmoeelocfokephfhfngmhdk	TRUE
ggianonmbdbbhhlbnkapeghckpnffeggopdn	TRUE
hcllodhmnbejbpjkogicgnbppnffbakjnkfo	TRUE
hmnpomabgkllbganicgjpedolknkigoajill	TRUE
ijamommeekoddiheolglggappjpbfmjfidkn	TRUE
jdchamoompknljbpegoipofojllcdiplhooo	TRUE
jnlkdekiongibelbpjbkphbodlfkebfdcnjf	TRUE
khfkeikdlhpaiflojpgidccejecocdfgedml	TRUE
kpgphnoanldmmkdgbcamlelhkcohflcejmim	TRUE
likglcconlcfjfnlmokpbegpljhkkpphojke	TRUE
mbcojecbkoecnkloecnlhiiimalbahncphkl	TRUE
mlagpdncladfkbkgihoajgdngfcfdbdjemam	TRUE
ngkjjfikkiojamcadbbkdelfgakhlnancggp	TRUE
obghokjmdnmjdkdconhbkgijjachgioapfjp	TRUE
olkipjlcmpceoioabjkippifiekofmmijdik	TRUE
pgeledhklcjofghnfmbobojaicmibplkfpmj	TRUE
aaahbikbeealimedbkpmkaibkapddojiegnl	FALSE
abpckchedpfdekfigpoenjbabalknjmokinl	FALSE
albamddgknbpaohibaiionlodndijbfnakkb	FALSE
babdplchlbammbaekmlfimhopleklkhngfnb	FALSE
bliolkbdomabkigidigdnhbkfbmahbaiedbd	FALSE
cfogapbgkikbjimnppmlpokiohjjlapbkann	FALSE
dajkbfjehilibajknnpalbjmabanhgldhkph	FALSE
dndomjkgngfhmjmemekbcngbabbakimijoba	FALSE
eilfclhggpnjmaboceeflmbaoobkaecbonlo	FALSE
faonbfibnaibalponlomjlkfngmokbmmhjhe	FALSE
fliambfngpgjghcbkahhnhiblhlojagjgjmf	FALSE
ggfkpcmejbfddbcmndaijbnbdfmbgbbabloa	FALSE
hdafmiaibokhnchikbhlnlmabnnllahmfnef	FALSE
hpgplmmlejgoecdhaplbfebdbbdhabhabpab	FALSE
ikadhbmabbfpmlicgplikdjamnldhabababn	FALSE
jenpckifhmmkjicokkiffealbablabmakeen	FALSE
kagbbfnpgkhpabiojkdabmpgebmpanbakebp	FALSE
kmhfokfeekabfofhjdbodhjfcioenbabamfm	FALSE
ljammbilknbaboafmfchbkmoidfcoklicfhc	FALSE
mdghonfoegopbahkmnknjbfppjopgbabiamj	FALSE
mmkbchainbgnnlalelflfifddedbjkbhanba	FALSE
ngdahjlnbikbiamnbaakfkochonkfmngeohf	FALSE
oahboeenhhakbmpajkbkijaihhidalofgokb	FALSE
olddfhogbakabdfmgppbajbaabaiiagfjgoj	FALSE
pfcbdamblkkiccjlejleilpbmoabaljemjhe	FALSE
aabhdoalalblbnfbjodmhhbgopboljfmkhaon	TRUE
akgnppmimfejmghponpodkfnhmnnjibdddajo	TRUE
bebfeppdcahippmehodmdfpcgibifagejceae	TRUE
bnmoejhncmgjcdncaoicfhcfnaibdglblideb	TRUE
chdchcmebcbailhfaackddclepidlbjelccnb	TRUE
dbingboaecikklajocmkbodjdgicmjceahaoh	TRUE
dligdjcknecbmdfpkhnkpdahkfeialgmlekde	TRUE
egflehjmdiicbipkmojdhjjjdlnbdgflfnldb	TRUE
famllkjjdlnobnfjmjinnpinebpndclfipljc	TRUE
fmklnaijggmmbfeimffennaledhndfakeolee	TRUE
ghcpfgclfoeaidjekjpklpihnllfjkmanffho	TRUE
hakhjhklfpjdfedfnpmlnbbfienjndogpbdlj	TRUE
hmchmhamjcojgoaojboojlenedgbnelpekjob	TRUE
ifkgpcjemmmpdofmidmlgeooodgolkgjnejdd	TRUE
jajpomdekkjpojjjpjjebcpjafhhliacgbgci	TRUE
jlgapiaajfdmdohifmmkfokpideoaljmokhmk	TRUE
kfkhmcicffccaohpbafninaodafgimklkdpgg	TRUE
laedpgffohnkjpaikljhcpellegkofhlcgcpo	TRUE
ljbapffhianaahfnfdmmdmladpmocndhijlbi	TRUE
mdhjiolgdjfpkpgmkcbngiicaplhbndiaadoo	TRUE
mopkepebiiickkfcclkneajlfneakacdlelel	TRUE
nklmdfdhmmkoninbojjkajlmaiddfeoigagem	TRUE
odadaonkgdbdmbmgdohojnfpicclpeodkcdel	TRUE
omgmgfoceggodpfehmblaalmcpfioepiibcfh	TRUE
pfhffjcmenbhfpimddccopfnlggodjpmglfeg	TRUE
aaakhbdbbjbppabpiakpfhfihccejdbakeejm	FALSE
adnlghggmbkngablffblfjhbnbhnapbaeglef	FALSE
akmimhbdikipngionidnkadgnbibabajbminb	FALSE
baogbolgdjcigeabgndbnaniiobhniaekimdo	FALSE
bmknepnjcabldkfpiklkedbiambjklaidecce	FALSE
cglphemgfcidlopnnaibbphhambalfoggglam	FALSE
danbdekibhioabaamdpakmdclielgjbkkgmmm	FALSE
dmcoakblbbolmkkdpdplcmdcoemjhjbabiola	FALSE
egfpnlhjmbfgkmoneabhnchinfbiaiboadgnf	FALSE
falgfjeogikoabjpkblchbmonobapbnamhfha	FALSE
fkfgjhdpmldcedkjlccgcpbabjbbpijabagle	FALSE
ggdohpakbimbanbaolebobahhkgmlfffbeilb	FALSE
hamapkbjbnomabadfhpjbgpoeahbpkamgendb	FALSE
hliahbcdfedlebmpbihakbpangfbjibkhpcgb	FALSE
ijnbgcnkkanahbkokclgadbajbjmahhlbhngj	FALSE
jebedmannobhggfonmhlbnlncojbabiaedcjp	FALSE
kabcoemgjhfecblcbpiiakgcbonapbhjooain	FALSE
kjoofodgembikgpabngjmkchdbnabhahmklmi	FALSE
ledhfpbbdgfedhflhabaiaepfbakobafmfbfl	FALSE
mabeflheadikglfcpnkcbabpajajdcojadjgl	FALSE
mkboanfpgaalnbeaemipnmjmhmbaobhadnead	FALSE
nebaafcgpaibmmnpalkbabapghgomfkjefkeo	FALSE
npkpmdakkolbobmlabjalmngibdnjdiojdjlk	FALSE
oljlaimfpbmmeabfebpgjabpiiikabkjmamef	FALSE
pfbhedahjloibfkldcmiomekbabimaikjnejh	FALSE
aalbapkcgdpopijdgmekkdmcdnlemdmdifjaek	TRUE
alcdmkmcpcajkhljmjdpkfjiajimmlojdljkon	TRUE
bffjfgfmglhbooenholaacahfkbccjgjhojbke	TRUE
bpikghljohaaocajmacebodmdihpcnhpckhhhi	TRUE
ckbejiifeffljplfmkdglnfgcfdddabncbmldh	TRUE
demmocgjfeemepmocnbcabnjognojfkbdlncch	TRUE
eakbfocpajfddgibcjnchgjaopdoimeeehjlbf	TRUE
elcjapnlbkhcmagnmccidgachlmglnnflmfcmg	TRUE
fekhhjfkeiijblidlckpblcijnndbignbemcjl	TRUE
fodjofbfjlnekdlcenjjfaebejfdbdiepagfbf	TRUE
giidkkdgnjpmofapfdecobhhbbhkbcfbcpgbfn	TRUE
hbgppbcjhihmfcioaoadacgkfkfekgkkempkbl	TRUE
hnkjbmjckljhleddnhjpidndaiepankhkbpgnn	TRUE
ikdchmknifclhnpmpmendkmglpmbdkljnjlnbf	TRUE
jcopmnlfnnpfcimoclglahbegokpfhhobocodc	TRUE
jmmgkgdfhjhcfamnjadoeifddekgmfjiplhfnc	TRUE
kgidjkgomcokdkpgkhjkjakbdangfbeehafnbo	TRUE
kpomomkgnambkflkjobkgecibpcinaoacppgha	TRUE
ljcgepimgnkeblfdjcnficlefjkmeneodloagm	TRUE
mefiahcdcpciblnjmdefkgobgponcggnbbdgfn	TRUE
mogokfihfbpolfjfablnneefdooaokfogfmckb	TRUE
nhkgkcbbbcekdjhiekcibmagghabklbnphifon	TRUE
occehmhjcalailobnplbbdglfdfbilikgldnfk	TRUE
onfpijlhljljneohgodbebcbdknjjaopgaejmh	TRUE
pghobfgkfimgddmaojoicoeipkdhngbnempcon	TRUE
aaaoonbimfhokagbohabpahaaiojefcbkohimg	FALSE
abnobmmkolpcknifmgcmdnfplbhjkabjimmafg	FALSE
ajoabbaobanbdfeclpfeoaifhlodjikjmjbcpm	FALSE
baabofpolbaoiknbajfcmdjiimckmjggdcidbm	FALSE
bkpeajobbgemnbpfkfbohbcjefgbpmpbnomaba	FALSE
cgchaagjoghkheleldbokigffabclbmmhabala	FALSE
dammppppbaefmedpjgfgkbaollbjadnnecdkoi	FALSE
dnebmleicplddlklfhcgpabkeghjkahbaljbah	FALSE
ehhaibmnnlollbobfhajababkoailiagajpkpp	FALSE
fbbeellpooikkabhdeldfhpciajmbabkiakkai	FALSE
fnnajpfmakpbigbekohpcjpgibmiihmabhaebi	FALSE
gjehbjfhlkpbliakmakbdcmnfbaljpkbmhoadm	FALSE
hdllbeidoejjjeggbamhefhnahkbjbbmlabank	FALSE
iabioddbldcgabbkmafjbjbnennbalpnmbajen	FALSE
ikbjckeohaibeboaomkhmfeemaobkpalbaidel	FALSE
jehehoahlkefkfcpjodanbiepkihbpambjiadb	FALSE
jpfkkknalobafmhfnfcdccnncgedcbahbiabmn	FALSE
klomcgcomdpjmhnajmabhmfliooknojbllanba	FALSE
liambcdlmofgbihmhkopihahbamfchnamagicj	FALSE
mambbiajiiomaabkfpfgbphnjabmhjadgonlhn	FALSE
mlcmllnlnapkofbajbbniabkbabkakjklljhik	FALSE
neajkibbabanpbpamgkdeebmcidmdblblfnkao	FALSE
npcnfiplabndlpmkimchhihnopolinahabakba	FALSE
okabakoaobihhoemkplmncbapjbabhhcojdhpe	FALSE
pebcfabgpeknabalpbihlhkadfhobfkkljedca	FALSE
aaadjeieblfnmjnhpiohhjenfhepdeghdajopin	TRUE
akhphgnkegfoghhaepnjfkinegfhibgigiodbod	TRUE
beadhchmilekkkaepbdebgillfgjaklmehopmbf	TRUE
bnjoadjeiofljcfcpadelkmhkmpimomhfldelbp	TRUE
cijmbhdjkkmmlgihoppgpchhklbcakidbmmdghl	TRUE
dcliejdieodoglcgekdaeakimogcanocjijnnmo	TRUE
dloglglcdlolomchfencbggfphjnojlibemjoha	TRUE
efdiipkggiclpncfemlodlfekhneibfaphjmbfj	TRUE
faiegfhlhhnbnccgmjnpknomjfadefjankbckng	TRUE
fnbdfklapcglclgaejpfakbjcfnbhgfebfjddgg	TRUE
gfpgbkcoegjpjbibcineiaeahadmhiaaccombde	TRUE
hajhimcnkdkfppfekmkicdjldhngkgnlifnjpmo	TRUE
hlmcejcfhjnohgjhkbbhaggkikmdcmnpioofodb	TRUE
ifmkeooeemdfcmeenkbnjagmbhdcmgapfbifpef	TRUE
jacdljfjpaihdcpiobigkjebojfedjaeindehil	TRUE
jkibegnckgfaioaafcohmeoppofhppckehkadao	TRUE
kdeecafkjedgkhbafdjohkpmimhimpmphhfdbjc	TRUE
kobcknndkpkijcooigllfhiehcmccikapalngjk	TRUE
lhjfojbhnncomdkknodnjhihjlhjpfdkmdafgjn	TRUE
mccplcdjlnolcjlfocienjkbjogomibkngglpca	TRUE
mmjegjlopaemlojlindnknlhooobolpbeekfbip	TRUE
nhgkepenbkipjcfjpeklnaiepbmidmmcacfdehm	TRUE
obgmpicacogjhcakgdcilhanakhibdcmdbjjcba	TRUE
omgkponmoobohanoegefjndggencjodniifodff	TRUE
pgdaokebokafaaaeeegpaliaomoccmjpkinbcom	TRUE
aaaaljecjabjjceejjfaaencoajkhiiinbabooa	FALSE
aebpakkbnnmblnamobaagjijibbopocbjophhni	FALSE
aljbkccabakilbliaenandfelchgnedgmdhmmhf	FALSE
bbepjoceahblgpeofbfbppambaagpcnfmafgfdk	FALSE
bobgiaajlbgondnanbkmmallobakjfdemnnefeo	FALSE
cjopdkfgabncpjfanhkbablajlenajongpofdpe	FALSE
defaekbbabnfnpcggabmgbipkahknbafmnckfec	FALSE
doojbdhokabknlbknabamfhmldgljiaeplhjjlj	FALSE
eikddpbgghpafpjfmaiabobohjkambalhllgelc	FALSE
fciamminmbfehoedibabmjaoefchkojibljhbji	FALSE
fnabhfnmdomjicibailbmhpjlhlajkolkjdhmhl	FALSE
giflolgdkchabmbijlghohdldhedgbiabloahfk	FALSE
hgabkpffihafepjbppofefdbhhciepfegbabaoj	FALSE
ibgdiaikonnkimmipkibjfabgiebnmaibjoamjg	FALSE
ikmngkkigkbimfccghajmopbbbcbamnjbagofkg	FALSE
jdjppnahlbkphpbopkmlapnpblhnmlhilafagnb	FALSE
jpbddnoennloiihlbhbopbiknabgbhajpmbnoam	FALSE
kjoaaffkflpjhfoobijmlejbikpnfohabbaibab	FALSE
lfimallhnmnmahbakpagbabnioapgokgpllppga	FALSE
mafnnapolbnkkhjeebmaknbknahdpohjnmcmjmo	FALSE
mlcldhbdpdbjgalhoabgbbaonokilmbhaamkfbc	FALSE
necalbkcfkjfejjncimgcllbklbaobkajbkdpob	FALSE
nomdpaanbchkocbabjahidnbadbalkkpmljlgoo	FALSE
okhbmnljabkfboehogblklpklkaliokkkmbapkd	FALSE
pefojmcakbcalhnbaikbajjmmfcfeeakhhlnikh	FALSE
aaaagmcjhbcnmebfbkkifjaplfdidnlabjlmoakp	TRUE
akcffnjdedbhjininnoogbcbhfnagdckgagmjdan	TRUE
bddofnfjbnicjpciblcnncgnhpeifilnfohljfin	TRUE
bncnhegbmkhpdgabdibnpbmddojanacaahhcibni	TRUE
cjgebllpleeofelhinkocblaekbojklncpjoheeh	TRUE
deinpckopegohbbbomkcnmkflkmhlfejcagdnaln	TRUE
dodoilpemaaaodjdiaimfojcbmdmllegpbbagofe	TRUE
ekhdchoddhomihphgofphcnnmjblllnnnbdbebdm	TRUE
fdkfngnancppcdmiammoaickacepkcoeoghcfeel	TRUE
fodcnnegnklkeaafjbiihhklkihkdgkhbndokiig	TRUE
ghoiamgnbilaplddkgakggcebdapgginlodkabec	TRUE
hdbelphebgnmenbecbpomenejldbgmpbjgbdlncn	TRUE
hnfgidpknbilmcfcmodhbgbmkcaaepnmdjndcjnj	TRUE
igmccnnpknijadmlfepeceoploakenifgmnonpco	TRUE
jckhbbebpfmeekbpigacjncongmhlgfpkpcgpjbb	TRUE
jlfdoblmljnjcicheehfhidnpmfllmfadmkileno	TRUE
kgbejjdkhnnnmeohkbfdlfcmahfojipempinefaj	TRUE
kpcibnmlpbialkilbndcipolmjeicdaggbkabkhg	TRUE
ljlfmkkbpiecmhgfppaodmldddaflfdghhdnaonp	TRUE
mdbemlhddojbgdnojobofcaelnikcdjbpaafbokb	TRUE
mngmehomkpndnkgbglmmigbmdjeiffcaebnehhap	TRUE
nhhfbmhbbpoiejbhddcebjihlilmaedkogdmfgoe	TRUE
ocmdiapffndlkbhgijcfmoampdkieenkhhppmdic	TRUE
ompljpbejbmmjhlocdbbofafjgboojmlejapobnl	TRUE
pgfhmclnlipmabiggndjeadekdkgdcjgobijbloj	TRUE
aabhncpdfgdgbpnbaobaajmmdemcdhfmbpefdlod	FALSE
adcgpmbnlaiikbnkpbmiabljmaemphkmddapbnjp	FALSE
albbegngmmfocifgamgbonlalbanonieokkfdgmo	FALSE
babnjdmbahebnkaepemokndibnmaadnegfbabamj	FALSE
bipgnmcapgjblganbgpjomjbphahoblalhihhaho	FALSE
cebcnmikaiknioabkgbpfmhbkjhnjabaepnghadj	FALSE
dajmboadpagmgpjlnlbfmndndgmklpocbpahppba	FALSE
dlponllkalbafpnnkjabhmabaplaggkanhghokal	FALSE
egppcmiblggkijjgjanmpfpcabikobambabeckpf	FALSE
fbdngidaddambfhdnpjdbbaoknojlglfonbjbaba	FALSE
flhkpfbmllnkefjhkjocmmaakaibkmhldbalbiha	FALSE
ghabjhnbnahjbohadmfkbidkkbalodmngahijiof	FALSE
halfkalbfhkibijbkmamnbafjlfjepkhpaifdfga	FALSE
hndafejejabglfbnabaeppbniebgmoomflinbonj	FALSE
ihpioohhahbjbmbpkammbagojepbmafdcihhddmf	FALSE
jdipencjbgpfgnlanabeeebabkoamaioaelemomi	FALSE
jpdhmahbpjjkakbilajjmobpkakoohagonmlfmag	FALSE
kgidmjcjmhiabbabkapjpgmdfnkohipamdopbhao	FALSE
lajjiphibpmibanhhoboafheekilfklggjepfeaa	FALSE
llkoanihibdmkefplnncmjmaiphaojbnjooabiag	FALSE
mhcbcooigapnkmbbabmadlbhmdgihhdnpdkjimoa	FALSE
nbahapemablbplhbhofcbahlobapbnpocmjjahpk	FALSE
nndbjhabklemikeclhcfcbmhfcbbbnabaekbogka	FALSE
ogjmhldehjggmdamhaabnjbabamobpicdnlnpglk	FALSE
paoenpanhjnmjhmjkbhffhfhbjgceafcbalnbapi	FALSE
aaaimiabnhaiehcfdhjjgnkomcgnmikpinkmhfdie	TRUE
akcafballemiohkehfidhbmeoaodbaagoomamfdbd	TRUE
bfpggplhlfalbcgdgbjekdbfcmbdciadejbepbljc	TRUE
cblcghadfhebibfolamickccoinebkafofcihmkhg	TRUE
cogccmbmldgciongnpigmcjhjkpjgjogenmcnclnc	TRUE
dhlaghfigambhbmmcbdmhpgoenomjnllkbcfjbbck	TRUE
edananbplnpkoglaacdoikejobddkblkaamniagjg	TRUE
emedciocpcjdonbhggnallkgnkchnpnbamhophjkd	TRUE
ffjpjfeblhmmicijmhgebclnjhcgppalpiigfeeel	TRUE
gapjlflhapppmjdnjjejfooahdblbkopmodabkefb	TRUE
glhkbihgbnkmdpiighpdhofoopjdnloeglibidkol	TRUE
hgcdjfligjgiekldbodlibphlhdjnodjpcnkdlkgg	TRUE
hpcbajmbogcnpacoficnjgnhdnnfcamdipflnlhdl	TRUE
ikobekfeeekencgdjipbgbhilpfklndhgbbhioigj	TRUE
jdlploofpepgpkjiakfbfbpkccpdmjikekdhheicc	TRUE
jofdkkljggijnciloengifmcaglmcglkdjogofnkl	TRUE
kgiakfojdbggmlehfailbpjadmknielmbbicdjmpg	TRUE
lagkmpdhnfbajjiholgfhldlclnpchamidfgedcfg	TRUE
llhlmommgmjcegkfkojpphboihbinilchfnphnehb	TRUE
mfhpjomjeebipghhadnhepjppbpnbopdobefglefe	TRUE
nabghckmcpjpacehapeocccdnplalghlfgcplgaek	TRUE
njicbiohnepnakoagpbnlloacmbncgpkdeeboealb	TRUE
oengidfaiiiecbeencbobkdpfclplagghcjpkbjcd	TRUE
oocdeemgajhggjkkgkljfmmgoknffdbpdcflonjoo	TRUE
phliadhpbdgbdpmioniglncjleodokgdlhhgkfkae	TRUE
aaabdejcidaapaejfijmanodhdgjhhjbmabajkbka	FALSE
adanalnbpcnglknfabpkpclllpecafmbabaoloaan	FALSE
akgcanefmnpaabpmoijmebjllbkbjabojalmhgggp	FALSE
bcbaabbfekjeaibanjihhpbagminfmglknibcafbk	FALSE
bokhpdkpnabcegemcjodblaphbanbekkfloajbfld	FALSE
ciohfccfihebkolaebepmedkpabpbabjamgdbdgbc	FALSE
deefimmpakbfcbmaiibpadchpihjhhmkbkcldkpno	FALSE
dnjclcapboiilchghjjedndbhclbaonbabkdblmnj	FALSE
ehjkojipiahokkhboihffikembhfopdbkjiabafea	FALSE
fclnddoibcmioopaniimkaapmeaobhaabbabpmalg	FALSE
fpiahbbooabaidegmfcjmpnkogicmkcghadmngncm	FALSE
gjjedhmklhkaaofabbanknpobamaeplopfcmfmion	FALSE
hdjhhohdabjmopefkppgfahdomdblajonbaeefcan	FALSE
honleomhlekmdmgofdapbmifobaibiialiemfmbic	FALSE
ikdnkpcnnfjgflahigcncaaijibcbaboaamdllopj	FALSE
jcofpopofdbapdeiheapbnoiebhanbagonelcedjl	FALSE
jnmhiipanhlmhbmjfncppcbaoibamhjfpgjodmhka	FALSE
klifanniblahbabahapnlkjpnghijpbehafgdiccd	FALSE
lfbgmijafkhddgapbmdgejdjihbaboadpooplnced	FALSE
maalbnbambajhbbhofbkcpkhppndmgdjihmfhjpop	FALSE
mjncidnabklfckkhkcmbadcgjkkpbabiamdpgdjlp	FALSE
nghcaanbcooeoomnhcdibahbjabfemhmhpfghdajl	FALSE
oaecimgfaflikmahibjekbbjanlbjhafppdnojakf	FALSE
oldmfhhanmiabcfmbaboinnahffklednnbgjbmifk	FALSE
pecjgkljomjjnfbapbejhocnjfpmjdlbababodlol	FALSE
aacflpkffejbogejdohlkhenbgfkeojbnnioggiphe	TRUE
akadgmibnhgopppfamjbggjbcclnlmpfllopaheoia	TRUE
bdhdcobkciiojgkpegjdbnffnhljdefapnbndegfoj	TRUE
boikggalgbmcnoglbjblefianjpnbgdhgdiffebcpc	TRUE
cifkbinlapojiagcicfilfddlbmmhkephghffnalia	TRUE
ddmpeocmhnknpfgfamfokmlehapdllmmldlhoebdem	TRUE
dphldeccidnfbiacedngeolbekhlkgdplmmfmimafj	TRUE
eillifabmejaioedldainlbdelmaokbclicekaalcm	TRUE
fclfhmjfnpfgihkfdobablekfgnmejhplhipdcfajh	TRUE
fljfpamakdponidpojeilcmodjmkbfhppglmiopecp	TRUE
geppeapnheeleildlfkkfomdgjaiomillbmggpcidn	TRUE
gojkhfjibadogckoebklcmidkiemcpmhjojlnoanjc	TRUE
hjoajdkgoijebbamoaiohkjchlenbhoahaeodopgdi	TRUE
ielmadfkfalmhihfolfllkcdjpehkdeibcfekjpgpm	TRUE
ioaamijjmhhjaljmphbnbdhpolgchipoiokoegngkj	TRUE
jiffanjpebadcmlgcjfhcdcfmllooaipekikchbonf	TRUE
kdjfcdpjkgnhojfnkipceiikihkljojaaoaahfpapo	TRUE
kopnjgljidppeecneocghgdcabdgfehhiancploega	TRUE
ljginfnpklkmlbkilelpcphbbkbfkjppmknnnlldfe	TRUE
menibneieengpekblmkffkpjndoagddbennlnhhcmn	TRUE
mpbmkidomjhcjkblljmlmgmbolckeppbalefjalmlk	TRUE
nhmkjfaobfpknndfecfgcegammdcjpdbncfldpbgeh	TRUE
obhbcdhlnkfgfacjebokaihhkcegcopjljndlhfbab	TRUE
omcpgandmmfeiialngaklmckfdncedojplmkndnonm	TRUE
pggocnlmnbeobaafnokaoakdkpihbmfgpmfnedplpm	TRUE
aaanpbhjieleojjgdekcjdfkfochbabpaogigdikmp	FALSE
afgjmfdkeilngndabmhdhhamfhcbooabafknfakbdg	FALSE
anikmmhlbpgpldgfkladdlbckndigbabamddgledbg	FALSE
bfiiodjbompaggonabpdbjfllbhjajbphpafblmknk	FALSE
cakdiklaoipakalbmjlleienngeloeamhebjnaipba	FALSE
cldjfabmeicnhbmabahkanojfjcfieenphkiihhncc	FALSE
dgeanplanpamgedkniabnkjbamoboknapjnmppdndd	FALSE
ebaiibhplidajnhjfiojiglbbkabamgdnheckbnkmg	FALSE
enidalmkpipkgapbjmpiajhlanbmjahopokmipbjaa	FALSE
fianajmphpbabjkmcmiohkfgheefkpclbpabanbbdg	FALSE
gblfkbcpabboiambialmnmnfbfahhagnglpphdgjhe	FALSE
gmdmhlkfabllmckigplmolbjmbjioaibaoliakbohp	FALSE
hgdahehhaaabhpchjabcibpeailpeajlebamlmbamb	FALSE
ianpbnhhgofonbkalbadnimomifgpkdjbcdgebbcdg	FALSE
ijokbmhojambdopfpioebiljaokkihobmhapmfpfie	FALSE
jepedjmmecjoiialhkbhefflelblakiijmbaaapbpk	FALSE
jpgjkdccahoahbkiinaidlocnkknbabapgeeigfdej	FALSE
kkjbjefdakpfmpgfgabpagbnlempnhkbmakbklhnap	FALSE
lffljpkabpljpedpamhfhjenjclcnbfbnajbalkaga	FALSE
maboaijlfedjofhebobakbpljmaonkmepgjpjfeggl	FALSE
mlmobaoibmadflbolglidlkpblbiabjajbngkjkfoe	FALSE
nfmkpijecpffimcehcabpepkbhpbmapmbhmhjaeiah	FALSE
npmjcejbiigainbhblfflcaombbmjnipllobabamej	FALSE
okodonallkbblccdecmjmjbiadbljaboadchchplie	FALSE
pfllpaklbplkiaoefamagjlnbfcmlbmammhbampbej	FALSE
aacenmickjiepnliohjdechpppfgkehhodfohdgbegh	TRUE
aklicgmgnagipnhhloemhpdhboccmgeoceinafngnkm	TRUE
bflodebhbhpaeobklhpagdfcelamnlhjdigofepfmha	TRUE
cafhpmampopcfhphhinahgkonidmahgbpimkejmdbof	TRUE
clgenjnahdcokmfomkddcmadfjaednfaofemdanjloj	TRUE
deoodpjhbalkcnepdiedjfeecicfgmahhmjomnpbbpe	TRUE
doafgmjdbnpbfkobcjnbmjepogbjbampnhhbndncblf	TRUE
ejbhdcjjelhfoifjiaknlipcflhkkaalddaefppckjh	TRUE
fdbjclmakaejloppgdlkbanmmncahjdhackfcnbocdi	TRUE
fndmaghjenfcpcejaoflnamahdfdgdkoadellijdolg	TRUE
ghpdapdofcibefemldbliahkkajelnelhnhpbboklck	TRUE
heiakefjcoapbidlljbikpfcnfcbihanmipcljencln	TRUE
iaahbgeicfbfmldcijfhkgdickllmbdmionpglnfjmb	TRUE
ijbdiccfflicocpbenpomdgbaccofanakcjbnnafbjm	TRUE
jcdnldhoeldjikheciekajeppgbihbadepfocfjpbdk	TRUE
jnccogbbdkjabfbbiffbpcomonkfooebjalckbkdljh	TRUE
kiallbfcghomkmlihmemekgbcnompdbahljpbdnjeol	TRUE
lalfgbjlbakbgndmfccjnohcnmnkalblgnpoajjckjf	TRUE
llbfgadgmbenlgkpgajjiloniochnplbbcclfoekaag	TRUE
meacclcaelinanbjnlapefeflkdfapbmoncdehigedg	TRUE
mokflfmddlaiifaneialfldfpglpnmmfikcokjfikei	TRUE
nicboedccfnmcjohmihjejdjcboddcekciedhbakefe	TRUE
obhgebiaggabnknoefhmagocmehnoekpbnpcbfklbfo	TRUE
oklnglgkmpafeldophfgafppahlcgpdlkobifnbpogc	TRUE
pghepmknebdjcjglhkimdnkbgnhbjoiicimfnbnmlpf	TRUE
aabbabanhhpmoaalgahjenmiffjgldgobjnlmfoekpg	FALSE
agfiaabpldhlfgjinmfigkibhpbanlbankpnkbljmcp	FALSE
anbcbhkionahjnboiaolgpbicjgfmaglbilkdnbnjjc	FALSE
bedabkmefobahjbahhhagghdjjlncanaodldkdckebf	FALSE
bppbjnahdbhejccmoeambeobamibjhaoehoohgkfmel	FALSE
cjobjhhjhbfefblplbibabmcjkmboabniahaaeamifn	FALSE
dgkciffndahibpbobkdbkkendajahlhkhbabagamnpj	FALSE
eaofpkbbegajobninpbanbaajeodaggdobpnhpkcgpa	FALSE
eoloejpeabljhoenhhibbkhanhnbadmflakfgdglama	FALSE
fkaknemabgakfpcbcekliejhbapohbpalhbfaiaofpl	FALSE
gfelablmofkkdlbabpagahelolnnlbedbfbbhkfifga	FALSE
haobddejnlejnbabpamglgdabommikckomnimnjebip	FALSE
hnbjnicopifnagojlkiaodaijbknchhomdbaboliapp	FALSE
ihbabijmnffnkbbhdmejpneecbpbhabhaadedgilfbo	FALSE
jajbjijbeehblnlannbjabpmfcdhooblohkmggjinjm	FALSE
jjkfbabbaibaglkjmheajhahfipfanbjddbpgdchhcc	FALSE
kdhjdocnifcfpkaibpimbpajhnjibadlfcnoonehpnk	FALSE
knddanlojkppobnlggnhegkbbabadfpnghnceohjipi	FALSE
lhccllhnnfmfiebkbaampbiklndbabhaidnkbdedjce	FALSE
mbgdfmfjanjlbmgakijdnniahaoakabjjaibmkamdnf	FALSE
mnjobcikbdfflfahbdjhifbpabnkaahfcefbamnibkh	FALSE
nhejebdilkiihlieaajhefiabbkimakboammdnoljfm	FALSE
oaoddbjfiadbooicmbdcopamfabmjbanbkagkghigem	FALSE
okbnkdolpbjhfmgabdleifpbalbljpjakfhdalgcjnc	FALSE
pdelbmefkpoifabgjblokakkkhhbjkjpiapbllmjgff	FALSE
aadoffkpbikjpblgldmiecjdapmbojakhhglgjpgdfmf	TRUE
akidpcaihcbbmpanigdbkchjokbemojfeakjeiebeahl	TRUE
becegnefagfcdmingdoegpgalmbjhkaekhnkdiafodoj	TRUE
boooifbabmkogidhgfiapdimhhlpbcocgklljmppiblp	TRUE
chffmghepnennappkekdkkdknlmjjkidoannonelljdi	TRUE
dbpdgopbdhmdgmfdfjkkhbchkkacimeibcleklhmimdh	TRUE
dnaoglkadljiebmfobnbnheelogffoejpiaibjkmafaa	TRUE
eibojlpjghhkcildmghgnkcdnejndlgplihlklbinokb	TRUE
fclehgihhbicklcenionkeknnnijhaapbalcfchlmklk	TRUE
fmdegihbldeghfkfflbjncoihaegfgbijkdiaoplnpgk	TRUE
giegbaddhpiakjdibbhjkgmfcokhmfhdaigbpjjiaeol	TRUE
hfhkcleoikcobbmalkhdlnpalkgkkkffkbjhfihekdjg	TRUE
ibapkmakmjilijmneddfalobidgmajamgiiakcnlpnkl	TRUE
iknlidnakbflilbmnghndbddpnelabbogfapppjonlio	TRUE
jdejhchiajephhbdbfdcjhjkjldbbmialadmeebkpkpk	TRUE
jpeodpbgmomnaidfdogjfeodaieppgaegldfbfbgkman	TRUE
kkaeniiancnnbgofbdjmklgbfdjmfihmgcipabbdjpol	TRUE
ldajkonlpecpfjgcpebcnmnnakhpfmgnllefadgfecee	TRUE
lmolohdhgefkoobonfjcgicmbchpjnppaccgoenilbnm	TRUE
mgboejaiokppeiejdibbnlgngnmagbgdbjoglcommdel	TRUE
mpoefmknfnjmmfofplfembpgjndilkghflpcdlednnpb	TRUE
nhphbkelofgoagbkgjammfnbgipdhdmjpdlkbnjppodf	TRUE
obobdeklmdlahlkaplnmdhcbcckekofdhmhcpcdnamba	TRUE
onbbnjkinhfhkkimcmphahpnglnaccnninghamdghdmk	TRUE
picjjfbobcgmeoaffcjneobobdbbdnklpkdcicgfohlf	TRUE
aababgfemdnnlfiagdljfdjhinpllcbbnhkabooabdhc	FALSE
agdfakbkbnniajkbaapfnpnnghhnlcmdmobiamaihefj	FALSE
ampgfpabkfbjaablalppjbiolaifhocdjhpbbeebeicm	FALSE
bdmifnhkonjoabpobeblgobabmamdmogjpnkcnhaabpf	FALSE
bmoenepdfabjcjabjhokbaopibanejnofpkfjcajidpm	FALSE
ciaakbmgoappdbabkmaifmejgghjkdjaodfmhfmbknjn	FALSE
dbadpdclanbmkojgnkababamdckjhedaeckieblbpapo	FALSE
dmddofjpankpbkdngcpihaglnlpjpdpfjebpjkjhnaba	FALSE
eieopegbiicglleealohbfhhhjlegjpjbibkblapbadb	FALSE
fcdicplkdhlkjaaaiomkjnjlhiapbepnibnjjamkbhao	FALSE
focfdkejokamblopgakbiknmjaljmlljjbajjinphnej	FALSE
gikabhhimmgkbagbbgpkchjmdcnblgklajinibaohboa	FALSE
hcegngebflmakjajbbboiapbklhjaecigklapemmanin	FALSE
hogekienjabjpfphekbakmhbamnppakbljijffjlddbd	FALSE
iiabhlhbkiaogikipefipbpoamboiahofbalfihgnigj	FALSE
jdpledadablpneeokenkehfgdbchcafbcjapbooabiah	FALSE
jocleabnhijbkiabaiehiaohpmhibmlccfheiekojbdp	FALSE
kjbggmknfgonlkdaibefinkoejealalblkgpcbmabadb	FALSE
lemdekhjmfigofbbiabmkfnkblpikamiboagcijbeccg	FALSE
lpgmodnbajkabbmepeaohkaifbleokdlmbnnloaboaem	FALSE
mkddjcjemmanbofocjpiljdebbaijldpbnajbooadool	FALSE
necapibmfddcloddoodgnddnbebamibjagdafojfejdm	FALSE
npffabnioiopfipajhgcccibaobbmhalkbklkohmjhao	FALSE
ojpnlafkmmdbdfnlpejfbgjlefheaablabkiallbaheb	FALSE
pdonmgfabkleaggbfpilabbnaibhkagfaemobnlmkbfc	FALSE
aaeodmojbinniedhefahfdkjginmooldicineeahicmgi	TRUE
akififloojbhkbblcdegghkeocephafhhkkpncbekkeen	TRUE
bgdccmanjpbkphlmpkngmkiilapdkjmelefdepkaogice	TRUE
bpnofbjjhjenipplknljlmfibpcjfodmlffcdlfjcieoc	TRUE
ckmmglckmbkimcplaoeioflnhfgkeagmcedjdmigoppgc	TRUE
dgdmgncalallikcoaocafhmpmlchkhggikdalgpjieeap	TRUE
dpldcdbbcjfnilpjgfmkknlinanmomkjffnpfjlejmpml	TRUE
ekhedanjlenenehockblbaigeebpaddhaijnbppffggml	TRUE
fecpclcjifgblngcbacjefjknmoddeggifaabngpppbia	TRUE
fnocjjnoigcoifjipmafikecbpppbfohgnnnfkjaoihhi	TRUE
ghogglepabealdbmoeehnpgjebgkdljdgmoobihpcncbb	TRUE
hcideopfemaonlcpbcogicmhcjbanpafjlhcjggkhlbon	TRUE
hlopedlieloaifpdkppkicjpanjafgaogolfbedhaledo	TRUE
ifgkjenfpgmfglbniehkacadchjakkddjcheccigkcjnj	TRUE
ipjgeaocpgmpgjcpkeboplgcbfpgclilboecobbnlbfoh	TRUE
jhlgjhhgclkkndajkikgicnfeeajonjdkiicccaanlinc	TRUE
kchhhhomdlaejhcpmgdcejijlbkpmcgpbjoanllbkmpkb	TRUE
kmmdbpcfdlfkndgpdbeiobalkolekaliblbeojdnbmiff	TRUE
lhimcpighelepjfjaoldaahpaganeennplahppkaamgpc	TRUE
mcjmohoadjafhleoolpjhpfiimjcpkhnhpgmbbcgknjmk	TRUE
mnadlcbonlhjhkpfndnfgfffekhojdaabhkabamfhinpa	TRUE
nibkifnlmkhppicnfpnmiffkipfklbmhhiicchkgjinml	TRUE
oaojkbgajbfdgilnckmilmcbdffkhjgnnjfimjbgmocfh	TRUE
omngljmhgeggpigmbkndcnggfhnapednhemnfdgofekgg	TRUE
phfjmfmlmelalddfofkfkkkiacjocbhaieogbmlcongin	TRUE
aabcdippgmkepfjjedkjdadaeamhemigbjanhbiikanaa	FALSE
agenafaehppbeahbllmnnpbcbabjihogahbabambklkfn	FALSE
anabnfeafpoafempdicindealkijoebabjnmamldehoha	FALSE
bgbdgmmablgfijbnfdaeimlncbakjnnbnoahjajafichg	FALSE
bphkapaopbfanoeoejbpkkcbabanahdglenbnpnpjdmcd	FALSE
cjjaiecambicdchbhegmipjaemdlmojcnbniabahphnmi	FALSE
ddggmccdmglbmahhijjkbbhpnbmnakobpmaddkifmefol	FALSE
doedifblamiljbhlmpnbhlakjihlbiajnlijafgkjbjbl	FALSE
egmhhnbabdadblppenfdffbankbkjljppoadanddmkgjk	FALSE
fbbiboaoihbajbpamnkbadanfhkgkfimophmchfgglbgk	FALSE
fmlfjhehidopefnjlkmbcfpohkakbbpkapbkkajphdomh	FALSE
ghgcollgfkbhggmaboiogeaeaokbmbabalpobffkfoenj	FALSE
hcmohebglahabjgppiiedbincbijokkabaihbpimjfiep	FALSE
hphkopkmhankjfbjabpbmlmkbnmpmhoajbpmalbicillp	FALSE
ikaeikfhjcgdgpfiabaoglklgipcfibkoanbmagejajpm	FALSE
jdgabnkegdpbhbihabjangndkpofkkpdgpgdhfdaghmbd	FALSE
jmapnmblejgpbclebammbjhjlhanfnpeoflpjdebockke	FALSE
kinhopedboanbademlhbapnojbnamheafgedbdboehnoo	FALSE
lgclhpoajejnanmobbabamkmjghmjekebdhhkadpandhh	FALSE
malnjbgpgeobjaphmhkobimafimmkapheimafdbcifiha	FALSE
mjjogojjoempepbglplnbccimjcbbabbgbakjimbjiaah	FALSE
nfbepapbaohimnlakefoicnjoobmlabangmefnnfoedob	FALSE
npcplimdbabffffebmbjmlnhahblijafbpimkjocnieen	FALSE
okhlpjiaolfgpppmlanibabindobahibajnbamleehdbf	FALSE
pdnghbaagnbagcjlimjabbnjabanecmbbeoapladbblaj	FALSE
aabfchcflaceddlhengaccokpecegghhjhmkdjamhjlclp	TRUE
akhmgmlbomgihobepfffdnidmhhdnlafbofgjolebnjbda	TRUE
bcoolejapnakmkeheaehnndmmcjocdhnjchocpabcgcmib	TRUE
bmppdkaodgmmahbjeodmoofkmpppgfacmgdfbnpjmlciok	TRUE
cgpafabaoaadekafghmdfhjeppdniglkafjjgbkonaelfg	TRUE
dcbdhfaimdpfhlabhpebglmdaipmpdlcelninjhpmcpbfe	TRUE
dmbcnmdbkdpiadeemcipdnpalacbaihncibkpbdbndmdjm	TRUE
efielblcaahdfdbkoiekddbjikmkdccmaoeeobhnanidkj	TRUE
fbckcmhbiplfkafeiklhfckcgdjlocpedmmihnnmeakklh	TRUE
fkibldgbchcdpandbjmmjplobmkhfphfpbbccgbeiakcbg	TRUE
gedcmihnnoicckidjofmlogjkeiphcabidgdfhdjagnmnf	TRUE
gpacaibgghblnjnfjpdddamnkipnmhgelikbonoojbfkia	TRUE
hjmipnnjnbcfmjgbhjiaapgdgahmgpcjmdiklffmipkpni	TRUE
idjghfnijjmgopnhnchbclhjbmblkmlncgeahnhfhiaike	TRUE
iodkemlkiogagfldicionnpjgkmlhihfjofnikjbdmbjcm	TRUE
jgpdockdmjhglcahldkadnjmagkokpidnioefkocfbkfpg	TRUE
kclhmfdbgdjjabbpknlihkikdchfjcghihepmpicogfjdh	TRUE
kmgjdpolgnmpdkibcmpcjekhciiacafeihljeddfjfgffg	TRUE
lgehkmagdhhibgbhhegpbmfmphbejaegcgfhnecjdkbele	TRUE
lphkgapgmbfhchmjdpmphjhjgglgjcikgomclibahnaalj	TRUE
mjibmgofcgbccmfajengeipmcimfhhhopmjbkodobjcidg	TRUE
ndmbjiakbiichhmmeipilikidppipjdjhoodcpmgjneipk	TRUE
oaopeclmnhhojjadnejloiggelpikbdenpcnjgmpcgjdpi	TRUE
olmjgjlgmgnlhlaamkldhjffckhglcheainoenefhpjbmd	TRUE
pffbechagbfgjpiiegkojlgmlalnmjfjmabfdabhjmdegd	TRUE
aabbgpddmhghbbjjamjjngkeobopbaibaobfiadmlllcdk	FALSE
agpbmikaabffhmlbjejdaildgjjbljmjndncbabknaddkp	FALSE
amnhbpbkjcinnpbgjicfpileaemjfbakopmbcbooabaalb	FALSE
bgfmabdnmiimipejlimggegpnkbloannjpoblajdpnkhad	FALSE
caobkmomngjldbgnlflhndnkjbhdgkbojhnbbkkjkabaah	FALSE
cllialiniabkbdndeimbnehggeidcnelbakhmbkiabdohj	FALSE
dfhmahnbcmlgjgahkengmlbnabaoojngneobhfpebdjaeb	FALSE
eadmajkhbjfifibabpoajlikkiifiidakjbodcikdalepc	FALSE
ejeambpjkbabnmadaoohlifocnfhcfkonjodgcggmpkhln	FALSE
febbghhmaaknkkhbnkakdmlnepboajbpaamhpgjagfkdbc	FALSE
gabaehjflfakfhifibogccgbjnapjjkbanifogjmppohci	FALSE
gkhmeophibnpbfhmphamabbhiikphahjbakhnbhndkbbdh	FALSE
hfmhecjhbiciedabahnbncimbpdjgigbgobajibaigfpgl	FALSE
hpknanppjnbeaiepmbigdoeoinppbkhljjabhadppkofla	FALSE
ijmdggmcbpianbfagmdjaboianjhbhpipafeoeeikchhbo	FALSE
jfjdpigapbblmcldbpnhabadcpeccbmkldohfmfmifnjcf	FALSE
joncmapnnbpmbnaobmnaalgbifddllgpiffebhcfjfcbfk	FALSE
khigabonebklokhiabnaokeglopffhhdenbcbcnjpgmjgk	FALSE
ldbojcpccmemfeamlingailmbmehmobabanbccjlpbojcj	FALSE
locohihicgnfgejmcabapdolcibabiagoeijgdeploolnf	FALSE
minmlmcbjaabmbheehjepekmbiakjjbamlbjmpjlccncld	FALSE
ncdgooafdicimojfbjajabcbnkaibkhanmfphboajggbaj	FALSE
nngeckkhgbkhaaalokbpjfldnfncebhmanblmjoagenpgo	FALSE
oighkkcmiolljfablpellgknaaiapafkhffjbpabakmfnd	FALSE
pdhioakjhibhagkceohmpoffekhcafpnaageebajkobabh	FALSE
aaajjcedbfepcdphamlgcmgcdcacclnaiaaobhbijploafj	TRUE
ajegieiclhpjepgegfdllbgkaelilbonfljbplppmdhnadm	TRUE
bdnaoocpedddljhpbghplpkhdbhemeaanpmkblcdfmnbjni	TRUE
bnjhgjlhhnloocldghofhhkeikmcapldbjnedilhhpoeojf	TRUE
chlamcfndoeheiicdjneknilimojopblfnkkcnjaclebbng	TRUE
dbcngbllaplggdoofjjcjgdcoefflinccbbcadncbblffac	TRUE
dkegpmfcleelhniogdppjemnmnnkkfjniiibflifbekebpf	TRUE
eemhjfmmklighggkjcngbipgebkjclopfanhbnpeabcecji	TRUE
eocajkbafpmbkddnboaekhkmibjgpbmhommhidklagoccfh	TRUE
fjfjfkcpojnpbdclgfpalbffkmkmpgblpmcjdimojegpdjd	TRUE
gbncgidfgbchiifaggcgghekobegnjejapomknnbnpehhic	TRUE
gkelfnmpamijialkdhageicnlipcdimhilkbbddngeeljjj	TRUE
heodjnaaccckncobinhepjaklmnhobkbandmnineemmkkim	TRUE
hpehkpcdpinblngmmjndjopcnfakdkcepfmfoghpbahmhga	TRUE
ikgklnfdmgheonokmpgelinnfippljklbfkjanabhccdhdl	TRUE
jegcnaoihahaildlnlpofiondefdpmkgjfdpaijknlidcai	TRUE
jpgnofclbfmkbkachjjdjalkfbocaolkbnalbkhbbaoonjn	TRUE
klkehboeohipcbojdcedgdfoleifibionjjikjfjnmgefme	TRUE
lgkkaanfpopndlabppodamleiboffgbcahgkpkhmkcidppj	TRUE
mbhhfapodhodipiacimjolakmllkghhhgeimednkpffchdf	TRUE
mmphhidokebefakmdgmhnnmfnbkjmgoffheihdnbnnofohk	TRUE
nhklhjbikjediopnaloellnphbbhnneockoicienbckjnao	TRUE
ocbgjjeeahenlghfbajjildlojnkfjgnlcpnkhncalpelje	TRUE
onimcbhmmfmlaklgngmocibabmgebcoennelifcemdfackl	TRUE
pgomckdfffnenhpdonnmeoefmjmbpcfkcmecbchmjbidlea	TRUE
aaaikakaibefebblkpdcmhnplcfknjcbahkinjpjnbaepbb	FALSE
aeoihaloampblljdlfcmfhbaanjbcpjchbjpabhaaafghnp	FALSE
akoikaiapjjbgphgeblnamjlpobonlmjokaggophbhnlklj	FALSE
babjicmhckbabaanfohbndngcakibflfbknojbofekadgnj	FALSE
bmdcfajhbignnfepmcmpphdhiddnlgfokcbmjbmakkbabpk	FALSE
chnpcddckjlhjhdnialbbphodhaibabpkapdpjnhelbedbp	FALSE
demccddjamibmbjlibpdcgbjajbimakhhhbinkdnobenfpc	FALSE
doolnfklmhocmhhbanhbdcdcopgegomooobmijpmobpkaba	FALSE
ekbppigcocedaikbgjndpgcchbffeoalpebalbafkdapabm	FALSE
ffabbjnmlakljhnbanhkmnffjnalaphogonochkbgcjhndp	FALSE
fpafaepbcbooidfaabbpabaeonhigjpcbpkegjebpgbbcfo	FALSE
gjabhbmanpmbiafhngnadgmpapphjmbjlndjmbipminpono	FALSE
hcmhbpoabnibbanbkabopgabepbkjklpdinegaoagmkmfoc	FALSE
hoccijhdeogdeagebflbalbocfebmfilnahmhabhajlbhla	FALSE
ijcdhdajbhpnbipjegkgfkidkbjkadpfibaobnaekfogjao	FALSE
jcdgjoojoabldceoomjpnfdpjmbalgeoafnbmakhbmamhai	FALSE
joehaikheiclnilbakbbgfedlmchpkobmlajplbpakgldod	FALSE
klabgmmepgogbdbolpghfnadfhfedcpakbabaidjoajijdl	FALSE
ldehnelafpnidncgoefgbailjokkbgpbapkbkbhiabalhpf	FALSE
lpndoabbpogihcffepmjboahbagogpejpeicdfkjbaakmhe	FALSE
mliljlhiabababopadhellaegbjmekhpmhenbjkbfhbhlmm	FALSE
nfmjpgcddbpdammojjflgfopoabhmeehfbabaehipbpccla	FALSE
obedejeopakbobgbakbankbcjlngijifagolhfhdolnepop	FALSE
omnmkdhfpbajgdblbjaogbidmahabdnnhpkociebpaobmma	FALSE
pgnjkanbdepoldgedlgjlkfekielhaaeenhdfbbaoplkpba	FALSE
aaaijaaggmbakfpjhlfdkhclendfkldhlimfgamgomejkahg	TRUE
ajcbefncnnapifmpcilkibmjapocbdpoedgefidhdpfhcbna	TRUE
bdbaojamehlekcakjcpifaddmljaojapmpcafmmkhimckphg	TRUE
bocpnplhpkhfbkmbplfignkejmgpollelfbflehdfjcfogik	TRUE
chnbamkkjopdjfadmagjbhdngbipgmdkhnmbopcddopekhkb	TRUE
ddangbhppfaocdohljfdiclbhcdjmigbdibddeffnecigmnp	TRUE
dmkldlofnjnhcifhmnickojhicbmlclhgonlaenkkjccllag	TRUE
ehjhhekopogglpdkmnefdbioceejgmdhcicmjnmbgpjabkai	TRUE
fdlandmceijnaaokkcipmhpdkgdaeepijokiebghnkgoebog	TRUE
folnmljlomeahamlekockodolcdlkbloejpbcplhbeeloenj	TRUE
gicjeeelbpldejadanbdmbmjfjkcpkkgogapljmdkgjmnlio	TRUE
hbkijcliljacpclnehaopehjeohchhhgbbjanonkjokphknf	TRUE
hlllclhhkbhbelhnnkleihhbdadnpnagndogjohlnpaigkbp	TRUE
ihbehabnpjpkhfnlnjamcjpgadjcjomcoaffkaefnnglgekp	TRUE
jbmdgcndeliieebkamhmglmnhfjpklojickokboeecioepen	TRUE
jlhnifdolajfjipidjibcligbhhingadnhcnfgdmkgmmcpil	TRUE
kefjgcmokegljondljanbfonmdbgiblnplhmdjfpnnnblioh	TRUE
kolecdgnhcgknikmlifpehbfhmmcpalmjchpfnkjpncgghnn	TRUE
ljjpepcdabcjihjdcbgefmcpblljccedbhfkecafdnelpedh	TRUE
mgfldkmbdnmahkdbbkjgpcmihaliekdjlhdhcamnmhfdkhjp	TRUE
nafdnaakpdbjkecpmnpipceilfcmhnhhahpgphlgphofkgdk	TRUE
njpopaaiohblnbacfgniganpjhjelconcmgfobnhjlagoihg	TRUE
ocljgnidodgmiabppichjmmhfpcfnjjipllhffiaaghohjgk	TRUE
omagibejkdiicehgigkhahmkppplohfnfclabjcggaejfmap	TRUE
pfmdglblnchlnecanffbddnhnebeeggdiflcaemkpbcpokla	TRUE
aaaobclmpcfndpddecfmbjbhaibpmpagbgagljjlmokekidm	FALSE
ahbandpcbmabmmiladkeagndioegnlbfiehenjohgcchcfcn	FALSE
anjlbmdmjmpneadpdpgaodblllhnanibhlakjigdgfppaldg	FALSE
benkmhplmkofeabhkodedkdnbalobpapfniclgodfifgdjip	FALSE
boghpmpflapbgfokcdlneghoojmgifgibahbalhpnloaofck	FALSE
cildnkpgajibfgijcfiegfboabalondhpbnandgjoodcffoi	FALSE
ddbbgngbllnabhhigcoaficcmhbkcbolinpiambpnloadcij	FALSE
dnlfkecchabkfppmoplffgkpbbnbkclabajaimbabjhhoafd	FALSE
ehmagfkaliblcadngplcbnpbohiakpbanaiefhecjpnoihbp	FALSE
fdencdfohaankplbbpkjnkjoabkamglmaapoghpmdgapemoi	FALSE
gabfhhdafgdoghbhbllaiikbkokaifapkmlghmlmcpphiiib	FALSE
gknlabbdnbfncmbipbopabaihbdkjbbgpgpjgekbhgnmppii	FALSE
hgaolakfbabcibkdgobajjbljabjjheecljkfbnjhojabbco	FALSE
iabgagemkdhbloobncjmfbabapfcdcghegfappoojhdpjaom	FALSE
iljbcknefhllaibenboggmnnjleibabaggbjoenfbccnccpo	FALSE
jhifedhnhagheehkedbpgflajplljhbiijbpkklijapbiiaf	FALSE
kcpdlfdgabampomdjdlcifkgpfhakfbdkibknllhnkabadne	FALSE
kmkmencmnmbjablcikaioknbambannngkmnnindjjpfdnnof	FALSE
lfpldhkljafabgeggocjdebmgjdpffgjbfobjbianbahlhdg	FALSE
mbbjmleabbamkiboamjeinpoabceiniaigecaoddadjibdfn	FALSE
mkeegfpidaabphnemnpdkaojihglobbjajlbadgpbnehenfh	FALSE
nepabobnipjecablkoajmdflcklbaboianlblmfhgfdialop	FALSE
npmheckjkmhjjglabmbpnnofmkjoakhimbpnjjahboabbjmj	FALSE
okhlgpofbaabnbmgebbanpbalnohdffidneiapbffhfoihgg	FALSE
pehblahlhhblibdchpgmnfjcldphblkaohkbmailhpjgdfdk	FALSE
aaakgcgcbimlkjfddadebacbapmacdijdpbkefglhebfbfhfp	TRUE
alkhkgldidjennmmcceecnmckhbohlgaiaifjndgacbgcbljp	TRUE
bemdihnjkbiciienimpbmfinoggbnghapajiccjahlmoneina	TRUE
bpbldjjfmdiclliidjfelkmojgnndhjdfklmgfddhebehbefm	TRUE
ckcacgiekplbfafcbbbaimpdepckhbpnmcljagcjeiloaimda	TRUE
deinpiejcblmaalhifdfkonekpiegemabfipmijgbogkjaach	TRUE
dphnppbbbakaaonnmhhdphancjikdhihjgndmbmibeabpkcjj	TRUE
eiolkjokjgbllhinpojabcebaogkddpopejeigalomknmnbel	TRUE
fbkgokekjcidellfdbffdhjmiojkhkmekcoaeeablinejonlb	TRUE
fkdlfegoojlacgkmoonheaabjkkaahbaclhgpnpkhkejjgnpc	TRUE
ggbeohfcdlfgncadbekecibfjaggoklnhakajdjjmhnkhdkib	TRUE
hajhjpblilanifmieeplldkjadipjphmnjcfhdjpaghigaopd	TRUE
hlehiebccimgdabepfajedgmgpecpkipbopcagffpjjhgcjkl	TRUE
ifkcbdahdkmffpjelkchjhbgbgnnckihckgpbgabelpeepjkf	TRUE
jcjlappjlbahoeghclhhnnibecejcobcegdekmjhfiloifkkc	TRUE
jmmblaloiflldmjpkdaepkglpkiomfpoobjleikgphnbjhjjf	TRUE
kihbdmcccpemphbafloeoppfmbkbbcejnbekghdcedbfkmmna	TRUE
lcfjmbafkhfcijddkaknknieaogdljalhkakmpjafnchjiajn	TRUE
lmckpolgjhihbipmegcbjhadplocjlijlaochfckaefjkfdjp	TRUE
mgafcgcpckjnfjabmgadkbiinjboeacpmbifmpcninlgeoiaj	TRUE
mpolflnikdjblhgpaeakgilhmljaekaaemdkahkojjojndbkk	TRUE
njbmajbcaognokbkelbicjdlppdpgphhkofemldolpijpallb	TRUE
ocieamgidhhanleadmhefmnbjhllkacbjmhgkcfjjmchhpmcg	TRUE
ompikfflmkneidneccohmacnflgdemkbeblmlbmomelghmjib	TRUE
pgkpljiiielhkhaoifffdhhhfnhbeljknidphjcohlipheipd	TRUE
aaamlepannbfppmhnbgmokajdnlbkabagliampepgiipdmgjj	FALSE
agomaohbccpmefcgkpcpciiifldahdfalfekocgembnbniaba	FALSE
aobiefjmkhpafkljebcfofkkcoljnlcinjnkmaebnabablleb	FALSE
bipjffgjkmnkmpefpmapoeaabcbabadjopgkiiifgdjehbhgb	FALSE
cepbpabimpdnoeabnikjdjgafcgpdbonafiokljbdhboaibaf	FALSE
dabdmnbmlebdhdlcebbnanbnabnplefnfigbponbdgpdlpfmn	FALSE
dldhmdajbpmndgedncboabaokhecioefadjfcjbnddgejbcmf	FALSE
edlbmopnnfmbmifgiefiabhijndgmbkklmehbabakofhheeha	FALSE
fabfjjcnljdmffenomlngdkfnonflkielafebknmmakojbagc	FALSE
fjlblaaobinbabaakinaaflcmchehigmpjecdfpcjaebanoil	FALSE
gdollabdkajomjkpomegdklmpofobigibigcbakmbpjadbboh	FALSE
gmldjfmpllhabchknhhoiijhkbamphionbhabpjcdonopejba	FALSE
hhghngojbekmplgglcohigbgjahbmihfcmjnnipigpgbaboao	FALSE
ibdgajbhdkejbbpabpbbphaobamkghjgdnhcjoeadjimoadde	FALSE
imehfoaehoalmbmmljgblpicapecpcbabladbhjppmfjnklbp	FALSE
jgpbdlgnfajgopodijpbjbibgclalalbjkbahkpbplpladeln	FALSE
kbbheabmidamdgglbhninkdkcjegjidhbecibabipmanjihdc	FALSE
klhneknhkhjnoknikmdalpbmnhhehmjfjofjobjajnlbaonhp	FALSE
lecbabimoaeibamppbhkjkajgbgnaemoofpimhiigohdmmnjc	FALSE
lpjcanhbcpmphcbolhgpobbggegidlmbbmkajbiaheogopgpc	FALSE
mlampibhjmgleanfljcafcgnegghokpbaoiblabjnelnbobjp	FALSE
nghiadjmpnldfbpgckicipifidjafcodmikjfggabdebhmaba	FALSE
obddnaabobhkjbambdglgfleapkipbabaedkgagodgejokcce	FALSE
olkaohbbhbekepabehaakkbajbhnhalpnfkcpjcjjmbkijhad	FALSE
pfhoaplbboeblplmjffcejlddbheibephcbkonabmiagdcmie	FALSE
aaccegieledkipipdcmchgepjamdbndnkcbgjibpoebadcpmec	TRUE
akkjjbodlfenbpiokgmpbbnmlfaiopamhahgmhanciaiidcmfc	TRUE
bhdglnmdenpbjfnglmmdkmbacdlgliolomnobpekhhobhjlelk	TRUE
cbihgeaihghcflobcbbdekekgcgkekjiipgkgkfmjkhobmhnnk	TRUE
clfabnfakakppnokbbnpooejlmeapaipmiblbhaffjkgfpdjlk	TRUE
deeiicfhdnpefjpohdjjpfecgmilchddagfhkddkbfekcanagm	TRUE
dnennpfcdallblkkafmlglkkhfgnnbokkdhjjhookphmeaefik	TRUE
ehfooeppdlafllgdjhboafbaahnkfbifbcolpdadhjppkachhn	TRUE
fbeeibmbllfdlnachecbnkcmicocehhlonnnhddmgegdflnfhb	TRUE
flekpdfdibdjgihcnchpoknpfmgpianippmemagpbhcpgelfep	TRUE
gfdlbohdigkncaonggpcmlbnpabkdfijklkgfmiolokmoklicb	TRUE
goifppcaliabifalcbnmlaeoleammialhpcicikpbhmglifgnh	TRUE
hifofhbpachlaknmoacphcamhfggikeohbjgfkfpcfilbemecj	TRUE
iddhnanhammlakocbgeknplegknghnkhemcjfgiboejklimmhb	TRUE
iohnndcfdamomfelopbjbjafbnegombigaliecdjpcmfmmhgdo	TRUE
jiiklmbblpaifnmkhgiekpdokcjflbigijgmpgaifcghjdooaj	TRUE
kdaifmgbpenemgkmjoifbfmmngapabjoifdijachekcllobjgg	TRUE
knldolokgcnbmhjchmjnbjdhdeppmjepbdgmjnmiklnklmlmjl	TRUE
lhdhcmeeaedinfjnpheijjmmkndakolepimikapofnoebjfdhi	TRUE
majjobkpbifdnacblldhhmbhlnkedcbamedjffnhbdkoafocmb	TRUE
mlidnjinfmehacdgkaneaofaonoogkedmadojdkombonfgacbn	TRUE
nghlgodmepimgolkmbljeoaejlmokdmibmdncgddbilhlkkbmg	TRUE
oagjoehccbcndlbpaemdcbpogcbdfklkigpoahiagjijfpkopp	TRUE
olkbgckbioeehbcakpdaenhliinhddeijnnhjlaheiljpmabla	TRUE
pfgpcfeddbkfmmpnkalbfdnaikjbjoeapeegggilacnnieghgj	TRUE
aaafhjalnkggbaehlabbnkihojhhgligdnbamboaaennlfhmae	FALSE
afipfhknglfocmdmhakbfhbaibjajbocengpkmgfcddicjplic	FALSE
amaanojloabdfmnlhdenpiplchfkckcgebmmambhapbmjiclhk	FALSE
bdnnifdeoafhngcjoabnnleobpnklahiblkoihaepailieiagb	FALSE
bncnemehmpliaoihbfojngiebhabaalhdhdgiiefnkjohiokmo	FALSE
chjbfbjjkojaiojkgddldejfhahlbjglfnfgheeecfjbnabpao	FALSE
dckmgpnehlnfmbhejdbflbaahbmpinmkilbopgnbpabaddbigg	FALSE
dnegfolofepbaoaednmdkaboeblabmaijhfodccmmcgpdajain	FALSE
ejclfbpdmakaeikfabdpffokbcheandnbdbaoboapdiogmbgpe	FALSE
fefphilmgammpkjohnmlobepojkjggejocaggffablkjhbabaa	FALSE
gabdamnlbhjfcliopkdkmnailggbpdmbognehhhalbbablaggi	FALSE
glddibgpnoaphamklniolljbifobeoidafaodmfocenibmiaba	FALSE
hgiiblgknmnbeddnfmegehngabbpghpkobmnmofjocoibabiak	FALSE
iadcakbllikahjkifjjeebaijbmalaehhjpomcdkhfjmgiomfh	FALSE
iklmbhppobokepmgedghbdakibkbaoiblahbepoagonknobemb	FALSE
jfcbnloinabepplgjfjdhpgfabihlelidcendokcionilbmaba	FALSE
jombkhikehibabamgpgjhjpbekfdigdlpiimkibjmoaboamhne	FALSE
kigocabmcjongahhfpfkefdikmamgdcgmalbkabkojapioeccc	FALSE
lcaipieadolnmilkpaokpikbopppabkmnbajblhanecpdphbcg	FALSE
lociejcndamkkbdaajmahndnfbgijhghookjhdamjnhdbabapb	FALSE
milcghekdfnfpcmhpanhkbfljehdmlmnjegfippboabadnknhp	FALSE
negihjabbbeemabjmnmlmabhadknbhgccnnognelfadcpdnimg	FALSE
oaibjiglknjlhonhmpijhebhlhmoabnakaokgaappannleildf	FALSE
olpammjbbicmdpekigmfkonbakjonbaepnkhnfnnnlpniihmfn	FALSE
pgaoljhohbgkigaioekpeglhngboioihfadnbabjnaofokolhl	FALSE
