aajajacecbilibjbobpn	TRUE
aahaamfhikhhgbblmbhi	TRUE
aiiaannkkkipggpbbopb	TRUE
aaaihfkbdikbnibjphkb	TRUE
aaanigmlbhmblpilbmib	TRUE
aaadahfiaadcbbkbnipl	TRUE
aaiaifhojehidkhcbbpb	TRUE
aakhajamkapbkmnimblb	TRUE
aamlambphbmjnpmolboi	TRUE
aaphakigiongagnbhbjb	TRUE
ahmmlhhakaiaablbklbp	TRUE
aiaaljpemoidllbihlbb	TRUE
aipnmjapajkahblbihmb	TRUE
akpaalmgiinfmcenbbmb	TRUE
akmaagnmgledmcbbhppb	TRUE
almamaonlebikgmbbhbm	TRUE
amhjalajdeebpphobhbp	TRUE
anaaacalgooffghkbhbb	TRUE
anolpoljpanahdbbmjbo	TRUE
aolaamgkdlccbhbmjmmb	TRUE
apajmandimjabimjbhjb	TRUE
akjkaomoaoemffndbbbl	TRUE
anaijkaellkflcejbnbb	TRUE
haaonahggminhlobnbbk	TRUE
hiaaaeondakabjbbboop	TRUE
hnjopaaafkeplpabbjbi	TRUE
iaahabbnffmlbpljhjbb	TRUE
iahaabckglieogbbkbnl	TRUE
imajmjaanbipbmmkoohb	TRUE
jaammabhppijfcbbhbpn	TRUE
jhjalkhioihakhahobbb	TRUE
jmaaaemadbfdaidbnbbj	TRUE
kaaalfahafoandlbobbh	TRUE
khaaolniaodibbnkoblh	TRUE
knmjhpoaaanobmbbkmpk	TRUE
laaijpomajfbpbioojib	TRUE
lajilojojoanafjdpbbb	TRUE
lmkalaolojkoanbbjnob	TRUE
maahilalkdnmpboiopbb	TRUE
mahmphailakhfbbnbhpl	TRUE
mlmaaanalbinhabkklbb	TRUE
naaanbdiinalnhledbbb	TRUE
nhaakpangneffjkblbbi	TRUE
nmalaahkjkglochbhbmb	TRUE
oaaoacffjkajiaclbbib	TRUE
oanlolaapkngbbopbjin	TRUE
oklaajnohadphdbbmbno	TRUE
ppaaaccmmgcnbbkbpbik	TRUE
palahampambbpnjbobjh	TRUE
pkahpoaafepfmobblhkb	TRUE
baajajacecbilibjbobpn	FALSE
faahaamfhikhhgbblmbhi	FALSE
afiiaannkkkipggpbbopb	FALSE
aaaihfkbdikbnibjphkba	FALSE
aaanigmlbhmblpilbgib	FALSE
aaadahfiaadcbbkgbnipl	FALSE
aaiaifhojehidkhcbbpab	FALSE
aakhajamkapbkmnidblb	FALSE
aamlkmbphbmjnpmolboi	FALSE
aaphpkigiongagnbhbjb	FALSE
ahemmlhhakaiaablbklbp	FALSE
aiaaljpemoidllbialbb	FALSE
aicnmjapajkahblbihmb	FALSE
adpaalmgiinfmcenbbmb	FALSE
akmaagnmgledmcbphppb	FALSE
algamaonlebikgmbbhbm	FALSE
amhjalajdeebppdhobhbp	FALSE
anaaacalgooffghkbheb	FALSE
anolpoljpandahdbbmjbo	FALSE
aolaamgkdlccjhbmjmmb	FALSE
apejmandimjabimjbhjb	FALSE
bkjkaomoaoemffndbbbl	FALSE
lnaijkaellkflcejbnbb	FALSE
haaonahggminhloonbbk	FALSE
hiaaaeondakabjbbbodp	FALSE
hnjopaaafkeplpabbdjbi	FALSE
iaahjbbnffmlbpljhjbb	FALSE
iehaabckglieogbbkbnl	FALSE
imajmjaanbipbmmdoohb	FALSE
jaammabhppijfcbhbpn	FALSE
jhjgalkhioihakhahobbb	FALSE
jmaaaemadbfdaidbnbba	FALSE
kaafalfahafoandlbobbh	FALSE
khaaolnibaodibbnkoblh	FALSE
knmjhpoaaanobmbbkapk	FALSE
laaijpomajfbfpbioojib	FALSE
lkjilojojoanafjdpbbb	FALSE
lmkalaolcojkoanbbjnob	FALSE
maahildlkdnmpboiopbb	FALSE
macmphailakhfbbnbhpl	FALSE
mlmaaanalbinhajkklbb	FALSE
naaanbdiinalnhledcbb	FALSE
nhdaakpangneffjkblbbi	FALSE
nmalaahkjkglochbhbdmb	FALSE
ocaaoacffjkajiaclbbib	FALSE
oanlolafpkngbbopbjin	FALSE
oklaajnohadphdbdbmbno	FALSE
fpaaaccmmgcnbbkbpbik	FALSE
palgahampambbpnjbobjh	FALSE
pkahpoaafepfmobblfkb	FALSE
aaajofkfkgbjbnhkhpbjo	TRUE
aaiackilmfpkfdebkmobb	TRUE
aaadjdlhonnlpbbbolill	TRUE
aaajoapnhpnkgbbhblpin	TRUE
aaacmigiaaobmigiobbbl	TRUE
aaamgjdlbdcogmbilbhpb	TRUE
aajkalhmgcpgombkmhbbk	TRUE
aalacoeljbobbknnlimlp	TRUE
aankkhlabmifkepelbbkb	TRUE
aaplkamkooonihbjbjbil	TRUE
ahapajbppjhjabkdobbhb	TRUE
ahnoiaabdojngbhjimjbb	TRUE
aiojaadajfpimibhhbhbk	TRUE
ajmljaoagdodjcbphbkbp	TRUE
akjikaafhfbmonbnmlnbb	TRUE
alhahiahehbblnlpkkhbk	TRUE
amahmhafmlikaloipgbbb	TRUE
amphapoabjelbipbokhlb	TRUE
annanaejjgjejoandbobb	TRUE
aomhapagagmbachmbkbbh	TRUE
apkaabhpiceecocfbbbib	TRUE
aaikaopojpbkmmmlbbibj	TRUE
hoaaadalioepbjkjhbjob	TRUE
hammpapoabmolnmbojhbk	TRUE
hjilaamladdmndpgkbkbb	TRUE
hpjojmaaaookimjdbpmbb	TRUE
iaapmhaikchhkgcabbbkh	TRUE
iioaaoacgnmcbmfpkbbbl	TRUE
iohjlokaainaibbgcbnbb	TRUE
jaampjpailcbmlbpopbkm	TRUE
jhhaajiabgbjophbnhhjb	TRUE
jnhaaalgjdpbkplhibpbj	TRUE
kaaaokjehieejefnbhpbb	TRUE
kappokahagejnijpibbbk	TRUE
kmannpapjaamdobmbbmmj	TRUE
laaaibdkomejfbbopbnmi	TRUE
laoaiamgmddbbibkppnpk	TRUE
lmaaajgcokkbbbllkljjh	TRUE
maahaffnpcbojpbbjohmm	TRUE
mhanaapcbijamfibhlbkb	TRUE
mmaompaapekpkjnmbibbi	TRUE
naaahicejbbeboinhpbob	TRUE
napnpaaonbofgghfobhbb	TRUE
nlnaaijhadnakbakbipbb	TRUE
oaaaoglpnbngbbhbpjhoh	TRUE
oapaaochnlojkjbmjiobb	TRUE
okjmnaaabchkbmjpbphbk	TRUE
opnnianjanpabgdbbbhbp	TRUE
pamamijphapnbkjlpboob	TRUE
plaajiialkonlbfbbmimb	TRUE
baaajofkfkgbjbnhkhpbjo	FALSE
faaiackilmfpkfdebkmobb	FALSE
afaadjdlhonnlpbbbolill	FALSE
aaajoapnhpnkgbbhbdpin	FALSE
aaacmigiaaobmigiobbal	FALSE
aanmgjdlbdcogmbilbhpb	FALSE
aackalhmgcpgombkmhbbk	FALSE
aalacoeljbobbcknnlimlp	FALSE
aankkhlabmifkepelbfkb	FALSE
aaplkeamkooonihbjbjbil	FALSE
ahdapajbppjhjabkdobbhb	FALSE
ahnoiaabdojngbhjigmjbb	FALSE
aiojcadajfpimibhhbhbk	FALSE
ajmljaopgdodjcbphbkbp	FALSE
akjikaofhfbmonbnmlnbb	FALSE
alhahiahehjblnlpkkhbk	FALSE
amahmhafmlikaloipgkbb	FALSE
amphapoabjelbipbokahlb	FALSE
annanpejjgjejoandbobb	FALSE
aomhapngagmbachmbkbbh	FALSE
apkaabhpiceecocfbdbib	FALSE
gaikaopojpbkmmmlbbibj	FALSE
boaaadalioepbjkjhbjob	FALSE
hammpapbabmolnmbojhbk	FALSE
hjilaabladdmndpgkbkbb	FALSE
hpjojmaaaookimjdbpmbk	FALSE
iaapmhaikchhkgcabnbkh	FALSE
iioaaoacgnmcbmfpkjbbl	FALSE
iohjlofkaainaibbgcbnbb	FALSE
jaampepailcbmlbpopbkm	FALSE
jhhabajiabgbjophbnhhjb	FALSE
jnbhaaalgjdpbkplhibpbj	FALSE
kaaaokjehieejefnbhdbb	FALSE
kappokahagejnijpibbkk	FALSE
kmandnpapjaamdobmbbmmj	FALSE
laaaibdkomejfnbopbnmi	FALSE
laoaiamgmddbbibkppnpck	FALSE
lmaaajgcokkgbbllkljjh	FALSE
maahfffnpcbojpbbjohmm	FALSE
mdanaapcbijamfibhlbkb	FALSE
mmlompaapekpkjnmbibbi	FALSE
naaahicejbbebcinhpbob	FALSE
napnpaaonbofgghfobhhb	FALSE
nlnagaijhadnakbakbipbb	FALSE
oaaaoglpnbngbbhbpgjhoh	FALSE
oapaaochnlojkjbmjiob	FALSE
okjmnaaabchkbajpbphbk	FALSE
opgnianjanpabgdbbbhbp	FALSE
pamamijphapnbkjlpbcob	FALSE
plaajiiflkonlbfbbmimb	FALSE
aaakdeichmffhnboinbbnp	TRUE
apaknmanlkhpnehibbblnj	TRUE
aaafecpecmmjmeblompbbl	TRUE
aaajjcnmifilkiokbocbbb	TRUE
aaapemncnoobbohhmhlkbn	TRUE
aaadfieimjjfambkbmbknl	TRUE
aajamgkmbbfkojbjnmibbl	TRUE
aalnoihmnpkojnabbibiip	TRUE
aaoahalfkcoanjimbhphbb	TRUE
aahmanlddhdbbhmknobjbm	TRUE
ahlaopoanejpcmbopibkbi	TRUE
aiajpiiiafhcfdfdjanbbb	TRUE
ajamhlmnabaiemabkombib	TRUE
akaabgnnbfnbhmaiibhbbm	TRUE
alaahpgefijpbnibbpihih	TRUE
alpahnajnbdmlcjebhboib	TRUE
amoaniknjnimaoioabbbmo	TRUE
anjanianhbdcgbjbbjhnip	TRUE
aoaoagmieipdebbinbijhp	TRUE
apaaolhclnebkmmpbnmbkm	TRUE
appkapmnhpnambniojbbnj	TRUE
amnjakagogbpooimojokbb	TRUE
hahoaplaiccamfbphihnbb	TRUE
hiajakjjkakamkbibjhblb	TRUE
hnmmkahioakmhajjbbnhhb	TRUE
iaahjakhogpbbkibjnjkkl	TRUE
ihajijjhaafbiabiblbmkp	TRUE
imiaaaebldhkdmbbhbinbb	TRUE
jaaancajhefbojpbobkkkl	TRUE
jaolohanppacjkajfdbbnb	TRUE
jlhnlakaiafoflcfkbkbhb	TRUE
kjjiiapnnaapjaogolbbbl	TRUE
kalamjjijadgpbponijnbb	TRUE
kjhaaahmkkbbjbjomhpnil	TRUE
konialainnabekobpjlbbb	TRUE
lahahokomapfbkaiobbbjj	TRUE
liimaaappfdldmnjminbbb	TRUE
loaaafeoanfnomlnpmebbb	TRUE
maamjpiahckifphlflbbbj	TRUE
manahafnncingbfmfhcbbb	TRUE
mloniaoakaomkmhebnlbbp	TRUE
naaamcbkhjocnmnbpobbnk	TRUE
naaiahlcejnkolefbhbimb	TRUE
nlhaajafcbeiefdbmbonpb	TRUE
oahaapgbmdkbbpbkjhhomk	TRUE
oamakaokninmbbobbnjjhi	TRUE
okalohaacgplkgpidbbbnn	TRUE
pamlnaijmaomjabbmojnbn	TRUE
paknolajnanmnjmdabblbk	TRUE
pkkmimananadhbbnmoipib	TRUE
baaakdeichmffhnboinbbnp	FALSE
fapaknmanlkhpnehibbblnj	FALSE
agaafecpecmmjmeblompbbl	FALSE
aaajjcnmifilkiokboclbb	FALSE
aaapemncnoobboghmhlkbn	FALSE
aamdfieimjjfambkbmbknl	FALSE
aajamgkmbbfkojbjnmiobl	FALSE
aalnoidhmnpkojnabbibiip	FALSE
aaoahalfkcoanjimbdhphbb	FALSE
aihmanlddhdbbhmknobjbm	FALSE
ahlagopoanejpcmbopibkbi	FALSE
aiojpiiiafhcfdfdjanbbb	FALSE
ajamhlmnabaiemabkombic	FALSE
akaabgnnbfnbhmaiibhebbm	FALSE
alahpgefijpbnibbpihih	FALSE
alpahnajnbdmlcjebhbofb	FALSE
amoaniknjnimaoioabbmo	FALSE
andanianhbdcgbjbbjhnip	FALSE
aojoagmieipdebbinbijhp	FALSE
apaeolhclnebkmmpbnmbkm	FALSE
appkapmnhpnambniojbbenj	FALSE
kmnjakagogbpooimojokbb	FALSE
hahoaplaiccamfbphihnbcb	FALSE
hiajakjjkakamkbibjahblb	FALSE
hnmmkdahioakmhajjbbnhhb	FALSE
iaahjakhogpbbkipjnjkkl	FALSE
ihajijjhaafbialiblbmkp	FALSE
imcaaaebldhkdmbbhbinbb	FALSE
jaaancajhefbojpbobkkklg	FALSE
jaolohdnppacjkajfdbbnb	FALSE
jlhnlakaiafoflcfkbkbhab	FALSE
djjiiapnnaapjaogolbbbl	FALSE
kalamjgijadgpbponijnbb	FALSE
kjhkaahmkkbbjbjomhpnil	FALSE
konialadinnabekobpjlbbb	FALSE
lahahokomapfbkaiobbfjj	FALSE
liimaaappfdldmnjminbbgb	FALSE
loaacafeoanfnomlnpmebbb	FALSE
maamjpibhckifphlflbbbj	FALSE
mnnahafnncingbfmfhcbbb	FALSE
mloniaoakaomkmhebnllbp	FALSE
naaamcbkhjocnmnjpobbnk	FALSE
njaiahlcejnkolefbhbimb	FALSE
nlhaajnfcbeiefdbmbonpb	FALSE
ofahaapgbmdkbbpbkjhhomk	FALSE
oamakaokninmbbobbnjjchi	FALSE
okalohaacgplkgpidbbbnen	FALSE
damlnaijmaomjabbmojnbn	FALSE
paknolajndanmnjmdabblbk	FALSE
pkkmimananadhbpnmoipib	FALSE
aapamnialjmjhnebjljobbn	TRUE
ioaaknaaabnnmbhebgbhkbb	TRUE
aaokkploniamgmpnbkioobb	TRUE
aaakmekfjnmoabjinkbhhhb	TRUE
aaadchinkcdejnimhbpjbbm	TRUE
aahjamckbjmidbhkmbpbljm	TRUE
aakadcoebmpbhbipopjmnpm	TRUE
aalpiakkjcaogaoobilkbkb	TRUE
aaohhamjcfpnpgplbbpbmhj	TRUE
aakjamdbcolnbbpmoipkkjb	TRUE
ahnajjpkkaemjbadcblobob	TRUE
ailahaahhaheheiheplbbnb	TRUE
ajimalnhhaaapameoikbbib	TRUE
akhhhaanofheegbbpbophol	TRUE
alapakgjbhmabjpphbnlhkb	TRUE
amaafdglgmblimbmlbkkkpk	TRUE
amokaaiooecbmmcfbbhoibb	TRUE
ankamnkjaacchgkabbibklb	TRUE
aoapapfhcljmnbhblbbiiik	TRUE
apajpafkghjdddoobjlbppb	TRUE
appknaaaeclcopdhbbbnili	TRUE
akplnakpagfccaolmobbbbm	TRUE
hpjanamaicpakdcmnbmpobb	TRUE
halkahaaeoipgdbkkjblhbk	TRUE
hknahoaponilapoakbjbbbk	TRUE
iaaaomanoacnfmhfoblmbhb	TRUE
ialakimpknaehfblkloblhb	TRUE
iknalaianbldafagalbbmbi	TRUE
jamanilmaohoahfcljbmbbh	TRUE
janaaoofcmhbbneklbbbmhk	TRUE
jkjiamjmkaomadccklpbbhb	TRUE
jpioljojnhamaaliodbklbb	TRUE
kailalalabdloecjgfabbbj	TRUE
khpopmammaagobidbhjjbbj	TRUE
klnahaadampbkbngjkhdbbb	TRUE
laaaembfebgciflkhbbhhpb	TRUE
lapalianolfmndjbbhbpjmk	TRUE
lmhaajafdppibhbkbhnlmok	TRUE
maalahnljhppmfifpbbbljo	TRUE
maiaijabkeoidipbkbmnhkb	TRUE
mlkkakaoillolnaiibibbmi	TRUE
niamijmhomaaabfcbmibibb	TRUE
nanlaoajoajkdkbjpmonbob	TRUE
nknlkoioakjaadblibnbkhp	TRUE
oaknaagkcfdiihdibokbmbn	TRUE
oalaahgmjdipfbjhamkcbbb	TRUE
okhpaaoaeoiembhjmnlpbhb	TRUE
oiaaabamkmhkdfibjkbpbbp	TRUE
panmmaabblpealikenpbpbb	TRUE
pkalaanndamaibkjlbbippj	TRUE
baapamnialjmjhnebjljobbn	FALSE
fioaaknaaabnnmbhebgbhkbb	FALSE
agaokkploniamgmpnbkioobb	FALSE
aaakmekfjnmoaajinkbhhhb	FALSE
aaadchinkcdejnimhbpjbom	FALSE
aahjamckbjmidbhkabpbljm	FALSE
aakfadcoebmpbhbipopjmnpm	FALSE
aalpiakkjcaogaoobidlkbkb	FALSE
aaohhamjcfpnpgplbbpkmhj	FALSE
ankjamdbcolnbbpmoipkkjb	FALSE
ahnajjpkkeaemjbadcblobob	FALSE
ailahaahhaheheiheplkbnb	FALSE
ajimalnhhaaapameoikbbin	FALSE
akhhhaanofheegbgpbophol	FALSE
alapakgjbhmabjephbnlhkb	FALSE
amaafdglgmblimbmalbkkkpk	FALSE
amokagiooecbmmcfbbhoibb	FALSE
ankamnkjaacchgkabbibklfb	FALSE
aoapapfhcljmnbhblbbiidik	FALSE
apajpafkghjdddoobjlbppdb	FALSE
appknaaaeclcopdhbibnili	FALSE
hkplnakpagfccaolmobbbbm	FALSE
hepjanamaicpakdcmnbmpobb	FALSE
halkahaaeoipgdbgkjblhbk	FALSE
hcnahoaponilapoakbjbbbk	FALSE
baaaomanoacnfmhfoblmbhb	FALSE
ialbkimpknaehfblkloblhb	FALSE
iknalaijnbldafagalbbmbi	FALSE
jeamanilmaohoahfcljbmbbh	FALSE
janaaoofcmhbbneklkbbmhk	FALSE
jkjiamjmkdomadccklpbbhb	FALSE
jpioljojnhamaoliodbklbb	FALSE
kailalfalabdloecjgfabbbj	FALSE
khpopmamfaagobidbhjjbbj	FALSE
klnahapdampbkbngjkhdbbb	FALSE
laaaembfebgciflkhbbhhpi	FALSE
lapalianolfmndjbehbpjmk	FALSE
lmhaajafdppibhbkbhnlmeok	FALSE
maalahnljhppmfifpbhbljo	FALSE
madaijabkeoidipbkbmnhkb	FALSE
mlkkakcoillolnaiibibbmi	FALSE
neiamijmhomaaabfcbmibibb	FALSE
nanlaoajoajkdkbjpmoniob	FALSE
nknlkoioakejaadblibnbkhp	FALSE
eaknaagkcfdiihdibokbmbn	FALSE
oalaehgmjdipfbjhamkcbbb	FALSE
okhpaaoaeoiembhjgmnlpbhb	FALSE
odaaabamkmhkdfibjkbpbbp	FALSE
panmmlabblpealikenpbpbb	FALSE
pkaldanndamaibkjlbbippj	FALSE
aaapemlabodanbhopbkhbilp	TRUE
aannaaeohjfcchgjcibkllbb	TRUE
ainaafipicicnnnebjgkabbb	TRUE
aaajlcfhdmjolkigboblpjbo	TRUE
aaapbhiklebnblinlbkmpjpm	TRUE
aaacnkablkplgkhipebmbbni	TRUE
aajaiicdlkgmjbcbbohnbkml	TRUE
aamafaomepeblggogbnhbjib	TRUE
aaoipmmaigkcckihcjmeibbb	TRUE
aaoabimnicepbcbopjkmlbkb	TRUE
ahkapkadjcknebbkpjmmbjkh	TRUE
aiikikaadolhlecchebjbbmk	TRUE
ajajihjaeklfgdbbinonbnnb	TRUE
aknaihnhnppahhnobkkbjmjb	TRUE
aknaaabenflpacpkldfoebbb	TRUE
alljapakjnbfpohaajanbibb	TRUE
amjaiaeejmmbmokhbophbllp	TRUE
anjmkapafeiikogkgjmjbbbk	TRUE
aoihamamhgjnopehbnonhmbb	TRUE
apamjojjkaiegcebklbllboo	TRUE
aalninmnmhokaleilbbjnbhn	TRUE
anaamcpmeomlfghcngbbbhlb	TRUE
hahijjpaakmeealoibbbhimi	TRUE
hioklokhaanpaccbjbjohhob	TRUE
hnaaaofnekgahckbeahebmbb	TRUE
iaaklpakbkbdackjdoabbbli	TRUE
ihaiahaodhejljhoknhbkbkb	TRUE
inaapoaelhcdlmnmcplegbbb	TRUE
jaaikapkhidmhnnomabbkjbj	TRUE
japlkanambhbegpekbkbbinh	TRUE
jlkakaaeohmgjacdbobikibn	TRUE
kaaakomniblahdkpjpcbbphb	TRUE
kanhmahnaojbbnjjlbopokhp	TRUE
kkoakahnabimimbnpmljbpjo	TRUE
laaohlomnlaefbekkafedbbb	TRUE
lampamlhmakogdcpdjhbnbhb	TRUE
lkaaaeikhfkjemldojalbbbn	TRUE
lpaiohamhnmoakdnbbbabbbn	TRUE
maklaafccojpfibbolpbhokk	TRUE
mikhnoaaaoboohmkhbmnhlkb	TRUE
mnhoamamjapakoohohnbjlbb	TRUE
naajnopanikcmfobbmmbkbjj	TRUE
nahonjpiapaonlpehfeobbbh	TRUE
nmaanalcldaddjmfpblpipbb	TRUE
oaaaaifbdcmhinblmjiinbbh	TRUE
oapmanopapdpdiniieobbbji	TRUE
omaoahnaecebhjlfboibimbh	TRUE
paoaaamhlhmjhjjnkebbbjmi	TRUE
papaacmnfogacnobifbkmbbi	TRUE
plahllaamplhfbbhnonmnlbj	TRUE
baaapemlabodanbhopbkhbilp	FALSE
faannaaeohjfcchgjcibkllbb	FALSE
aeinaafipicicnnnebjgkabbb	FALSE
aaajlcfhdmjolkigboblcpjbo	FALSE
aaapbhiklebgnblinlbkmpjpm	FALSE
aalcnkablkplgkhipebmbbni	FALSE
aajaiicdlkgmjbcbboghnbkml	FALSE
aamafaomepeblggogbnhbjik	FALSE
aaoipmmaigkcckihcjmeibbbf	FALSE
akoabimnicepbcbopjkmlbkb	FALSE
ahkapkadjcknebbkapjmmbjkh	FALSE
aiikikaadolhlecchebjabbmk	FALSE
ajajihcjaeklfgdbbinonbnnb	FALSE
afnaihnhnppahhnobkkbjmjb	FALSE
aknagabenflpacpkldfoebbb	FALSE
alljapakjnbfpohaajanbibk	FALSE
amjaiaeejmmbmokhbophbllap	FALSE
anjmkapafeiikogkgjmjbbfbk	FALSE
aoihamamhgjnopehbconhmbb	FALSE
apamjojjkaiegcebkclbllboo	FALSE
calninmnmhokaleilbbjnbhn	FALSE
mnaamcpmeomlfghcngbbbhlb	FALSE
hahijjpaakmeealoibbebhimi	FALSE
hieoklokhaanpaccbjbjohhob	FALSE
hnaaaofnekgahckbeahebmb	FALSE
iaaklpakbkbdackjdoabblli	FALSE
ihaiahaodhejljhoknhbekbkb	FALSE
incaapoaelhcdlmnmcplegbbb	FALSE
jaaikapkhidmhnnomabbkjaj	FALSE
japlkanambhbegpekbkbbinc	FALSE
jlkpkaaeohmgjacdbobikibn	FALSE
kaaakomniblahdkpjpcbbephb	FALSE
kanhmahnaojbbnjjlkopokhp	FALSE
kkfakahnabimimbnpmljbpjo	FALSE
lacaohlomnlaefbekkafedbbb	FALSE
lampamlhmakogdcpdjhbnbhd	FALSE
lkaaaeikhfkjemldojalkbbn	FALSE
lpaiohamhnmoakdnbbbabcbn	FALSE
maklaafccojpfibbolpbhakk	FALSE
mikhnoaaaoboohmkhbmghlkb	FALSE
mnhoamamjapakoohohnnjlbb	FALSE
naajbopanikcmfobbmmbkbjj	FALSE
nnhonjpiapaonlpehfeobbbh	FALSE
nmaeanalcldaddjmfpblpipbb	FALSE
ogaaaaifbdcmhinblmjiinbbh	FALSE
oapmanopapdpdiniieobbebji	FALSE
omaoahnaecebhjlfbfoibimbh	FALSE
pfaoaaamhlhmjhjjnkebbbjmi	FALSE
papaacmnfogacnobifbkmkbi	FALSE
plahlldaamplhfbbhnonmnlbj	FALSE
aaahpfmaejncjciolbblnibhp	TRUE
koapapiomagppmhhafoilbobb	TRUE
amkakabpndfkbmmpmpbkmbhoi	TRUE
aaaifcppifmhcmdenbbilpjbl	TRUE
aaappfpccgieciakbmkobboll	TRUE
aaadmbboimhmbjjbbpobnjoon	TRUE
aaiomllaldbcolpplgdmbmbmb	TRUE
aamloahniamicbnjnjibikobi	TRUE
aaoinnaikciojfnbmkbklbhil	TRUE
aaafhfgaigpbmaakidlfbbpbk	TRUE
ahkommalahpdpphhlbfnlebbb	TRUE
aihmoaaciffnjdediedcbbbpl	TRUE
ajahnkajocfnieeakdgdbmbbb	TRUE
ajpplmjhanafnbhbhhninbonp	TRUE
akohaininakpiabbiiipbjhnb	TRUE
alnaapbhdlglibkgmajabnbjb	TRUE
amjlanlljafgbdndpbhkknbmb	TRUE
anhaonipakagenjkebjibmboi	TRUE
aoahajpokmkfabgdgfdcbmjbb	TRUE
aphampakaffeghbbkhnjjbilm	TRUE
apnahoamkefmmakbhbbjbbkpj	TRUE
amaiafmlldceapjinimbabbbm	TRUE
haajaakfghndjfocbbblkpmln	TRUE
hhaaoaafpdiidkiglbbkibmbb	TRUE
hmaliniajioaebbppjijhbkno	TRUE
ianaiaahbgjgnakcdpmkbhbnb	TRUE
iaopaanocafbopbibnonhnmni	TRUE
illaaihalgglpfjjabjmbhknb	TRUE
jaaiadjlohpmakbnlbobohjjl	TRUE
janhkanpkmikpajfdblikmhbb	TRUE
jkiallakpkaocecjhabkabkbb	TRUE
jpioiaaaeklipeboibnpikoob	TRUE
kajmhoaoommaimjefbpjbbpmj	TRUE
kjlkhmjlaaagjhnbnombpblph	TRUE
koaaacjphbjnjakbboiobnihm	TRUE
laamakpgnnfkehjhhjjgbbbni	TRUE
liaaaimiccenmpmfeelmebbbh	TRUE
lnaakjllliabkbmbbmnmhhkmj	TRUE
maanhagjojmchgeokdbbbmkij	TRUE
mhaaahekjglefkebdbmjonkbb	TRUE
mnaoaamhkmpfpedefabdbbppb	TRUE
naamkkahmnogdofbppnlbhjbh	TRUE
nhaalahicpafkileghbkhbmnb	TRUE
nlomajmmipaakipllbbomnbjp	TRUE
okamalmacicegbaimbobphbki	TRUE
oanaaeoggkajbfhgbjobbkokb	TRUE
olhkiklaaaaijebbbnhbioknh	TRUE
palaalfleaokkgnajbbbokiol	TRUE
paoaajidakeoeelmkapeblmbb	TRUE
plaalikaoefhdofpmbigpbobb	TRUE
baaahpfmaejncjciolbblnibhp	FALSE
ekoapapiomagppmhhafoilbobb	FALSE
admkakabpndfkbmmpmpbkmbhoi	FALSE
aaaifcppifmhcmdenbbicpjbl	FALSE
aaappfpccgieciakbmkoiboll	FALSE
aafdmbboimhmbjjbbpobnjoon	FALSE
aaiomdlaldbcolpplgdmbmbmb	FALSE
aamfloahniamicbnjnjibikobi	FALSE
aaoinnaikciojfnbgkbklbhil	FALSE
ajafhfgaigpbmaakidlfbbpbk	FALSE
ahkommalahpdpphhlbfnlebbba	FALSE
aihmoaiciffnjdediedcbbbpl	FALSE
ajahnkgjocfnieeakdgdbmbbb	FALSE
ajpplmjhanlfnbhbhhninbonp	FALSE
akohaicninakpiabbiiipbjhnb	FALSE
alnaapbhdlglibkgmajadnbjb	FALSE
amjlanlljafgbdndpbhkkgbmb	FALSE
anhaonipakagenjkebjifmboi	FALSE
aoahcjpokmkfabgdgfdcbmjbb	FALSE
apbhampakaffeghbbkhnjjbilm	FALSE
apnaheamkefmmakbhbbjbbkpj	FALSE
jmaiafmlldceapjinimbabbbm	FALSE
haajaakfghndjfocbbblkpmaln	FALSE
hhaaoaafpdiidkiglbbkibmbbc	FALSE
hmaliniajioaeibppjijhbkno	FALSE
iacnaiaahbgjgnakcdpmkbhbnb	FALSE
iaopaanocafbopbimnonhnmni	FALSE
illaeaihalgglpfjjabjmbhknb	FALSE
jeaaiadjlohpmakbnlbobohjjl	FALSE
janhkanpkmikpajfdblikmchbb	FALSE
jkiollakpkaocecjhabkabkbb	FALSE
jpioiaaaeklipeboibnpikoofb	FALSE
kajmhoaoommaimjefbpjbipmj	FALSE
kjlkhmjlaaagjhnbnocmbpblph	FALSE
koaaacjphbjnjakbboidobnihm	FALSE
laamakpgnnfkehjhhjjgjbbni	FALSE
liaaeimiccenmpmfeelmebbbh	FALSE
lnaadkjllliabkbmbbmnmhhkmj	FALSE
maanhagjojmchgeokdbbbgkij	FALSE
mhaaahekjglefkebdbmjonkbbf	FALSE
mnaoaamhkmpfpedefabdbbppbc	FALSE
naambkkahmnogdofbppnlbhjbh	FALSE
nhaalahicpafkileghbkhbmnfb	FALSE
nlomajmmipmakipllbbomnbjp	FALSE
odkamalmacicegbaimbobphbki	FALSE
oanaoeoggkajbfhgbjobbkokb	FALSE
olhkiklaaaaijebbbfhbioknh	FALSE
pealaalfleaokkgnajbbbokiol	FALSE
paoaajidakeoeelmkapehlmbb	FALSE
plaelikaoefhdofpmbigpbobb	FALSE
aaahgakjbpgcfgioibheiabbbj	TRUE
mnhalpnaimmaeinefbibplbmbl	TRUE
apnjljammagkfdpjjmejllbbkb	TRUE
aaakakkggkjlngakbpnikipmbb	TRUE
aaacfboakkbjecglobmlbbbhop	TRUE
aahjolajokglclpgkmdnbbnjlb	TRUE
aajioabnjnimnbkbnljlebbhlb	TRUE
aalmadnafphfnbbhppjhiomjbj	TRUE
aaoajdhmbnbhbphibinhjjlnjb	TRUE
aahopankofijcdbebaigbkibnb	TRUE
ahajlmoalajklpbonipmjbmobb	TRUE
aiaiaebnooepkbekibdbbbnhko	TRUE
ajakinahgkfadcajkeeionbbpb	TRUE
ajnnppalonoiaendgjninbnobb	TRUE
akkkhaabijifhblokobblklokj	TRUE
aljkkiajadfgpnocppgabjbnbk	TRUE
amhoaacodhcgdopnhkbmllbjbi	TRUE
anaabcpafekhpncdmnkkbcebbb	TRUE
aoaaebjbgedlfmlacdogbimibb	TRUE
apaaaleeickgnkppmafijcbbbm	TRUE
appaanahfoikgncffdnhibbonb	TRUE
ajaalbodmpdojbnbbhnmonmihi	TRUE
haaojlafhmcmhlcjgbinbonibh	TRUE
hhhkojhnnlkjaaaaebcebbnboh	TRUE
hmajakaopolkaadelahfbmkobb	TRUE
iaaajliiohnlokblpljbmkbjpi	TRUE
iapanafnjaggojdkmbbkmjplbj	TRUE
ilaonaaacbegknckhejlnbinbb	TRUE
jokalnliaaldoggabhibkjoojb	TRUE
jaohaanmbillcbibpnhihpjhpb	TRUE
jkhaialjkabdikanebbnmplobo	TRUE
kjoaamanpoodohfgmgccebobbp	TRUE
kamjjaooahglmbnbmjbbkpibpb	TRUE
kjklkokmaaooniadieobbbnhjn	TRUE
knolamjahhadmnmgefbblbknmb	TRUE
lahaklahagjcgbcemggagfobbb	TRUE
liaaadfbppcppinjpbbkhklbbj	TRUE
lmoahahhhjkonapbomlbpoijbh	TRUE
maaakfombfhidgoenkekncbhbb	TRUE
maaaidhlbaccgdiofiangbbknb	TRUE
mlhajmoapakcgdjkekhnbblbjj	TRUE
naaafcndhmlollnahdnbfibbbi	TRUE
nammaaimkniddhgpccibiibbil	TRUE
nlkllnaaaglblmdjeodcgibbbj	TRUE
oamnnnamnabkobckjjdihbkbhb	TRUE
oamaamodiahfkljdhpbikiblkb	TRUE
okiaaljpjalljcglgbbbhmbkpi	TRUE
pamahjnachgdplihdbhnobpmbj	TRUE
papiijmaahbnijbjipbjlpihpm	TRUE
pkppajapilkahnkcobnjbimnhb	TRUE
baaahgakjbpgcfgioibheiabbbj	FALSE
fmnhalpnaimmaeinefbibplbmbl	FALSE
agpnjljammagkfdpjjmejllbbkb	FALSE
aaakakkggkjlngakbpnckipmbb	FALSE
aaacfboakkbjecglobmlbbbehop	FALSE
aahjolajokglclpgkmdnabnjlb	FALSE
aajigoabnjnimnbkbnljlebbhlb	FALSE
aalmadnafphfnbbhppchiomjbj	FALSE
aaoajdhmbnbhbphibidhjjlnjb	FALSE
aafopankofijcdbebaigbkibnb	FALSE
ahajlmoalajklpbonipmjbmobf	FALSE
aiaiaebnooepkbekibdbbbnhako	FALSE
ajcakinahgkfadcajkeeionbbpb	FALSE
ajnnppalonoibaendgjninbnobb	FALSE
akkkehaabijifhblokobblklokj	FALSE
aljkkiajadfgpnocppgabjbnk	FALSE
amhoaacodhcgdopnhkbmllbjebi	FALSE
annabcpafekhpncdmnkkbcebbb	FALSE
aoaaebjbgedlfmlacdogkimibb	FALSE
apaaaleeickgnkppmafijcbbm	FALSE
appaanahfoikgncffdnhicbonb	FALSE
ijaalbodmpdojbnbbhnmonmihi	FALSE
haaojlafhmcmhlcjgkinbonibh	FALSE
hhhkojhnnlkjaaaaebcebbnbeh	FALSE
hmajakaopolkaadelahfbmkojb	FALSE
iaaajliiohnlokblpljbmkbjpe	FALSE
iapanafnjaggojdkmbbakmjplbj	FALSE
ilaonaaacbegknckhejlnbiebb	FALSE
jcokalnliaaldoggabhibkjoojb	FALSE
jaohaanmbillcbibpnhihgpjhpb	FALSE
jkhaialjkabdikanebbnmclobo	FALSE
fjoaamanpoodohfgmgccebobbp	FALSE
kamjjaooahglmbnbmjbbcpibpb	FALSE
kjklekokmaaooniadieobbbnhjn	FALSE
knolamjahhadmnmgefbflbknmb	FALSE
lahakdlahagjcgbcemggagfobbb	FALSE
liaaadfbppcppinjpbbkhklbdbj	FALSE
lmoahahhfjkonapbomlbpoijbh	FALSE
maaakfombfhidgoenkekncbdhbb	FALSE
mkaaidhlbaccgdiofiangbbknb	FALSE
mlhadjmoapakcgdjkekhnbblbjj	FALSE
nadaafcndhmlollnahdnbfibbbi	FALSE
nemmaaimkniddhgpccibiibbil	FALSE
nlkllnaaaglblmdjeodcgibbj	FALSE
oeamnnnamnabkobckjjdihbkbhb	FALSE
oamaamodiahfkljdhpbikibdlkb	FALSE
okiaaeljpjalljcglgbbbhmbkpi	FALSE
pfamahjnachgdplihdbhnobpmbj	FALSE
papiijmaahbnijbjipbflpihpm	FALSE
pkppajapilkahnkcobnjbiamnhb	FALSE
aaanmomhgggjjonmllffjmbobbp	TRUE
aaagblflgcjpcdgmmbnedbbjmbo	TRUE
aaadlbplmhckllfkkbhhjmlbnbo	TRUE
aaakeeehmlpknfjdeoijjgfabbb	TRUE
aaadkliojbnphplkdiddpbibkbo	TRUE
aahlkkilabepgmepcbdbplmbbmo	TRUE
aakajkjclhnffpcdkbojbmnbkim	TRUE
aamjmpancaojelbciapakbbjbpm	TRUE
aaopnphaloiofflbimobpbljkjo	TRUE
ahahjabdjhjnfkekbgdahbknbbj	TRUE
ahonpoaangfpljphcbbipilmhbi	TRUE
aimmpnkaameeibjiiaobaabbipb	TRUE
ajkalialcdmlhocbiiinmbgbkbb	TRUE
akaojjnoianhobffnmkjfbimbib	TRUE
alaallljehmlnaoahbbljobnhhp	TRUE
amamahlijbppbakiiglfdnobbbj	TRUE
anjohnjikkaafmkkkfkhblpobjb	TRUE
aoajknafinibpoeinfgebbjklkb	TRUE
apaafooaoncichcneabkbjmjihb	TRUE
aplkmpkahalcmjlkbnomkhhbbob	TRUE
aanafjnjmlkobcofahphielbnbb	TRUE
haahpolmamjeopgkfgfbhkoobbi	TRUE
hapkmaolnabfpijjeehfgcbblob	TRUE
hliahaaikfepfhphlbjobnobhol	TRUE
ijaaaemcljfhfdppfdjkbbhjbll	TRUE
ianojaacblfiokoaakbjbniilkb	TRUE
ikaaajhehndaghpdngefjbbibhb	TRUE
ioiiiaaiachllmabcdhdcdebbbm	TRUE
jahmanaljdnpjhcgmhbknbpjbmj	TRUE
jjlaapajphaakfglepphngbibbk	TRUE
jnimiokahpioaannnmdbbmonbil	TRUE
kaanhainibfmdjnfonobhobmbjb	TRUE
kiaakoadiklefchecgdaibbbnoh	TRUE
kmjonaaonhjlhaomdmbjlfpbpbb	TRUE
laaacaekmcnfpcbloknmbllbpkn	TRUE
lhaoaklpaofecohikfhofcbiblb	TRUE
lmaajolalnejoaaopkbbbmjibmn	TRUE
maajnppaemgcdilkpccbibjibjj	TRUE
mhkilailonaoaebiohoibmbnnhm	TRUE
mmaaakmpgcmpopbenehpabjbibh	TRUE
naaaigbbidghnfkfncmlkpbpbbk	TRUE
naanpanmckphkkbemnbmnibnbpi	TRUE
nlajhallnkahjimegkcbabobjlb	TRUE
oaajajahaonlnbkchkejbbbjjkj	TRUE
oakmhijhikamkmijjiaphbpmbnb	TRUE
ojjalamnnianmjcfecdbkkjbbhn	TRUE
ooaljaadedhbfiinggippombbbm	TRUE
paajabdfamefklilabekheiblbb	TRUE
phaapajhojidbkhhcjlboibjpbj	TRUE
plmookalmamnioaibbobnliknmm	TRUE
baaanmomhgggjjonmllffjmbobbp	FALSE
faaagblflgcjpcdgmmbnedbbjmbo	FALSE
afaadlbplmhckllfkkbhhjmlbnbo	FALSE
aaakeeehmlpknfjdeoijjgfabob	FALSE
aaadkliojbnphplkdiddpbibkdbo	FALSE
aahlkkilfabepgmepcbdbplmbbmo	FALSE
aakajkjclhnffpcdkbojbcmnbkim	FALSE
aamjmpancaojelbciapakbjbpm	FALSE
aaopnphaloiofflbimobpbljkfo	FALSE
ahaehjabdjhjnfkekbgdahbknbbj	FALSE
ahgnpoaangfpljphcbbipilmhbi	FALSE
aimmpnkaameeibjiiaobaabbigpb	FALSE
ajbalialcdmlhocbiiinmbgbkbb	FALSE
akadjjnoianhobffnmkjfbimbib	FALSE
alaallljehmlnaoahcbljobnhhp	FALSE
amacmahlijbppbakiiglfdnobbbj	FALSE
anejohnjikkaafmkkkfkhblpobjb	FALSE
aoacjknafinibpoeinfgebbjklkb	FALSE
apcaafooaoncichcneabkbjmjihb	FALSE
aplkgmpkahalcmjlkbnomkhhbbob	FALSE
hanafjnjmlkobcofahphielbnbb	FALSE
haaehpolmamjeopgkfgfbhkoobbi	FALSE
hapkmaolcnabfpijjeehfgcbblob	FALSE
hliahaaikfepfhphlbjobcnobhol	FALSE
djaaaemcljfhfdppfdjkbbhjbll	FALSE
ianojaacblfiokoaakjjbniilkb	FALSE
ikaaajhehndaghpdngefjbbfibhb	FALSE
ioiiiaaiachllmabcdhdcdebbdm	FALSE
jahmanlljdnpjhcgmhbknbpjbmj	FALSE
jblaapajphaakfglepphngbibbk	FALSE
jnimiokahpioaknnnmdbbmonbil	FALSE
kaanhainibfmdjnfonobhobmbfjb	FALSE
kiaakoadiklefchecgdaibbbnog	FALSE
kmjoeaaonhjlhaomdmbjlfpbpbb	FALSE
laaacaekmcnfpcbloknmblalbpkn	FALSE
lhgoaklpaofecohikfhofcbiblb	FALSE
lmaajolalnejoaaopkbbbmjibma	FALSE
maajnppaemgcdilkpccbibjifbjj	FALSE
mhkilailonaoaebdiohoibmbnnhm	FALSE
mmaaakmpgcmpopbenehpabjbebh	FALSE
nagaaigbbidghnfkfncmlkpbpbbk	FALSE
neanpanmckphkkbemnbmnibnbpi	FALSE
nlajhallnkahjimegkcbabobjlj	FALSE
daajajahaonlnbkchkejbbbjjkj	FALSE
oakmhijhidamkmijjiaphbpmbnb	FALSE
ojjalamnniknmjcfecdbkkjbbhn	FALSE
ooalcaadedhbfiinggippombbbm	FALSE
paajabdfamefklilabekheiclbb	FALSE
phaapajhojidbkhhcjlboibjphj	FALSE
plmookalmadmnioaibbobnliknmm	FALSE
aaalabjkklkelblofoelcgjfbbkb	TRUE
ahaapcpippljgiiodjddljblbilb	TRUE
aalilakdojmgffgacioehbebmbib	TRUE
aaalephioanaammafgfjbjbplbpn	TRUE
aaabnimdbiohljbhhlpbolljmikn	TRUE
aahladaabmafabifpfkilhbjbplb	TRUE
aakakboklcgdbipafebbjojbopok	TRUE
aanalhalbdcoijoofbmcbpbkbkki	TRUE
aapliangiclejejmeofkblkbnblo	TRUE
ahaiagjmldlakbfeeoembbojojob	TRUE
aiajamdohhehmggaolbblhhhhiob	TRUE
ailapoikadkajbachgdkndonobbb	TRUE
ajihhlhlanapfaaknmhgomdibblb	TRUE
akakiiamnieebdfaidipbijblomb	TRUE
alaiagcgaliimimojgpabbmbimmo	TRUE
amaaakckpdpafobcldebkonihhbb	TRUE
anioamnapjicdkbobgaboejlcbbb	TRUE
anopkkaaelfdgancdihmgbojimbb	TRUE
aonaiablbphcjpolofclanbkobpb	TRUE
apikjaoaofekeimdnaiobbmbkihj	TRUE
aaaphlloffhjhldbgiacmnabjbbi	TRUE
hihpaokaajbejcfcighdnogmnbbb	TRUE
haklpkilnaaniekfjhfhmdebnbkb	TRUE
hjlamaaghneaflldlmomfjhhbjbb	TRUE
hoaajafdfnlifcacfmdihaopgbbb	TRUE
iaamlajedgcdlkakfimgdofbcbbb	TRUE
ihijamhaipalmfchkhbikhhbmjbn	TRUE
imnlaaaniklflfhaabmiljlpbhbk	TRUE
jaaalhaeboialbcodpoaghaibjbb	TRUE
japappnjiagebdnhgbbklbmhkpnk	TRUE
jkohaaaoeahjpgekaifpjhabmbnb	TRUE
kpaahkaophgehhnjkgmkijbbobhh	TRUE
kaoaapmjhmmciehjjcbjolmhobbp	TRUE
kkliaaaibkdlghkllooahgbbmnbm	TRUE
kpnamahjadddlcanambcffnphbbb	TRUE
lalapagobacoeanoiolacmbobohb	TRUE
ljhijaaaifcmjkkobgekibbhhobn	TRUE
loinamamahihpbcaachdbbjblpkn	TRUE
mahpaaahbpebakiebgmabbibhblh	TRUE
mjaaknaneedmnljigojlgbbpbhpp	TRUE
mnmpaaapjmhiienpdjjokbimbkjb	TRUE
naajnannfgdgedjaebbkloobnhib	TRUE
nhajijapaejjfgkabnhjjojbjhib	TRUE
nmkakijkamiiaodbcblbbjnhllpp	TRUE
oaaiafhdhgbooogbkiblbkmhbmnl	TRUE
ohaaamfbadjpmlimnplhebbnbppp	TRUE
omajhokaakopeceffpofdblibpib	TRUE
paaangoibajobidhklbebphbliob	TRUE
papahajhgfinpbieeeamakbblbjp	TRUE
pkmaapohhlaaifjbcnbkibkkljbh	TRUE
baaalabjkklkelblofoelcgjfbbkb	FALSE
fahaapcpippljgiiodjddljblbilb	FALSE
agalilakdojmgffgacioehbebmbib	FALSE
aaalephioanaammafgfjajbplbpn	FALSE
aaabnimdbiohljbhhdlpbolljmikn	FALSE
aahladaabmafabifpfkilhbebplb	FALSE
aakakboklcgdbipafebjojbopok	FALSE
aanalhalbdcoijoofbmcbpbkakki	FALSE
aapliangiclejejmeofkblkbnbloe	FALSE
ahaiagjmldlakbfeeoembbojojoi	FALSE
aeajamdohhehmggaolbblhhhhiob	FALSE
ailapoikadkajbachgdkndonoobb	FALSE
ajihhlhlancpfaaknmhgomdibblb	FALSE
akabiiamnieebdfaidipbijblomb	FALSE
alaiagcgaliimimojgpabbmbimme	FALSE
amaaakckpdpafobcldebkonidhbb	FALSE
ancioamnapjicdkbobgaboejlcbbb	FALSE
anopkkaaelfdgancdihmgbojcmbb	FALSE
aonaiablbphcjpolofclanbkobpn	FALSE
apikjaoaofekeimdnaiobbmbgihj	FALSE
faaphlloffhjhldbgiacmnabjbbi	FALSE
gihpaokaajbejcfcighdnogmnbbb	FALSE
haklpkilnaaniekfjhfhmdebnbk	FALSE
hjlafaaghneaflldlmomfjhhbjbb	FALSE
hoaajafdfnlifcacfmdihaopgbbd	FALSE
iaamlajedgcdlkakfimgdofbcbdbb	FALSE
ihijamhaipalmfchkhbikhcbmjbn	FALSE
imnlaaaniklflfhaabmiejlpbhbk	FALSE
jaaalhaeboialbcodpoaghaibjbbf	FALSE
japjppnjiagebdnhgbbklbmhkpnk	FALSE
jkohaaooeahjpgekaifpjhabmbnb	FALSE
cpaahkaophgehhnjkgmkijbbobhh	FALSE
kaoaapmjhmmciehjjcbjolmhobbf	FALSE
kkliaaaibkdlghkllooahgbbmnpm	FALSE
kpnamahjadddlcanambcffnphbmb	FALSE
lalcapagobacoeanoiolacmbobohb	FALSE
ljhijaaaifcmjkkobgekibbhhofbn	FALSE
loinamamcahihpbcaachdbbjblpkn	FALSE
mahpaaahbpebakiebgmabbibheblh	FALSE
mjaaknaneedmnljigojlgbbpbfpp	FALSE
mnmpeaapjmhiienpdjjokbimbkjb	FALSE
naajnannfgdgedjaebbkloofnhib	FALSE
nhajijapeaejjfgkabnhjjojbjhib	FALSE
nmkakijkamiiaodbcblbbjnellpp	FALSE
oaaiafhdhgbooogbkiblbkmfbmnl	FALSE
ohaaamfbadjpmlimnplhebenbppp	FALSE
omcjhokaakopeceffpofdblibpib	FALSE
paaangoibajobidhklbebphblioab	FALSE
papahdjhgfinpbieeeamakbblbjp	FALSE
pkmaapohhlaaifjbcnbkebkkljbh	FALSE
aaajpphjakpmdjkcfpdicmpkckbbb	TRUE
aalhanfmdonggpgpjkdefjgkalbbb	TRUE
aanakhglncgipljaghbmbohlbhikj	TRUE
aaalbaodjjdlnhcgacopjbobnmhnb	TRUE
aaackhcilmmhcaieedgejbkhbpboj	TRUE
aahilmlooloklmnhjopladbboiboo	TRUE
aajnllabpocohcokpcfoeenbbbook	TRUE
aamkaocdkfbjkkaeopaeepjbjmmbb	TRUE
aapakjccbmodpcpldabjknbhbppli	TRUE
ahhaacnkgjoglipphieabbpkknobn	TRUE
ahplklknaaagilggclikhjdbnbbkl	TRUE
ainhialnaeecogfmmlfehdnnbmblb	TRUE
ajmahmaefieablfkfmpbibnibiioh	TRUE
akjnakokadcellmnfnjipbjoonmbb	TRUE
alhahpnjahkhegekjmeibpbnibkhn	TRUE
amhoaniamninokknjnfaibohnmbbj	TRUE
anamoimjlaalfnmfkhfbhhnhnikbb	TRUE
aoaacaickepdfehkfcibmlbmolipb	TRUE
apaliikmjaleicmkejldnnakbibnb	TRUE
apmanilpladkogajpeggohbibblbk	TRUE
aajhadgmbbhbgdkelffnflbbnmhob	TRUE
hnpoapkhajnoabhggbiikjinmbpbp	TRUE
hakmahaejnpjkcgnjbmihihhlbhbo	TRUE
hjhanoippaapoghpabinmohbmblmb	TRUE
hpjajhahjloalkdjfejnblipnilbb	TRUE
iaikajahcoampfebninpbddbpbmbh	TRUE
iiiknmjalaaalgipbhnkolblipkbk	TRUE
inljoaanjhhapmikcpikcegihcbbb	TRUE
jaammadmlbciohiiheefdmibblobk	TRUE
jhpnakahljlhllpjpaimlbmlbibnn	TRUE
jmmanaaacjlffmaiajkhejplcbbbp	TRUE
kaaaeioglfbfdfpiimklicgbbipob	TRUE
kaohnjllaaojgfafohedljkfejbbb	TRUE
klmpnlaapkkafledbfmejjbbbpink	TRUE
laaakjnmgblohloanllabgobopnbb	TRUE
lalapaefapbebkkninfendebbbnmk	TRUE
ljpajhmilaoadbimbikbinkpnmhni	TRUE
loohplaloajabeionihpakfhbkbbp	TRUE
makahkohaafkbofgpcmbkbnbikjoh	TRUE
mjhjaakmoafnfjdjecgebikbknlbj	TRUE
moajmamnmnnamcahbjlbolbkppnbn	TRUE
naanoaobhcalbjflcjhakbjlnilbb	TRUE
nhhlkamaaoalghdiebgdbioolnbbb	TRUE
nmlipjaiahkklplanifckjbbhkjpb	TRUE
oaapalaejhgkmbbbhnojllokoojmn	TRUE
ohkaaalghhajmkcgdobnpopjlipbb	TRUE
olpmjahmoaiajnaaadjkfblbbopno	TRUE
pakiaajlaobllpmhjicjpgebcbbbj	TRUE
panlaiaijlofamcepmalakdbbnjmb	TRUE
pkaaopkmapcdamjmbbinjinjpkkmb	TRUE
baaajpphjakpmdjkcfpdicmpkckbbb	FALSE
faalhanfmdonggpgpjkdefjgkalbbb	FALSE
anakhglncgipljaghbmbohlbhikj	FALSE
aaalbaodjjdlnhcgacopjbobnmheb	FALSE
aaackhcilmmhcaieedgejbkhbpioj	FALSE
aahilcmlooloklmnhjopladbboiboo	FALSE
aajnllabpocohcokpcfoeenfbbook	FALSE
aamkaocdkfbjkkaeopaeepjbfjmmbb	FALSE
aapakjccbmodpcpldabjknihbppli	FALSE
aghaacnkgjoglipphieabbpkknobn	FALSE
ahplklknaaagilggclikhjdbnmbkl	FALSE
ainfhialnaeecogfmmlfehdnnbmblb	FALSE
ajmahmaefieablfkfmpbaibnibiioh	FALSE
akjenakokadcellmnfnjipbjoonmbb	FALSE
alhahpnjahkhegekjmeibpjnibkhn	FALSE
amhoaniamninokknjnfaibohnmobj	FALSE
anamoimjlaalfnmfkhfbhhnehnikbb	FALSE
aoaacaickepdfehkfcibmljmolipb	FALSE
acaliikmjaleicmkejldnnakbibnb	FALSE
apmanilfpladkogajpeggohbibblbk	FALSE
hajhadgmbbhbgdkelffnflbbnmhob	FALSE
gnpoapkhajnoabhggbiikjinmbpbp	FALSE
hakmahaejnpjkcgnjbmihihhlbho	FALSE
hjhanoippaapoghpabinmohbmbgmb	FALSE
hpjajhahjloalkdjfejnblipdnilbb	FALSE
iaikjahcoampfebninpbddbpbmbh	FALSE
iiiknmjalaaalgipbhnkolbflipkbk	FALSE
inljoaanjhhapmikcpikcegihcbbbe	FALSE
jaammcadmlbciohiiheefdmibblobk	FALSE
jhpnakahljlhllgpjpaimlbmlbibnn	FALSE
jmmanacaacjlffmaiajkhejplcbbbp	FALSE
kaaeioglfbfdfpiimklicgbbipob	FALSE
kaohnjllfaaojgfafohedljkfejbbb	FALSE
klmpnlaapekafledbfmejjbbbpink	FALSE
lacaakjnmgblohloanllabgobopnbb	FALSE
lalapaefapbebkkninfendebbbnmkg	FALSE
ljpajgmilaoadbimbikbinkpnmhni	FALSE
looghplaloajabeionihpakfhbkbbp	FALSE
makahkohaafkbofgpcmbkbnbeikjoh	FALSE
mjhjaakmoafnfjdjecgebikbknldbj	FALSE
moacmamnmnnamcahbjlbolbkppnbn	FALSE
naanoaobhcalbjflcjhakbjlnifbb	FALSE
nhhlkambaoalghdiebgdbioolnbbb	FALSE
nmlipjdaiahkklplanifckjbbhkjpb	FALSE
oaapalaejhgkmbbgbhnojllokoojmn	FALSE
ohkaaealghhajmkcgdobnpopjlipbb	FALSE
olpmjahmoaiajnaaadjkfblbbeopno	FALSE
padkiaajlaobllpmhjicjpgebcbbbj	FALSE
panlaiaijlofamcepmalakdbnjmb	FALSE
pkaaopkmapcdamjmlbinjinjpkkmb	FALSE
