aaaaabaabjnlagdeobga	TRUE
aaaaabeppmmgjlgelikc	TRUE
aaaaabkhcmhlpikgjcoi	TRUE
aaaaacafiikhmgdgnclb	TRUE
aaaaacfemfaoldfkllfa	TRUE
aaaaackbioacmhkepbaf	TRUE
aaaaacofocdepaihpdnh	TRUE
aaaaadcpfhkelggmkimc	TRUE
aaaaadhfnemlmcbiahdf	TRUE
aaaaadlokeodgnnehdag	TRUE
aaaaaeaoeknjjccghcoi	TRUE
aaaaaeelcaphhlbfjnob	TRUE
aaaaaejiojcfphdkphii	TRUE
aaaaaeodfajbhngldble	TRUE
aaaaafcfpoophhomemcg	TRUE
aaaaafhmmcejgbempnid	TRUE
aaaaafmlbpjnkbooljbh	TRUE
aaaaagbfgpppgepdimka	TRUE
aaaaaggefoffiahcjpgb	TRUE
aaaaagkooddpmljohodl	TRUE
aaaaagpemhpfgcnoldin	TRUE
aaaaahdpjphnmanfmiac	TRUE
aaaaahimbcppdekefdhh	TRUE
aaaaahndanlgiepmpcpg	TRUE
aaaaaibodekceadkpjic	TRUE
aaaaaigpphmoabolkcpk	TRUE
aaaaailfgadaonphkgpp	TRUE
aaaaaippbjjlmbpfmppp	TRUE
aaaaajegldmnaacfppjl	TRUE
aaaaajjbphickibbmkko	TRUE
aaaaajopaepgmalkahfm	TRUE
aaaaakeccgmlecdjkkpm	TRUE
aaaaakjbanhedfhdeend	TRUE
aaaaaknneggnjaekapji	TRUE
aaaaalcpkfhiabboobdm	TRUE
aaaaalhghpmkaeobikgf	TRUE
aaaaalmpfbaonejlmkfl	TRUE
aaaaamanellmlhnpbega	TRUE
aaaaamfmeklcncnimjgm	TRUE
aaaaamkemdbdcbneidkg	TRUE
aaaaampkhekalelagkoi	TRUE
aaaaanebidiobnjbjcac	TRUE
aaaaanikibhbifadekmf	TRUE
aaaaannochldklodfadm	TRUE
aaaaaoceoibbmdcleeob	TRUE
aaaaaoheegnepdlcidjk	TRUE
aaaaaologbohinchggjc	TRUE
aaaaapbhjcpebincaipa	TRUE
aaaaapgjljajdnhkbimo	TRUE
aaaaapkncilckpmjpfih	TRUE
aaagleiohloneoelieke	FALSE
aemmnanihogaoecmmigg	FALSE
ajcefcfdigninkeaihkc	FALSE
aoocfhielgafinhfgdbf	FALSE
bdfkfimmkekhfbkpglcb	FALSE
bidjmlnlenaebkamgdde	FALSE
bnfnmbegenpkojgjjfoo	FALSE
ccmmgaolcgjilmcblkml	FALSE
chigpaocpppdahiojbho	FALSE
cmlicgmageacemipdeho	FALSE
dcdgadejkpnbomeoapib	FALSE
diafliohkffijbdgleci	FALSE
dnigppfeflkadeipefdo	FALSE
ecdfklancmplkkkchema	FALSE
ehcnadncngjamgammdhi	FALSE
emhijamhejglpcjejgbo	FALSE
fbgaolhgafamnaifimfj	FALSE
fghfebnmdeldhgmmpcaf	FALSE
fmklkjoaknjedffhdlbh	FALSE
gbefcofnjjifdbciinnm	FALSE
gghjhplaoblfmlpmccfo	FALSE
glaeifenpofinhepobbh	FALSE
haecmajonncjoiipkhcf	FALSE
hfhddphmnfmafpngdiah	FALSE
hkahkildknhlpmgeleoc	FALSE
hpfbebeebnblaheoafcg	FALSE
iemcnnaepbgiaglgdboj	FALSE
ijpilhgjegfeglajpcii	FALSE
ipoolgbfolmccfogpnie	FALSE
jfcgpapfkimlaecildpd	FALSE
jkbifdafpidbmioknili	FALSE
kagdiaeodmjgeohigjlm	FALSE
kfnghjkiflklbimlbjcc	FALSE
kkjbilohpojcnhagjoom	FALSE
kplagoffeikhapknlcfd	FALSE
lemmjkgaomefppfepcje	FALSE
llapgopmpggmngjmjljg	FALSE
lpmcoiamknbhodkelhaf	FALSE
mejipedkhapacehegofk	FALSE
mjdiicbdndhhaemaalhm	FALSE
mnnjflollabfmjilbhib	FALSE
ncobolbkojchekbnkbge	FALSE
niebfbomnlmikiboench	FALSE
nmimmfjjmiibnkfihocc	FALSE
obpcaooeeallmojhkjom	FALSE
ognpghpajfilfhhiglgf	FALSE
omckjiaofeiobfhpeleh	FALSE
pblbiajgjkcihkbeohej	FALSE
pgfbalohdjlmfokcbcco	FALSE
pkkdkjaeiccmgahfdgfg	FALSE
aaaaabaapcfeeadonmkpl	TRUE
aaaaabfhcjpgcpfienmbf	TRUE
aaaaabkfldcianlihbfmg	TRUE
aaaaabnpnopceokaghcaj	TRUE
aaaaaccgiklonlpkbcfhj	TRUE
aaaaacgncjehhfbbflhil	TRUE
aaaaaclebcboiebhdkclb	TRUE
aaaaadalpnpmbjfapfdih	TRUE
aaaaadfkiijgfnbiheecj	TRUE
aaaaadkkmbkdknieiiand	TRUE
aaaaadpkpbjkkoekfinid	TRUE
aaaaaeeojlkjconfaepjd	TRUE
aaaaaejkmnepdnaacghbi	TRUE
aaaaaeoffloofdgkfhold	TRUE
aaaaafeacdmijbhnlcflc	TRUE
aaaaafjefiaaflkkgboen	TRUE
aaaaafnonemgpnbjgikha	TRUE
aaaaagdbffifcigombhli	TRUE
aaaaagibkiheeohblohlb	TRUE
aaaaagnmccmkpmdmegdbd	TRUE
aaaaahckaodddnobmgebp	TRUE
aaaaahhlbffpgomagbacj	TRUE
aaaaahmeddmmacajaaddl	TRUE
aaaaaialbopcojkjkofbk	TRUE
aaaaaifekkbnbkpbpcpal	TRUE
aaaaaijkoobdheeifhehd	TRUE
aaaaaiokpanligjpahfpm	TRUE
aaaaajdpbaghnbcmaebif	TRUE
aaaaajiieabbaaoggigik	TRUE
aaaaajnjchabddmgbegfk	TRUE
aaaaakcamjcnjocjnpmpp	TRUE
aaaaakhcpihnfdfmnlnmc	TRUE
aaaaakmhdiapelkbcadec	TRUE
aaaaalanmokjcifggpdic	TRUE
aaaaalfoddbdhoppbjdpl	TRUE
aaaaalkmpobnjbddglalg	TRUE
aaaaaloklkggkijeallpj	TRUE
aaaaamdnefefdmhgiphfl	TRUE
aaaaamieidbgfbpafodlb	TRUE
aaaaammlenihnmklkkomk	TRUE
aaaaanbhhblbihmoaefoc	TRUE
aaaaanfodnlophpmnjoia	TRUE
aaaaankoinjabnoampjoi	TRUE
aaaaanpphelhbfjolohel	TRUE
aaaaaoechimdlhbldngjb	TRUE
aaaaaoimemeeccogejlln	TRUE
aaaaaonpmpppkhjhbbmdd	TRUE
aaaaapcgppdhnnffbnomd	TRUE
aaaaapgolkkmmgibcpfcn	TRUE
aaaaapllkodnbflejoicp	TRUE
aabalbkejkediaanfbnfd	FALSE
afmpjhhgndjhklhbnnmec	FALSE
alhdkmkbhapgoijdmbckm	FALSE
bagkkiaeojgfiikneipog	FALSE
bfghlaegdjacibfjehibh	FALSE
bkijedlkbognahakdbdid	FALSE
boljbipaeempbfhdgipgg	FALSE
cdhjpmcfjedmlamdjfimc	FALSE
cjhichdanlpelemooidfd	FALSE
copjklkgcdmkdhaodekma	FALSE
ddjjhkamclhhpkpofabnn	FALSE
dihplcbhdgimcmeolobdc	FALSE
dnjkcmedmjhajjgiloopi	FALSE
edmcjlijpgmodbkihjclg	FALSE
eieapekeeiohfhecfobdm	FALSE
emijpnmleelglpmgnmagc	FALSE
fbhpplanoenfjnbkhjppg	FALSE
fgcgjnefbiabollbflbhf	FALSE
fldklhjldibgbjokaeogh	FALSE
fpjnadeanbldiahiaanoe	FALSE
gfhfpinlaboobmhnaaijc	FALSE
gkcafmfbbcmmjejeekcje	FALSE
gopgnppibhpdknmiepnbi	FALSE
hdmalnklecnpnigbieoci	FALSE
hjamibebbehjkpgfjailb	FALSE
honpabljfbofdjnlgofii	FALSE
idjpffgooblnohmcfnpgp	FALSE
ijdgacjknaohlddcgoeil	FALSE
ioejiilheiilallkdmgbj	FALSE
jcnbibchblljfdmhocflk	FALSE
jhojmakinpnlbflklnpab	FALSE
jmkjchncgicclmpnbcbgc	FALSE
kccmfjhmjholjabfjjegf	FALSE
khnbehoocphkdfdoogllk	FALSE
knegejphemjoadpefehpg	FALSE
lbjkooabmnimpdlalmlbc	FALSE
lgnnfmfafcppocfpphboh	FALSE
llieicngnhpcnagojflfa	FALSE
maneoecjfojddlffjgkcb	FALSE
mfnjfggedklimomilmenh	FALSE
mmljbpcdpehkfdemgbplb	FALSE
ncibmilcmllnnfikbbali	FALSE
nhffidppkblfooobacfch	FALSE
nmabjdognpmmefmbjnikh	FALSE
oblfflbbckglhfdgbfmfb	FALSE
ohannpghlhmfkjlocajlp	FALSE
omefmhgoeegffkmpnlnog	FALSE
pakhojpiloaejcpjhmoen	FALSE
pejnnncjnicejidchldlc	FALSE
pkbcpfeabafmbbfppmnig	FALSE
aaaaabaabgcebhmjhbjlob	TRUE
aaaaabengjiajmnnochnaa	TRUE
aaaaabjnccchoglknfhehd	TRUE
aaaaabojdipcldoiimllfd	TRUE
aaaaacebolhfepikbplbaa	TRUE
aaaaacimggjpjnpgfjiblj	TRUE
aaaaacnjcafecieggbbhle	TRUE
aaaaaddcbdgiefplcalfhp	TRUE
aaaaadidfkamaiedlkbbdj	TRUE
aaaaadnbhakpokhaambnep	TRUE
aaaaaebjgoaaodkjpinkid	TRUE
aaaaaegdhaljliedlmalpk	TRUE
aaaaaelbopgoojnecncfig	TRUE
aaaaaepdlpnhcpdcpabead	TRUE
aaaaafekngfnhnngjhljnf	TRUE
aaaaafjbfkjoceianfdkdb	TRUE
aaaaafodfngkgljdmdophb	TRUE
aaaaagchccaiojlpoongif	TRUE
aaaaaghcgnnnkloobgjhjk	TRUE
aaaaaglkjljjobhpaagomh	TRUE
aaaaagpnlnioellhfbfikm	TRUE
aaaaahelkdfjnjfeidomfm	TRUE
aaaaahjboidfdacdlleadh	TRUE
aaaaahnjcpidbochmcaajg	TRUE
aaaaaidfbiedncdbppdbdj	TRUE
aaaaaiideinacfgklhdnie	TRUE
aaaaaimnploobmdfhjohop	TRUE
aaaaajbgmhihcllliffmgm	TRUE
aaaaajgafeahcelaliagkl	TRUE
aaaaajklchingpgdnbimoa	TRUE
aaaaajpnfkfepkbmddngfb	TRUE
aaaaakepbgacomhckfaphc	TRUE
aaaaakjcebagnmjbljkpjp	TRUE
aaaaakobleggafcecjclll	TRUE
aaaaalclfgeigejeechcka	TRUE
aaaaalhcekbcealdfikiif	TRUE
aaaaalllhefhgkdoehalpp	TRUE
aaaaambgnbjbpmijmjcldn	TRUE
aaaaamgklhjfdekjlbihdn	TRUE
aaaaamlghoailjpncedfgb	TRUE
aaaaanbdfkaohcehoennjn	TRUE
aaaaangendmglkkmacecnm	TRUE
aaaaanlhpedhpcanlkpbco	TRUE
aaaaaoadfnngiijoehpgfj	TRUE
aaaaaofblepbleckaaheho	TRUE
aaaaaojolocgaihhgleofc	TRUE
aaaaaoopohkfmhioefgekb	TRUE
aaaaapdbnbeapengaobdai	TRUE
aaaaaphieiapibehmoehfk	TRUE
aaaaaplefnjbemmnbiacae	TRUE
aaagbadpehdcihjhodeiin	FALSE
afjklobjieoehcknhhfcpb	FALSE
akhffehndggonbppeeehlg	FALSE
apfahfglbhbcoknlkiagpe	FALSE
benoljkiodiidodaanbeda	FALSE
bkekgjacfjplclpbhcclek	FALSE
bpoddmokhmoefmklpgmjml	FALSE
cfamhjgmjdpmbjfaepmgmm	FALSE
ckajinidmfgfkfkbmjgegn	FALSE
coppmhleoncgfeooflhbgi	FALSE
deajhnkpejoloflhpggjia	FALSE
djglcfeegajkpamocbmilb	FALSE
dogphljpicbnachobcjghe	FALSE
eejfcjgjcdghhcdndedmof	FALSE
ejicgapjdihmcpjncfkeeb	FALSE
eohppbmfmhekbndncccegm	FALSE
feinbpbfiecpenibppfbeg	FALSE
fimhohejhhnojlfaenfiff	FALSE
fnkmlaombpcgpdiabcncja	FALSE
gdcliicfkppkmfkgdcdjhf	FALSE
gidmmfbdgdaglfpafaaomp	FALSE
gmppmpakhgiieglpkckogf	FALSE
hckaddphepkfccebipmkpl	FALSE
hhdfknnmlmiecjpplnlhfl	FALSE
hnifgbbnkefeonncdmgpek	FALSE
icgpilicehcnpaggklpngm	FALSE
ihfjfaieffjialeenhdepi	FALSE
imnjhnpifljflogilmgpam	FALSE
jbommfkcebmaoelokfjfej	FALSE
jgjgdeklcfkeemiddadnjj	FALSE
jljmlbgcfjdbhcbekfnedc	FALSE
kahipgbhfiddajoihkenpi	FALSE
kfcdccjfjkkffbaldgfkap	FALSE
kkdpfafkdblbealjgbbbap	FALSE
kphajkkmnjcljfdhbcompa	FALSE
ldoigpjgkfiailojpikfgb	FALSE
licabanfngieohpeaccamp	FALSE
lmkepgnfapbmjfpjgiepmj	FALSE
mcfgaakcmlebhgiogeemdd	FALSE
mhhjndabbhgoiepjbmadim	FALSE
mmhcjdgoinaoldheokgkjl	FALSE
ncakmbfkkkhdemjibbkink	FALSE
ngogokjfghmnjaehcchgde	FALSE
nmediigedfpldfpahppgmd	FALSE
occknijfgmahelpjkgmepf	FALSE
ohcfbpbcopfdjfdebabeem	FALSE
omldphkneleffcgpgnhpmn	FALSE
pbimmjjmnpenekflbcckhk	FALSE
pgknlepgdjfnkianjpciag	FALSE
plbfcecfgmopbdhppfdhhe	FALSE
aaaaabaackckkpokckaalnd	TRUE
aaaaabepghmpnoegpnhjabn	TRUE
aaaaabjmjilbkchffigpcjd	TRUE
aaaaabonjpljelbflhmboeo	TRUE
aaaaacecdpnonebljfdhnhl	TRUE
aaaaacjjeecfkfmmdikdjjk	TRUE
aaaaacoigaolbhgejkbmllk	TRUE
aaaaadclhbaenooobcnhbhh	TRUE
aaaaadhegihgahafhmkkjoh	TRUE
aaaaadnahidcmckpcjpaemd	TRUE
aaaaaecdillafkmemeffdpn	TRUE
aaaaaehpmlnmolddidfcllf	TRUE
aaaaaemofbeggjlmoidggfl	TRUE
aaaaafbhhidmhjlnkpoapmk	TRUE
aaaaafgaffdobodndcmgfce	TRUE
aaaaafkoajiedgdginjoknp	TRUE
aaaaafoobcnjelggcfkoojd	TRUE
aaaaagcnjhkhkcbkoogcmap	TRUE
aaaaagickpmfchpmoodebjb	TRUE
aaaaagnffjnanmcnfjjhbjd	TRUE
aaaaahbpakpaamoeoclnknd	TRUE
aaaaahhbcmnigaddlmdehjg	TRUE
aaaaahmacpdhpodbdlmapai	TRUE
aaaaaialamhjdhlhfmmiglo	TRUE
aaaaaifapkcibjmbbgmfhki	TRUE
aaaaaijdhfliddijgdkdjcl	TRUE
aaaaaineeemfefpcbaobkgp	TRUE
aaaaajblljfedmcjgeejgki	TRUE
aaaaajgmdjegphgnlbdecpn	TRUE
aaaaajlinnglfjlgddeajci	TRUE
aaaaajpophijilhcnhnkdib	TRUE
aaaaakfehabjnjpbodbljma	TRUE
aaaaakjpphigffbenagmada	TRUE
aaaaakpmgijedoapmiejhah	TRUE
aaaaalenlkppkhcfkoidill	TRUE
aaaaaljpmcdelmkghfiejld	TRUE
aaaaalpbfagbeklmfmdiaid	TRUE
aaaaamdbaemnooioccfenam	TRUE
aaaaamiiphjhmpfebeofhjp	TRUE
aaaaammkimbmjlnhgegcmgb	TRUE
aaaaanaoijehdkkafdcnpaj	TRUE
aaaaanfobpmpmabgbnoljei	TRUE
aaaaankmnbcmcpbfmgnhhjl	TRUE
aaaaaoaciffgcbibcglcano	TRUE
aaaaaoefooldjedagjccjie	TRUE
aaaaaojeahikbjpfpcjaafk	TRUE
aaaaaonenlboknebdpdlckf	TRUE
aaaaapccbghogmeglkgpdkd	TRUE
aaaaapgkipbllniibamcblh	TRUE
aaaaapldilajgldkggfcdge	TRUE
aaalboppbeaoimphnbfnkoe	FALSE
afklidpimlnifkgghpcbdbo	FALSE
akgpgllbohkiecnleabjibe	FALSE
apbppbnjaodacioompeabfk	FALSE
befaanmjlollgnlloiefcjb	FALSE
bjkgeffcageaejahbfgiiko	FALSE
bommpleoeepedeejlkdelcj	FALSE
cdodbfdinpdiamjjdaiogam	FALSE
cjachflmefiahbebjhomggd	FALSE
coolebchmoakcgmckaahgan	FALSE
deehabhjcifcbojkhkcoifg	FALSE
djnnoemooejglhfmkgfmaen	FALSE
dolgkjemlfenafjfonipblj	FALSE
edjgobbfgjmbpefcnppggnj	FALSE
einhecapeddmablflnnlkde	FALSE
eoecblofnfgbhdjmiopgmjc	FALSE
fdhgkncbcjbnafffipcdpnb	FALSE
fiobkoninpeebpkklkkadkp	FALSE
fnalgdffelbbdkjbbkilfdp	FALSE
gbglinmckflbopfdjjefebk	FALSE
ggobkdcgieipmlkijoiilci	FALSE
gmfilkakebalkpmgnolbihn	FALSE
hbepdnpnpkchoenoikjgiic	FALSE
hhgkihbbfakfbdagamidkii	FALSE
hlgodnbijmebkpbmkafglpn	FALSE
iajclncmbipemfiomjonili	FALSE
iffkeilipdilhicmnncennh	FALSE
ijhdeelodpgodndjfkmepem	FALSE
iocppdcbmdaojbbdjdfdikj	FALSE
jdddgdppfjdpmjdbldlccpa	FALSE
jhkdfngjkmhnnnlaiagcfak	FALSE
jmnaocmnnggmfcgnlanedbc	FALSE
kbpcepnkfipdhegoldpahom	FALSE
khhkdfoaeiphfcajdahkfde	FALSE
kmidcdgfcnohkcckdghhdbj	FALSE
lcjgmnhbmncgpoamcikagde	FALSE
lhhidafebjgmgecmapcping	FALSE
lnbffleiiogdgdflddplolb	FALSE
mcbkdlkpjijpjajifiekplh	FALSE
mgiiokkakagkpbjkohpabad	FALSE
mmhiahpnjiokipnncghhmgm	FALSE
nbnofngebkckoccfoghbbfp	FALSE
ngpfdjhglemjnedanlkdkpd	FALSE
nlofeoaldimcbcfcejbenkp	FALSE
objmcbekpmhemngdndihbdd	FALSE
ohlknfnnbmfhmecjodcplco	FALSE
ombkdaaliahlpdhfafolodn	FALSE
paoolgcgepelkjkohogkmbn	FALSE
pghkofekedpccbmaojebebm	FALSE
plobdpjkfojfpcodfklopok	FALSE
aaaaabaachlkmpdaaffokobh	TRUE
aaaaabfhfamnoiijcafpoidl	TRUE
aaaaabkeojlbhnomggebihlk	TRUE
aaaaabojahlbaeademjddcja	TRUE
aaaaacdlmbepdaicdgkpabme	TRUE
aaaaachiajamncjlgcbbdidi	TRUE
aaaaacmkpgipeioechpmjoej	TRUE
aaaaadbkbnleoogahjcafjjm	TRUE
aaaaadflemkcclnoaikgjinf	TRUE
aaaaadkedcklgfdjonfgkjag	TRUE
aaaaadoocedjifjoebfljfmi	TRUE
aaaaaedbbeombfnaaoleafpa	TRUE
aaaaaeikpojlgjelafnbcjpc	TRUE
aaaaaenipbmampppkgdfcpmn	TRUE
aaaaafbmplanggplhnednkkm	TRUE
aaaaafgakdladbknmkklejma	TRUE
aaaaafknkdkilkpclfehkplf	TRUE
aaaaagabbkdjcclbfdamakbe	TRUE
aaaaagghcigcdkkockkphpfe	TRUE
aaaaaglclibjbfahlajafphl	TRUE
aaaaagpafpglklcakcoplada	TRUE
aaaaahdklilpkndkhlbibmng	TRUE
aaaaahhpjepmdldffegndmgl	TRUE
aaaaahnbngaghcdjllddfmff	TRUE
aaaaaiblefbljdecjonnngfa	TRUE
aaaaaigljoffldlfjienbhig	TRUE
aaaaaiklnblllnllajkcnfam	TRUE
aaaaaipbjamcelhpmiccmnpi	TRUE
aaaaajdofjjflkjgajkgfapb	TRUE
aaaaajjkefmfflblpophdblo	TRUE
aaaaajodnpdhigngigoediaa	TRUE
aaaaakdpainjlokpeoodinoc	TRUE
aaaaakjefpkilopcnkkbijej	TRUE
aaaaaknnlebohaenkjgccllo	TRUE
aaaaalclnlijgiolpnldcoml	TRUE
aaaaalhfcecgooabejencihp	TRUE
aaaaalmapepmominhcblplah	TRUE
aaaaambnengbkogijfhiblin	TRUE
aaaaamgjlmakfanacgamlflp	TRUE
aaaaamkpjfnfanoclpkbhjih	TRUE
aaaaampllohnmhlmgckfbnof	TRUE
aaaaanehboagihagnlkaahoh	TRUE
aaaaanjkfcijjbbdjkmndpig	TRUE
aaaaanoafbfeacceapdjogeh	TRUE
aaaaaobpbkdnfhdddchhldpa	TRUE
aaaaaohkpacbdmdkhhmakflb	TRUE
aaaaaomaakkbfjgoodkdoknp	TRUE
aaaaapaooadhddbefddnbjnc	TRUE
aaaaapfmpgfjkblajnpndgbf	TRUE
aaaaapkecmceejhcjdidffgn	TRUE
aaalagkcchlonijhooamploh	FALSE
agjeaabokelbgcaaldimcoep	FALSE
alkphnmppdoafmechhamcmfi	FALSE
bajgekljapajblfgabkhiapg	FALSE
bfigonadipigkepmcnhgldeh	FALSE
bkjhjodmppiiajfhaiffefkp	FALSE
bpledommjgenpdfilbfhohbj	FALSE
cecfnjhddfdhhldaafdmhenp	FALSE
cjbkcfihnlnddnadnkpfbmjg	FALSE
cmjejjnomiifpkhajabgijdk	FALSE
dbpbgjhdkabioipejiahmbbe	FALSE
dhkblcepfmhjnajmlicmclff	FALSE
dlknklcfbcoioikiifimfkom	FALSE
eaiggmmnoamkahhabckiijdj	FALSE
efomepglaniaepcalhkglpgk	FALSE
elmmeegdcafepjamlbmnmplg	FALSE
fajlllhnofkeechnfpcijmkd	FALSE
fffbhadbbipgkblichocdhnd	FALSE
fkkjdfppeogommibdfhehnbi	FALSE
fpkkgfgjlikcoeibmaleekgo	FALSE
gefhphohjddhjaaafeojckhd	FALSE
gjdccdlmjilgjcdnfcdnjccg	FALSE
golhfmgcmmjhfbebemaoekbj	FALSE
hdeacgcignhclnjoabeadhbe	FALSE
hhondpcffdljfpfjfcfpikjd	FALSE
hndmegeankmcogimoikfbnln	FALSE
idobaeacjookdcbfhbbmnjgo	FALSE
iiloffefbaflmklibgcipffe	FALSE
iofpakohlpdmehnpkiknnmjc	FALSE
jdlenmmfpoljpdcleibgfoae	FALSE
jienhmhfabadjioiicfieklj	FALSE
jocgonemicidjjnccbcnmcom	FALSE
kdfgiihbeiegdjodnnfgmelp	FALSE
kiaaaepdhofgcncgbelelkaa	FALSE
kmnfdcgkpoedgklpgdlkmddg	FALSE
lbimadmnfjneejlmipiglgan	FALSE
lggomhfnkhjmoagbndoenghi	FALSE
lljjdcnhdhpjladglamegabp	FALSE
mbheeeonkmfpmgjpgaeaglho	FALSE
mhcnenfkbnhopnibhckbbhlk	FALSE
mlmmeidngfbapogbkanckkgd	FALSE
nanblgemjlobpffmedfliknc	FALSE
ngacghbbhonfjibjpmbabjdj	FALSE
nlfoponljbflaamlneekhoag	FALSE
oamldkodooghidpoljnmbodp	FALSE
ogjihnpeccmckoahefmmhfbl	FALSE
omcapecpodafhmokoppfmppg	FALSE
papgofpiihbfnnplogknolej	FALSE
pfpiedmmhmngjailechgbeik	FALSE
plckglcefhlmfhegijijpblc	FALSE
aaaaabaacihcaefkidejbfhob	TRUE
aaaaabebkkcglnhbloakkccid	TRUE
aaaaabjdmmobojofjneenhhkn	TRUE
aaaaaboibimlggbelmmipknkl	TRUE
aaaaacdgnefdelejbjmadfflh	TRUE
aaaaacidlbdilimfnlghpmfee	TRUE
aaaaacnifcfpeodnekaekfpef	TRUE
aaaaadcepijhooliifjcokehp	TRUE
aaaaadhfimajfibjcednjohfi	TRUE
aaaaadlgfdkhbfdmlnkoobbbc	TRUE
aaaaaealpdadahajpneoeanfh	TRUE
aaaaaefhcnfkjlfeapekfmjcm	TRUE
aaaaaejomlikapljdedkedgnb	TRUE
aaaaaeoepjeimgagaplopbcno	TRUE
aaaaafdffknkmggcekbipddee	TRUE
aaaaafhkoeomccmhadniinijo	TRUE
aaaaafmcfpjekjhekfiaacmii	TRUE
aaaaagakdjhpbefclkinebpmj	TRUE
aaaaaggbcdgddgpdpfmnibdba	TRUE
aaaaaglkkgpbemjmeakfpgggl	TRUE
aaaaahakkjkhdmjkfenhmcckm	TRUE
aaaaahfbgdlfclbnbcogbhcli	TRUE
aaaaahklkdmfjclcgbhdmnpaj	TRUE
aaaaahpmffppkkpfgelpnongn	TRUE
aaaaaifgggeecfgekdfmbllak	TRUE
aaaaaijgpckdlpfaepenailld	TRUE
aaaaaiohjmkebhjjgdidiknlm	TRUE
aaaaajdonlnpnhlbikomighje	TRUE
aaaaajigibliejnjabneeodjh	TRUE
aaaaajnchcmjidcpalopddfkb	TRUE
aaaaakbhbijjiihikojhaooph	TRUE
aaaaakgafacafhlnnefpcmobe	TRUE
aaaaakleecckkkdlgccfdmhle	TRUE
aaaaalacdghdjeofoanpcbdbe	TRUE
aaaaaleklgdebahdhipbmbnef	TRUE
aaaaaljphdhmalcjnnbinhlhd	TRUE
aaaaaloceaicplmanndopmbhg	TRUE
aaaaamcmhjekncohoembkalgj	TRUE
aaaaamhiplncolhlmdhdieann	TRUE
aaaaammcdjcbmiekmeinnljlb	TRUE
aaaaanbanmdbfalcipmccmmda	TRUE
aaaaanfjkokckcjhfmaonfedb	TRUE
aaaaankabkkjakelbelefdaij	TRUE
aaaaanoldknlffckfcifafbfm	TRUE
aaaaaodfdfigigmfjnccdbcap	TRUE
aaaaaoipeohadehpoiomkdgid	TRUE
aaaaaonghbgdghealnmhkhhdl	TRUE
aaaaapcafnjleaeeogonbcihj	TRUE
aaaaapgmkfhfkjhglhjlldbmp	TRUE
aaaaaplofhmkomakicdpndgfl	TRUE
aaaieaemncnjlihibdmhcbaca	FALSE
aecpinhblcjlajeclgmbbdldc	FALSE
ajicpemedfkhbpgplggfkigfo	FALSE
apjjgbkmjgchahaapefgldkdg	FALSE
bgaecehkfhifcfanpfgfmhmhj	FALSE
bllddofcmjjcjopidlnjpjmae	FALSE
cbgpflhiilfhamliplbkdnpgp	FALSE
cgkogdlddepkfknoainopgbjb	FALSE
clgmecmjjilohchfaadccioia	FALSE
dallifnjndjckpafmmhjnmecd	FALSE
dfnelbbholjblkkaaobjkofkk	FALSE
dknjkgghnhkfapmmhmndmhcio	FALSE
eabnanohhonjnkigeclgnmomh	FALSE
eflclliocajkgfkkjldbbllai	FALSE
eknmhjhhmfmoddfikfgmgglkk	FALSE
epnbhdgapkigiidhdfhlpfkda	FALSE
ffdiolphagcnibmocmljjebmg	FALSE
fjnmjljfgehgbebhomepgcdhn	FALSE
fokabhojagooikiloilblnbmh	FALSE
gdibmfnoapjnilkiihpfdpjlg	FALSE
ghgpdmpkojogdmfnkkejnelcn	FALSE
gnebmmffgnglpknhgncdfnaah	FALSE
hcgpkblllhoepijhfigdmkkna	FALSE
hijcegipdpfmbnbindhhehbic	FALSE
hoeldoefglaljiighakmdpfia	FALSE
idekhfkljmcepoilohmlppcfn	FALSE
iihebfkphlcfnplllifgkkpeg	FALSE
inljeefgidbfbcjiaakgmcjmp	FALSE
jcloglgkelkggfdjcmaefmcmk	FALSE
jicjcendjgnjcjceomcmkomib	FALSE
jmfnfojcljgffeopoibjdnkcm	FALSE
kbgbjkffdaebienmpakiemmof	FALSE
kgkfnnchlegigikffhfgdkmoe	FALSE
klijeehniphhmbgoeffeohnfn	FALSE
lanagfimackoeeemgpnbkngaj	FALSE
lgconkdakofinobnedeggjlbb	FALSE
lkkdgjohmmapamnhngcndcpdd	FALSE
mabhpmghfjnclnpmbgecfckmc	FALSE
mefbnnfkgafiklmglhlmohifk	FALSE
mjbobofcmakjcgombmnlgpfni	FALSE
mnpdmiejcefnfkgecmamkmhhn	FALSE
nchhnmbpfecnjbfleiaoblflh	FALSE
nibgdkgaamgfjamejhldenamd	FALSE
nmnficgiebipebbjeieeamajk	FALSE
obiakmdgobbchnpakgappapid	FALSE
ogemoofdmjmaelajcpnlephnj	FALSE
olfdbcejmdegodkhnmkndmabd	FALSE
pamkjnacijhlollgclkbpiaii	FALSE
pfcfkaeejeejghfbdpgfbeamh	FALSE
pkffnakodkeelgldklkfkonaa	FALSE
aaaaabaamgakbpffaknfmjapmp	TRUE
aaaaabfbgjfdgaflghgidodona	TRUE
aaaaabkbcjahpapmiagnnhapnj	TRUE
aaaaabocihjnbheioeaeaklggi	TRUE
aaaaacdigpdgpkcmbbgenjnlbd	TRUE
aaaaachmpaapchfhdmpoglppfm	TRUE
aaaaacmjfhcgldfdnllodlpjnp	TRUE
aaaaadcpeldgphgpiakjklhoga	TRUE
aaaaadibhdelfakllifcjnmocb	TRUE
aaaaadmlmgkhkjajdagpehclih	TRUE
aaaaaebolmehlcjachmfaijdfh	TRUE
aaaaaegplcohjbpnnganbmijho	TRUE
aaaaaelimefhdmgljciieoafnk	TRUE
aaaaafafcpcmdmpekcmicagfgh	TRUE
aaaaafelggiggkfnogfcnnbbaf	TRUE
aaaaafjajkjigokkbfcjfkdhhf	TRUE
aaaaafnkfhedjbbgmakchpkobm	TRUE
aaaaagbomegdjkhhhclgdkdgfl	TRUE
aaaaaggglnkdgdlboknbdjipfl	TRUE
aaaaagliadlnkbecjnldopgcpm	TRUE
aaaaahalijeeifpbjelanaeofp	TRUE
aaaaahfjgkkjgngglobpnlpnkh	TRUE
aaaaahkehmiichpafmlaokndpd	TRUE
aaaaahpjbjpdldmlhgcpinkppd	TRUE
aaaaaifapkdbbneclcepkjdhcj	TRUE
aaaaaijdfphkiabchjcefdnkgi	TRUE
aaaaaioaanfbmdgmcionilcloe	TRUE
aaaaajdgdnpbnjojjidlpblgia	TRUE
aaaaajigdjhlcnkmjjjkeohcnb	TRUE
aaaaajnkdkghlkklfmpgbefblg	TRUE
aaaaakcpemdadleabfckjmefcj	TRUE
aaaaakhohnocejgihkngdnmcho	TRUE
aaaaakmlppnlfflckcaalbgamn	TRUE
aaaaalappkjlbkohdkbnebfnbl	TRUE
aaaaalgbobolbnmobjdjoegidm	TRUE
aaaaallgmjfokimpapnknncmdj	TRUE
aaaaalpiljehebekbakmgmkehn	TRUE
aaaaamepjomknkljconleledki	TRUE
aaaaamjjhkdomnbmkdaihnmahp	TRUE
aaaaamoodlehmoclheeajbiefg	TRUE
aaaaandknmglhdnfedjfbpking	TRUE
aaaaaninmnkhhbfjbjbdonendc	TRUE
aaaaanmneolkgenmkgncncbfmi	TRUE
aaaaaobcnhpabmapmjfnlnlncb	TRUE
aaaaaofggnjcobclaebfcgbcfl	TRUE
aaaaaokgihkeljoigipflgcmge	TRUE
aaaaaooplgkapecdceklondjhb	TRUE
aaaaapdjnopimggdfnginfplem	TRUE
aaaaaphmbdfndaojpeambncilb	TRUE
aaaaapmbiagjojegcnpfocgoon	TRUE
aabeeihemophkdiooejmhgjkjm	FALSE
afhbjielpkmaiblllfeknfmcfd	FALSE
ajobpodblnbhmhededhmgkkmnp	FALSE
aonmmnfnpakiafkdngnaihkakj	FALSE
bedkmohkfbjjjaeehbiiplfmlk	FALSE
bjgpndfecnkgpagmcnlbjhjfbl	FALSE
bphdkogbdhjgkihbacfmnnnpmn	FALSE
cejllndijhkpbkllcghhdjanfm	FALSE
cjmjebdhkpanpebnknpcnnogln	FALSE
cpfbgpkphifnmdjbdojhdffgoh	FALSE
demjjbiaiigknghcanjbmiacfl	FALSE
dkcgcbaicjkbfenlpdjlbbdknp	FALSE
dpjcjkpcjchkpeiacppgdnbmih	FALSE
eelcnfjlmlhjedklhncplgfanp	FALSE
ejphblecclhabpllfegfpeffah	FALSE
eoiapgapmbmfadpofaibjmhnck	FALSE
fdligfcnnophficigkgcofjdfg	FALSE
fimkgikjeodmmgpgipjhfknmmh	FALSE
fobhhnnkebmbbemajmjjfbclhd	FALSE
gebehocghcdioofpnombkkilfp	FALSE
gjmjnafjaehmgkfidpmeplhfcj	FALSE
gofobedefbebkkmbmkhhedlpfb	FALSE
heeiajmpiibbkhjaklalecckak	FALSE
hjoadafbhgogaghdoicebifbea	FALSE
hoimbjmeklgjgfoldcdjiamphn	FALSE
idbdgkcpebchllbcnodpnjddjl	FALSE
iiahmlbjhkmfkpilcddomdbbje	FALSE
imjeppnaofmeajfndinhpgoefj	FALSE
jcckgdgambignanoleblfikhdc	FALSE
jhicmfhbbpmjghdconengjadam	FALSE
jmknmnpnibnkflpjiolgafdgfd	FALSE
kbkpojdgdnhajgcfchgfidlnfe	FALSE
kgmngfoehcflcmpobkdmcjmcfj	FALSE
klijkepgldpbdgnnnnohhaomji	FALSE
lakcmpclganpjemgffbpahpplm	FALSE
lfelggidmgmeiccehjhaenpoed	FALSE
llbjehnofcaalfbgcbkkdimgpa	FALSE
mabaongoencfklfmbkhglpphoe	FALSE
mepggjnhblcfeldcgaipacahni	FALSE
mjeifajokkckeldggmlkagdcik	FALSE
modnfkjpjiegmbdbakcmpjeogk	FALSE
ndbcoldeaaapeinnakklddmepo	FALSE
nhlofdpbnlepndmjlpmidkgmpf	FALSE
nnmalogijgbfnghpkijdfhfndb	FALSE
odanobfncniibcebgdojfegfao	FALSE
oiboihdkhmlkldddgpnmnppegp	FALSE
onaihjdpjbofpbkojjjihnlflc	FALSE
pbppjkpogoacleanongiebeaen	FALSE
pggpgklekckioillpainddngaf	FALSE
plgancakipfhpmlgedkjfcmbll	FALSE
aaaaabadfogojolobcagfaiejlf	TRUE
aaaaabejalpghiaddakligmnbpn	TRUE
aaaaabjeeafdikkepfpdidphkii	TRUE
aaaaabnncddhnmhdebpcciebocc	TRUE
aaaaacdbijnibphcjilfkbpjpno	TRUE
aaaaachkkgoagmblhjkbehbbgih	TRUE
aaaaaclmiolabnjdkkigeoanann	TRUE
aaaaadaemaiiiepbcpckgcadade	TRUE
aaaaadfbmfnmfbjkpdnodkgdfdl	TRUE
aaaaadjoeaihepheocbdnhcaabg	TRUE
aaaaadpbgkhlpelialoegjdapna	TRUE
aaaaaednjegpklcnhkihddeljip	TRUE
aaaaaeipfihagbdcoieoijnggdf	TRUE
aaaaaeojdncocbbcbhpfifjgfgp	TRUE
aaaaafcmgijlibdmkdfbekdkgfp	TRUE
aaaaafhpalfgcepkfjinggpfaeh	TRUE
aaaaafllmkimiimfdbkgnidncee	TRUE
aaaaagaepoadgamaehmdghmjlod	TRUE
aaaaagfmfljjabkphlcllfkfkhh	TRUE
aaaaagkipgoenecppdkmcichibf	TRUE
aaaaagpeeoeodlillgemindhaff	TRUE
aaaaaheahcdifehcmcdgaeefkac	TRUE
aaaaahjfbddindfffkcfamfpaob	TRUE
aaaaahodoclmjlmljoadelgnbck	TRUE
aaaaaidccfhoeoeaecpjbcdmdab	TRUE
aaaaaihnlknghfhgfnlbamdfnca	TRUE
aaaaainpoapjdlcbccompmincgh	TRUE
aaaaajcnnmbohogbglnpnopbgad	TRUE
aaaaajhiiillnmaoildjcjklpkm	TRUE
aaaaajmalnhahhpccmgljjlgcgh	TRUE
aaaaakanhfgdalachpoaodommbd	TRUE
aaaaakffmhkkidlcnahmlpapngm	TRUE
aaaaakjpmnkegjnnlineknnolao	TRUE
aaaaakokkghfbiobmmiinmlcbof	TRUE
aaaaalcpbmncjgbodknjbahpnmc	TRUE
aaaaalihllpabhmjddlpkpcaggc	TRUE
aaaaalnaahnllnhdnahfnhckimg	TRUE
aaaaambpdlbobnicceeafjlofod	TRUE
aaaaamhjpjgjpaaiombjpchjmih	TRUE
aaaaammjalcaaehnkmijfcbcnkn	TRUE
aaaaanakkiojelmnkdfjjednlhi	TRUE
aaaaanfjceahlfdnkhgfgjbpnjf	TRUE
aaaaankjdmahdpocjoganeagmjc	TRUE
aaaaanpdpmfgdglgomcjecjehoo	TRUE
aaaaaoeakmodegppmakmdflcghf	TRUE
aaaaaoifhmkccpnajoigpnnppee	TRUE
aaaaaonflckmgjeakpgfobdbfli	TRUE
aaaaapccpoapcddkcdaebfbknfn	TRUE
aaaaapglpgamgnpahpkhegohilf	TRUE
aaaaaplcpiiakemegnmfifimggk	TRUE
aabkendjnjggpdmekdlmgfgjddf	FALSE
aefblkphngcahhgchbdbfoalikc	FALSE
ajmifhjgkblhnmgaecahjmoinmb	FALSE
aolfndiokbaneloegjoomgglaao	FALSE
behpehebknbmfmadngofojpjkmg	FALSE
bikgahfoaeedkmgpimaiaomohoc	FALSE
boahhgkilljfiikpmmkieofmmoe	FALSE
cddoopmedjnbcedlcghcngmibem	FALSE
cjackmikhobgimmfndadjpbdcic	FALSE
cohcgpgfabhleoddbpmpeecgkjo	FALSE
ddbofffhpilcokcklchkiiijbha	FALSE
dieekijbncbedobcakfmnjpbhgn	FALSE
dnfagjhcbdcfnoolgifhcbgiecg	FALSE
ecbnmehanpfilkgloihonojahnn	FALSE
ehlhdfabcljekfdikbllbaolagl	FALSE
empgkgpjjoimfckbgiakojocced	FALSE
fcanlgiogifefoocdmlhdanjklo	FALSE
fgpcldldndijnnolahaghjndcdf	FALSE
fmhdodkggpijbhcmnnpicdnghke	FALSE
gbdmhnammhdacpclommeibffhic	FALSE
ggbfmalagjobdimeabhmdlmjnpi	FALSE
glkhcohgpijnoeeojkgjcnbhjod	FALSE
hagpeapedmedocenalbbcomlddj	FALSE
hfiapipeplkpdehnmkbboldhnfp	FALSE
hknidnimkkffjjfhhbjhmafijnk	FALSE
iafehhgmnjafjclgehbecmomecl	FALSE
ifiajgaeabbjjfbmigeggejcmbn	FALSE
ilfpmeopbokfpmkpobahloialpp	FALSE
jalpgdkjfkfccgepccdeapdcbfo	FALSE
jfjkblkoliepnhnijdlphdbkeom	FALSE
jlcnecgblmlfoaloflapkhfmoce	FALSE
kagjndpkdnmjedjomddipncehmg	FALSE
kencidpbghhggdpkgcclhbimidf	FALSE
kkdfcgggjebhcbdjhppbmejimae	FALSE
laembmfpfidjdoegdeomahnaapd	FALSE
lfhibdoeimlamnhhhkjblcchgmn	FALSE
ljmidbdeldnfhkpckcmhipclcda	FALSE
loionedmjehkifogdpdeidghmoi	FALSE
mdcmfmbfkegeafaaleojhnffpcm	FALSE
miodelakdpenklgohempkckibfh	FALSE
mnldacdnnkgopiafnakciedelgk	FALSE
ncmeebaeiddhbghjpnopcdgpama	FALSE
nhlbljkkifdldadfhfbmlogcjon	FALSE
nmhfaihlhclfmaobcgeijbjbjfe	FALSE
oblodleeiipncbjpjlpaemnhpgk	FALSE
ohfghhpopoppkcknlgmpfflcpdg	FALSE
omkknafijgmoaklmmmnpiapnndi	FALSE
pbpeejlolmopibbdlfkehbgcifi	FALSE
pgjncfmklhbipmoiickooghemic	FALSE
plgfnfobidpcejkcfnelacdhdec	FALSE
aaaaabaaeadcbcinecnfogndfkfi	TRUE
aaaaabfeogfmkboaaiomddllfbmd	TRUE
aaaaabkmbonkopcjgejhhndmikoi	TRUE
aaaaabpecjdikmfhhgaghccjhahl	TRUE
aaaaacdiblgfckjkmjgifiagnmka	TRUE
aaaaacjfcihoceeaddhbkapmhnpp	TRUE
aaaaacogkdkmloiebmgmalfcjaeo	TRUE
aaaaadeagcfcadpgniboegomdokn	TRUE
aaaaadiifblgphjkhikejmggilhp	TRUE
aaaaadnkhdnefleiaaolmjomeofk	TRUE
aaaaaecdneoeopokpnkeiabpppbf	TRUE
aaaaaeglakgjaaghjfcenkakeeel	TRUE
aaaaaelkffnanbjllhnnghmedjbg	TRUE
aaaaafajkkcninjkjlmmaakgpfej	TRUE
aaaaaffhpimkcmngmmjiobmhmcnn	TRUE
aaaaafkbfhicalofkijkeomcidkb	TRUE
aaaaafonnpacemhomdanogcmhhbc	TRUE
aaaaagdeookoeepnaonghnhblnnp	TRUE
aaaaaggnoffmimoloagechlkkecp	TRUE
aaaaagmaiceiiilobejojfbojohh	TRUE
aaaaahalcbcdocpfmidjkknhaigo	TRUE
aaaaahffgahdfacphpkkpcelelhj	TRUE
aaaaahkljhpgablejkbegmcpgfhj	TRUE
aaaaahofoagodgjkgapemmcabjjd	TRUE
aaaaaieapbhgjdggokiafbjpibhk	TRUE
aaaaaijapifmodephbaoeefmgpci	TRUE
aaaaainlhnnjchioahafomkciijn	TRUE
aaaaajcaplcjgafdppleickphjkn	TRUE
aaaaajhjefcdphgenkkdpckmlkij	TRUE
aaaaajmnigiihbephecpgnmpodob	TRUE
aaaaakbnkhbopchngjiikonbefgn	TRUE
aaaaakglhcgbeaejkgonnkdnbmjb	TRUE
aaaaaklfbijciacegldkpmajnibb	TRUE
aaaaakpkecjnapmkfmkfnkafhpkd	TRUE
aaaaalefmkibkfohlphhloagnhmj	TRUE
aaaaalihohjmelnpdniaglkblial	TRUE
aaaaalnmpgkmneijphdpnpgglkcd	TRUE
aaaaamchccpaaeoacpimgnmmgcin	TRUE
aaaaamgnjlmdoagcfcgefehdljaf	TRUE
aaaaammbedcejaiemdcbejbbnfoj	TRUE
aaaaanajdkcnlgkmcphgbiokhffe	TRUE
aaaaanfdbklecenhihhjkmjehdee	TRUE
aaaaankhjdapooaciobcopajeclo	TRUE
aaaaanpfpakgiimdhccpkmpfhlgm	TRUE
aaaaaoehmpdgmgmdlkcakjaefffo	TRUE
aaaaaojdfcilfgifnccahceibdmm	TRUE
aaaaaooacjbgncfkpkpnalldbemp	TRUE
aaaaapdchlhfkefalbhabglikegg	TRUE
aaaaaphgbinfjnfebkckkndbpgbi	TRUE
aaaaapmdjkefkhdnddcjcheadboc	TRUE
aaaepgocefehlmkddonhobobggfd	FALSE
aeinkomhdcicadkeigfbddlfjopm	FALSE
ajkgcpegnpoollkdepoinpmamioh	FALSE
aohepikgbcaifcccefakdnjdhgob	FALSE
behepgcbjfeapbaimibhedigbalf	FALSE
bjgiklhbonngjikeafkdcfaennmb	FALSE
boiddohckebnfjdbibmbdmdlcpkc	FALSE
cdhkndbngcidmnnaehagbmigdfnf	FALSE
ciklekkojmmpcpcplgbnoabajgdp	FALSE
coegekdjfgjnbhokpolpfnmdcfjh	FALSE
ddkmflgeehheiipfgcpkgbjgamhn	FALSE
digcmmlekaojfehcldiacmehihbl	FALSE
dndejfbconnbjikcflhpbaffeegi	FALSE
eccbbildmmeaniehiojkaemdokoj	FALSE
egmonmkgfnkpdjkmmkjnbkihflga	FALSE
emdchedjdocjockkkhbmjbgeagpp	FALSE
fabelfahegocolepjipfgcpdjgff	FALSE
fgeahkkjiafndjldelgibbimneae	FALSE
flabgpfegkgeffglaeoopahcldln	FALSE
gajbkimlafdjkejalkfcgogaaifc	FALSE
gghneeiideoolfgefgggbidhncme	FALSE
gmgggpbkcoffidfefagkgmbfkhbg	FALSE
hcciidodfhoojmaapljhinpndafd	FALSE
hhdipadpmpaijehphanjlbflpcoo	FALSE
hliinglbbfgolajkmdgdhomemjal	FALSE
iamjcbjbeclelamopnjbgadembco	FALSE
ifjlhfgfhhikbfmnjbpffpomfdll	FALSE
iknckfkjaonhkcamacfnphfombgm	FALSE
ipijefbgafgmdlophofmfnajjnco	FALSE
jfjkfmkmmbmkdboikgefalifflen	FALSE
jkkmilckinoapciklmilkmfpklnf	FALSE
jpoeiblipcllgpnlmfjlmeilgdmo	FALSE
kfggmemciekpcbmgkmgoccfohnji	FALSE
klimagfcijfbifipflmjjpdjheia	FALSE
lbhcmncmgbbidogglmhhcknpghlc	FALSE
lhaejajngnddoaphleknidbjfndn	FALSE
lmopaokldbglomjlmihkgbefbflj	FALSE
mbmpidicmkblekpkbnddcfbncamj	FALSE
mgnlmgamkdiihbippjfkalconbcl	FALSE
mmajoeonlmnpigpkkmefjhcmoiam	FALSE
nbbpbfeohjdmlglfgednljolhane	FALSE
ngeomodiinehobmffigffghfnokc	FALSE
nkoampnhoelabjlmfdoinhofheaf	FALSE
npkmolahmhdhllmdolkkmlfheool	FALSE
oeafefooaebjinlmfipkbjjcajhd	FALSE
ojchapejcginggfjgkaggcghkegk	FALSE
oncffddkgikoofandnhoknkeiklj	FALSE
pbkkjhikfddlljdifpklfjhfbpda	FALSE
pgchhbgnegcpeacfffljmaanhfgc	FALSE
plbilfcojggbifceaocfkjnagjmp	FALSE
aaaaabaaghgkmgjjhabcfihahkjic	TRUE
aaaaabejbmlcghblkmeepnilheann	TRUE
aaaaabkgbeonlgjkmdkbmhflhmnlp	TRUE
aaaaabpkgbncpinapedfniidmgfdp	TRUE
aaaaacdoigblhhodmpnjmefkjhiga	TRUE
aaaaacjgmkmifnmchcimodddfloom	TRUE
aaaaacnbnlombnjalfghpeekpflim	TRUE
aaaaadbjjhmnkpfcabpopaglcfcnf	TRUE
aaaaadgecoblkgnncdngmfffilhdo	TRUE
aaaaadknijjbfmlmegfmhojiclomp	TRUE
aaaaadpfklfhhofnjmfleljdoiehm	TRUE
aaaaaedkbojfbfnldojkoimpdagcb	TRUE
aaaaaeikmdnjmimopdecakmkdjema	TRUE
aaaaaenjgbhmnecahdbomfdcmmkba	TRUE
aaaaafcbnbnegiceocikmgogoeoeh	TRUE
aaaaafhflnmgjiflfhbaedekclgpc	TRUE
aaaaafmghgcbijpcdbedcldmcibaj	TRUE
aaaaagalkjpehpadjlgeeabmbodfk	TRUE
aaaaagfmmjpjihenbiilcepjpkjdn	TRUE
aaaaagkgpageaagmpglecnejcpndc	TRUE
aaaaagpcjdfoghjmpidifnmgonicb	TRUE
aaaaahedleffaokaojbbemgbigmjp	TRUE
aaaaahibnpnnahhhkhecofigjkmea	TRUE
aaaaahnbooaciepoffdhghmafnbcc	TRUE
aaaaaicmflipdoomafcbjdgcaenck	TRUE
aaaaaihojholnepmbbbnchnfliflc	TRUE
aaaaaimjecngcilldjnjebjcoomdb	TRUE
aaaaajbildlnlcflghpkplnedallj	TRUE
aaaaajgbglfnabmhhpngalbipbekj	TRUE
aaaaajlendjdepjfobdkbmdbjfooj	TRUE
aaaaajplanjipgmengfgjgiddljoj	TRUE
aaaaakfbihoigkmcdphkkpaaloojf	TRUE
aaaaakkgcgjdobflbgmbdfhajbkln	TRUE
aaaaakompaleanaeljbjcenmefapa	TRUE
aaaaalcikacabnkfhbgfhhadcabhj	TRUE
aaaaalhnffbakembomnmndalimodh	TRUE
aaaaalndkgjemciedfddcmpdjgpae	TRUE
aaaaambkdpppbjbpbicmdoohhdjje	TRUE
aaaaamhaehjjeiiahpggkjnhpbban	TRUE
aaaaamljpmhafdjeedojjlmkafaim	TRUE
aaaaamplbgpeinppmgnpnohblbbmp	TRUE
aaaaaneeeknpchafhlgaelccmjejf	TRUE
aaaaanjcpfiloidolohlloajcfclc	TRUE
aaaaanoldclhdjkgdehebneodccgd	TRUE
aaaaaodeplmcmhaiaakeenlefldbm	TRUE
aaaaaohphjhacikpmlkkeeelgnhbb	TRUE
aaaaaonefcgpldmpgohiodhijlaen	TRUE
aaaaapccmpmbifaeecilghfbnpnka	TRUE
aaaaapgjpkkmonmomdbickgclflbb	TRUE
aaaaapliofkkgmfahdigfmelckgod	TRUE
aaamlegemlhbogllfkachjmdjelfc	FALSE
afabgfmmhfhcapejcgfggojnkdgjk	FALSE
aknehopiadonconpjekdabclbcgcp	FALSE
bahklojoncihohfodnpnpngkncgeo	FALSE
bfgefboehacmkdlapbhmkajajmjfn	FALSE
bkegfgjjdbnaadomkiffeibiibfnf	FALSE
bpcdikjcaapicbkommhdnmfkpombd	FALSE
cdmcdlcakganahoonnkokbllapebi	FALSE
cjbjnfgdbmpcamcikhojnnlhealfb	FALSE
cnnajknabbammphemggfggfipffge	FALSE
ddgkpfdkmmmikpmobiccjpbfpgmhb	FALSE
dinfndmhdlhnjimbnggaamoofiffb	FALSE
dnihcfpliljjdckddkjpbgnbpegka	FALSE
ebpnacpgbehhgngbbolcekbjloaak	FALSE
ehkpaalbpbobjonmifpmjdkgnghhk	FALSE
engoodhnecaeilohhjmfddkoflicd	FALSE
fdafaopjeehokblcdhfiglgfabikp	FALSE
fhniilhbkdeagfbnpmjjbpjiopngi	FALSE
fndlimbhdkpnckbmdhcjoemaalefn	FALSE
gccjmibpkelimhblbljdhmigagfaj	FALSE
ghlfbdanagdmocaokagecihcccinn	FALSE
gnbcgpppdmoebphkecmbhigmohala	FALSE
hchkhckgbindjomlmhadjmnnnooam	FALSE
hhibkmnhifnfageeeahejoefhdfgj	FALSE
hlmioaaagddkdmbnbmcojfnecindj	FALSE
iaihnbpflojomffnlodbmmmcfkhna	FALSE
iflgjccbpnecfmohemfngdgkellnm	FALSE
ilfollipleocffibcbipfeghhbefg	FALSE
jbcknigencnmppjlihaojfmcelhlj	FALSE
jglpicnoldhllbolcobijclhokico	FALSE
jlhppebeahfilbppgmnfbdjkboodd	FALSE
kaoijlfgbffjkplokieinehmgiggh	FALSE
kfnldcgeldjlmfahbfkpfhnieldbd	FALSE
klhkdkcefcbcjfcipfhojhkpeehbg	FALSE
lapdlmdpiicpbfifnlmihpacahbln	FALSE
lghhaenjdhnejpgkaghakklkldoej	FALSE
llhpgddgiinoajlmhpedlljjlakkp	FALSE
lppchgmaalgknnhcfehlkhlpgkhpn	FALSE
meimbcffinopmgopkdfcnfniahclf	FALSE
minebdllbacagkijoogpddbakopbg	FALSE
mocibagelgpolfedoapkmhkgdifig	FALSE
nddcfjkjmlaopbeepnkkkoinngfno	FALSE
nhipfhnbdhiabmbbenabgkddlgian	FALSE
nmgmbikeijpfbbodmogkmpmamkdem	FALSE
ochhdhghcnjnopgajohllajlogphh	FALSE
oigkikaghohlmabclhmbaplhndfhn	FALSE
omooehjebnklinganmnjpjhmhgfch	FALSE
pbemkiiedkjopjehamknnpbecejhd	FALSE
pgkcppplnblgndpibfodilbnlkjfd	FALSE
pleeclgpjkophkfiiphcopdcbeepf	FALSE
