aaacidcpikbbidbldmenbijgmkecagc	TRUE
aknglilfifdflnebelaomnpmheglloi	TRUE
bffddfbfijgmjhlffckkfholjacnolj	TRUE
cbbaliffhajmlchlhmfliieplehaaka	TRUE
cljfhdncjcelloihnbpbejhofffhmpi	TRUE
dffcdkaofhdblemnjhaidmkngigjjni	TRUE
dpmhpepelkmajojchnbaifbdgafdcea	TRUE
ejoiehmkglpeppcdefpmpgdedjkdjgb	TRUE
fdpmgblhfflnimfnabjjjalobbbbnnb	TRUE
fnkphffbkibpigbghoofcoimoldfmih	TRUE
ggcfjhpobogipbkkjgbkkmlejpebigm	TRUE
hacfpnleompiafaddpgfaadndidboeo	TRUE
hipbofohddbadgpgogiajigldbmnbai	TRUE
icjjmmonaiffeggfeijmabmdggiblfc	TRUE
imdkddcdebihkcloogpppildolmighp	TRUE
jiiomcgpknccojfcoebmglcjafkchcf	TRUE
kdiillfaifemeahmbecimboodejhelp	TRUE
knkclbpdljonhibkdoifimkdmnjpkml	TRUE
linkodpaabogckdiohdglglmmddhiio	TRUE
mcdmidpknabiinlgcifnkmjjfliiddn	TRUE
mmmdbdmoaadlgnccgdbicfeimaonclp	TRUE
nfllggnekhinicbodmhgonefngfmkcl	TRUE
oaepoomagcjkdfdhhcdcbnifakhjnho	TRUE
okmddhkfkegpbjokmcdbljfgcjpahdl	TRUE
pgepcmfbbmmmfcidfifgdghdcpjkokj	TRUE
aabaabablbgbmjjeolgjcbkcagkobdj	FALSE
aghkfipocfdbabakdiocoldpknbpefn	FALSE
babaceiikfepjkkaieinaaaededgdom	FALSE
bgglooclkjniemeabablmpojhaliddm	FALSE
ccdnjehljopebabafhnhaoncibelpoj	FALSE
cmkmnjmldijklcfgbabaebbepnnoafo	FALSE
dgoabolijfeoehbmlekhagfemiababb	FALSE
ebffmaggjgjaiofmkfigcggfifbbaba	FALSE
elhdmmgdababdcnhmhcglkbbpjdohel	FALSE
fdkiomljjkajfildaknmiopeababogp	FALSE
foldhogkcccbeihiflababccndfdeli	FALSE
gjifpibiehlmgcehiomhncflbabaaif	FALSE
hffchfbjkncoklbabanmhccdljmdmfa	FALSE
hpgjccielbghphpipmfonhkabablofm	FALSE
iijjedfbjmfecjjjaoglipiababjfpj	FALSE
jdhehmldogbbebbpflddndfcfbabaml	FALSE
jnklbmmcclaehlgdabablepmodlocab	FALSE
khidmofmabhcklpccbabacgmieilffb	FALSE
lcfogiiababgpalffakdbmhakjdamli	FALSE
lnclimpkgfibabanaeajdkmeecghgdl	FALSE
milhhacmpppacaabaglbabaafbfiblo	FALSE
ndljkbgnalkiiahjcmhnfjababhciog	FALSE
npcbgfkhacofljchmlmbabahfgpaipd	FALSE
oigeponboenfjcababeejflenabapad	FALSE
pelanbojjbgbabaandnmhhemgjgphof	FALSE
aaachjahjoehgifnmpghjabgmaelblhn	TRUE
akcnpfkfdcobhpiednhohdncfcjmmome	TRUE
beogeckglbndceedjgplindbllhoncff	TRUE
bobnicofjfmaccijaelcbiikoblalclc	TRUE
cicobiaahhelceifpijmahcfdpanclgk	TRUE
dbjdalcjhjcpfigkcmcgdfcclabaabee	TRUE
dkiedoladajmcgllhcbbghhbkapnngdl	TRUE
eemjnfgljjckhdidbbmfjmhoomcaodpi	TRUE
eoldeieimhoemmojpfcagakoifciidfo	TRUE
fgniaemjbpfhailpgakkfjifpdadbbhk	TRUE
gcdlplojckckchlghonakebihpcihhhb	TRUE
gminbngbpfoimeakanoofnmdnjhgohdd	TRUE
hiakhlkancjjgmdigphkhgacaobjoaaj	TRUE
icdpoaghpojdeknjkbpklhpamobjhlea	TRUE
indejibjjncnpmbaihopolghacfhefmk	TRUE
jgpbdokigdphampllnekfdjpnigoecio	TRUE
kbacohjhljpdohdogdcclfhndamjgkhj	TRUE
kkifnmcehmfogpakmgenhibadmebnjng	TRUE
lencnkmhgkehnnnjgkhkgeikiocmbdon	TRUE
lopfiaoofnblnljamkloolebfbpgkbjn	TRUE
mkjpefngdhdblbcjcibclhfhaamkjbnm	TRUE
nefdhjpiacmmpkognnejjipajfpclkcc	TRUE
npnllogklcfcaejlpnfcbmeicejmljdp	TRUE
oldcolggiaahgjpbgbaidcnlpjhfogkf	TRUE
pehppakjdoogalkijpgknndebefdgfoc	TRUE
aaababdmdhigamonbcagefopeoioclaf	FALSE
agaenbhababmjbbeindmbabcgobdljie	FALSE
babaacgakhanmkejcanmcfhhjjpfhilm	FALSE
bfdoclhdababipkgjoicbinphplodcfl	FALSE
bohecnmfbibffknmababhahlpofcoock	FALSE
ckbmfpdokmcbgnephndekddeanbabadb	FALSE
dfpjkadijmblhlmaklbnkcbabaodggjm	FALSE
ealagnjkmcjegbkbpgpkeekihobabahc	FALSE
eminmhldmogpedfbalegababjogchoid	FALSE
ffnmmoababfjkigkckpoklenigbkhaal	FALSE
gbbalejgppmfdddpjajlembjbababdeo	FALSE
gmdiafjopelamihoifobabadanadfjbn	FALSE
hfaeifannblphjcfcoafjefpffbbabak	FALSE
hphihdnpeddplmgiekbhchmmababdjfm	FALSE
ijnbbabaipnhpdlbnoipigfgbefikbjg	FALSE
jeigcalmanndhnkababodmeanfnlblpe	FALSE
kadgpelfgnlcababahbddcmeemaillhp	FALSE
kjdlababgmnfbeeplajlflcdllihplde	FALSE
lcemmolababalicjdmjlfckijoldmijk	FALSE
lnpjiniclandcnjokfbabajbmbokndaf	FALSE
mkefmdbabandmmjhepkibpfejjeidime	FALSE
nfjjokanepeojbbbabaobdkfhlomendg	FALSE
npogkbklkkeimheeacjhiohkbcabablm	FALSE
olpccjkceppahckindcnpeiecbababkj	FALSE
phdpcpgcekbakcdhkmdpbhnbfpodbaba	FALSE
aaefkfnbafkjjmmadnamklbgahideddel	TRUE
ajoijmigaijfelnkehdpcmkajmaabehgp	TRUE
bemhkjmmeclnnlpngjgenfahpopnebfhb	TRUE
bnmfmigkdflbmfbkadpnpmmkhbhmgenio	TRUE
chhicmgiejahkemgajehnfebbbjjahdnh	TRUE
dbnkhbkekbcohchhbbeajheglaklkmhhd	TRUE
dmfhlijmcmddniopjchddlejdellkojlk	TRUE
eggmabpfdjfpphahhidflallioehehbab	TRUE
fcfcamobhnejhmmoocphneepcippninaf	TRUE
fmikokjnacfegpegngfhnlkjicbljefmk	TRUE
ghicnklkailokkkmpnoahlnjfflpbegec	TRUE
hcmkmombeebiajhndglelhpnaheahnaki	TRUE
hnlkepihhcficfedbpakpoklppljflgnh	TRUE
igccpikipaaflomnabpjkbgcdljbnnilp	TRUE
jbbjldkkfbagahhnhdkapmfbkmiennajd	TRUE
jjoldijhpeabcpincbkjnaeeekpldindm	TRUE
kdicpbklekehdibcjbfhgegdmpjaaojfo	TRUE
koahpgogffijilbmobibmpadbbfjiinho	TRUE
lgofblejidicgbllgfgfccmplkgolekej	TRUE
lpkbflgmmljkmhdoiibnbcomgahjkakkb	TRUE
mkipagdgdaffhhpmnfkdfpolnebhdppba	TRUE
nfhhngdcgjncahfibamcbcnkeelnofadc	TRUE
npfhinlhjibiheejmfjgaigambhgfedhb	TRUE
okemdppbkjcambgimhkckiglpahopidop	TRUE
pfgnaaalfpdgoageekbflocibbnhjaeim	TRUE
aaababpgnjohjlfiljaoakkehcaimnamo	FALSE
afonhdkdkbmpbfababmeilknndhkihbhm	FALSE
apogbkajloobbabakeiecemeehelpmdil	FALSE
bddcpbabaigcmakgbihpioclboomnncej	FALSE
bncnejpimkfokgpbfniknocglminiabab	FALSE
cgjababkpjcgkeamemifkaedmggpjbpkb	FALSE
dcfgnmdjhkggekegdinjmjclmhicababf	FALSE
dnfifaopmaolfnefoejbogaigpnpababf	FALSE
ehknpaojdbmopigfjaffbabacbhkdedgp	FALSE
fcgpilpilfaeimnjdpaeendadhhababme	FALSE
fnmcoabpepennjeababnapfojfllomnfj	FALSE
gjkpbeoababohpgplfhgloeeaklalekcg	FALSE
hfmfgphjcjbbomkaidihkbabamolaedfn	FALSE
iaollelkockfbnifgloelbiedababaaai	FALSE
inmpaeecgmbdieljnmlohooiapeababol	FALSE
jhdmicojclafakgedmabkdgaihbabaplh	FALSE
kbjhjhhfbabanedcmgbpphlblheemmken	FALSE
kmjbmfjfgingochbabaehilkochnkcjgj	FALSE
lhejjpngockoakggjddpgbabacagkkbba	FALSE
mbnbfafgdefppageababdoajaljbbehkj	FALSE
mnioababmemnlnonidfhfkjeeefgbihnk	FALSE
nilnimjonkbdpfikfkaajmjkababgejcm	FALSE
oakoegababhdmdkjmnihdbcbophbdabhd	FALSE
okggodipdiolfmpcdmkcfodklnmbabaed	FALSE
pdllbmmceechababpaceciokhbkdjbdek	FALSE
aaakkklibandeffgdmebbpplgcgmjhdbhk	TRUE
albdbkocjmcgodkgfjbkhnnnplpopahipe	TRUE
bfmdncjlnmflkfecgffkhlpfhnnclccphh	TRUE
bpgolkfobigaelnnkgcmhaafgbbcldiobn	TRUE
ckhahekaflfgkmmmdcielckiiplodlokof	TRUE
deikckjmhhaabbieleiimgcjdflfkmjgdk	TRUE
dngipandnjoplfknakinkidiklodcmhcal	TRUE
ehiijpablodpmjefmgfiobklaokjocbagb	TRUE
fbddnghjdmjajaonmeecgdobknohoiojoh	TRUE
fmbjceakpopoicaekapfmbahbblmdfpcfk	TRUE
gfihpjfibhbiiifcoimkediecnielnkglh	TRUE
gookoffblpbcmgnohbcbhpdaeiieeojkgm	TRUE
hjkcciopgneapiadmjbjbejngbepgmkinp	TRUE
idcecklknhgfmldnfndhglddnabigofahh	TRUE
inofacmpjpfhjloooefiiagajiemfjjakk	TRUE
jhomfoaeaknbfmhfhhoeemdmlheejlnlhc	TRUE
kcddldcfjahhelajcddnpccphbpgknkaak	TRUE
koodoghclapcokbepffadhffdfkijajlcm	TRUE
ljjihfciephapfbplgkbnkjlfedkaanccl	TRUE
mdloigdpfmdbnfnilchkiddcignkfhlbcc	TRUE
mmkgaimfnbkiplibppfjckiohplakaaehm	TRUE
nfmgdfdhgmladikfcoongpnaggcafgmehh	TRUE
oajpmiidjhddfhokakbjdabobieedmbbim	TRUE
okkkjgajghmnglkiigoifgigoodldhnjhm	TRUE
pffngfbacomoackaikafgnjmbikghabceh	TRUE
aababninaglegmfkcghpedekmfepjnfjig	FALSE
afgngdlpjlnpjkfpbdljiabbabadhchncb	FALSE
babaadhnbkkgmjalcjldpflblbndfcjjgd	FALSE
bghedinophphagmgcanpjpocffkababkfa	FALSE
capofakldnciagkmmiknibgbabahlpfjgh	FALSE
ckknfmboahmjhpababnefmfighfkededoi	FALSE
dfjpoadhoojfljhgababfoejlagdgonbjb	FALSE
eahdedchgfjbabadkpandociekiaelljao	FALSE
ellababcpopemgakgccnojdehgnajfnknm	FALSE
fhllkfiopinmbdchdoffababgfhjedimkd	FALSE
gbajjjpcofebpkfdhfillfbabajfkbpdap	FALSE
gmajildnhllfngffphgipbfocgbabalech	FALSE
hflmoicmpigipccgkfgbgeojjbinababnh	FALSE
hplodnglmjmfbabdidlckababdaenpfaef	FALSE
ilhmgkpidfpkfghfpababonbnkmbolecle	FALSE
jflkelkfbadpkbonbmhekienaelfababge	FALSE
kahgakoddkjlmdobejebhokfecgbababkf	FALSE
kncjcpfhamghohdpbabaloolenkcedhhhl	FALSE
lhajbfdbabahhelbgkpjnhlflojoelbiba	FALSE
mabolmognmddkilpjnhokcbbabaagempid	FALSE
mkkodohgikpjmnljjkahlecababcdpbeai	FALSE
ndlbhlkggdnipdkgbpbdbnllncnkpababg	FALSE
nnbabapdghojbokffkeiedkehckmlhngkl	FALSE
ojmgcjlppababflelaecipjpmlkggbkoga	FALSE
pdnlfkalgnmigckghfhbgbabadckbjphfb	FALSE
aaagejecmalmnejmiecgdjdamiemfjfgoic	TRUE
ajdpbamhghoikeoajhgdgeipbieaonliepk	TRUE
bejmalfngaegjcjfpjebhcclekofblcjjib	TRUE
bpadbcaepljobbipikmfpgmfnjljjkcjdji	TRUE
cjiaflmnonhbcpciaamlfbdnhflfonlejnf	TRUE
deedoelfckefacbdapfcmlbeghijdpmmmkf	TRUE
dnghipnpccppoabgffpafcniichckffhbcf	TRUE
ehdjhcndlgelpgialmfegdhpgcpkefgjjll	TRUE
fbokhihlbgnojhjmegpjpgdeamlkpnmdkbc	TRUE
flceboliimglphibglodhmgjemifmopojfj	TRUE
gfjikpamibecoohhjbdelmbienfkgpaadff	TRUE
gokioegjgllncaekaclbplildpdhojjeipb	TRUE
hhomkingnjoajnblpnlagbliclgedilfoeo	TRUE
ibocpdjingbbofmkpnnkjimifngiminhnmi	TRUE
imdhocdbdcijnicbhmomoahombdmndgnmfl	TRUE
jhcnecdoaloheohomnknbkhgpoakkdgdgeb	TRUE
kbbmlpfbdmoicmghicjbpelniphpkfndpcj	TRUE
klomghaioopcddkgglbokhnnkoblmkcphlc	TRUE
liepmkhldgdbdgecinakhnikedeimnddpod	TRUE
mbpbhppoabgcliibgpepebkmchbnopcmcaa	TRUE
mlgindfnkhcjebhiocfcblchfjhdbanabla	TRUE
ndnmopokhfmpcmpdpaokbdmoelmepffndoj	TRUE
nnnjnmcjlkcpofdblofhgmlcljhpfbjbibn	TRUE
okflddbadmdmakceifhkdoldlkhlgcdkibe	TRUE
pflnnhhhelddmfbkjglmbocipcfmcpckfih	TRUE
aaabababcafnbjblbeejkhjckdfcdjpgmjc	FALSE
agkglpjmnamibabagkkalbfiimmeccbbfaa	FALSE
babaidaolkmjneicifjfdagcafhoehpejif	FALSE
bkjolmbebggmlccgmbpidblababifjmfooo	FALSE
cfpcldgjbecelmjabimhceajkbabaejmpin	FALSE
cpjlieffiabjafdmbkjhkaglkmfgnacabab	FALSE
dkhbabadmbkmhcfcdgieahnjghlbinagoel	FALSE
eeiggdmgjpmkijnababffffhpffjpbapchj	FALSE
eoacababkhaenhkddepfmnaobainkdjcclg	FALSE
fimkpikoedeafblddcmilbabadffmmmlcke	FALSE
gcababficlgakpdlchncnpddjeoppjoghdk	FALSE
gpgbifmbabafmofccckhelfeohcighkpmkj	FALSE
hifginlcliiemnmffopckeeopnfhogababg	FALSE
iblfjojafoajkjfohgalfbabaalbihmehfn	FALSE
ikloinaikaobggahkaababcnhnnepcmaihc	FALSE
jhalmmiidgigaklieababhigkhoicmamfff	FALSE
kcjholefjahinihofbdelobabablndpidho	FALSE
kmnggaljhoafleioeeaababajdaojaohdcj	FALSE
lhmnlhgnankcachkckbdbkmncnaababeedc	FALSE
mcfikjmbffcnlhfbabaebfgcndbdimbhkan	FALSE
mnafkjkmonjklocljbabaeijdlhhnclincc	FALSE
ngnccfbookamejlfdengkdlkmililiebaba	FALSE
oajgfhjidlcfbhegfceijhhmmababooljee	FALSE
omblhlijgbennejepklgepnmhbabaaaeejm	FALSE
pejnhnffnacdilmnebjbmfnjakmllbbaban	FALSE
aabcghjfplgmhniagdaaanmiipameafhhblb	TRUE
allcnfkoalclkhnpdanmibgkdfihjcpbnhge	TRUE
bfjlpfefdcjjbahkhaigacekajjieniiklep	TRUE
ccinakkdibnnklefpnciknclmfhbdijjkjgg	TRUE
cnhaaeapmndjmodcipgegldandnfakmpeccn	TRUE
dihobgfkmdimhpgpenhnkndjejnegelafmph	TRUE
eckinicdckcmkgghccigppfdkemncojkpbkn	TRUE
endeokkfmimiclfmckkklgahijnoaecjamgk	TRUE
fglpanhaiiihgbiphohfhimpokfmkplkmkka	TRUE
gaipepbenlflcfggfjaeflicejpdmaipkkdm	TRUE
gkffampgfadlheobhknigediofcficedlpid	TRUE
hdpmdnljblgjbjmpffdochhecgbgchbinnbi	TRUE
hoaeoaaclkooiphaffojnhkpbmefdgkfkmko	TRUE
iillgiomlpipalgmfjfehhjakeokfpkcekhp	TRUE
jbpmfgahfihbooooobjokfbboainbdbjjgjn	TRUE
jlbohgjnnfhpdcinlnhoabpjjenppoelplgo	TRUE
kfnmhblmjlefcklelkifmacljlmflmfhpkng	TRUE
kpbgpgegmeoophpepceodecdgefebpdedeoj	TRUE
likdhlbengegdlphpolbppeenjnaeihopkdn	TRUE
mdfcfdoaaggblnhllbeellbicadpmpgkfgef	TRUE
mlohgafbcgfaffmmpkcihlfgahkhoamldldc	TRUE
nfghplhcdlihmiadnlojkpdcgimanedkifkf	TRUE
obdidnmmdchebicemafjlnbbngmceemmldkn	TRUE
oldojpebffllppbebjhjgodfhgjblofjnaaf	TRUE
pgidllgcdgjilplpddlghaicabfahddnmpef	TRUE
aaababphdnflhaiohcohnejpknkbobbaeifa	FALSE
afbiihcnpniimojfndchbababdlimmoccahc	FALSE
bababohfhigabdmnjfiahnjealmgdabnmicl	FALSE
bhlccnbeijpneababllpicdfhgojdmjmbhkk	FALSE
ceelbdfbabafmmicpdnnhmkjacapjnojigfe	FALSE
cpnodecbbddnljcepbabambdfpglfgddbngg	FALSE
dkboppajeanlnababmkmjbaennjdfmgelkfc	FALSE
eclfbababohbachdgcepmjiikjpidikgijcc	FALSE
eoinebabacedpfjonpcjobiljoaodldhmhol	FALSE
fieaejfknifaefcjofnacoobmbmdhnoababj	FALSE
gbhnllahihhfedncmknohibkemjbabamlacg	FALSE
gnfcappflinijbblpofjkidfababheedjepa	FALSE
hhmdbdeopjooalinljalgcbldaaedaalbaba	FALSE
ibdmnibmibmfebibodbfhpfbnmkgnnlbabak	FALSE
imglldmemeifdmnnjfongnbimjbabaadegak	FALSE
jfopkficemdjbkbabaainjlbfcfpefgaajki	FALSE
kcbimenanbabaleljffpalebccpefkoffokh	FALSE
kmkdpakmcmkojandmbgcaldkfbabadmcjkop	FALSE
lgpmjfcdldknbklababiigblmfhbldipmgbf	FALSE
mbabalngfmagejjnbocoogndhkbmjlddleoa	FALSE
mmngcfbhababmmkaomhdlipdhdcanabjnmij	FALSE
nfdndnkpdabablfcecdncgjlakmoamdicnnp	FALSE
nodfogneodkmhoababbpdmdgmgllhepkbnff	FALSE
oifegmnababhomikleojckgndkbaebmhhmoe	FALSE
pcmfglbiabjppoffababbhhmoclnggnocbpo	FALSE
aabmbhdiedoeakjhihmkhcmchgoijmfllcfkm	TRUE
akpmpnfkgiobbakppjdflanncmikddppfnngn	TRUE
bemmeagmnpocajpmbplmejfibjnhngpgploal	TRUE
cachahcbegfiglhcengpnalnelfhkkkhmgioc	TRUE
clcmdokkhnhojlbamhkmcidpmbjffahobkbjb	TRUE
dellacgancafmmdbkpchhhniebachkgipmljg	TRUE
dpfojmeenlkceagfihcdijfankceajbdpfhcg	TRUE
einlkngdokjknggmlpajoegppfjdcklenjpil	TRUE
fcnopmclhcibjjkpibfbkhklfepeobeopgaak	TRUE
fmembdgpmedepcpeifmkbccmlbgkjcapimkba	TRUE
ggfoghfkahndehhjpldhglohpjfldoehondhg	TRUE
hbcaafmjogegbfdkpmajhljijdhdhmeaemdgn	TRUE
hldgclibohhkhncphjpchgakakmapgmkfibee	TRUE
ifmmabhdhkgindphhmgdoloapibphdjgklebn	TRUE
iommcgcdmdaaplbepdkgmkgdeobnllimnkdpn	TRUE
jmbegiponcmimolcacnodlenklfmmpgaffeem	TRUE
kfkcmmcpaihgooigdgcejechmmpfhfibnckkc	TRUE
kpphioapcdagikfojeoieghohckgbbgihlhpg	TRUE
ljnoknpcflcnnmoainbmfdchimpcpncjdceai	TRUE
megmlldpnkejfnfjcmbodnhbnbahjidcjojae	TRUE
mpojifffmnahlbjfnjfjnccelcedjfnachbel	TRUE
njpfcfidebjchbpofhnanhhnpggoejgngppbi	TRUE
odadegkdjcaadiiddigmpkngfdbbaljdpkmfi	TRUE
omjjmbacggljfnmgkmjlkgjjbkbfgiamgainj	TRUE
pfmbmahdbbhbnakafcdjlcbpidfnogkemngeo	TRUE
aaadfhcoohiclhinjddgmpfhjfijjbababcah	FALSE
affbdjlocdghjddccjeecmoiaacinlihbabam	FALSE
apbgcddcbabaphhdnehoihfbdammkfoogpgji	FALSE
bfpiaimpkccdgnbckeochjibabaelphfipode	FALSE
cabablcappiijnngmflchkbicihijjkedalnc	FALSE
cljnekmpbopkafciagldjfababcedjldphdim	FALSE
dflipbccjodagjfbabaddnagpndbjeefpoppm	FALSE
eababbpfghemkmnjcpoalhfcgpmgbkiaijinc	FALSE
emfpkfaceonndimjljccdljmdjcgmbabakpij	FALSE
fgmephgdgaaebabacjbcpegfefappokiekdcj	FALSE
gbbabaflabimagipjfildnmjfjnemkgjpbkcm	FALSE
gkdpbbbabadpfmoahpjjcgikmlggooaglempe	FALSE
hconoppbabafgknnnddmcgdmlkjmgmmmkedje	FALSE
hmplmahipheodjcbgmlkedjffiloleababgpm	FALSE
ihkababenfclpeimbmgemlmekajndakclppfi	FALSE
jdkcabmmkjiababmkmkjbenimkedoagjekcaj	FALSE
jodmfeeccanlbpngababfnfnekfpfjmedppel	FALSE
kjlenadhababbdikgphnlgnelofgkbkidimgk	FALSE
lcdhjknbabajdgielbiknbnhcnhkfcnijjemd	FALSE
lobabahninncbjdmbhfcmepmcbcldooecfoil	FALSE
mhcplehobcabablcmimffmbbkihjgmdgablkk	FALSE
ncdkdpmhkfljcfamocacmbdbfooffpleababp	FALSE
noojhdgffbabaodndeelbjoodemhdfengbdjc	FALSE
oigbabamamebojcpahgghdaniodkknaondioa	FALSE
pegpcgnjkfgfbeccfdnmkgmhbabaepbohakpp	FALSE
aaebjhhfigmgklgojohiideoodlfhkeobbockj	TRUE
alhnpmedhbecmofdineckaflacffnmeoppoogp	TRUE
bgccjbjfkoeciphpblahmegplbfgompmmgaide	TRUE
caibjljpjnkgggnonbdgiohjfnigepkgjjchfj	TRUE
cjhanjgomjplfdjjndkafnbnjilfhbfgephfac	TRUE
ddmjiggichcfejjfcbibpikdonikngmcondecc	TRUE
dpccidijhoppjpbjajgijnfcbfggiipdaicbik	TRUE
eihppbbjkamgepilejpaaahnkfpameigocanbf	TRUE
fdjiceadpcmgibnnbckpmjjbboklkhmoboidff	TRUE
fogdfjcpnkhmdglhkmdekkeebbfoimmmfdebim	TRUE
gjbiephaofimbaajbjanpfckpocfeimghlneda	TRUE
hcoijcfceodlbgldhjiniohjflepdpddenehim	TRUE
hnhalomfhobaeoghfolnpclgfnimedgklnomlg	TRUE
iimgeelclfphigadnhkfcmcgomghiinipmbbgl	TRUE
jcbfjdmdhkcmjnehhiafflelipgiphognafmll	TRUE
jmoelllfjbfmgpfhdoibbbhdjcjopfchddkcpk	TRUE
kgfpmgkjdjjolobijbmpjldilbffclmbmimmca	TRUE
lbeldfjndighdhpjlombnaelafcedepfmebcnh	TRUE
lkmcbpanhnkpgjiknfmhkhnckfhghopchljlbh	TRUE
mepppehbmdbpipbpiiaifibdpbfdjdlgdhifoe	TRUE
mpnjkoifaochmllplckmfnfidbmmjgflheeblg	TRUE
njaeapenkdhikkmahbjcedgahlfohbmmneelea	TRUE
ocilmacmbogffhpekdeehohlkfhcnoafaolpme	TRUE
oljngdjdeccmenigplipabelklemlppnkeaplc	TRUE
pfjjfkepfcbaidjciplcdapncaajknoaidnmkp	TRUE
aababkidbpcggappmmmnglbojecfdagpojjleo	FALSE
ahgkamebnfihgfnjdgnngoacnebabakeipdpio	FALSE
babaaenmkgekihbcepldhmenmmppoehaiaknah	FALSE
bfpjmiojfejlblbabahlpnkhclmlfdkdllgbpm	FALSE
caababjigeonliolfcdikclippdfpphpkmncld	FALSE
cjljajhkmabablidcjibgjbphgpfjbkhcpfbkb	FALSE
dcdafamclokbidfbmdnekimjakpnknhhhkabab	FALSE
dmmnkendfjknaejamkfljhlbcababoeogpicmj	FALSE
ehjnnihcghcgboojiidhcapfpcgkababifegmf	FALSE
fapmopnnanhemdipicomecccmoabkababpnhak	FALSE
fmffedjjhhbkkmopojnpgjfhgbdggkoaababca	FALSE
gfkkkababebedmenoddbhcgghdceiikkhckojn	FALSE
hajhjhdggnjlmioigclkaakbabafbgifpmhkpf	FALSE
hkinehcfcgobkgkhmcgldghnkhoababhpjnhom	FALSE
idcpgababgjnplmlenmnccjcjpdkkadlnpeahc	FALSE
ipnooekenbnkkfleojofmlbcolhlgmabbabald	FALSE
jmfjpnmcfcgbabapinchbkmofipfbjcakabmlb	FALSE
kipfhaeamejocgahffemhababkfgilkmgcgdgl	FALSE
lbofbabanpabkcoomddkmhfnpbbpfhakpaijai	FALSE
lnmbabaccjbggfleojgofnonaiilmfkmaldade	FALSE
mkmbabagilfmeimopnekdbjgniaphmmpahdjpo	FALSE
neilpladihclhdjmnocegnnajaodbabapfjdld	FALSE
oahckaebkkifephnenlhonhakpmbabablcdleo	FALSE
olejgbabajnmldklnddimbacndkgikpdabeedo	FALSE
pfbahphgncmgkbbkkpdcbnkdgaaiineblababp	FALSE
aacnmicacldiehagacbeccehapccbmjpmajlchi	TRUE
alfagbnbccnghigdlbjihnbcjlaecmmmiihdieg	TRUE
bdlijjpgdjbngfjbllnelefckbellilelihbgpm	TRUE
bnhjjafgknkdefjnidbfbnihljlnnfklnipfknn	TRUE
cgjhicehhonhghnfgjpmoabjhhjdbdpjpbojiab	TRUE
cpmkdclagbhfflnnfjlmbkddemcmlngpenddnmn	TRUE
dkfbbmkdebnebmccmglmpoamabjbhmjfhkmbnfi	TRUE
egjnjonmednhkecaoopljdjhnmangjaoegbgaih	TRUE
fahnhaeiiolkohefcgiheagfbhdmlhifojkjfac	TRUE
fjnnnmoapjkgcigfijlecoailggodfaiijjedjk	TRUE
gemacdpdmaafailknaboikgffkiogobfankgiom	TRUE
gopmgkfgjfeiknhklmnandjhpjmpeapjnikpimh	TRUE
himbeljdpccphfgnhaggklplcmnigclcgihokfd	TRUE
idbilcoehnfmhgldjkihkjdcekhhkcacmpjplhm	TRUE
ipebhigehcjmkfclmpclelgaehedhafnadncfig	TRUE
jhmcmbfgfiphnehknpapbaonilkmaaonmcjjjgp	TRUE
kbjoomfojbhfndmlcabjemkfcpnfoeoeiidcaef	TRUE
kljofiolknoblmeaahjhakfiangijhphkbeepjm	TRUE
lgkhgfjjjnpbdlhimjbaddkbeijpgnhnllmekef	TRUE
mbaoomabhbkgcgepfajnodidhohbpbbimhgiegg	TRUE
mlpdmfkgcpbgjjkdagocdngfckefbponineheol	TRUE
nhnpgaploaohjpemhhpfmecjndnndpaefkihhbk	TRUE
oclhoabndmjfplebbanabjdojcmljkgdnglmpbg	TRUE
onchfkfcghcjbfmfgcnkmjcgmcloemjnddecimm	TRUE
phcojjejdpimkmiobgofmmhgdnffnminodnijam	TRUE
aababdegfnepcdoocechhfgdbapbijigmeaebbn	FALSE
aejiacnajhfhcobbdejigababfnifangaonfidb	FALSE
babagloegfnheaoboijgcefkhkjodgielipnikf	FALSE
bledjgfccokoiijlbdkkogababpjknlfmjocdgl	FALSE
cfbcbabaggpcepkobhnlfllaenplekcocangebm	FALSE
dababilnpbagimnbekmhbabjacmnajncnlmclmk	FALSE
dkkennbeamababbdceejlbpijcngmekenppefao	FALSE
efgoiefoenicpibabafjamkjbdaliidmblipdbh	FALSE
fabmdkdmcofbabaoialcaleckbcgnhfkbeemgam	FALSE
fkbjgpehjinpigjidpnecbcdbabacdadmncjnok	FALSE
geglfjeccpjookgbdfjhobcdpchjababngikach	FALSE
gnanjgcmjmpljaababomcamfocbpofniimpfddn	FALSE
hgpfkgpmanhdhacbliebhechajaiahaobabaaoi	FALSE
iababopgfnadlgbkkcpfagnmicphdeadccfnglo	FALSE
imdaogphaababkmkhkpaoanmapdofljjhjenogh	FALSE
jghkbbhmpgphpbabaggkkblgnfnedpdinolmbio	FALSE
kdpigmjpababillkgbodgjlfmonkdmidpghdoma	FALSE
knpdmlkolfenfababckkgaeleonmgigiiidejip	FALSE
lkbalojgahkeopbabalkoemnllbogmoiaolbpmi	FALSE
mejapdmbnhababenjjpgfnlajflkmdpnbkedaoe	FALSE
najigdaidkknfhlacbabajkndoninifafkcejnh	FALSE
nlfkdldmjcbabajimccejgifnlajphlggahdgog	FALSE
oehcphdijegafobkghkdkdnbabagnhkhpkadegd	FALSE
oohlmcphighlpokchoababmdpnjmlmpbejjlbfp	FALSE
pfjmeaoekdmjjapipklababehhhflcjcmiijmpo	FALSE
aaaclmhfkjahdpdldilchjhpfhfhddhmbngbppkj	TRUE
akhfkmpddokenomecijlhhknfoaolocabkaapgja	TRUE
bcapnahphalmbjkhbecnjbnobjnpgfinnjahpkio	TRUE
bkofppepfjdofcjiiofemajibekdnillmelcgheo	TRUE
cfbelicmnllibebfldklkpjfkgmhcjkechfipnmb	TRUE
dalbbacnoogkjcnlnmcloabhbdaikmjcnhoglekb	TRUE
dlplohbnjpifiklkjpcpnhoghhdnebebeknmalam	TRUE
eenggeoibmhobabfdjnmcnheabipfmhdihlaihdj	TRUE
eodkcakcpbfkjegpldhgcopjlcnidiggbegomopo	TRUE
fihogmbfabgkcfcddgcneafemapmgjbkodmnginf	TRUE
gemeadkpoiiofggpopfegkfnhjneaoicffaccfcc	TRUE
gobhmkncfapcleeggpfjhnpkedoijddemgokdopp	TRUE
hhmafofnaeogpcnpcebaklcalebnpgokafmifgph	TRUE
iancagplmcienhadcemmcllokakhephgggfdmnfm	TRUE
iljlmmmgbncanodiobebgmcgnmceegichoencaak	TRUE
jgofppiilnbgonpopgelciaoaiefglenjgeldofj	TRUE
kaeamlgnfmbbomdppnmgdhbolidgnjcfgfniaefm	TRUE
kmaihifnpbaackecjlcplkdajfhelakihghdhkij	TRUE
lgdnbkmmjnifbimimienloghaggmlcljnjhkmanb	TRUE
mbdfnljkimobaleppkgjkjbingbnikadedemkfpa	TRUE
mkkgoggjmfdnkhdmdajdkehdepmhbbcjpbnkbbio	TRUE
ngegekpecnpndfajkddjlhfmlhmaiinfbeffcphb	TRUE
ockephfbpimgnanhgnpkbdbmkkgbckkbadacpgih	TRUE
omhfcfhbjlicipcebacgoimgnlighipnbgllcafb	TRUE
phamdngdncphfkedlllkcffghlnfmkidolcapdlo	TRUE
aababjjgecbolaekaifoiblphpemfcnjnfdgfhje	FALSE
ahhpibogfikbkndhefdmjocdkoejkocnkolhabab	FALSE
babahiijolaciceapgeefmjeoindnancnpoobjbb	FALSE
bhdlmcagnfoababijkofedhfgajbgnplmglcccoc	FALSE
caniahckmpncdjfkbbabaogfffmmfdlhlfhmmdnd	FALSE
clkdhcababmcdhgmonckfengiipanefjfpipkbmf	FALSE
dhjbcajkimfiababioaedllgnnjibebdalibjoef	FALSE
ealalccmbabaeckilegghkoopojmffhioefefiep	FALSE
enfiidgfbddfoihbahnenbabaikgoeklgobneogn	FALSE
fkbababaflnmlbpffmoceolljnmomoopogfnccno	FALSE
gclbabhfnbnhjknchpmhfpaclinhofababbjgakd	FALSE
gnababddflemadbophhpbpdfkjaibilanajhanga	FALSE
hikbfpapapfodofklbghaabhlihihmididdpabab	FALSE
iciijcpibabaioamghoceogpnkigpdlngpjcacfm	FALSE
imjbmfemokbabajknpghighojcklnbkfddigipjh	FALSE
jfcbabalmlnfcihmcgibibmdclcejgcklilnnkmg	FALSE
kababcjoinglpkakedopadmfaegeiaeifgnlooch	FALSE
kndongdkhmbabakfmmgddhbiaodedmiidnlajbcm	FALSE
libgbdhogababmejcijjdekbkiaeljeadddmcgap	FALSE
mbikplkhgnababgfemcdpfjbkmnccmepnghnlohe	FALSE
mncnncmdjmlbjdckjjmkpnhlmpfgahfegjmjbaba	FALSE
ngbhccepokdhagggoohnlgebafiababahdfjdokp	FALSE
oakmpgillckecefhkcmhklfbkbnagahdlbababco	FALSE
ojkbbabaedbkkgcoajcjidcjkpbhhmajbcdoakgb	FALSE
pdlloembpgjlndgbabapjfphnmjmchigcdlbinfi	FALSE
aaajofihdmmmmaohlpfcgfehpchabnlkieifibjej	TRUE
ajppgniojjbgcmegjninmccbealaokmckdphaampf	TRUE
bdhaabdbibjlcfaeakplamfpnonkcigokflacmakn	TRUE
bpgajhibngaognofckgijjgefmfnfbjpmfmdbanlj	TRUE
cjjcfmoicpcpepkkajplfmgnodkafalakjcmknmfl	TRUE
dciodncffhamjmgdoleaakehmopcgjcibnmmkemjg	TRUE
dmbgifoiodafboiapiocjdiodeledkhhhejgbnnai	TRUE
efnibalhpgoledpaecfkcjfiabppilehbjehofapb	TRUE
fbgopniadfkmgghfaalaleafjnkkcjenpgifmbbnk	TRUE
fjoilkjaefeoefkiaogoilfacoeffmekeempfggmd	TRUE
gepofdakclihceifkoddlmmpcbbmcdiifkldplpdp	TRUE
gpejippeomhojegjdjjjmokcjcfmfcgdbiobhjckd	TRUE
hkljoaenmjjclclagbpoggjlcholckanolgaaoinb	TRUE
ifpcllnaogepojfdpjpbpmbgphbcbaelonlhcjojl	TRUE
iofckjlojklfealllpapoeimgmdcppcdaaaphbibb	TRUE
jiohikiimbdmopjibmdfjcalpajapmgpeeogpbfaa	TRUE
kddcjldmbfpplkcefakmafoplmabnlhjoloahgoof	TRUE
knkblfckknkeklajajlnpnmppegnkcgdejbmabncf	TRUE
lhclhmmnbajedaedmaikjdagkegbhlabpnmpemogo	TRUE
mahknfdgnahajckgdekiaakoofggeabgfnlbfhckc	TRUE
mlcmjfbeljmgpdlfejdffkmhaomijmdokipjnnbja	TRUE
nfgmgfmjdjjbjipgcfekhkjalebadgkgpbgfpmnbf	TRUE
oamhfeinmdelgdeejhehnpogefemnlbbnoangpfgj	TRUE
olfpffoiibhadajpfgffheojbnjbkoaajoappialm	TRUE
pgedkfenepchgmlmnkkfbmlideaikehkmkjahinie	TRUE
aababdkaboldmncggpgoakpdeekfognolafphllbo	FALSE
agofagcichldppiiababjlbkjcjfheeilbceapoed	FALSE
apmfiababbccfecnfoabcijkkjdgalhdifdinnbmh	FALSE
bhbabaeemnkfoabaimgllimflagndbmonmkbjiofg	FALSE
caiehfabablgfaofeaobchbmoblamifgkeicfmfnd	FALSE
cmloeomjaigjaigimfcijbabafmanjdbhomcdojnd	FALSE
dhehhgeailfpoaafegcnmkjcjpmiidlebabacleio	FALSE
ebhakagcenkepgjhiipbclncababcmjnnjgnfoaij	FALSE
emhobnkgpoenmlocjaebhcofjchmkhbcbabahmcpc	FALSE
ffpjkjiaahikkeababhoodjjghdnbbaejgpehmgdh	FALSE
gakbcdfjpcopalababghlfopbmhlkjnijlhlmmjhp	FALSE
gllaindjhffogbllilfbmedmiacababdgiekfjpbh	FALSE
hehohdllcgfmeehogplgababigobhdfbniokfnedk	FALSE
iagmcbaancgeoibabaafcachgnjmdnmjcjpgjjpae	FALSE
ikmclfjnmihbphhaijoemnicpbabalchcmdgoiekj	FALSE
jhjkaebnhchpmjfcdmceanchodjenababfjimknge	FALSE
kchamfffoblakhgjinaopkbabappjkfikfdofiekk	FALSE
kmddngjjgmmknmmhcidfjcnmjkafhgkeppaababld	FALSE
lhhekhannacmnhfgfokcekghbflgamanecjbabaae	FALSE
mbbabanijpefpjdbcjdjaboggjlljpgfaonjhblen	FALSE
mkamiihcmnafegbblmikagdlcbampjlmjcaalbaba	FALSE
ndmklfmkkfpbcaihbppimibebniipdababiohgegi	FALSE
oahbnlogligigmmoekalmadafbabanonnjdcolcjg	FALSE
okifgpcidhcpnabhpmojmababamjokcgcmkpleoec	FALSE
pdeojckbabakaefgmfbgiabgofedlinbkebiogmjf	FALSE
aabnncldpicfbplamphnpcgofddemehoobnhcblcpf	TRUE
akbganfepafhnmndoogacpomfnjelfdlmlnclojoeh	TRUE
bdohceiplapflicnocaojoaaooaefeanpmlbmbhpda	TRUE
bninhgnpepoobelchablngcdjpnengcajhcmnaenhb	TRUE
chbaeokhhmcafainmenphihbhoflkmjicjkmhkapbb	TRUE
daephjgcekhlplefjcmjhekdblgdcokfmblpfmcocg	TRUE
dkojagfleilaldnofcdkmcepimblpbaikihjedkmap	TRUE
edgnoeaolblfnnaahckpfikdiikahfmjmphigpfedg	TRUE
epajcbmglkblbaablhimoncklfmncjicapcnnlbhki	TRUE
fkemoalmbcfkdohpafjmliddhjlkeckickndbiopca	TRUE
ggjnigppbajlbldfofmhnoldhlghnaehoglbpojepa	TRUE
gpacjilienmofockadmoebcnggodclmcmjielkekfc	TRUE
hikadecaocpaeedonjenncagedlgcofhgadgmblbkc	TRUE
idkbighihkmbjajdjpnmbaamlknfibjpgjghimdfeh	TRUE
iombedfinladbdkpgecjplklcilikedanodcoiognf	TRUE
jjdhidgdelcdnlcepakgfhiebnpgkcjfcbinmoljfo	TRUE
kekophcmgblfmnlloldpekkogeojhnjacknaondkpn	TRUE
knmhonmkbgncpmmldkanihnjgbknmoplobbeeepfgb	TRUE
lijmiolllgpnnojjpdkgnkjfmfoheejolffngopcbo	TRUE
meglgbmbicdlokkjjelipccbbppeommelnplhjbpba	TRUE
mopgelnedlkobfklgfakmaedlchbelfkahlomlimdm	TRUE
niedbkijliilcfojpmnkjdccldfpealfmkkadloamm	TRUE
odkggdhfniomjfmajknkiblfmgfojobpoedjgklcmb	TRUE
ompbiebdmkpghjaflldphilehaegaapbfnmjcohmib	TRUE
pgdgolbmmpapgideomfedimbidmgomckkpkeobfdkc	TRUE
aababfcanjjnihmbkppiefmiefhnjppkipenfghjdg	FALSE
agnjgkilfbkkaggjemkjjgjbabamoipnnjaccinngd	FALSE
bababopidcpglhnfobbmcpmappioiboaeofiedfnla	FALSE
bibkjfckedlcahnfmobabanhffjgieljmicmlgkdbl	FALSE
ccecgnjjigldbabamegfffikfkhdnmdlekmmpdphgg	FALSE
cmabplbaajfjchgjiinpnfgnpkjkipbabaiecekbjo	FALSE
dgehfbagefebimohjflbibfdiialmebabaknghphlj	FALSE
eaphjpdabghhclhkffnmoieckbabahoidjeookgedl	FALSE
elabablgegdjcoijncnnnjflpcncaibgjhhpkefaic	FALSE
femelklkjjpioienlalbapjijfbabaokgnkkcfaomb	FALSE
fpdbecoababhbkcjmddjcoainmkfdkijlapoopdboj	FALSE
gklgfbabajdmloldelgpofipmpkkkdmocbaekbnjfb	FALSE
hfpkoababfclnabiolefddkpdafpjfekpbjbdienci	FALSE
iakhcgpbbgjegkmgiaokfioaahfojoeaenhgbabape	FALSE
ikfeidhpdhkhbiakhdgbabaflbkbmbnfkdelhffpni	FALSE
jhhoeocbhadlfmfoopkakknnecnplnababbmjdjpii	FALSE
kbdkmbabapkoennkdfpmpedaonheoeoincbcbbclbn	FALSE
klmfdjeaknpeopbmjlfenkkajbabackninmmfcecal	FALSE
lfgfbcfafjoebfnfhpaababfcclfjnbjkemkofokfm	FALSE
lofblpahppgomababepcmcoghllngihdbcgmfealbo	FALSE
mkeooapdladmcababebmmjninpfkebodfgapgancgd	FALSE
nempeghmdeibeibeihgmbbabapgkakenjdnpleghgh	FALSE
oakcicababkocejlaclkafonjolkjdcpacmojkjchf	FALSE
oknhdgahnbgjlpmmlkababpofgppfhlmaojjangbhi	FALSE
pfbpndjababjhaldlicddbfjjgmegeidnkpljhcbmn	FALSE
aaampokldhgobnppclhngioabjogbnpobfjjnpfjhif	TRUE
ajeccnnjphhchpjieodjpigpeodggamhihniijngilb	TRUE
bdpfmgdbdbgaeflpdndbeabkkdclnmhoidjkleajbgf	TRUE
bnnpbijmcjfaddcdojlljcgnmkmgeglpfnhkhcfbpjd	TRUE
cicfomhhpogjhjjkodbobgfgfhnlfncklnonafgobkj	TRUE
dcfjblolpbjlgakkcniiofiojadmdhhjalgajbnhpeg	TRUE
dnhmjdbciepfaiplnpmfedmkpafgglnnndmioahgmob	TRUE
ejckkniaefpfopfjnncnoiidpidejhndcdmbpfnidob	TRUE
fejnhcliplokgkcfjbemaalibmemggfdigjipdjjlgd	TRUE
fpjgmapngomoonehbngafhhdkakmcjmgihndoohmodg	TRUE
gkimoafdacnggkhchmfbalpdimhekhldddmfbpaojab	TRUE
hfcmhmlniiephppfepipamiaaphljfeblpgjgeabloc	TRUE
hnniefcljcpmigcabojapghjbodigjohcnlnaifafmo	TRUE
igjajgeecheobejdckfdhmeebadhnmbimakmdinelcd	TRUE
jakkmedkmjlppomhepebcoghdmjofgigadkhebbdacm	TRUE
jkidhbaplaniobnbbhigcfanpjpjpiljknljilfppjk	TRUE
keocecoaoapkjdilahkoginnmkldochpjomofhaeebc	TRUE
kpkmpgojlgkmdoiplnaofbhecmbameelbblgkggigeo	TRUE
lkbmmobnmckjofdieaegjnjflpicokejdphooommefd	TRUE
mdhblghpnicloaieofnkacmpfboamabfjclbdfhjlmp	TRUE
mnbfamobpfiddnibbefogfokmpdfalkchaonocpjglg	TRUE
nfmbkcfahpghgfaldfgobhddmppbibfajpaglmlmhjm	TRUE
obfbfomgpbmafhfolaendilceaeejhokhlfdenmbncn	TRUE
onbedlokjjlkjedpkacdcbhbmjakglgmlkkpoabimgb	TRUE
pgaobgenfbokoldfiloogodmklohknmbnmiikipibcc	TRUE
aababfigmggfpkbailfjkoncicihpiamnnnfndefhaa	FALSE
afickhcahnnaffecjjpoccbcebnnnbmoolbkpphbaba	FALSE
bababodnlbklfnhpcdpngdpdiolhdcbmililahjiiel	FALSE
bgbjjababcggmmmifaoollfkjanfegbfnioohiejncb	FALSE
cdbbabaldeepnccbaffgjmndfcjoicpfnaobfldighk	FALSE
cpcbmldgcanababbjpobdficijdbnljccmgkldfbdld	FALSE
dicknchioglioplflfiaianlcepklkpababdhhcdpkn	FALSE
ecjbafababfldipcoklahjognlmhhacejekbpijabka	FALSE
eodddnkdcbalpncababnallnboeiomiolkajiilgpim	FALSE
fjphdgnedgdiigfpkfkjacbabakecpljcggcpflbcge	FALSE
gcgokdnbggemdppdojffnhekghfadkababelbpodacm	FALSE
gnifmdffdhnibbkmicjipocgegnlbabampmnigmeand	FALSE
hhcecdailghjiijnbapoogefmblclkjfjgeoligabab	FALSE
ibadcabnbngafjpnbmionnlljmbebabaemckopgndjd	FALSE
imlfnodojgjeffnkfjmaaobebfcemcpndocababoikn	FALSE
jijdfkjejdacdfjaenkadgpbababfgnimakcoofcafl	FALSE
kckcfhajfapanijfjdenplcooenababonipfpmhmnbc	FALSE
klnhacfamdmimalkoogpffpababiobkohbmabcabmje	FALSE
lfdimnjmclnlbehmnegccbabajmffmkbbpaoflpdndg	FALSE
lomdchfnkhcchlloojdmgbabadchhgpfhkdpmmnohgf	FALSE
mibihgekbljnmclnbabainaeoejnepogngepgiodmhh	FALSE
ndieaofjahiibabacbkcaiegcopedofmmdmcmpbfajb	FALSE
npadkhfjfjhfhbnbcgebfimbabadomgneehgmhdkecf	FALSE
okaabclpejcgnbagamabablpfpegceliilkijecjdeh	FALSE
pfnlhbabacneamgkkbaofkbkbkbomgkcalnllemicnm	FALSE
aaececoecifjcbmapibhidljchpohnlieblmeaijjmae	TRUE
alcaboadpaaibmooankndkmmojcbeilppnamfildnbfm	TRUE
bheofoeiolijngfhcpliedbdfngdgedlhppahjlmjccm	TRUE
bokieadocdmkbcllomkaigmadjljjkccigemidbhfpdi	TRUE
cihmgpgdeikaalpecdkfbfnokdmnlhcddcjgomajlbmf	TRUE
dcbhnemkffbpdplhaapcgefbohdakobblomnciimkbgb	TRUE
dlojnhmpcdnjgkigbboppoffljhmmnaijejkeookgfie	TRUE
egbpmnafajkeldijglejfhepplocmlmnelmbjpiokgad	TRUE
epkjicfmicflniakbbigbgeohihndcbndfabofificbn	TRUE
fmfbakkpbbjjfkbfmehllmcaibknfhjjeblpledikmph	TRUE
geklncnhnjgclgpikpnhjjkhbppekbknhcjonpmpljil	TRUE
gohcgnipbjiecekloajldmheakfpcaepcphiobegbgbo	TRUE
hhmohkpolhbbkmmjceeoggibjjjhifppkjjdimpideke	TRUE
idimfejcokcibmojkgpmklphbfkcjegpbmepfofjoiok	TRUE
inkplahanabdjjlpabgjbgabicmjahjekddjiagccgal	TRUE
jhplcglahpenaopnifkpnklgbadnpklmpjgehokbppae	TRUE
kaafgmfcnlddjpanehgkbocfifhchkoeplakjpnbhcll	TRUE
kmeepkcnfdnagikkiigkkppcmldaldnfcamcpghfifpo	TRUE
lhfohofdedfhjnpaiikemklebahocggonmclnogelmkf	TRUE
mcfcnegmnjheehbdkeldflfmpdcjikpooijldojnfhal	TRUE
mneohgfikpabbblgodoflllpogfhlmmaofmhlknhmjhp	TRUE
niclgooaefpbhehmfcmmjohgglpigpkkcoplacabdmhf	TRUE
obnfojgbdeippahelgfhagggdndlodbhjeapdmelihkl	TRUE
olhbjgjnmciblefodkfibjidkhjcglnheljnfebpioab	TRUE
pgoflfgigdjdhpoadoggihdjnpohlochkjbibahklbnn	TRUE
aaaaafedmpfgoemhbpkidkjhfhcionifmababcanhfgg	FALSE
afnndbhedanbciablihpababcmihokolhoedfdifabhb	FALSE
babacfplffgfhagolnjhpokbjmoljadbpapjhcjnlfim	FALSE
bhlkfcncjkbcmppgfdababplfjkodcpkkceajkaellfo	FALSE
celddhagolkldhpmojhkeobmdababhgnhmdacdidhadd	FALSE
coobbpaplcomilbhioggooagcpbjlbbabacpkbeaadnd	FALSE
difhghjjbahpcibmababibekhjnfnafpbfldhpelobnm	FALSE
ecdbmfifhhmangggdlfmakmcbbabafmemahefmijlaij	FALSE
elbhnmninaojepbmababgakhilpgahcecolppefhojjp	FALSE
ffgijooeababliijlbkfgmccmndakbenbajbnnkalkne	FALSE
gbicgdbkikkjgidhhamnilfpcaababfcdohpedgebkcl	FALSE
glcacealkopcggjlnkfnmmlcebfhhfadccklcdpbabam	FALSE
hgknfaelnklaihopcjjejiiacjohmllghlegmbabaekl	FALSE
iadlppbabanlalnlibdildfjhahgchbciihehgollkkp	FALSE
ikichjijbendbeiedmciafbhbehibbfoababojnneapg	FALSE
jfhbolaclfgkpldpifgababckphjdmpodlekmjppbeid	FALSE
kbabpgpjnjcfbbmhgkbabalofbdfcdenkdmpgnmlmgmf	FALSE
knpagbjmihjppogeojdhkhfbdlababhlbaokoacggbbd	FALSE
ljhhdoommjeicabablnmanajfnlmidngnppmlhjlhejh	FALSE
mbpbabaieihadfneihdhlpoocmfkpjackhgbmafgngld	FALSE
mmakhjpbcglndckhhdgaljcfpehcolmofeeababmopeb	FALSE
nfebdbanmloalddmkjaecnfidmndcjiamjgbhmkababc	FALSE
npnlakfdababoildkliaelpdbbidbgjpbipagkpkijnp	FALSE
olpbafcppeamjhabablocmjnccpancpiimnhfpnlhjfm	FALSE
pfchcmgindhagbgfelfdlnhimababbfknlajcecaabhm	FALSE
aadfhabgaobdkpnjnmkaigkadnipmgfjknplihojhhmmm	TRUE
ajongaidbgljgaffhjiaicgmjgbbnfgkcpeajhgbaenge	TRUE
bdlepgckehafecalabhhdoincjlfolahhifckjleamcnh	TRUE
bmgjimindhdoebfdbcopeknomnhciejkglacapnadbodm	TRUE
cghkiafbilpiffejilaohblgkngelgclnfnfdekibddck	TRUE
dcflepcbgjkkcgbcccpedfidpaojimhadbejonjecijla	TRUE
dmgdjckldcaoiejmfgilajiehfcddhfgnendmnhapkclk	TRUE
eipkndkiibfhpjgajeckkmfgfkolahonnonfoajfgiclo	TRUE
fcnnhdnpaciplplbpdomipijoclaepmpgbmmncjdepnif	TRUE
flndpfdieocnlfhafokfijmaldoppafippkljjnbdklhc	TRUE
gepgigggaalfmcdhgknedfblnkmficjgepjnogdepjjbi	TRUE
gpdolnoadnpnflmemocbdlhpjehnfkclodcnhmaghlppg	TRUE
hjlpccmfjfohcbjcpomgkacgkfocioknboiajfkiggabl	TRUE
idpbbpbgdangkciclocfafndghmlpnnpbphapedpbpnfc	TRUE
inalagolblamljfbgmjkaogjbgddnkamdmegbajfnjond	TRUE
jhakellfhkalcmkfhjbcihgfagcdhpjnidalecelocmem	TRUE
kcdifddbbocadnoekbnlcmoefifiehklmagcfhaefgdmd	TRUE
kmiiaggmbbddnjlnadjcpionehpkkldfcnmedgnjplped	TRUE
lhldedggdommnkjmkpokgchbolacoolcfhheobbmfkdbf	TRUE
mbfedljhjljbcafeihflpgjdieegopbpeaddpgkfnehhe	TRUE
mnnemomppjabmcgojccgcjepnecanlpinijbemgaghpbi	TRUE
nhngimbeicicpafjkjikgpnnmdinkicbkdhmmnoaelkjb	TRUE
obkedjbhmddelppconelejonjlclddjgdjjhineeempop	TRUE
okajfnefbnacbmacoekcclhifbpconldhodjacdhfjfmp	TRUE
pfanhgingichdaccjgjallpgcilieokpfhlebfpdcfgda	TRUE
aaaidihcccjedbblnnomgeabdgajlopbaababakfhbdof	FALSE
agpecbabahmiaeafjhlhpkpalagbjlmeebgpmpnboljpb	FALSE
babahigjnmobdkccolmncgckjfbhlgpejmocfelkcecii	FALSE
bhncljahbfipiknlcdknnbabajankkincmcchelpkcpjp	FALSE
ccoababafnbhcidedhmlopchngkepcnohhaijbjgcbpoh	FALSE
cmkkbabajkkfpfmelehhmjimcmfnddeojjkndjoanhlde	FALSE
dhjckgbkhmflofeofcbhhgababmekdpgmakefpeijdjml	FALSE
edfhjeeocogijmmidijjjpjkihdmkpkfohonnbabackah	FALSE
eneamcgdoccflogimnmcogiababdoibbiagpjkpohbkda	FALSE
fhfngfbdocnhidnbabakmfmpmcjabiihbddkpkbjkmnde	FALSE
gcjndoikekenhfloghajigbbodababnnamjopdppddfof	FALSE
gnbabaakjobnmhpbpmohpgboeakiipbkadeapiaaggefh	FALSE
hidbmcdifkhdnehcpppkaababidpljdcjjnmcjdjcpoim	FALSE
idpibbabaelfmgpkikmgjnpkppladnjbllbjkaeopijof	FALSE
iogclbhmicnnbabakgjklgdipegpabglmglhbpnanijpb	FALSE
jknkipofjoapnjjaeiokphodnababedleglmopakochlg	FALSE
kdmnnababbclmilfeiobeimaikkkekmocjbphoedgbkng	FALSE
kofncdmighbhpolgcjlagfjkjojdbabakpailofmioodg	FALSE
ljbbfahnpildbdahnnobabahclfnhlkokimgihgepocpj	FALSE
mcgnlekfijholababhnglonnpcfkdahjbjgcikmpdgigc	FALSE
mnapbakieababpnomndelkjoappdijnakkljdlomfipln	FALSE
nfkgpiahhmbabajbkaimpomlgbkocgicdleblejmahppa	FALSE
npojenbopaibohababngfphibkhfaleeagpfkdimbhogd	FALSE
ojmepeolbpaajkifcbhdofbabamamggbepkejiackggin	FALSE
peiekbmkfcfapjabablcbbdhepmedckikfmhopoljejgi	FALSE
aaddgfafaeejkeboejclokmahpedmbhfbjplbeeelccfmi	TRUE
ajoldidpamipbjfljohmohofmkalkpinejhpipkmoffmhk	TRUE
becajlcjcopfpnkeidlamoopeehkgpbbkgfoecijpchkoj	TRUE
bohloigcfcbkoinplhjkpoekcjdglhbgjejfbkefekkhoo	TRUE
ciaohjlinkjecoojfpcfgpofkdlnmlenefdefohconcmko	TRUE
dcdbacmkainldgakeegmnfapfolbanplollmjjjnlamjee	TRUE
dmodmomdpdhcfhcgkccmiibmmglggmmgilmpkbmahjpgjb	TRUE
ehiejgeddjjkalecmeeadgjgnefkfbmejodcockhchoekp	TRUE
fbkpdooekhgappapampanegmmcebfbadmbfamahonfanpn	TRUE
flifgheobammdbobijmahnkacbkikcpoabhlopkaooeoaa	TRUE
ggdcibpihibplhnnffbfbkkjgkgokoollllaligdcjehhm	TRUE
haloinnkfpbnfknmebepphlbehmldeacjhdlhabkpclpao	TRUE
hlljecimlebaekebdialkhcdiadojoepddjfkpnohhlabn	TRUE
iehdlgljoeiaclennkokobdhllobdfacblkaobkmoneamo	TRUE
iomdlamfkaojomdhoodfhncjiacbfedinbjhidgokchjaf	TRUE
jhhdkcchbpofocbnaofkkbgabchkjmkalpjlnkfpkkihna	TRUE
kdieeofhggfklmjhkgebjjmbcophmfkkjgapkpdcnbkbcb	TRUE
knhhgbnohcanblgbijkiancejghfolaloigodkljkcjpif	TRUE
ligokhbbhhcooailcnlnokgihbglnfepicmklafneajnij	TRUE
mckgoefjeehemhbieboohbekdpmmipeglnfenhlmhmdbgk	TRUE
mnfogfddiaiobiacglgmikblhbhcgfbccoapjjibcafjdb	TRUE
nghifbhbcgiokfjjfaknpebhcplacakfpkcnmalineccmh	TRUE
oadfkhgdjjbioomhfabinikgcoiihnnjengifojjjgamkn	TRUE
ommhkihbikcknkpoabadaallcbegfjlalmjfgkhibjcebi	TRUE
pgbmoceikjggpbldgbcdmifomdbpnooijeeagpkclamgap	TRUE
aababedoemmhegnnfhbbffaiooohannblkcfnkckefjajj	FALSE
ahmkcjefomlbabaadajonahhkjomjoiplcjcknmeikkmmg	FALSE
babalbakpjphgbjfpanlnbjomkgmoapfnnmfopfamgfcli	FALSE
bjldlfdoblopmbhkkjkbhebabalodegnlmgobkhlnogkha	FALSE
cdlababcpkookjgannblcccpbffijdodhhfcnckphokfkn	FALSE
coponflejlhgcjlnclapphdanmklhameababoegijmmnhf	FALSE
djdglmgepdoolainfcfgmhkomibjloababojapeffngdpm	FALSE
eccafefokababdjmglebpcgapnnojcaamlpgdjgnpgcejb	FALSE
eonejababhaniienomdpgecjbnclkanehibphcooihdhcc	FALSE
fichklpbkdiagababnhenlpghkakgpalmmimjdjeakpdpo	FALSE
gbofiliojdhlbcmlbabanidlnkajaggcjmolnohoocbajn	FALSE
glgkcmmjfbcehiokojakbogjcpahfckababpikmapllgll	FALSE
hhipababooidppefcmlekifnedjljddajoigdabcnljnmn	FALSE
icpaidenihbcefdnnhhgloedokbokfahoilababnehcgia	FALSE
ingpfilhofheaghbbihlheacgagpnbabaiegaocljfikdk	FALSE
jkklekgibabanafndmgcpaeidbmndjdpodbedafdogbofa	FALSE
kecjfiabdajhkbophdnnnljbabajailiacopepbaoifjdb	FALSE
kobgdokanceohapngkmllonabablodaaedmcfnmdeocohk	FALSE
lilpabgncncbflgmcfjdaehknababdkabkfepakhnkikie	FALSE
mchgfekabcenakbogdeoogingabablkmnlmhlibgnnehdh	FALSE
mlfhjofokigcpljiacpnjcbabacbpokkechihckidfgaph	FALSE
nfpbloefgckicjfcbbcbnhbbfbiadpofhbeghbabampnha	FALSE
npikpjafanehkgfmphneaflpbhidhbbjkbabahgackfcnf	FALSE
ojjkhkcnffababmjckbnbkgbhcckalmejdjdedahkdomgo	FALSE
pekbabahdiefaipeebjbjihiaggepgpnacfkfaadflebmi	FALSE
aachlbnmcllgfhhffenpaogdaegmgkoahegbhglfgfjmplo	TRUE
aneohcnpmddkkfjnhdcjfgmdljiigdgmcpagioghllbpaee	TRUE
bigpdeenhhcindgdpimloemeolndmljbdpjihokofjmhaff	TRUE
ccknobhchkioohklnnjcffjffcdodmlfnnigbjcegkblkbe	TRUE
cmahefdlicnokeackebapjbhaedeibepjkkffplnnflglfi	TRUE
delgahogbbpnglehgnbecdfeginokmipfdnfgfhldmidgdk	TRUE
dpdihogclbfnjoelbbkedfpphibjenplmnlnodoiklbdcbm	TRUE
ejogiallhmcnklgebfohglhapppjgldelngpghcaiceahkf	TRUE
fdihomdihdpkekejnofognjbnhdojfefcpbphoaioeofjjk	TRUE
fmdkgehdfoijhmncddnnpcbbifjdlbikegjnlknehimcldh	TRUE
gganjnamhailnmfjhhgidgnjfnhlfggpghlkgiblagdiaoh	TRUE
habcmgpddoaojojpkcnfabkajpfcegggglemehbhfdkeabj	TRUE
hleeelgffplaiglgdbcilkndeogipgmljecahnegigfhjho	TRUE
ifakgcmckcfankgmeckijhfkkbdefincljkchcaannmjljc	TRUE
jbhnfcmmafgnkjipebgloddepbdjhhhbaocpefpcljhccfj	TRUE
jmjfplmaolfhldfcnphppmkbekdnkjkpidnnpmdakcbfdlm	TRUE
khjdjdmpidfjblicmffagekjcongmodnanmnpedoiolceak	TRUE
lbblfknhcmlopgbpmaiblbekoclbbjepkikidohmmoliefb	TRUE
llhdbjcahoacbcibadjcjhdklbalfmfpfbhhhkofhieffaf	TRUE
meeddjoelobemflociklbmclllhljfealnkogialpiodlag	TRUE
naokjloolhejiegagopfabfdipghjopkpcdgefljkoadelp	TRUE
nlnbkgnjdmlbmolejdcfdgmfcpfjhiehgaoigogeedmejel	TRUE
oejadjhopegjadfmbjmkkalkipbigldcjbeciloleefmbgg	TRUE
opijibaoopipjlklmeidehafojefjjdhncfijhjfcdoocdm	TRUE
piklhhepdfclbfohmdfamdbmcedkjdohdbhgepbffknedoo	TRUE
aabablcjigjhjbaihadgcfcihlhfamdcmojjmcbmcdbhhob	FALSE
ahdeeihahkajajlkijhmcmkfjfejibimgnndmjpababbfbl	FALSE
babafmmjdjniimbobkgacbchdnpmpojhmlgiceaponffmkn	FALSE
bhjfpofgedbabacjnlflnahggjiakjnggnfedijokeccnia	FALSE
caepkiabaghfldopcehgbgikdlhookkflfiioababdgemhk	FALSE
clbabamiofemcadpiagenffkjnpfhajpnipepobmhpigblb	FALSE
dekcbabandfljppichgedjbbdmnpogklhemhaopmkpedfpk	FALSE
dmpikhdpffmdhdababnlddclpaiohaiimmdhpklkaeifdfl	FALSE
egopejkefadcccdoggicdjjhbabahaknkfgpdpnejhobjkc	FALSE
fbahcmiigflakbbabapjffnogainpgojehdpaepelgicnch	FALSE
flababopihlelmlljomdiilpobibfojnkadlbhbfopkgcdh	FALSE
gfddmgobfgddppljigigemblpkicjdohkfbabanmennkjhb	FALSE
hbabanomledhccnioicjfikngbpgejnimadbnkpgpihbila	FALSE
hmdiagbabafadnaiidpndgmgiaodmekpcbofngmpcpboicn	FALSE
ihncbmcbkielahcpojmkoilbbgkgoepchpmkckeobabapgo	FALSE
jbelpaidmabeeoohlfkmdeambhbghcjajdababpceimfihp	FALSE
jmbjdllhnbabalnplhdldcnhjphddnjgppjookaakkmkabo	FALSE
kjnokcnibmmjcgloldofnldienababnbpmjjjjplagdhiia	FALSE
lekaleiddccopnjkiajhbnnccgiobabafleffoicceejcnh	FALSE
maccleaghnjlcgfepffkadngbehmdofabmjababimannjbj	FALSE
mlbjgkecdndmmffdmbmeabfdaapmmeipggdkibabaehpbhn	FALSE
nedgkdinaionojofclehjdakmkieggpkoncbabadpkaigng	FALSE
oaclioidmgclcmpamncimmialikcldcffpecnbaababaohc	FALSE
ojgjpfdecfkkmcgcebabahlmlplmfmepdlmolbccjcjnakm	FALSE
pdjoamdjjccalnpmdbcmhfkbkfbabakpnbjpblhocfiaihk	FALSE
aabhdllknaadieganihegddlnjlegdkflochblpdcapbclkh	TRUE
ajpcbciiangeeokmaachhnchojklkkngcaflfgbkdgohohpj	TRUE
bbjlnmgpmlbfcdbaogifiemcbihbgephfkfcccllmfjpikmh	TRUE
blljjkimoifmjfckcedfngaflheogaonkhhkebkpmbjkkall	TRUE
cfnjmhljlnjpolpohilablfdeflfnhniadpicbaacfckghef	TRUE
dbklpepgaigdadhnhmhhjjhpebdljmojjnpegkieladimiab	TRUE
dmghahfgcibjanjfjpnlobifpkpnaejjgcbainhkiegnianh	TRUE
efpjchlkddipobhgnahjmamgaodphegfbijonfnhnpkeicmo	TRUE
fambfhjlkehphiialdcogdmjckcdakognjjmobhchhibceca	TRUE
fjplbgalamkjlfggnoklgkmcbmnmmfjhejfnhbdofkbkdifd	TRUE
gdjcobeegplmjkknmlajdblblkacffbcicbepdfngoembfhp	TRUE
goaobccolcaghficahfcbgmnnlanhjolfgineicoklmcdech	TRUE
hjcdjbnpcolohnmocfmbmpmgngjdmndkeonmdolblicgbojh	TRUE
idnacjppgpokhipodilonnlmmegbbpmemooofaeimpghdmfe	TRUE
inpbmdkadhmaoclaijlaldpllpbgbmhdcfabcfnbgecidkgg	TRUE
jhkcoclknjdhhfjepaeleloiiiddggokllikcanocbdmadno	TRUE
kcmlgabjdgmichnmelapiaebgdnjicdgdlnpcmfgnmlbbmjm	TRUE
kobgdnhjiflnmokgnjcebijfakbjledinlfkfohjjpagkpha	TRUE
liehdcldmkdakogljnpnbjkngjkioifpgmhcbjhekiojklbo	TRUE
majijinbbbeicndhffnjhfeibfohdfbafpjkgpkgcmnkdfmb	TRUE
mkmamcdlddalhepdhnakjpcjlklcphenflihlfhhfmledjhh	TRUE
nggpeafkofmemadaanoackklhcpcckallcjgjkjbjncmilig	TRUE
oafkigeknkeeafhbnbfgbefaokfbglfjljaekegkgjcdooik	TRUE
okgfjgfpcogbbdekhljpcchmpdegjomnfiegcfcenkfkcjen	TRUE
pfipmiiinilkggcleklkkbfakodhadbjjlahniebfhjaknef	TRUE
aababkaaojeebhemapipoojlkfcaeecabaakiipcmfmfjgco	FALSE
ahdaokpnbgodokpaacipgokhfbjoogebabaljdlkhgdaeeil	FALSE
babafdchekihkjejmkibfbfebkpppebhepijdabiljkpbnfd	FALSE
bjmjfomjpoigilapadcbfiojbabaekanjjcgmhmonmlphkgp	FALSE
cecalhleheemhjmbcaklennhmaleedgcfjmkgjcbababfmjj	FALSE
dabdkeiajklhhegflhddclfojpaoababicppjbadkbfhhcdn	FALSE
dlnnccmababdeolaojddblnaijicelhiempiamdeibcoofdo	FALSE
egjbllbpjckollbcfmdgljellhpikcmpaababjoaelgnbbbl	FALSE
fadfginidgjdaleikmogpjiendbabaohdfcjghmifkfaakla	FALSE
fjffjghgkippbifgmbgababibbcfefomakfkeocegekioapc	FALSE
gceiabgpgoihiphfgdkpjeofleeahbabamoojlpfjgkdfoij	FALSE
gokababhdkggmhinioljemdfhpgigmpdfcimloiihjkmckmc	FALSE
hhkkmholnhdbebabajdknfnmjkopgmcelokhbhjbmmehmaee	FALSE
ibgjbabadbbepleplaoedppncpihfmdddnmkoadlpnhkdeni	FALSE
ilboilbabapedfkhphnllmhlmlbdlbgmmhhdhoigbcepjhij	FALSE
jfdomgpmejhnmbalhobcakimebbjebjphbabacplniioomfj	FALSE
kahkjiokajcmjacfgdglhippfcdbifffmfgfhpjboababncb	FALSE
kleppfnaababppefgfdbncocfbkeccpnobbooniiiofnjadf	FALSE
leaabhkkniohgdkhpopoiiloojdeegfjkfjdibabafcgbheb	FALSE
lohmdhfkgjbabadkacicoijijbpokipjgendhhmbfmnejocd	FALSE
mlcoefdbghnojcmopckbljmnogeelidpchababcihpdifngb	FALSE
nfijbabamnakaeglmjihgaeaepknkifpfcfjiplccolgblaf	FALSE
npgmhdnababffnfoopdakjhcknfljgalgkniaoebchilngkb	FALSE
oknlfkdmalpnbfkhodobmgpilpnhnababfpnpabphlmmkbba	FALSE
pgbkfababnbddeafbjlmedoapkfihhafaadeleonaiijpcjp	FALSE
aaadfebkcmeonnpkpiamjdkihgonopgijdpnpkknfhfbpkgbn	TRUE
akpgconhfgjggdkpgcgaelgfebkmggglfkfmabpojdnoapbbl	TRUE
bejigomlinpoddfpdcipaoloiebhgnedbgfhcjnnflkkoiabi	TRUE
bobcbnmpkgogdknpjgjhhdabhdebldpaibpckbiehljpndjob	TRUE
cjagbobldkikfkgbcofenelecgehnchcdbdhmelhmolpmdmmc	TRUE
dekkpbfgncfpccokaejcnokjdmmoklafljeidhbkhidmopfnc	TRUE
eadpmobfmnplknijeonhgdjajcfgdpflfejjfgcghdlckdhdc	TRUE
ejmknagmolbaedjfpfepkdnneakgiffcepfkcmfmabmcblbgg	TRUE
fegdgajicpihbamminfnnmnelblkmbliggdmmfnhjjkdmbkil	TRUE
foabpldphdomcmhehoheahjhbhmmejhndpkpepohaiphncbch	TRUE
gikchinfaecafjlojnjkeiiajgilkboknjkelgdcmikceijfm	TRUE
hcceadiidadkgpgclnfkekennmngfdckbinmegfgpekebboic	TRUE
hmcgamcjiokhcmkoghoanmlpmgganlcmknogjgbnljcicgcji	TRUE
igpegehnkhfoopeegocmaocggloamgioknpfipeejkbdpnahl	TRUE
jbgjnmimbchpnhjiofekimfgohihglialolafhjnmmhghlgfk	TRUE
jmnjgcdekmiddfekhjacopfadbmmildajfcfgfaeklmbpkbnf	TRUE
kgbhaokhenkjifpdpggbbbflkinhiecagjplcgpjjcelijakk	TRUE
kpphjgpeplkgjohihdoacbckhidnmoenfchibbapcdlkkdijj	TRUE
ljpognbndgnpbocihihikegoholidmefemcgeciinikidmfig	TRUE
mddfohicagmblilmegienhoncbgnafbpnjgcfagpkbekkjndc	TRUE
mmhbnchjoholbldgoblpphdipdflkgleefbeelkknheennbfa	TRUE
nhjdgefffecmanclanmkmhjklhgffdpffoaelebfgpafhoeii	TRUE
oaohpejacenfkffgkcmgbdcfjeogfcbffhkejjpkfemdlncdh	TRUE
olmepoihjomdbjaajmakemkedbjkbfbnnenkcilcohemejpgi	TRUE
pfmggpboncappkknakcjjclgcelpgcmbckbeanlgncjkagpde	TRUE
aaababpkhfnflbcddmacmeeobogcejnbiicnnpgifgjeaadhd	FALSE
ahcmakckonafljjggjbpdkgdhaafjfdclmjjngecmpmbabadh	FALSE
bbabaihpjbmmfmobkhoeahdiiedlkcblfmgliifoefkbgopfk	FALSE
blababhbgdliicanjpnlalbombdjfmimkogaplfkcihlhlobg	FALSE
cgbhlhkpmkjnmidchajkhchpannababghemiedojmkmdpfjjf	FALSE
dbcbkhaalkcomcjjclfdmeebpoikkpddafnbogababdjegnbg	FALSE
djmmbepgcoaleoaogjfmbilpopdjbdlimojpghnocllbabajc	FALSE
edgdpgehfdjcababbbjhooofagfnhnncbfboimealfjklpeco	FALSE
emllmeigfoigjpokokdiipcfhmmagnebabafabbppbkjgnban	FALSE
fipmfgplbaeiffbabaamnaapodockgccakiebckjnknaofknb	FALSE
gdkpgkpfkcgmdpaeadababdpeppgoffclbpnijecepfclngfo	FALSE
gnllapnookjannkophoffjgfbdlpjbabafpahmbfckigdnfhp	FALSE
hkjkklanpjolbfoifhgjmkaababljpcdnojoeoedlliojbnfj	FALSE
idnfokhiibmhhobabajlkdpambfhgenjbfmphnfbgdbfbllag	FALSE
imbofodipbhgijiicgaeiiagndababnpfkencedmpelonahmg	FALSE
jhjbblgplnldjcdnjopmajgabababiccppioeimaegpkdpfdc	FALSE
kccbgpfjcbabaindedjkpbddncgfpeifobnmdoghiimiflgfh	FALSE
kljcefobfahbfababelahlbkclfgbgcnaainhghhekeidhejl	FALSE
lhafmnoolbhkflgnelehlnongapeojnkkiebabajfdeekcehc	FALSE
maigndddkhhdjmnecdnhdnlbbbabaccmhaelgdobckflngbch	FALSE
mlkaaghnccfpbifhenfphfllajpcdaijbabagifnknbihdidc	FALSE
nffgpfdkfipbomjmoabablepipljkjnhpegnogpeplpmmdggo	FALSE
oababgidkmjchmkdblbjfhhleldogkjcjfpaaghodlbinacjb	FALSE
oklppecjjpjobbabanaganoonlkioooldonkkpibfheoongfh	FALSE
peegolkihfmojpmnillhleocehnepcaodneeababihdhfkmdi	FALSE
aaafehpogbcfjbfiilmifkipnknjedffbifokdbalnolhcaicp	TRUE
ajabjmnimdioliekokjdajkmdpgidcjbnleihflhficmapmhlk	TRUE
bbnaonfefeholopppfaoggmfblllekgepodgmcgjaagoggbmmj	TRUE
bndhlcbfocohocahocijdggbkicjjigomhobiigppkhbgkodec	TRUE
chjagjelkggohldmgooafcmlbdgojafbjlbpfgkmmlmfcaniij	TRUE
dcefikadepacelgeomnmmfckbhddophajljpicomhmjglmkmcl	TRUE
dlflplcfdhdncjhkplfopcghogbadfkgicabjggfjkeahbmcoi	TRUE
efoljmbgglfilddkhmjcpnagbchiihdklcfpkpgcndohekkafe	TRUE
epnofdbjoomeocipdjekaonkgoacdojkenjbalogphngjbaane	TRUE
flhgfohhafblannlaljmegniphogcdopgdmdaehmahchmibneh	TRUE
gfcpegjbnpbdbbcjbhniikdmlmcnlbokmkadaojiccpghcmakf	TRUE
goeocjmpadknmeapdfecijjjmaajbonbgjcfceekdijpfppgdf	TRUE
hickemlcbocceidilnfakmliebeepgihkpbmhlnllnhpmgifkc	TRUE
ibloaefnagkckhkmcbaapnnddbakpnffbdoincampjpaodbffo	TRUE
imkgaolgdklcbjcmmjmoiciljkgejfjkllaffogiiehdgcedgb	TRUE
jgfemjdakfjnmcmmmhpmpolngaagpefcfgoboamphpjgacbboe	TRUE
joilojfnhadhkojjedlgeiadodcgahfeolgommbfcfcgkejmnf	TRUE
kigbgomihfplbbfopdbacbhneekmindfjkjhddlpmhjlhmjomc	TRUE
lfcilandlfkbfindlkmhfcfilbfndgbfgmfhpkogiaofahdbaj	TRUE
lplambhenmgpabikbhekimlpfgocjdcnldehiociejgeegelhm	TRUE
mlndekddboebojaeaaemacfichlakiilfadolnkhiejgjcdngg	TRUE
ngibkcgifmcapejdmaoafipkpoekmnklapcgkepjekebhfkpcl	TRUE
oahkiflichnfdpfpmhnkmcfjlcebdoamkeikfibpnklmboiaik	TRUE
okpaiklkihegboaoeenoonopgpedkjdifingmlleaelcbdmood	TRUE
pfgeaphkdkmghhckefnnggkdmbknnimidmpciffbbjpaennhgb	TRUE
aaagahghmnbadoghodnimibkmbpnnoaabablelchjlljgkdfpb	FALSE
ahpmpghkbogiefofjmkenhgginbdkghafeaflekhababohmoki	FALSE
bakalmjdbaababkddlejcblipekaoifeklambphdoljkimehej	FALSE
bkhnahhbnibbaogmnhhakfnoficbkmanbabaegafaojlkojkhd	FALSE
cekgjpjinfcakplapoecnikifbabacdlghebgccpmppdebhegi	FALSE
cpababgjnnaofdegnmghbdlgoeclempahnolhpbljjkmddnajn	FALSE
djphanegpcagcbigbabajhglimnnlhkailcokjgjpmlnephghd	FALSE
ecggalbdepjafpdnbhlmpmpndebcfibabaaedfkbfcjigkjcdl	FALSE
emgimnkmklababhjdhplibeaibbmildkhjnhkkgdiegfgfkgnm	FALSE
fhajdifpopfpjkgigkpebodcciefmhijlnbibabajokghmponb	FALSE
gbolnpoepkcamojmlmmjcjefmoemmaijhjdeoaehbabakccdoo	FALSE
gnfjlfphkcmdloaobabamffkpimhhdfifckfonnjmfgfedehbk	FALSE
hinhaoiabableojgkeeoomkmhjngpgdfgdlpldfaghcdfdhgmd	FALSE
ibhockbekhanmjclmhfelglcjjhpkhpababbpbjbdnpcofmjkj	FALSE
iofobkfimhhmaikdhababcedejjddnlbpaomnebomcoclngiek	FALSE
jhgbmkmijpocdiebekaehlemlllmnlnefbaadbcngmdjegbaba	FALSE
kcgbcagefaofpfjdlgchlkpbabahkpfnedmcpbflcdhpkamhfk	FALSE
koadnngdgfcijjclfilljgnbknbabanmklhdjckojlkkjafcdn	FALSE
lijlnghecmebdfkdnkcpcbabanemklccciphjekheeeedaabgh	FALSE
mcllpamjepddgjmbemkpcaoccngilekogdjcalgidaababjflj	FALSE
nabbhgdklfikmgndadmmmgljjfgfcpcdlababjfohadmpjkolh	FALSE
njgeaogdmiljmnpadhhbcdjhbabaelgfkllgpjofhedffbebhg	FALSE
ochekolalioopocjjdjgiabableoegndfgphpojlpkbnogogih	FALSE
onbabapdfknoliedhflflnelepkflgeghbnhmpiiieghpnlefd	FALSE
pgepkphhjlhbijepbgkfagopkmemebabaojjmeidbckleedfid	FALSE
