ùǔoaaaěJmaǒuMtaǔuqhz	TRUE
ǔaFtapúHLaèúaèIswTǔa	TRUE
àTaèaJvaéawǒpCQǔlaáa	TRUE
ǎmjIIFqvaaèkúxIaaKaS	TRUE
èYIaàFóaquéXGKWazSaa	TRUE
óAJTIaSaBaUuvaFFjáHa	TRUE
òqFgOtaaVaazBhyajNfE	TRUE
úaNWqVaWUaaXóvmaDBKA	TRUE
AvyaèaaJharaIlUiqLtW	TRUE
CaEGàxjCWòUéaaaABZǔa	TRUE
ELnaaXaúaOliaIùgHǔpR	TRUE
FrYraaNAakIqEMatafkL	TRUE
HaáaKKaajoJZUUOěàùUa	TRUE
IuBktaEgaWraoaaTiKCY	TRUE
KaNUaaIatOěaBHvJùIúS	TRUE
MèaǔóMaXaGQxUZazjaom	TRUE
NnKmWòkèaùCqaGèaǒaaO	TRUE
PWúhUaMaWakMéLaaùKmB	TRUE
QwazappTǎjkOǔYàotaaa	TRUE
SKvakaKvmURaaVzBamEY	TRUE
TkxóauélECLaDIaNóapa	TRUE
VaéǎBùHaBuBRkǎaajqay	TRUE
WwúXaaanLOsXaaTeXOaM	TRUE
YaěZǒaúXBahvOZaviCaě	TRUE
aùZFCàiaapalPEoarlQE	TRUE
aèZǔgaxòkKqaaPVòVaQJ	TRUE
aAaEzkwayFèHlMàAYaaT	TRUE
aHùRSapRéJaWaCàtJaBL	TRUE
aNMJwǒaSaaafhwTóduEX	TRUE
aTǔataaaǎLáhbGàěHhéó	TRUE
aYaùpaaGBxòzAaQQLmER	TRUE
aaEmúanaoóxjèáǎǎTaLh	TRUE
aaaǔYaòaóbvcPmàNiwvN	TRUE
aaqaóaAéVZUpǎaqǒòFxB	TRUE
ajaazèDEéaYzaNLOtàòé	TRUE
apáTrnuayaYuaEGOXjaw	TRUE
auaúěaGnǒvolóTaamXsù	TRUE
gYxKaFSǔVaagMuaHSzka	TRUE
hvkgrDPahKVpOlèaaaèa	TRUE
jRǎJjsaaarnalYòMaAZi	TRUE
khaTǎàaNóajMawmzaCúP	TRUE
mKJZèǒFlIaǔnakǔaaaVs	TRUE
naǔakXsHǒǎLggaiaazrě	TRUE
páaoKsYaaHMèaaáWgGwW	TRUE
qaURLaaaOòyoǔònabQUU	TRUE
sGaèyǔEsaéEJVaùViTaa	TRUE
tgaèaxòòóavQazònóaFy	TRUE
vaùapkwaVlpBaqWWFaTù	TRUE
wmpGjahǎaGaxNoaaRIVf	TRUE
yaóDǔúsaCXanéaéysǒéa	TRUE
ùǔOjCQfòéfzUaGWǔqUèh	FALSE
ǔFRzúuáfEZòCgAUoFHVN	FALSE
áZjnwàmKěGLVbǔGéVrug	FALSE
àqcMósCDwGùocEnGcǎRr	FALSE
éCòtúCRPSJyynepzpngp	FALSE
ècwětmóòèHZYzvlLEwHb	FALSE
ěaYrdhoquqòtQjAsJcěá	FALSE
òǔibLNǒEóSTiouAjùUBd	FALSE
ǒCuuUuèNHtrwosIOvǔSy	FALSE
úLǔUèǔAǔToNvMpBMuùLc	FALSE
AeòàtaóKuBnczmArGJbo	FALSE
BxcàMctáYéLeNAǒVEdàW	FALSE
DǒvGAfBjYEefVòàùLBwc	FALSE
EKDUGQěKǎǔaZǔORLgOZR	FALSE
FjòǒoEòbVFèdecXxbgQA	FALSE
HězoáYTOúqoTgpáhojVO	FALSE
ITásVDèZǒWòwóeydPcǒU	FALSE
JZvDàsEcjWAóoCEmfGcB	FALSE
KnǎeAéOOcǒTqmIATóùPǔ	FALSE
MèWjsjseuRPQKOKOkEca	FALSE
NWDCanòófǎZsaCJkǔeòR	FALSE
OpǒZěwoQomáUKUmygǎpx	FALSE
QDKúQKsYIRǒtTvPyxTDS	FALSE
RYIyndNJUQVIOzúòtmzě	FALSE
SymNJmHWoyHPzNrvZybD	FALSE
UDǎkITWxaòcVàMéxFěig	FALSE
VbXvqUmúòěǔnfǔJcqcQá	FALSE
WpTùIKzQvmylǒaèXUùZH	FALSE
XxóXMOfúsóvVǔǒùǔVUHW	FALSE
ZòJJEQǒJscUxyDDYuzch	FALSE
aZxGfDuEAxtZùǔWAhFnf	FALSE
bvTWdyéviùtDNEQnúkja	FALSE
dòZKSZFSóKZwQZncóeWG	FALSE
eJpPUDàhǎoYútlksMrLV	FALSE
faPǒSSbrFúHdtjùhVAgx	FALSE
gbúdhvHUwVIǒAPFwjBTA	FALSE
iàPwFOTmHQtfnJJnoáBǎ	FALSE
júxXgǒhábWkEHsàgeéoǔ	FALSE
kRpAXwQQolHkvTùloǒsé	FALSE
lqnoQumbEpBUOsTSxdGU	FALSE
něBǒKaǒoTXtjYIvWkClě	FALSE
oGAsOázbnQYKiZdnwZTX	FALSE
pnáóziVNqòVYòRuPXERj	FALSE
qxWjVoKDsdbSCEIXrPzB	FALSE
sOWvzùeRaLntsiSnDòXE	FALSE
tXTXǒcsEèHWaitBVoHǎt	FALSE
urTOMVJnúGòQyPélduYf	FALSE
wúIǎgyiNùhwBMqQgOuOy	FALSE
xbyàSUsbcúSějěgdlmKú	FALSE
yttVRYFbAYHùmjEFBxvR	FALSE
ùùaFPkaaEOpoIraQDaKòv	TRUE
ǔsotóaNhaYJaàlNaaZOzV	TRUE
àQaavMaaělòGúHjějkaxà	TRUE
ǎjǎóaaónsRǒamEaTvaqkb	TRUE
èFaqEyanXsgRěKYǔqKaaa	TRUE
ěaxwaVVaJùIuaYksTǒaju	TRUE
òGaaùjCaòěaaóuqNWFVAò	TRUE
ǒaaóiiaJúLǔChQaòaTmmo	TRUE
AúazaǒhǒiDFaěsRiaěCaá	TRUE
BjFOvCKiSxaoaoaNaFqaA	TRUE
DúxCaéawtHhnHěNaBnaaZ	TRUE
EaVaiBaAéaKlaùàfGMrqǒ	TRUE
GèazBǎzóKaaanIwOJhaGQ	TRUE
HZrHNěoYaHúxaqVaàěaaé	TRUE
JéBLavaǎoAaAVBwaVaMKH	TRUE
KXaqNawHiàǔarVataQDUO	TRUE
LsZmKóGVuaaDaǔIaGLJGa	TRUE
NaMměòmatévDXaMHòvsaa	TRUE
PàòwOaaIPPIaalCBwaǒàY	TRUE
QaǎahaZIaqwǒacUIyvětG	TRUE
SLCàixaěoDaasOómaBGXa	TRUE
TaXaaKZáZaùaKBQfáAsré	TRUE
UzwKúaQaNmWRvSSaUagaM	TRUE
WaúMZUalaAZjamééARFaM	TRUE
YQasééwinxsmǎSǎaàaxaa	TRUE
ZqaJúaIraǒaǎaSUGJlFvF	TRUE
aéGXaXxssyáaTěRAaEaqc	TRUE
aúHGaBáaJùaánòEùèaǒIǔ	TRUE
aExáaaǔJajaqǔIIigxGǎó	TRUE
aKùwqapPǒiǎFgEéaaaPmp	TRUE
aQPLMYwQajéaanaǎdMyJw	TRUE
aWOYàNOWUuaOaZKIBǒaaé	TRUE
aaHXaaAaǒǒedMCjiǔSéJù	TRUE
aaaXyaaHwiǔylomAGǔPZc	TRUE
agNaIěHtaUVpDaZzaedUb	TRUE
alRalzSěJyaarAhBgafkH	TRUE
arYQvraaaXǔRMWaMZǒIHǔ	TRUE
axNapaVvFVǔFéaǒuKLMaě	TRUE
goaǒaaǔRòaPlKZúRafpue	TRUE
iTǎKPSxOnaBaaóuwwkaan	TRUE
kǔJTBAaBtWyaEaILaaùPG	TRUE
lahaIXéMCYVúRMaaoaPFJ	TRUE
nKlzaSAJaDnpaaauHMóóe	TRUE
pááayaYaXaIacaTPNqgéM	TRUE
qaúoAIaxNCùOOàuaaINGa	TRUE
ryTùCaaaaaYbjiEmvtNùz	TRUE
tahmaZRáWpaajoaOjǒSCú	TRUE
vFaqawxaǎlGèáJiaawYów	TRUE
wglaHaSgòéaHgCaaaVúGó	TRUE
yPaaIMuIEUaTaOFǔaSNow	TRUE
ùùùùásyKxHEùnyfǎQYnho	FALSE
ǔQDIqIKgpyHSjWZǎěfùLó	FALSE
ájNlhòPppxUbsóXxǎěmèw	FALSE
àsèKáaEfQVkYQáZnjXòZH	FALSE
éòkuzkrvXQJVěEěàuòakǎ	FALSE
èMGoWjSoěNǎtrGXHàLǎàn	FALSE
ěevZZxMvvdaxqjsnuèKYě	FALSE
òǎMrHéEJkaáéèèǒiUaApE	FALSE
ǒJZpYAúyoXùsyǎGDòGúuH	FALSE
úiǔptUNRfuUaómDUZjnFU	FALSE
BǔwUQOSFSbPéǒsDwwwběp	FALSE
CDéòúaBzNqZeboùàsGSsǒ	FALSE
DYDhJxlWnàamměqatuUVF	FALSE
FàCútáTèTcCZsTicèQMvH	FALSE
GOLlèǎOZùKòMsyǎcGTPWó	FALSE
HjfIWFKLszglOqdxùrKPù	FALSE
IhPlSzghUnǎUaSipHMúeO	FALSE
KěUbcxéèQaSOOQjmárhVè	FALSE
LNiQKBBuàrjwèLóUùeměp	FALSE
MhèúóbOoókBZfRoIoBiùx	FALSE
NwVGEYToSAmQKulWlsQhU	FALSE
PDLBǒkqneoěJuJcODlnJk	FALSE
QbOkSXRCdǔNlòMCěemdnP	FALSE
SábTǎvzCGTTBcúIKvxGKè	FALSE
THNNGJǒOǔóRPTóZúYBrZm	FALSE
UQiGlèeUàAhuEOKUdǒcěY	FALSE
VjAWègDZměcowOWcqùvcb	FALSE
XáfmèFYImMsávèxǒDyZFě	FALSE
YQǒpYkuLgNxéDmWYnKIKb	FALSE
ZYǒlsNWqmuúKkbRRvDùVé	FALSE
bǔǎDfǔzdSiwxSZáòUUàdj	FALSE
cóǒrKáDKǔAjKhǒHcYèfPl	FALSE
dMtǒLóaùèIEyhxJpYúùúP	FALSE
ecóCJhlwbBMǎùwJiRèDOP	FALSE
fdòhUpWCTdbYkRSqgPKsa	FALSE
gvmYOgQKhěǔsOòKtàPVvg	FALSE
iUǎǒBhVfòKwRòLFbXRkgQ	FALSE
jzsjàgèAUcǔyLGKAGFWsb	FALSE
lǒaxktXósDiDpSsmNSvZc	FALSE
mXRCXówgzlèXJrHpzáNSp	FALSE
nmuějMkàsǎneNlWVǎqeèI	FALSE
oyOtFugoWmǒòYpuEEAGCg	FALSE
qǒXómEmUáwééuvgaEkqJù	FALSE
rgnymLAkwOSTjXKQwKúvH	FALSE
sdpSzsDZwKQxjWèbHúCcò	FALSE
teéUeCgHDdDBrěApieoPk	FALSE
usQLQùjóeùRObfcTóFSGǔ	FALSE
wǎGabxàěěypzhědLózLzk	FALSE
xEògmNJùpSAvXtòyCRóSA	FALSE
yQǔDfLěSJǎǎiWeACEpthú	FALSE
ùùBaápNmHZaRaxMpaaXǔez	TRUE
ǔYJUiǎaaNagaLwaXcIoIgǎ	TRUE
átkpkauaKúaEagǔaYFLXaó	TRUE
ǎYéCaqěKgpUàaùéuXaaamN	TRUE
étaaàmKgUaLaFjáaRùMQjv	TRUE
ěaaLèrtYATjWqsòQQaaazM	TRUE
òBasmaxuaPgǎàgiǎXǔXaPa	TRUE
ǒjèaǔaalQaYanVuPjAGHQè	TRUE
APaPHEaQǎTiakQǔCJOJaia	TRUE
BozIǎǒCgaaQaNrújBǎukaa	TRUE
DMILqsqwéaahNaaoóZadjc	TRUE
EasaséaXkaOmaPDVQFHwuM	TRUE
GDURxaUBaaaEòzàZFUJAGa	TRUE
HaMTInwéàaǔaaaZéùàcUXù	TRUE
JCjpFoZóCaHiEGnBaqaJaa	TRUE
KXOumazaKanùoaxWwGFUáa	TRUE
LuaKOESuFèaòChaěBmwaab	TRUE
NaùAOaxǎiGaaETvaidèfew	TRUE
OumaMNGxèaakaqaóǔaTǒji	TRUE
QaaùQaasmMǔaWbOVnBBPRF	TRUE
SùaXRHJúaKhnamzUaOaěSM	TRUE
TapDaùóuFYaaràqHMLaǎQo	TRUE
VIRBwEǒaBHaaslaGǔHMaEF	TRUE
WyaaarpùpěyjǎaazNquFHc	TRUE
YCzqǎaaFFlaCaǎaúàxVAOt	TRUE
ZxaQQaYFaMGOaJáSZwaMJq	TRUE
aéaaPDaOějPaWMaGUuBiéǒ	TRUE
aǒsCǎěVuaazLǎAéáaǔpǔaf	TRUE
aEzXrMaàJFCQòqagawkaio	TRUE
aLEaǎsRàuaaaTùXxBLJGbm	TRUE
aSéjaJóFaMLpTnaUvnDasB	TRUE
aYGTDaFáHàúxtIWaaauèvq	TRUE
aaBoEZDXaSUCglaEjIǔaàé	TRUE
aaYmayAhNIqaYaáaJTòffz	TRUE
aaxnǎǔSoóJèzPISàaWaaIW	TRUE
améIaraèěLawlwaHaPǒXWF	TRUE
asGaòauaǔozBGCSpǒBEaeU	TRUE
azěsǔoyaSaKěaPLWóaFoyǔ	TRUE
hAapTaaIoCaUváyraEQfùc	TRUE
iaaDtDCHOkaòJòaúwGgBRa	TRUE
kǒsaǒhGsoawlaaùWyPaApf	TRUE
lkvztiaǔzaUaáiLMEùèmaa	TRUE
nVjětDSqàIaqsaaaRUváaa	TRUE
oaZQaoměhěáWkMBQraèaae	TRUE
qKjBLùBnaamúSDóGaamJsa	TRUE
rmlvNYhXBgaahHajaICxBa	TRUE
taPPèHQaYǎaaEónayáyběz	TRUE
vèuMaRaèěDaoxYZèaóFLaě	TRUE
waaMúǎJDPVòtaQiyaajypd	TRUE
yTmaMjáwaJABaLaatúpǒóN	TRUE
ùùòNéBkqcgVXIvgVnèsèkB	FALSE
ǔAKToROèúǒCùkRCKoDFsòq	FALSE
ádúOwǎQgXjòoDvséKOǒsSg	FALSE
àuXEyZǔShPRèjJkápJWOLǒ	FALSE
éěěnhiRTákúSuvejTěàksT	FALSE
èéyyàyZvMxZgLhfhbZZMZD	FALSE
ěKEYfUHèKmLlBkáéúLmiHy	FALSE
óShWrsQJèHifèpyRmzsAzL	FALSE
òebgwteGjsàòrǎTàHǎSnùz	FALSE
úáléiPgèlcáérǒAernOqNs	FALSE
APeázMěvegBérUEzáAǔCùy	FALSE
BdYlěètHpZDVrEEiDPaHfà	FALSE
CnyXjFnfèèKkcóyàatXRKF	FALSE
DtvVHXJimoEZtmRydiTNtq	FALSE
FUsNèJAóYvYHLwúpTJzǒNJ	FALSE
GsnolághsPLcBbJFRòǔbQV	FALSE
ISéfùttǔAoLXTxQdJǎTpkK	FALSE
JqèHzjpOEtXAfAAlCǔMmuě	FALSE
LààpóZjjjixFOqSvYǒxyáQ	FALSE
MQopfnóZòOCǎWoQJóǒǔoxB	FALSE
NqLWYéFqǔMǔǔmùRIéMǎsCi	FALSE
PǔEárvEǔoakNTHFWùIloEa	FALSE
QAqFREgypěVúFiHtòzJWòq	FALSE
RWhwwxRHVLIáeDmuTssIDc	FALSE
TǎupnpèIqyóoppumTZcskr	FALSE
UGYégkCkouQXDǒóKùàlzùa	FALSE
VTkkOvFǔLiaUáHtoVADkMp	FALSE
WghZéNmdQǎQyhGpóvteDJá	FALSE
YàloeǎátZkpéǔóRQgzOsPò	FALSE
ZúpònóbXqpkSwtJcxéVnǎx	FALSE
aRJedgmuǒFGNòtWbzdmHnl	FALSE
bgClxDáPDérzwóoháěorUo	FALSE
czuduyǔoCáVRVckxxURPòk	FALSE
eOJygnjǔXGapóubcrèróCD	FALSE
fhTyaúZLNCèsKAnnRTCtmR	FALSE
héaooZEsAéJAolùJokzáYg	FALSE
iAHsgiGǒDdJàEJUEunhmMg	FALSE
jWǔMYqqdRdFPcDhàGIqDàH	FALSE
ksXeLEIzRhéSǎynlRǒErhm	FALSE
lzTcrtcóYMmoJèǒPhóZDXz	FALSE
nCjTHòléZCxnAoaǎySzsNá	FALSE
oYLxESMKùǒùKzjéQUǒYsXu	FALSE
pqOǔOMzYúWKwáPObOJInbB	FALSE
rǎEhlúTévJlnYuQlCAeMzE	FALSE
sUdECmAodfueziKyhNjXTS	FALSE
tsiOǎuvúfXJèègHuvfdǒxK	FALSE
vǔFhUQtcXBèMHvzUEěúLIG	FALSE
wEèLúMúUobDòóvòEéSùEAé	FALSE
xQWǒEgaLuARnXTWéècSEkB	FALSE
yoOàOiFuLbRKzYNSsoHvúǒ	FALSE
ùáaatNaaaoáIVvTORnuFmèZ	TRUE
ǔaQoaMGSèihTǎraDCavpèAa	TRUE
àHaNvǎAwmajaCHgiaijvavj	TRUE
ǎaaaàZéaàrtaùǒQGXgWtǔqK	TRUE
èèaMoLaEuaǎzhóqùávaRVia	TRUE
ěZasàukojauhOBaòaaèEèqV	TRUE
òGinahaaaTxěěgqaóqHfQqm	TRUE
ǒjRáaATmraraPaáuǔGaǒAeV	TRUE
APvuAzUaLknaKwHaapwǎwaE	TRUE
BqaDaUISwaAVGórmaVUaLPh	TRUE
DQPQvaYHTaaCBǎaaúqFuhxé	TRUE
EaaIaZLKXBagèǎhLgaUěcTp	TRUE
GǔFaMaIBǎMyaǎYatCanHKWě	TRUE
HaoaNUaaXvòyrgaKQǎóNCIx	TRUE
JCCǒBhUǒahaahtétSaěómaS	TRUE
KaaǒwizaPàBǒiGKaǎBmaóěN	TRUE
MùKWaNVTǒǔaaaaǔzàèSklSw	TRUE
NLFuHaaǒBùòaúSxBATatEaE	TRUE
OlNYajOqHUaaHMKúaarjFòt	TRUE
QaCQMtkBoWauèwnmamaMaòb	TRUE
SòóyTJTaaWWaqaaXòěVfGAp	TRUE
TaBaWwatRaSaZTOǔǔSuHEXT	TRUE
VEFùaaaUoTFRěUQETFaSVoa	TRUE
WaáBwyàzLRRaavǎaXPGúabe	TRUE
XnòǔqZnqaaaoyalěROQHmFa	TRUE
ZTtùUsèvaaarTaaDOvuHxoG	TRUE
aàamSWxóaaǔjaNgkKBtóeùB	TRUE
aòvkkOěépaǔaTaaiIpxuéSé	TRUE
aDnaUyaliTFaThJaWADvjnc	TRUE
aJaavǎLjaQáTaRcCtěbàoòě	TRUE
aQParòCaMGCǎzaabLghDgKc	TRUE
aWayáRvDGToǎaPawsKaKnKé	TRUE
aaDuawaUáaáXkOjěVoaUùsd	TRUE
aaaRBFpPVěvaFǔaENOJXLSm	TRUE
aayxáOOuaauaGǒòpúnpqzQp	TRUE
alvAaTqóYaaHHzIAPPRIaǔé	TRUE
aròZIlòǎCNLLaahǎhWaòúaI	TRUE
awkgaKSgǔqaùaQǔabHRKóǎH	TRUE
gaméǎàěaUEEnàBǔagaKanúa	TRUE
iRsTCaaFěnjùaòBYTDaǔaUn	TRUE
kòVqNèèóaaaǔwéaéMzóèwaò	TRUE
laaXIpUqaEMTTvAujiUzana	TRUE
nǔMóàlnCaàaappòúaakRóós	TRUE
oagapúǒéuBéwSNZJwǔaTaèa	TRUE
qTCryjaazaaǒaóùXfGzLYmg	TRUE
rnZaPsuálWaaaHAKǒFùàoan	TRUE
tGwZwEDDBaaBaMUhaacHǔvX	TRUE
uaiaLaRwgaòvKNSHZùLQXQa	TRUE
wHòmArFRyJuaaanǔaǎZIAaC	TRUE
xyaaSaǒǒakùaQátòCùkXáAV	TRUE
ùùIEǒHwXdABGZuRpMvxIlyà	FALSE
ǔSòóltTiúnEJZLàdVKèUòSq	FALSE
áiaSáYXéHxEWBnSǎlǎROláy	FALSE
àqcwòVfyěǎvrWKxCǒLáMàHr	FALSE
ǎxOòzJslSwOxCaAYHZàRVwl	FALSE
èBSlMPWFuxèjEǒWOPùóXTùé	FALSE
ěLAORNòZzDùySHAǒGǔTAKzK	FALSE
óOnjmFuWjáFQRHhedcvocvT	FALSE
òmelIóáUSLpQqùZllttsJWH	FALSE
úǔWHoěIaduTǒuZdriemwpǔp	FALSE
AGòěDmnxàtnxòpIehwCbXǔM	FALSE
BUFùpOeéJXóCKXkòPyXáèaE	FALSE
CeDBlúmúèáBFHXhǔmQpyébx	FALSE
DròLwlBsfkěùziSSXhHNjNz	FALSE
FPpmUnqǔjèVsuCrCYYwMtYF	FALSE
GsVvllwmGcgàaéěXaFUóepm	FALSE
IBoZfǔGpOTERǎJRHSpZFHùh	FALSE
JSXrúuAkLsxhRrtáthOtzWL	FALSE
KhěóhrOCKnmǔisGlWtgmZsI	FALSE
MùUCLiurhrnuúhMVKBHwkFq	FALSE
NějyVUdRpVrLHXNCxfXqDIM	FALSE
OLJVcViwòaVdàǒTLǎǔROúfS	FALSE
PhhòKTaYujDHsLàCúúRtDàk	FALSE
RBéǔSǒklWàòeFcDRoVǎèékm	FALSE
STlàlǎCǒúTIXTràTpùxZhCH	FALSE
TqútQoZhGSPTěǒDnhUVUágc	FALSE
VòzvzáOLPéKDAóIněvěVxáQ	FALSE
WNsQYněfhquSàSdyyYRwǎiI	FALSE
XpbwbióNgPcTMUMZwzTǒǎVT	FALSE
ZòǎsnUúbǎènYAOnJEWǒFkQù	FALSE
aKǒòàxqAǒSIóvhbzmDFsmFm	FALSE
bhùGOUǎbaxTvQhizRHDRBáp	FALSE
czáNSKivqshWfUQkOKbLàmǒ	FALSE
eǔzoèvúKowkfgzmúUnvLèGD	FALSE
fNǒhSUwumBgDiClfCGUuòoi	FALSE
gWaETeMsZHeěcwWqèWjJVID	FALSE
hrCceyǎòlǒFuDnTYZùCòmrS	FALSE
jòqKdKjKhmiqlXNmRaòLBzú	FALSE
kNJOuTUfávfQdObtǎéréaUZ	FALSE
lnlGncnYWěMcǔcjùóPgUToǔ	FALSE
nèsǒOóTuEvjbxMoǔNyQěòàb	FALSE
oKdSXaxSEyóJAkvǔYnJlùyF	FALSE
phJgRMúWzLsqgǒěHzJIpKSu	FALSE
rDRùJěúlúinwúǎddIéipJǒǔ	FALSE
sUpnqbyfDpoqfAáULBhhvúY	FALSE
thElIYnzbtmwQToóaZGKRcg	FALSE
váùàiMàǔCAùbmGzgYkPwhzv	FALSE
wHcIóKòCafRBECàùtlěojcA	FALSE
xXKAǎQólYrVRèòoqtYkwJWq	FALSE
ymBAúbqfKhATiCNǔlgoinxx	FALSE
ùùǎPHaaòwvárKYaSDjpaDaěg	TRUE
ǔZwMsVgwElujaqyNEúaàajaa	TRUE
àùHVěkBsataKamgmtasGJDja	TRUE
ǎPUǒNXIaaaòóGaOzaytòúhfp	TRUE
éaazùuakúGNygUáaIaǎDBdáp	TRUE
ěDAaaoarOBFòtVzHPěhmajka	TRUE
óqzEgSuaǒpèmaTǔLHèaxJMaa	TRUE
ǒèmUaVEXaBaSǔiQgBaawliMù	TRUE
úarLyóǔasaXWWLMaykǔohZóa	TRUE
BWoǒwHzFuaWRanDaáavYHamO	TRUE
DàaáHrVaYMkayapWàwùaPmùq	TRUE
EkèrúSTZZaaWaàpaCtgvFàan	TRUE
GPaKòàaZFěaDRaKǒQYaǎIwDd	TRUE
HoanǔsjajaavlNyackqVAiTj	TRUE
JHaaZyéaaAqHaJDxzúéYèàen	TRUE
KavYǎěéGéaóUvDaaIXǎúaQTá	TRUE
MSàNúaaǎaXóKaiOélaùùgYmè	TRUE
NwwaRxWuJéQCǒPRǎWiaaAaap	TRUE
PTkauOpMyKMaLawSFěsaaàOR	TRUE
QlaaaxaKkgYHSDaWCAoPBǔEh	TRUE
SěaanǎókGRTǒyIGayaéFaizS	TRUE
TFAaQVQawmsBaEaAkaeKànòà	TRUE
UagmaoFQHqRaaXIJQaěhbTIW	TRUE
WúorRFutawharILhMaQsvLaa	TRUE
XaaMCaPuèaroYiyaNoSPJDEK	TRUE
ZOJavalZTWwatNxxKNaVZGaG	TRUE
aàqYwàrViFaaCaùrulsnHYaǒ	TRUE
aǒHVuJIQanǒaavDaáDoRàcSx	TRUE
aEsJaaaadóJawpUOobqpòóǎd	TRUE
aLaúPHKXaUéùtzLiPZàSèùaa	TRUE
aRoVaazUglǎhtyòpaumoXěar	TRUE
aYnaaùaQvmFpNEFZǒQěVLaxě	TRUE
aaNBFhhUaǒixHaiXKaǎOVdHp	TRUE
aaqaósVǒDiKéOàBòavkalbfk	TRUE
ajmrǔaSùpFùaamBKraEDnBpx	TRUE
arEHanvIúòJFKWaDaèaápNfá	TRUE
awiGaUKaOXLLqapoàYùDaRyi	TRUE
gXaayCGvTQaGawKsòaENOǔaq	TRUE
hjDǔIWiTúaalaǒaQakúoNùfV	TRUE
jaaXǔoADélAěěaèaúNWAáMIa	TRUE
lúaitěóǎAzvaúqxIHanEǒaaw	TRUE
miěaǎPǒòLUWǒHaaúlrèFaaàǎ	TRUE
oLkaAyjRúDaraarzWGtBhǎaR	TRUE
paaovòxlGXJaNaáBUamòxCcY	TRUE
rDaJFéaMaagàravMrǎZWPqDp	TRUE
slqaaEaDPXaaúǔwMǔǎǎěbvJD	TRUE
uěaFXLLòkGEěmaǒaCaaǒDáěQ	TRUE
vaOaésCkaHMgamjJDOaáIJkd	TRUE
xǎtǎùaakxaLaǔǔgǎRCJxǎǎar	TRUE
yaègVaǎaqjhaóTNKXQQAmgaM	TRUE
ùùFǔCUpwrzǔdùNTJelyùVǒHW	FALSE
ǔPfwǒǔèjúUóuvBhGdYNòaVce	FALSE
ákhCETBMlérAKUVxLJYWatmy	FALSE
àskDùòkXmòèféàPYqXMJUPBò	FALSE
éáeFBydRGmzeSDéěǔǎǒNVènG	FALSE
èRàpJgtVóǎQZSmfèjvHeSBúk	FALSE
ěWaltSJdHsùjccJNbúpTgòDn	FALSE
óydǒfUcOxRěBUDúǎúùKpCiZD	FALSE
ǒCréúúAyfhtzfgWAWǔpzáRkC	FALSE
úPjICtNKUHhóYdEpRéVvhDěu	FALSE
AjCJAGrNUhpDkFbùǒLhèsINE	FALSE
CAThǎClmffěQOòRfzORěDBǔh	FALSE
DTuSiEIǔQrWWcOSlaTAjWtèl	FALSE
EnmnvèEqótJaSDéAZqMòNǎyò	FALSE
GútaáWQmàUrǒFǎóYgáǒLEoǎú	FALSE
HQMXKqzCyJúsávJǔáuGRMǒúJ	FALSE
IeoròMocávcPYwSTHqYúYxTI	FALSE
JněxJGxlǔxàDWVtqasuisWǔú	FALSE
LéBǒzzwwùSQChSlěNǔUCWtoG	FALSE
MHppòSOǎgǒDáXiuXhSoáRSkS	FALSE
NmàxQTVuǒcwhHCfJOWeaeǔěz	FALSE
PAhWàXhXCcdXOGOLWytPSàǎz	FALSE
QXHddVtNépyúwLCiDAèhùǒǒQ	FALSE
RuIDlùáMvBabGLveùtáòéàUě	FALSE
TùǔSDRpéLzWFhùUéOujZRùtr	FALSE
UFVàUStyQqàLòtawfDxdáaAf	FALSE
VjITèfGMOxyAFgybnoǒjSLew	FALSE
WwqékDqnOoitLRǔáwLsXùxqé	FALSE
YǎUcbMMsVXusǔǒkùtYCqJIóf	FALSE
ZFpWPsDópǔQrvGIfRSbcJáYn	FALSE
abèiǔǎPSgmgyzkfǔAziáàZsn	FALSE
bpnùZMSeòvùcvGGpWBSvYYaw	FALSE
dáfoiYadslzxWkossUúIvMAò	FALSE
eCTboopRlrcLààVútqdnjRèǔ	FALSE
fLIPKnMecùOzVMfèběBpThǎr	FALSE
gPóWxlGweéZJipvoQǔeměHěI	FALSE
hkCóYMMrBvoóǎóJpsyBgáGaf	FALSE
jǔZHoèVeRǎCèieIǔULZàYlSN	FALSE
kMFQSáKoòUùǎvhǔóIǎaSèYvǔ	FALSE
lhbIaněMoPtoěqxsǒtDběyǎA	FALSE
mqPIbzGxólóǒòBKrǔfěyucéA	FALSE
oAJKRQúaQéMyrrJaúTmAqfǔH	FALSE
pMěCHeòwqáFtzLDKzèccNbTé	FALSE
qYùZwWùèPYLqeWǒjFúnYugLo	FALSE
rkTrGxàqdvnbóáéGafXTOOXú	FALSE
tǎMYCǔáDYjRETǒZLMèaàjěVo	FALSE
uUCDNbyBlBWAǎǎěmùěǔmWKAR	FALSE
vpnGěubpnkYWkàZnIéQcYVPN	FALSE
xJsJNyXǒBybáSwaBèKnMVǎrd	FALSE
ycpkvkIWIUkxcVuOòiòyaXèL	FALSE
ùùPsNDyaraéǔDaPGRǎyayéAaà	TRUE
ǔaLǔagépnBQWAPpǎoaěaanwúL	TRUE
àèJRirngaúqyaváaaaélnsǎěc	TRUE
ǎNǒXǔlaěOgBKaaéXòUKEwmaaY	TRUE
èǔaWlAxaaùlVtNGLpYqaaòNze	TRUE
ěPtaxwTRǒaaKEDoMlqwaIaaóe	TRUE
óauaVwOswáákǒaapPěàARaxLJ	TRUE
ǒOHQJávaaYBaaòahLǒQRvEube	TRUE
úaiZèaǎaaNoYnGsIqméWpNzJa	TRUE
BòxkaóqvAGNaRWkaaBTTVTGóa	TRUE
CaKgDumDaBZólUDaCkújaaùyX	TRUE
EúRFaRvparClwaUhDaNǔtsAaE	TRUE
FaYuZòmaámHMaCáqasYacrórN	TRUE
HQzsQTWaDaaaqWXpaúfJRudFp	TRUE
IvkěaCàHErhjáaaéaAhxUaBrè	TRUE
KPWJIDHSaaLǔàaùUzATYvMaQa	TRUE
LxiarawaHótǒJmélauSpéǒěGa	TRUE
NaMhjápyLakSèaaTaOSàxgEeh	TRUE
OmMSxaGaDNòaVNRaHlěaCězěX	TRUE
QKHIaaOgNXOlNahTaaMsUBPZp	TRUE
RauYiphéaVOěaqjVěmauóòǔam	TRUE
TOaHǒQDZJgwarmaalgEZAǒjka	TRUE
UuJmaǎJnEGaaaOúayTáǒóèLGw	TRUE
WPUùauaxaúpVěnrKóoJéjHaaD	TRUE
XniJEDuaapǎǔOaDoaJamBWFèm	TRUE
ZYAaUaaywAQaytmpGtvUsCaǎl	TRUE
aéHúùjaaaDuPùEaXáXǎěyOIif	TRUE
aúCyaohHaBFKóauixaXDápàón	TRUE
aFkNaalùHkkFaKtCaPRTVlEBW	TRUE
aMwNHkzrvSaggFǔèOavXaCayo	TRUE
aUVVqaQězaqaèéoMiateZwPkZ	TRUE
aaóaaóEMaDvěURùHPkàUFLywA	TRUE
aaaxsiqFzaǎmXaùùHQIMNhgùP	TRUE
aiVYǎvaaàQVsóaBvlMaeòwòRn	TRUE
aoAěaapoEHéaéàaOCFòvèabwl	TRUE
auxNkaaèEmNùxapaaówjujnJl	TRUE
gúvaauěǔwùiaZIERmiáKlàaaR	TRUE
hTèópBIaCIgèùVaóHZBǒaZWaa	TRUE
ikaDaYrHòOyXaxEDmpǎaAàaVé	TRUE
kHMlUaGagtaaMowǔaXDQJgjti	TRUE
lktnaCRaàLFxLaúahWxaWSxTf	TRUE
nHaIótSTúMsKzSaWaahmIaspb	TRUE
oaiosNlaaUhaIǒIàiIINqQěal	TRUE
qàxùaaaaRaáùZMmǔGúuypvOòG	TRUE
raúOwáFSmaVkHaaOéxlHKCaYá	TRUE
sataSzamaajAJkrǎHJBRhòlWy	TRUE
uǒKǒàaQaéWaYóúqěoFXòaFaár	TRUE
vaTpuJzYJVUaǒaSEaiaeéEWóz	TRUE
wzaqtXjòèaaKaNaěZSǒppùzdù	TRUE
yZaiyLRqaaógaSEǔǒLafǔzohp	TRUE
ùùééIodǒáLBkdtpúemnbYPwRJ	FALSE
ǔCemútAǎyXnnypáJZǒZsAěQkE	FALSE
áMUǎVFWRoNòDkVgLdǒCèǒjoǎc	FALSE
àmoxùogkLqpQqùJtLOXrávnMr	FALSE
éèvBoaOTóVDǒTiMuKǎikeJpùW	FALSE
èeTǔGkěHbóǎKcnùěJrDCOZqVg	FALSE
óěgkKiqwuvYùWohǒSěúiflǒUN	FALSE
òHWOsNoaOòěduRmbKWxděssnǎ	FALSE
ǒlEucǒfAàLHbhLádIkxěWigew	FALSE
únmzgmhnqdqòcPYOBǎuHHTrLa	FALSE
AvěrAhGBgOjpdTIòRósQCèPTǔ	FALSE
CúzFóqààpèrpntCǎGfBdóUACQ	FALSE
DUàPRYáàúRcRCMeNDIàniǎABS	FALSE
EnénSjyàItoEéNLQpAzNGtFkY	FALSE
GAěBvéCPAXFMyRaeVOnélOpXz	FALSE
HNtiSpVIéáOFuáXEIrmZdYwUà	FALSE
IcòlFójrrQPVMéUVUóSBèkPCd	FALSE
JrzXKtéasltèoǔzcAsjWgbDvM	FALSE
LòóhQyCDOiWinPkèAéRaWdetO	FALSE
MRzMáSYyPZǎHàYaMXlQveCruB	FALSE
NkkKùhXgJFfqLUZèfZvWáESlà	FALSE
OvàòJúijDǎSqvuEslYwxějáqs	FALSE
QúIUioaàóqRépucòmMUodócde	FALSE
RNRuchòběRǎJiGYQUqkéXlolb	FALSE
SWzhjpLtwMdmmfOǎGPDgTùoòá	FALSE
TlHwaóDéhIOwoDókUlnHùUútt	FALSE
UvǒXfINlěPRjèFTjhNùùSyǎej	FALSE
WAiàǒǒqrtTQǔVXáGKéPWQzKTà	FALSE
XXNNeLXXèeoGPdtgHeǎvHǒfly	FALSE
YunèYpàùKdAùúàLFěàZAeBNkM	FALSE
aCCjéPOWneFUBTFGmBééútNCě	FALSE
bMAjHvaǎjéEOBCǔMpXNaùQǔùé	FALSE
clUnuòéGYWvHDrkQàoXèǎǎovK	FALSE
dzQpUpqRúGGebctcinHZALxxò	FALSE
fBRUáIKjOérWkěqtoNoǎèrGCl	FALSE
gZYkYmGpǒQAqMúXfwEFtzoǎXb	FALSE
hsehzoáKWowXRntfbjYyRXBúA	FALSE
jDEVfzCVùqRDàEfZòIòSěsuvl	FALSE
kUfdHqáNúrǒhVDTcǔrèaésjdm	FALSE
lnQnTHfMuiTqADRfkxDtfTqǒe	FALSE
nǒpTUǎǎiǔODěWXSIWǎBLiyǒaò	FALSE
oONITJrǔsYaCmáiccǎyxèvNQe	FALSE
pYwyCòlnèksTěDTRTKXWNYěéA	FALSE
qhxOGEěBhUWYCákQóGeǒZkúoc	FALSE
rqcEYEùèxQuXThooSKVsqújEP	FALSE
těhCzkgZèèKHwóKTàDWdsbMsn	FALSE
ugcWésúeIKǔláraSIRSDFEǎIA	FALSE
vpsYSěáZQudpStlBǔYnmnjIsJ	FALSE
xèèTiNúGDvHZIvlEfárZtbCTl	FALSE
ydcHPCUòPǎXiBbDRǎǎFsDRljz	FALSE
ùùaYzaùúFkYgaCYiaèJaRěxtMé	TRUE
ǔaJgOàWnaáUPòBaQUaaRrgàǒhú	TRUE
àMzWaprOaPaKmENAàykòWaQrGa	TRUE
ǎwCagkVASúpàaDCaVZEsQoKawa	TRUE
èXiqaBòaqkKúCěhMàDoaaaòNlc	TRUE
óèzIaDǎaSòpkaúèěaHFáaMáǒpv	TRUE
òHkùqDaRèWkéKajàPLlHBawaaA	TRUE
ǒmCKDqaéMěaCAXǒqBaDjakaèpt	TRUE
AGmEpayDgpPaapǎWAaWIIaXeoA	TRUE
BaGaǒzPaaBDqùXadGákvànTqIo	TRUE
DCEaèYaBykaHlLYXaJxSséWjaM	TRUE
EaDaNhěaZuSúàMIHHIFRaaOGMà	TRUE
GàaIaǔvJaEǒwOaaBvǔqzwgtònA	TRUE
HUJkCpDaoTSùaSaaVsQaNsùèmT	TRUE
IhaYPOFFzRwGaróǔaMYPJzaKaǒ	TRUE
KCótùtaùKxagaSTaùQqDiaSHyq	TRUE
LaBjvBàùòoaóókWMGaDrraVhaj	TRUE
NǔJwkéaHòkaaǒéyOanGayObaLè	TRUE
OgSxRDójhéaèaaERóOWqxnBwaa	TRUE
QéěMòaàJypUNkaPGaóaMCELèaw	TRUE
RMaěěBaAǎaauErvarZYSQxJàAn	TRUE
SmaoěǔǔapajqGpnCMúVaǒkǒoat	TRUE
UYaGQaTRaEèsaACTPùèvsqWQwa	TRUE
WèRaaRoRJpěPaEkaMEAOaùkpQP	TRUE
XaèǎKCaUnMEslWamBáaǎaMsnzE	TRUE
YuBaòzDùGóaSaaPlmQaihBáegU	TRUE
aáèFKWRónYaòaqaqVJúDtaéwmf	TRUE
aóKPǎDJQgaGRatawInètaljàZè	TRUE
aDLATzèGánBCFaěaBXiQéaalAq	TRUE
aJrNaàwmàaóvAhnawryaedxiYS	TRUE
aRVFǔMNIǎkAaaaáiPjyBgúVhHa	TRUE
aZRàUEòaauIKLmaLCàèTaADàAl	TRUE
aaVBúOéJxàSzaLáPaZaMkQKUrf	TRUE
aaráaaǔTyQòEaxIjMgéǔVùMcWf	TRUE
alChlRaaúHCmmtiGKBaGalfvep	TRUE
asBaggaǔAWǔǎHiCawAáEúéèaup	TRUE
ayaaaAuWLàvyqDRapùtzZàdwvc	TRUE
hOLaaaDKyxzBQgMJUaRóEavlAj	TRUE
iiCYaanaǔOTlǒtaúyaSRmIKiCY	TRUE
kémǔsǔJJaèùǎùǎaaQlvóCiJCaa	TRUE
lMúaǎaWěXaamayHiJwLxǎTCHwR	TRUE
mlSéaNrúaGùNOsZLQaaHXàYiaQ	TRUE
oHèmatkkaaaaVKjpyWqrùLRHQw	TRUE
paMLméaVFàwzKyaNaayoòOiVěr	TRUE
rǒaRTaǒáTnoasyòóQgTòUhPoaa	TRUE
sSùéáamǎUassRéNsraDjóaxǒra	TRUE
tpóúaOPZgEaàkgTùHéǔaOwyaTa	TRUE
vIYRuaaJjagCóúòaaùJWxgfdQg	TRUE
wrrGùZuaaàgmspnRaWsàaDOaUP	TRUE
yNòPaùoSDaèaěNzěaúěxùNJGàa	TRUE
ùáùǎVMGtwSKlǎdEwúTJJǒCYicd	FALSE
ǔOIùRpKipàSzxúáobòSyòhTJěg	FALSE
áneséjtvYknǒǔJZzNnòUDkyhic	FALSE
ǎǎǎBEylbJJDDuehdikdIidGEùx	FALSE
écfRIjkèPDDǒlSpvzDǒnywBdXC	FALSE
ěùZympGirDhWiOTǒǔlxǒóèviEy	FALSE
óHSLodLPVbFKSǎèlltézCDwBlJ	FALSE
ònkVNkbOWóYúxTxmeZVKrLKXQp	FALSE
ǒjERNJóLlǒYàfèaNloPaùóvHPù	FALSE
AǒNxlǎqiYměWOuknnQgfpRLEòT	FALSE
BRLSphǒOTHCWwjàEèTáMEàiófl	FALSE
CtOwzǒqhIiUbSóéèzlRNyQkèUc	FALSE
EDXBBKyaqàToèzsǔǎVgàcWGéúJ	FALSE
FWCPEòwGVSmfNWjqóYSuěWmAyA	FALSE
GvOǔèWTLEEEHùmYuùIsàSǔòumù	FALSE
IHPùBùLeROvéLAàdwsDKhZFfCz	FALSE
JVnRěǔsCvlǒCkǔpQúVvǒomuèem	FALSE
KoéwYpUSMmJsxXMHlGàrrmKúwo	FALSE
MécdTVOwùóCMkqSèkWkKàanIRT	FALSE
NPRVcxDWdGAOXivémbbkǎiWDDD	FALSE
OxypbqpàXéOjCOslbkKpAGóOěo	FALSE
QBLúPmltyjóseéáaQxYDLóáaYt	FALSE
RfKèZéUVtuUQNLQǔCzZWhXQhéR	FALSE
SdbliAWZéùZekXscǔOwNěwWúbg	FALSE
TpHOVQxUemeTUèWPHytVNVJXDX	FALSE
UufǒuyBàeóCfSWOqzvMHfxmIEh	FALSE
WàeǒéxHcjeUWjǔbbMáèKjHIxuO	FALSE
XúětòèǒJnzSkFktocRnòocyLPR	FALSE
YTnMVǒKétZRpqXxvGzmjZVěQgI	FALSE
ZfǒbqoshKSǒèòRtóNLUoAùxDNe	FALSE
bǔùěJjtěINjdAHLLYXChzbwzpó	FALSE
còeQoMkAdCoPFpxYKdpwTèèOTV	FALSE
dMkNjxOIAWjǒSJBYòBcIHqCěuo	FALSE
edBosEFlNàlBiXkxAzǎCqcLamB	FALSE
gámDAXPapuQXFvculuMEhLZtéM	FALSE
hAKéǒRiygézOZAetoabAxtRAQy	FALSE
iLǎnlFléinQyaiYěKùěécéùǒrě	FALSE
jdjJdbváXWADwCróboCòIWsǔMó	FALSE
krHakhTěùXFoEPlgzveDXéàqǒP	FALSE
mǒtUonsDnLqéIetgQxPKlúZKZm	FALSE
nNXsNuwjNIUDajXxòhppmHòMJV	FALSE
ogòDWfKOPóltYóLcLIEthQhSva	FALSE
qǔMaLMoBzéUTlùiwtOZLǒihSGT	FALSE
rIègODcYàǒRúaakàcZóuòWHnǎA	FALSE
sOǒZǎZspBgYUVzhISMvXofGqGa	FALSE
tcVSwdDOIǎgpGóYXaZqùXohTYS	FALSE
uuVYǎǎCxEqùǎǒTPbuhǒGHSéUpù	FALSE
vzokWrNpOGSnYIxNfnaEzqTVàx	FALSE
xǒTRPiloUhváoSFKNrJùéǒeFZQ	FALSE
ySǔUǒlálùxDUcscnPNCpbKIkát	FALSE
ùáSyjǒaaùFCizaoaqIkàSaYàAXE	TRUE
ǔUlgaQKQgógmOIpvaamazaúXMUr	TRUE
ààazBaoNmtaUGaKǒMzaóèIěiěkè	TRUE
ǎWpaaaagOxǎHúOsUGWoóAaFfhWò	TRUE
éaxaEaTiavaYWǔòLRYàCòWùlFhO	TRUE
ěDYsaúǎKxaaHaIamàRfbHHgǒGEr	TRUE
óaoǒkYópaKHěǔaJaaGEZùxjAiàt	TRUE
ǒúàaèUawópxajaréwiSXǔSaAmlX	TRUE
úaqYuPNraèǔórKQaáaGLgiqYjèa	TRUE
AzzèaaaǎmPvkAPMQYavaptNlCWq	TRUE
CVaaéáSTaDMquǎaQómhvWuHaáěK	TRUE
EBaapniHaàHaDKkuFúCgCáyyqaJ	TRUE
FiSaaaàùHSCayFèúltjnZnafIaD	TRUE
HòaYiQyngsaLrHǒaEázàaSòèéna	TRUE
IhrCNanaaPòoKpJrTYùrOhaaǔuo	TRUE
KGLaquòaǒtaaàùaAurúwBTèAdúé	TRUE
LaIxOàIaLaTJwǒHPáRkoàalláal	TRUE
NǎaèyèraUaGaNOaeúJKùCmáZtFó	TRUE
OUaùwUváqaJúaQjǔǔEataPdwgFb	TRUE
PaWmǒaaénuEuTaayHAòTwCáóMTt	TRUE
RǔPwwDiagǔJRmaaèǎRYLoaakwIL	TRUE
SWUóyaEFasonVYztVaozroaVEna	TRUE
TqqatòaBlèPasaVgsQmZaǒHǒǎlb	TRUE
VLaHàCKqaBgwSIXǒgaELUàJǔsaa	TRUE
WwáùaKEaAqWCěqGaFaWúúaBEBsR	TRUE
YYmlaWaaOvarZXméaèéǒVMóóódw	TRUE
aǔIaǒtEěMLNaòoaavLqnyNNwYaá	TRUE
aóěhCThǎkrMCgaǒkǔlaúhEaxkva	TRUE
aCnóXIéuSaVUsKoaIAtkǎavPapy	TRUE
aKěHDaAVòàiYkTǎlaoLaxXaJBFE	TRUE
aQtBiJHéaXALOaènaQaQùCSnpJv	TRUE
aXtKDBAǎsuaBFazMnàaravLǒSio	TRUE
aaUàaóTvasèHPaZJCbbDmzXBOàI	TRUE
agkáCwPhNryaaFDpmXAakDtòaqX	TRUE
apèazhKMùvHsóaaSvéxavgHYtTk	TRUE
awGPNkaMaWyaòúaVvaQFásǎXáèE	TRUE
gKZTvaévgǔrasaBOsawkaàtdqpr	TRUE
hoPaZgaèUjEpUWhaaamsàPFTler	TRUE
jNWaakIléagaòkaAOYaqRhlzYěK	TRUE
kVgUKCuòZwSxǎaSQDéLGSaaaabm	TRUE
loDǎHnózxóymaUaNaKVRDWaóLta	TRUE
nMàazQéǒaúoaIZMramùxéGqǔUSa	TRUE
olIsnMaanaǒUMxtXyàEaqabòùJS	TRUE
qXLDRBFaaWaijǎZFmiEQaPYSaèY	TRUE
rvhChayNCúJpaPǎúNUtaoǒaóaaj	TRUE
taaGùoaóWGOaIélZMXDaNoGgWfn	TRUE
uqZaiqVzDaTagFnzgRyqàGOUaia	TRUE
wAHaěFòzǒtjoXaǎaagaězbúGuEO	TRUE
xHaWLRVLlZaKIDaamrUYóàkalLn	TRUE
yinajykulWgnaVEgWaPavnFWnpa	TRUE
ùùuFFYZPfAiěùZRjZQAáxfèbkSǒ	FALSE
ǔHRfSǎTMumàTóèǔfqNYooóbNswC	FALSE
áQRTùhzèWùUTqòjlpgrGrcdúKHi	FALSE
àsLfbRFàúcAaOmhPfrPáEFǎAyVú	FALSE
éàǔéRKLimbrXLjàGNùOthbdvywǎ	FALSE
èJZDIjáECFWǔprhěfégUKòàBzFǎ	FALSE
ěuǔFXtBlcLxúNbádDáyvyRcBáèn	FALSE
òópxěxyVSjěàèROàKGGwYEéOdtw	FALSE
ǒWdéúacióqYYèrǒénPùómJzóvUR	FALSE
úoWǎBurNFiIBáeiiIèoqNěézRcM	FALSE
AzOtLZMOCwěMcwmfěviSYGmhcVg	FALSE
CFtvúkZlDImxuPǔSwòGyQOvvMVD	FALSE
DcàtáXdǔǎdYEIwǒóYDvgvCǎbaRn	FALSE
ExNqCfsMáJORǎICZfPǒbvùhaFmq	FALSE
GFfBHzEMfxqéǔnScǒtypFKhYEjE	FALSE
HSmPqSàěùéDJStLráNcZaorQCjj	FALSE
IfXzzKǎLkǎcucWùqQIwWPRIǒQtà	FALSE
KěáRnéLFAMFòAcbPlwaǒúyyaǔte	FALSE
LMòáRPQyVowogkkvGáYCHlòAJXD	FALSE
MQúbmfNmzhaòěIZwSéKqàáyZoPQ	FALSE
NlSBBtPPDadúVáfeSvPytfxTPpV	FALSE
PáSajZùòWkhIǒkpxèRǔaǎqósúDv	FALSE
QTxéEVYvVJǒvHzúnǔKnpAmBGPNp	FALSE
RtoeqJcùaullbdnwǎéFOHkkNRCB	FALSE
TòáhGpRYOávdkqFbtiéjěéúLáYa	FALSE
UWcRWsLvǔzznlSVPAoǔjXuGǎKzj	FALSE
VcHnDZǒQKpeMqIlyKǎLDYqNbafǔ	FALSE
WwbVFpUkWcEZDyRHHùNgzFswKòJ	FALSE
XxbyǒàòSAACEsANBmǒXuieDktòi	FALSE
ZúxWaHnCěJejvpùROúnGVOMfuGG	FALSE
afRIěNLyúfáǔǎHxbYaúǎsvrPMǎO	FALSE
bwGaCZáHVóùsihUEMeaKéáBHiǔJ	FALSE
dúTBmicuǒWnOcoràuóigemQětHè	FALSE
eWWǎgFthchEAZlòMkóǎChWWvkuA	FALSE
fsěxLèjòhdóZWYSKxzQdkxZSkvó	FALSE
hBrCzTòLOjAixNayBvWúelQNbgQ	FALSE
iXěQUqIVhmAwdxVTccJGKóNzHEǒ	FALSE
jitAcEKjAèSpúfáTWèzbárjUvzf	FALSE
láFěěǎSwNòèlTxGLěYněDZMlǎAǒ	FALSE
mAQItěyéaéQVTněZjEPúOkBbùLo	FALSE
nQJuSeèluAǎhEóǎHbXHSiǔdwXix	FALSE
oiRQPfSukXddèLoyIáǒgPuTZojG	FALSE
pxDXNRáqFúRKLsxRhàKáObjbóvm	FALSE
rHééxdxUfitRXPeVMǎOKèfPwVvJ	FALSE
sLclěǔPPYhrsSpqRPMjGBifJjiO	FALSE
tcCuDéHduóóDrUwǎRsmPIbJARéN	FALSE
upbaǔxTZicbBùkHcáDxByàJǒfèW	FALSE
wòNcyOGuàSmvcérEHèdúXZZIòǒI	FALSE
xRǔàHéQǒódOSNCóZHvthoònmKSB	FALSE
yaQbXCQRvěóvBoòkfkoBdPwBsNx	FALSE
ùùJiěsǔjDtǒaaáSLUHlǒaaGaLFmǎ	TRUE
ǔPOaKaawaǒxǒVKZMRQǎrVIzaqbCa	TRUE
áhaǒhaxsXWóiJOamàgVvBaavMúey	TRUE
ǎBaJFZogaaLJarHaXVWàdSLxdèMi	TRUE
éQXSuhlWmaVaàkóKaNayWlUarmqm	TRUE
ěèCKWaMòUiJǎòPàQaaGaóNayhǒhU	TRUE
óaDQhOBgLuQKJúaQqiIaǒHòwjaaR	TRUE
ǒBnaQESiyoǒlaèahlQImúǎqǎgara	TRUE
úiAEEanNpAaXavsěApnàaQǒDaǔNx	TRUE
BHJǎOuakXJIBǎěqaSéaaXaBqBYVi	TRUE
CPjAéaQkaǎtWhFPCSaatúmaJljnf	TRUE
EěáqaèZhmNTFYaqrzCzaGǎYWaDHa	TRUE
FaTFèhèqaoWkWàFòFlauaaMúoAsC	TRUE
HóaaàěhaaǔPBabdZéfaDPBtéúfnm	TRUE
IZiiAqLJZuHwTaaǎvaVDòhaMwOqa	TRUE
JtǒúaòDùaHBEhJaZWkquóIaèuakQ	TRUE
LIKIuèUQQwtQuòaJZaaJóaMUaòRx	TRUE
MXéThataàjJaaZAaèCóTzéSbrfwW	TRUE
NmaAaéaqaoúáùiawlcùázrúPǎěgH	TRUE
PUaaàěiùaijDVQóBNOiVaFAaiHAK	TRUE
QqANURaTélaǒaěaéLaLxdaJXKJJO	TRUE
SXnxIXèòtaóoàáǒaaaPúéaRrǒWwA	TRUE
UóaqvúKáǒJtrRKaaùaèWhTawoHnò	TRUE
VYagàxsómGSqXrJagěRxioaaZúae	TRUE
XěanoPakáajwǒXěaaGNKPZepDrZě	TRUE
YaLKmaqěBvJvapjxUAaUoFúFXacZ	TRUE
ZqCaáyaOVmóòTXVXǔǒaaáqUaeJǎS	TRUE
aěMmxáEFxéèqéaNmaIOǎaaCjifòf	TRUE
aCWjYèKuEAJSǎsOHǒomgRaaaSója	TRUE
aKCápuaagówKauMktayAMjRRYzgs	TRUE
aQvgOlzèFHiaxaWèàèásáahAuaOè	TRUE
aYaDURqèxaFARkěQéNaYQùWOXaǒn	TRUE
aaXPéKgazokǒmWaVCPIaeáZVuBXǒ	TRUE
agAǎBvǎwòùayyhknpvaaaóLièpsK	TRUE
angàBXGLLEulúaaMàHóWùNOagamz	TRUE
auznDEFBZaQèaUvaaázWèGMéYdǔK	TRUE
gPúègTgzaùYaaoQaxaéFBhkMrǎyǎ	TRUE
harěaWXXtěRUajmkaaǒYxnGJOtyg	TRUE
jLjǒDaaJaxJsǔvxGZèěéaǎxarUJf	TRUE
kaRóaWVaǎéaQàCaswvdmkKJědJfV	TRUE
méNkavGGrVaaFDWaEzCBJTàaygbk	TRUE
naáasnaJǔlJQúSěaphaKwQdOBáNò	TRUE
ortBsaOǒáZaètòazáarkCrtCBBTa	TRUE
qFanaYaOypaYBIùaaěmèǎnědoWDó	TRUE
raiaYaOváhálDSazuaPUiěsávGFb	TRUE
tǎTsǒjFaLzBhWCàúTavvòzsaaaZh	TRUE
uBjEaaaěoaǒàkòvwKaǒuèwGzHpló	TRUE
vaDòkqgiDqaYǒQGvtvTǒHCtaFǒaa	TRUE
wvOWkgSXaúaapOhjaLDZpaCàACiE	TRUE
yQpDQNTGOaaǎtaaǔGzrIéóSTaNNo	TRUE
ùùXqòZkKkefSEBQVǎgéUEǒcFiQeò	FALSE
ǔǔSèCDMYFEùèùǔYxpKsRZùhvRbKè	FALSE
áMǎEHCEqdǔoéǎrLJoàfQmǎZXagjr	FALSE
àhPfHxsxxRélméénxIIAnQéNDlpe	FALSE
ǎzkTvQǎITèXWxmòòoòBùCAkQcrhu	FALSE
èJlwidOàémkéaèAóbǔNYnZffdmhá	FALSE
ělgVùúòrOHEdtUbHGWpDvUCyddNq	FALSE
òHkRlIjaùKVnjǎèóQLAGǔseómxlA	FALSE
ǒbdVBHTYeěxXyPóWUpMNéWAHMkiW	FALSE
AEǔLǎBánRfmMjgEáFxgpIRdèmcfó	FALSE
BPVàzFMdùtùizrxidúaǎPYxOUéZY	FALSE
CrzTDuPǎdGURbOAúIòJméòǔsěsǒě	FALSE
EókLUǎSfǒHMINCCSmRCWésizǔswé	FALSE
FLkénúXpCowvjVxúPcWwLblPHHiZ	FALSE
GkTozMMEòVnAjǎImIaZgAóBeóWYT	FALSE
HpgǒKZVfMatJQhgsTQVzFtSMutCq	FALSE
JèJféówAqIrRǒrRUzDǎEàDAJáaúp	FALSE
KEXSKAèSwgtězapbFzJTǔǎcagYyN	FALSE
LWUbàIyúeǎRqtUéWBjBébsxKáohè	FALSE
MiYHUxCxJnUSdSNYaYQIǒǒxcexěa	FALSE
NxHúswDOxMYLcúòPlpXyCfǒjJLib	FALSE
PDuJbxnHdXrúcCqTHHqOCáBKUhPP	FALSE
QGNTezgoKgehnNSQěEzuAhHmtfwz	FALSE
ROHòWoárWcbgMǒkVQtUYlzlsacqg	FALSE
SjbraSoéPNSéLREAPTèeúòZSVNKǎ	FALSE
UIHCdLIádFEaovǒhòbqWeqCohhYq	FALSE
VXruVSaYLuKJèpzeVnsVDwjrNQnS	FALSE
WazèaRIwXOWóYGwLSUZDjMcuXtFb	FALSE
XoNnǎmZUCZpTFsròYLǒezlaǎKviá	FALSE
ZúfàIjeáèZhNsǎAkpóawQǎBjfbKJ	FALSE
aVdIFTxOnPéHgirxPKaMSwwělRHw	FALSE
bmàǔǒIùMRMùkòytGCulSteJKúAWá	FALSE
dàwhSwLNohdqwAvdWSàCèSVXErXs	FALSE
eLsEWcsQúBúiEaǔèszábfIhUǔaCr	FALSE
fdOZjqIiSRmMfQNYMeZsvOléZAnW	FALSE
hàáòRCMMcbVWgmbyKhjmábHǔSfBw	FALSE
iMvXIùFTǒShHaFhFòQiPpZèPLsRM	FALSE
jbǒJwmǔkULálJmvDVáupèWqLWúXg	FALSE
kumnTwtjhKFWYMùyEútgzLwOěLVj	FALSE
mèvRUbàAVBàIILGrXIroizjàsiWQ	FALSE
nBúsiǔlHNéǎmsveKMtTXlpdaVRqJ	FALSE
oEkfIpJsDSjèfqvǔvqàUjnǒSótòH	FALSE
pcHYXyhFrJútoXrrDueEùǔcMEacD	FALSE
qsMoKoóquRfzEǒuonpZWkàDkiBjn	FALSE
sKxlTqùuSGòOfBPTǒaDoIòZvZiǒx	FALSE
taTcěazwYtǎuóyOSpěéUVCdóKqzò	FALSE
uijepDúHDpytǔVDHvièsdOaOòèěǒ	FALSE
wéUòejuǎWctxGHicǔoTTcPótúGZg	FALSE
xVàBoVvǒsDwòUILǔYfǔggFiGTqBk	FALSE
yXnuOqalkXtèDMZKǎóltùwúPWynA	FALSE
ùǔaiFvTùpTaSMmaKgèBCAGsqrJzaa	TRUE
ǔEYRapRAyVúáaaiùMgúwòaǒRvYUWa	TRUE
áPúORaZàKxaWěaSENqoXkaěEtJéIa	TRUE
àaáèavKDutxKIKVWaaIoYǒPaFFCNj	TRUE
ǎljXDaézKPúkYygMAGKsaaXvwawqa	TRUE
èKlòòlaVPuóLKDaNqaahIBDKNIaiS	TRUE
ěayDYaaaaLǔFtfdúAǔRRǒBfmIěkáD	TRUE
ózóLaógùloajaaajlKEésmrqQavbj	TRUE
ǒVLtaGgúéraSSNRxǔHuIxaaWpTadq	TRUE
úiaXaqèzaháuDúúěDxxaVPòajYèLK	TRUE
BFaǎTwAXòózxaykZkJJxmJaAàaaHz	TRUE
CZmtmaCrLOxaaéaNhZnèVoalǒtqJǎ	TRUE
EǔOaiaraHARPAòODǎJoúaoxaèbAmE	TRUE
FFòTvaHVaBZARaamkkrUSWaǔtXóUq	TRUE
GlapshBxORzsMLěXmáMKzkxYaaaaJ	TRUE
ISiaaCvWiqǎzguénzaTnaaKeǔOwDv	TRUE
JxaIHCLaiaaFězxùKAzUPEYrqàMFa	TRUE
LLCPéǎVaaaǔxhǔZOgTRáqnrOaxpaò	TRUE
MauRtǒaatMaQKoěiJXGàWCQaGpegD	TRUE
NytaxoòWaKykRaamwoúuqóajjohKǔ	TRUE
PYzaRaamIaEZTòòtòaeóWSNiQIòKi	TRUE
QzaGùqCEaanaZsnKMǎFùnaxuGRùWQ	TRUE
SMuIéDLèaEVWjàFaěǒVCYRaXLanag	TRUE
UǔaùRúPaùvxRaJPmYaúáěǔDjaǎNeǔ	TRUE
VXrCHFéBǒùèaùaXazXUéhMTaùQacé	TRUE
XásnAiRSmaawaianaǒǔheHSlEeWnò	TRUE
YOaaoHNLxNJglYataémGwvrTèaFnk	TRUE
ZopQZsavIJǒáyHiaAwgaaxVaejóEk	TRUE
aèwtawFǎvéaěwǔǔCaNZàěVaDIPǎQM	TRUE
aCTláPSiUaáavXaamGLèǔzigoecuq	TRUE
aKVǒUóaFtRǒàazkJDHNmyúsèaSǒaz	TRUE
aSijyaYAùSYHRaaDèMPaFhǒseeXGM	TRUE
aZsnǔpuUwiaaYvFúKasèěGéaǒéǒéM	TRUE
aaaaaeCDNkrgáGflLWXǎDOQJVPHdI	TRUE
aiCCFpaIHVUrAzaaěkkaéCXòTVòEl	TRUE
apOuaWTkaNaNCMyPBòCúLaùyEǔkSS	TRUE
awzaYNlarDuOQǔGaitDǒTEIlaxmaJ	TRUE
gtLOǒspǎBRaaamFòJjsálaòNRafǔǔ	TRUE
iJUgèqOaúWàxpVaaaDákYzǒYùaEFE	TRUE
jvlǔzaIRaòaMlpòYáùauxsnMLǎǒaě	TRUE
lQsòwaVYaéXaOwxLaǔúaúǎDMǔoùMf	TRUE
náuHMXaJaprjvuaAùnùaKFZyaVòFb	TRUE
oYapaělCVuOaAxoLáàuOànaaysInA	TRUE
pxtauuaJDNěaHkswQiWàghvVéaaDa	TRUE
rNaZitEiGsLǒYúaqBuhLaaadùPǎZW	TRUE
saaqlqYSBlalyYxrtaSTazèójTshn	TRUE
uǒaKuaBQéavZáOjéètzTQaLXaàkǒK	TRUE
vaěUXhAWFXvJPqèFaiiaHTXpaCVaù	TRUE
xDapóatRQYǒsANHaPoXúaVRsàaùJu	TRUE
yYaǔNEKusCLlESlJDgKaaQúFaòVHa	TRUE
ùùYàhNqWWòVbAucTIérǒZoàVaPEPR	FALSE
ǔHvFèǔHkùIVIOGKiHjHhAAqjtILWú	FALSE
áXlrǔwfCVUKuGIǎgùOàFKHYeJǒVhv	FALSE
àjBizXhbwcBtóCóJIHoDGYbSZnúVR	FALSE
éǒztjhGéBJwUctóLúùFeakgùVCfLú	FALSE
èJQPpglgixèIjùfózxespHqCNLUMá	FALSE
ěeInARuHúPcjèBwwlòejeiùiwáiVp	FALSE
óvTCyhWPxuqAǎlpáMxWnYàvLdXrué	FALSE
ǒCBèEùllppzǒTuèETWDFělwzèYYll	FALSE
úOéxGCxEOwúiǒXFjzuDpgjMóCzrNv	FALSE
AjmuIJvǒopKQVWUfAǎděUKYXǔgnDD	FALSE
BuǒxElFLomcOàièàypféèàiúàYCfs	FALSE
DVXstféUfIàKhòwwúZOJmYwǔvZzbC	FALSE
ElizǒèǎDTtrnMzTǔXFgOBwfnzěiPI	FALSE
FpgRzdOmǎSyáèVrpXudtYcòePXEEP	FALSE
HEěPfǒSxAwXWóIgWvfIsúUfPysAMY	FALSE
IfJPQmFJéCFquYifYKúoawzHKfqyw	FALSE
JsaksoLzeǒqzeàkQáqgQiJnòDaùQě	FALSE
LòzKLJXIXqDkSPfhcAwòUIFBzOqCl	FALSE
MBXldǒUXSFXLxrKfkqNpYgIPKóJáò	FALSE
NdUǒZtǒLééAgxVyéKtYnǒbBRnjómJ	FALSE
OxUóBFITàxVhYǎVKúnRULVMOaRRYz	FALSE
QǎáadtgMLQHǔDpeèNjòVhpǒMěugdX	FALSE
RKRILxukYRòWNdyXTWLbClqFBUFJǎ	FALSE
SPFHxiuCúErhYZQHǒzèěaHBNDTUXu	FALSE
TqwgvàfěiGdJJeRLiSuipyPKQyVnF	FALSE
VHnvENóTZntěajrTVgpòilTPúfRrò	FALSE
WcKúbwnhrHDAtBiwvaTLǔéLyofǒVá	FALSE
XvúqKuGfaKWǎelCGcZùZtjfmnTEfù	FALSE
YxAwXRUXLbéGXPeLiIVGaMIuSJiGn	FALSE
aHJFlUsǎYTUqǒxchNPfuvJvhMqFěr	FALSE
baùGéFJhuISěóPkùǎǎpTǎKAMxlfXc	FALSE
ctQbòIóJǒEFWTNZXǒdùoǒóǒCtkgZě	FALSE
eGEXqkFMgCrMShúoJRxpFàYMANvJQ	FALSE
fLqYaZwHòqNOáagCCPcěEUzbéRòeT	FALSE
gmOUEHVtjàmDèIaSXUtàěvǎYqbJGG	FALSE
huGàYHiǔmcXrqMCávónyxWqUreZkH	FALSE
jBcriJEdǔúCcskúZuYFàhBUGSéGNV	FALSE
kUóQPwǒfRnZfQǔQěbǔXzwEXmjézlb	FALSE
ltIvZdǒǒqQomOJGsCkVxHVyfumipk	FALSE
nǒhZlQlnúpbGAgèYJǎǎaKPSEpòKKó	FALSE
oMibcevùDAMHMlióyMrěOfúLffsáL	FALSE
pVKHòúPDMXNNkGǔyGjauFùdJiLǒmá	FALSE
qotOáZWKǔeǔǔzaokFapàRúvěZzOvO	FALSE
sǎPeòSNbHNoclrKǎhwGdPfzwnoCEK	FALSE
tKǔùàáRǎěwtPTImnXwEWPXdhTréqO	FALSE
ueEiJhòPuMéúoXfryEùvTXòHvQZwǔ	FALSE
wàéHaènaACNhGrùàHézǔǔǒFDóxiyo	FALSE
xTVCJPNzsDrHQdPeoaùMóvZfRBlPp	FALSE
ymLèsiIdPáJCjTùncIeBlfúcCqjas	FALSE
