ùùITUOnlaEAéaAaPIKCJ	TRUE
ǔGNrlMèTTJjarHlaéàao	TRUE
áayoùJpmarablóóméZHà	TRUE
ǎACpQNYAlampraZéxKaW	TRUE
éaBéCYuoUtBazaóFnówT	TRUE
ěǎYraaVjOjxFèAhhùlax	TRUE
óYXZǒètóaaMǔkóYéaòZO	TRUE
òvaazlázAàrDXqxMstxa	TRUE
úaaDaAgěisùkLTNFeòSV	TRUE
BǎLtkakxMaèiMDYaBǒia	TRUE
CYsLyCèǔapaHpROwaǒSh	TRUE
EùaàSùoaHOǒWoIrwLawZ	TRUE
FNSàéXaakVrNéàWNracT	TRUE
GaZkWDIyAWoanXTRNRab	TRUE
IǒYpawmKTúlEBaOaRhHc	TRUE
JaǔanvAyzkJmGèganFEá	TRUE
KsWoVXěaUǒúnSXwaúiaS	TRUE
MDǔéZùMXzaLPouXlaFab	TRUE
NamxkaMVàYaFkóZWmVlz	TRUE
PArpuJaYoNCEKzwtaǒaá	TRUE
QaéǒùaǔwDjàJěakúèAùD	TRUE
RnógUaoISàòwaòǔEaGYF	TRUE
TCkYQSMoaFYOuiaèZabJ	TRUE
UguéLtvQaéFǔLàWIaáat	TRUE
WèGsrqǎayanapyvámxaa	TRUE
XPTzaMHǔoaBaEzPlohèǎ	TRUE
YaKLRotdQCVayHaéaalF	TRUE
ZxsrlNacaBùraXǔóyyak	TRUE
aóGvéumaaEXFUùvhbáǒp	TRUE
aFDIěsaNySQZaCuOmròQ	TRUE
aLtuòaǔhPHáadMSmuWYD	TRUE
aUGnamIygRúSADkTpjaV	TRUE
aaǔHRaqsDBGuBKáGaéBq	TRUE
aaqCNmUúǎafpztmvOQǎA	TRUE
amOaoPǒàéAkYxjaxjěeH	TRUE
atǔgmǒaBǒjKúqláPaiZè	TRUE
gùGqjJaoAzShaKálmnaF	TRUE
hTèTECEpCKyPpaaéDAal	TRUE
igzùǎéVaákàWǎJaIBSPa	TRUE
kBiwaQqMàargòJkLTUga	TRUE
laakLazùKǎóógdaèzzDé	TRUE
mxZCùwZhpaSNhaLòPaxK	TRUE
oGPGSaěaYLREálcaàavé	TRUE
pqyXhjalaaǔtIuǔzOMZI	TRUE
rQPNGTPǔèAaHasaEoqBi	TRUE
sqawaòaěǒǔynJlxzEBòù	TRUE
uGaNwEEǎHǎyaAaǎvwAùi	TRUE
wàSTFYIaéPMQaáyjVòpa	TRUE
xZóVKLěnaaSOxzGéQéap	TRUE
yawYěòDùQaǔyHslzlato	TRUE
ùǔCbǔqDytdUòVqRwJhái	FALSE
ǔAHVifàBntvbEkYnspwn	FALSE
áMǎoTwRàxáAEsUèOcǎHi	FALSE
àWàQGBGhuFǎocSbELfcW	FALSE
ǎvPmqùtVTMFczPKXLJúE	FALSE
èǎdCǎmóQrùcrhAbOJvPh	FALSE
ěbúHǒqǔéIèdHfGMUpzCl	FALSE
ólLzbUHóWWòPXJtěUùgD	FALSE
ǒBàMěSooRTkǎdFSsǒLjt	FALSE
úbbyùéhnfjlbánywfoMh	FALSE
AyVMéfeǎaaǎHEcQǔǒmuù	FALSE
CéMtxúxǔBòNusaǔúǔQEi	FALSE
DJKYxúKàDZrUCpgǔǔǒuV	FALSE
EbǔxDCorLJqYàùWóyálr	FALSE
FnJCGXFfxǒbáàWóéùcac	FALSE
GqrOxáSaqSúàRRGbxèyǒ	FALSE
IèkLXǔsUgZnJHnèWméUu	FALSE
JPǎúRHèzBTCmLZóǒcHMV	FALSE
KoseWJoHFùmavjǒNěsàY	FALSE
MǎIVMZVrVJRIjpygXhkw	FALSE
NDjěnXAkAúùúOUWTpBǎù	FALSE
OSWáXnfqJPCǎǒnznsDqQ	FALSE
PlVodóWEòkóóTmvUSugé	FALSE
RósIcgǎYxpměaARWéVwH	FALSE
SPEMADgIúǔwtèuLCRIlA	FALSE
TaǔésQǒSPPEUéFFòhBMv	FALSE
UslcfǔYKdnLuyNNBxúáN	FALSE
WMGMNYTGSéǒuTàVǔAicr	FALSE
XUBWYIbYictkfruOùHzù	FALSE
YhMCóvOàFsúHspdGQcvé	FALSE
ZvcěoéxHRùRRěPXetjPo	FALSE
búETXǔYLLAEàOoJytèyb	FALSE
cdrEDNARHarOZFsǒùkYT	FALSE
dyZqDúAǎzUyuSTDrvjǎó	FALSE
fIVáòrkwpWnzqxjwjBgh	FALSE
gacBTKIifèCFRLrGgékp	FALSE
hhurSLráKwhZMmwKcmTa	FALSE
jùEudODVpPSvdLTǎBTpi	FALSE
káyKòlXbòOálZrùeqFWm	FALSE
lúfUaGdjJvěSUVkKFFUs	FALSE
mfKvvcHEsywiWUàPpkrK	FALSE
oǎzYQUOWzYZǎrǔbcěxój	FALSE
pQodyàjNAfLSFXVoJAYi	FALSE
qbYZZEcěavKKTdNxlBàù	FALSE
sǒeMópDǒpyfMtěJWNqeH	FALSE
tLfGzCrQDyIFqúewaúNn	FALSE
udOgpòHyqGǎMBvdfXàQY	FALSE
wǔZtXàYYIfroyYKFJBǒM	FALSE
xRwálcGQxǎuSqvbúóBnD	FALSE
yaHBkuzshviJǔulZiNaG	FALSE
ùùJàWaapzáEOgWǔAòajzK	TRUE
ǔGaTǎaurNúyTèuXúUaeǔA	TRUE
áSaUúótàUoNaDaXBnnVJu	TRUE
ànKǒnanDZǎwNZAOaVóauy	TRUE
éSJVGavkǎhWòaWǎkSQRSa	TRUE
ěǔNèhěDBhaBuajnapájdf	TRUE
óQzǒBaúLlFEOBQwaakgùh	TRUE
òhCaTaWnqroaǔrǎDHYWjF	TRUE
úǎoqastàrniVǒgúIDaèGa	TRUE
AUùòǔZatkhaKivCǔrrpay	TRUE
CátěNaUjasnTRCCnaoPjá	TRUE
DLVyòFSZSùntDHZCaèaia	TRUE
EhùaùaHSwVWxěǎlqajoúB	TRUE
GGqguIzVarěoVútuaěxaá	TRUE
HhPúùQgaXxDVUREaEmaxH	TRUE
IxIyxòOaàWaaVVFzlIlVo	TRUE
KVoYoFawtaOúaCIAázKBs	TRUE
LlkaZLNGantàZHéaZzBOK	TRUE
NEgWǒóaPaaEkIWqhúvJZK	TRUE
OaHáTàYùDvaIFéòQamwěO	TRUE
QAaBJóaIùéTanyIIOègzP	TRUE
RUwxzHAaNaRBRLsúzaSúd	TRUE
SnáQTěkatòaVBPaasCVáS	TRUE
TvtFhjaFaMmróZWǔakééz	TRUE
VQǔHHRUgKiVgěalrarayK	TRUE
WsLkyàPǔPlHvpVraIOqaa	TRUE
YSPxIaFJpǔDqIaaùkZtaè	TRUE
ZzalaqCotgvóDaǔoAqkWC	TRUE
aèMqògHHOajaPepvàKMpI	TRUE
aEFashLXasějRZNnjRaùǎ	TRUE
aKvsamDXVIrgFaYBǎVNuD	TRUE
aRmxkzPJkzOaàgǎVlaǎcq	TRUE
aZèaUontaòùbǔtpzònzMp	TRUE
aajJOVIaèKǎěwInXukuùc	TRUE
alúaòvǔǔqVNgǎFòSHaèWR	TRUE
atásaYoFZSVzIáhonuBIa	TRUE
gRWoSjǒóTúaJtVJFhZpaa	TRUE
hiaRhàaHèjNlqrWxjahNt	TRUE
jèěAaKETMhaaTcgǒEóeSa	TRUE
kQMaaOaxymfrcànXylzOz	TRUE
ltùwqzaaFGanjéLpDUXòZ	TRUE
nLVaYkZNlvDóglMMaBaPǎ	TRUE
oaaǒEanǒVHYaHáPǔTSyaN	TRUE
qàEawTraZabVaCpQAAóby	TRUE
rUǔmǎgaHEaaHQYdbbUZOd	TRUE
slgěùnaanaAokPDvaGaJx	TRUE
uULXwKhaQUCàKytǎaGaěR	TRUE
vmúJaaUnOGDgǎoaéóUèúǎ	TRUE
xGaMHYgjyàVjEMaaMSYcb	TRUE
yaYWqZaMoóabsòplZVGtA	TRUE
ùùLAinjRUugyLxEdqtcVǒ	FALSE
ǔEjSSnVeǎQtèǒéYǒfYěQK	FALSE
áRnùFFBHBzóXZjheXVrJú	FALSE
àfMzjàptúáòJěRAVnXtǔF	FALSE
éǔǎWxfwǔàOdEúAmvxnlcS	FALSE
èNVVgvKlifcáòǔYMVgvaT	FALSE
ětIwěvióbzDLCáàǔOkěbs	FALSE
òITqLnIǎRHLapWúúgPKnX	FALSE
ǒIHXqǔJakòNFSéqrSàNsm	FALSE
úIEKaEkMgIrLùkúzDěGuR	FALSE
AjǔDxKCOéoWUQvXàZISOI	FALSE
CèmNeBdmFoFǒmóCsLWHBó	FALSE
DJIWGèoNAGěIǔóhSifJFw	FALSE
EYáhBlǎwcRRaKǒěULjwRg	FALSE
GéOmBèSDUXVcwHmeNqCáv	FALSE
HEsopéwCHacàxTódáNArJ	FALSE
IdaǒánùělcWXyùqXrjáfè	FALSE
JjùvYJěeJnErrěLXXVEOy	FALSE
KsfzpOěòǒmUmUCQòúRswa	FALSE
MYDioBTRrrZNadZtLRgùQ	FALSE
OáócwbFwzàblMxǒGXFcLR	FALSE
PByDTáéHdNQmlLáyúngvò	FALSE
QWrCǎBnaiVfcXNOòKQGhv	FALSE
RueǎhXóBGpOzbooWaFsXg	FALSE
TCyèISFLJnPMHPARcXNrH	FALSE
UWPbEpcòvWLOeKonmIǎiS	FALSE
VkZABǔarfhzlhězDesáVZ	FALSE
WuVòǎFRZyúKoNGKPèzPzF	FALSE
YǒZcěoyNQǒBbútiEbpQLP	FALSE
ZdIùWkǎrTuRkjMyGLoUKF	FALSE
akasZiMwMǎoqùtǔúHDMlE	FALSE
bvjèQBkǔNDyàBYpKipNòǒ	FALSE
dAfiAhxòNUwěGiAIXǎǒXg	FALSE
eXVsfITYúeKùPOùàMBXAz	FALSE
frWbcúòuallbOwkyGwpǒl	FALSE
hòNfLòmUKYbiQUUlFKHqW	FALSE
iPhqqoúuLQzaqGzkijsix	FALSE
jpJéiézoFtTyóXyJAoǎIo	FALSE
lBEtFZéǒZKRqPuYǔIXOxu	FALSE
mZndùkǔùPXùuQUùIodYNn	FALSE
nzVPYcwDfUhóuOhiMàthZ	FALSE
pàcpJdwscóskybQUMMEèa	FALSE
qFfǎDNùnuWbjOSyTBágwè	FALSE
rWwEmMùnònùbeNuàpǔqGu	FALSE
sgkestLJdhlBYUveUjWVo	FALSE
uǒKZdGIXZbhhWiYcǎfmuǒ	FALSE
vLhqáNrgFpqǒDOlHhLFxR	FALSE
wdKbKltUràfóeViJoóyCN	FALSE
xuǎjqzXSklGLěOOjezàǒe	FALSE
zécǔSTLvzZàùaPSécXaYB	FALSE
ùǔlmǎIIxIIBsakOajtaXAZ	TRUE
ǔaElBZPavYFQHAaaMeODOá	TRUE
ávpJùaoqaúùrOǎizinzúJa	TRUE
ǎDragFnOGKJèàaiYNaDIZq	TRUE
ékZòpUClúCuGAaòaaFBWEP	TRUE
ěDmMTWgRBaaIùoUhiahHùe	TRUE
óaiOaAohIěǎFàaWKúwQSay	TRUE
ǒIhéóaùNùaùvVóàǒóayècú	TRUE
úZTqazaxTtXZiòapQoSgǔT	TRUE
AiyDnǔQKaFMǔěYAgúajJHa	TRUE
CùnHXNXENèzSLlaWuaallá	TRUE
DTCatluZóúaappěòPlTdHN	TRUE
EaNzLCpaWáWtaYYáclrLFJ	TRUE
GùlXaXJmxwpaòPpatVQRoI	TRUE
HLDpoaéRaárYTJvaOnùyéR	TRUE
IlswaaAIsaXJDéxwvpFeTq	TRUE
KCgaaUáéDàptygIěEYaEùj	TRUE
LaTyǔXFpuaNYyafQRHMYTǔ	TRUE
NóBsǔaBFhósQDBCansaiǔx	TRUE
OXJraFiyWjpJěújNKjaGaB	TRUE
PrraaefmZdkaQSHaoJbmwI	TRUE
RóUlzWxQnajùaàLyaedRaZ	TRUE
SQIauDCKHXjOaqkxEaIZúy	TRUE
ThYaxapgàèrUpGXaèJèeWv	TRUE
VúCaòIawquJmHlèaQlmaTb	TRUE
WaIiǒBOatagdoXUqwnAzǎa	TRUE
XxaasjxXgsǔaàhqhKtáGBo	TRUE
ZVxGHèSèZaagaNxVNZáSJW	TRUE
aéQrFExWkaamPUtàIJIseu	TRUE
aBrFaNwSLmàHjOǔaúgmQkǎ	TRUE
aKBVXòaCjBtICgTiǔFWGaa	TRUE
aRpLùOUěIayZoEprtaREèv	TRUE
aYBǒCVAwBhTuHkwǎaUXlNa	TRUE
aahhamzvéòǔcybNèěéèXnǒ	TRUE
alráràwúRǒCmtxtǔǎxaoQa	TRUE
auzpazEaèODrxǔhjboBdsy	TRUE
gRiǔIuaAxazěaNTùgXjUǒN	TRUE
iàáOhyHáHaHTǔáaUSaùUmO	TRUE
jIùauwqnùtǒKaPaTbWvMRm	TRUE
kahóKACòyoqmàCóMSuǔaaV	TRUE
mégMQòyQKaǔaǎvUawkpSrě	TRUE
nZguAOéwuaCVWaaUèTtzSU	TRUE
oswGZazsACaVǔBAuàWaPaz	TRUE
qExMiǒěCàaHANèXpzSxaFa	TRUE
rgaKataARàtyàxéběónfòé	TRUE
tCuMáǒWaBgùMmàaTùQóJan	TRUE
uaǒDanpnAEùúmmTNaRzrǎY	TRUE
wéXXWUsaéaalYnfnLvIwcǔ	TRUE
xaFDuaxArùOàoUtxiǔHCqa	TRUE
yroEaGaEFUEaLYǔúkcnpDà	TRUE
ùùáGwGgDjNvogfuvNùtǒKú	FALSE
ǔGùIǎuěeOBXmTHuiczpèAW	FALSE
áYxThEàòvòfaáyBuXǔMlJà	FALSE
àoYcLkOǒWHCKBBWěmkTMeF	FALSE
éàCjfMáòpmHǔsZtgVnDaòc	FALSE
èVyjsáxcVOPqSfnǒbkACvz	FALSE
ěnbZzǔěbbóǔagQolIQzRUǔ	FALSE
ówyùhlácálRCuXpYAfhURQ	FALSE
ǒúmvjYBUNoóVwóuSéiZpáQ	FALSE
úEPehGZLXplhsmVàSèTqmS	FALSE
AgóAnèfzuIWYrqKwnǎcàzS	FALSE
ByHáèsúvNbIKtYisBVWUuX	FALSE
DMiwatDEAcDMdvlǎqbzDBT	FALSE
EUGègIdJQCIòScòWRǎbjlx	FALSE
FmFiPPWúǒóZBàkilDmxXtu	FALSE
GsǒǎslcyhàVywBmèòXHnúz	FALSE
IǎBHacXEDMRǒIóècùhHězǒ	FALSE
JDàxǔPOzZGmmbgtJáwcaIò	FALSE
KZxHWJáFvRǔQèSTKéfkrFD	FALSE
LoYǔXLúMXWúéjqùLwóròlK	FALSE
MnwTsxODTozòOiǔVXjwElP	FALSE
OàaQKáxòisáúTEúEHèztqě	FALSE
PWZQFnFzèHnvNóZoGwàEsg	FALSE
QqprǒEQgaqoéuqàGvǎLǒDb	FALSE
SáiZZOaDNaoeǔsrgǒhpDwh	FALSE
TúlNIdvGVgkzǎqrwbKǎoWd	FALSE
USUloèVecUaàmIXWfxEPúC	FALSE
VtbYLAKHYCbWhTòǔMǔtGXM	FALSE
XúfhdqtIMTydóEpLyRAnǒá	FALSE
YXlHjHfMwwDZòqjèJLNhdc	FALSE
ZpnpNàKSǒòmGqrJsPdáwDW	FALSE
bòqCDsjExuemǎkKǎvqǎUQá	FALSE
cJOétCIósLCRùEimòyúěwX	FALSE
dulèùuIèQqcQnGtlLěnfúS	FALSE
fQbXáeòòGǒàeZWmeéǒPMQf	FALSE
gssJòúMèJMúDczpOLóxMpF	FALSE
iáyGcUúégpoFRUéDRWěáHQ	FALSE
jMcSyHQYGMfeZUEǒhDkWTS	FALSE
kYèòǎCnbnFZODwkDZgauuK	FALSE
lsEbjhaplióftfIYylóòǔě	FALSE
nàNuWyzqIMaTurǎwòccHAZ	FALSE
oStuPmgxeUkMpéyEXwènEr	FALSE
ppccSxtNùuoQmJhpTmcImb	FALSE
qtsGNMrPNěVZěàIVBAcnfh	FALSE
sěPSéǒimǒXSUxAIQufRTNL	FALSE
tJJrojAqluSsDsbrPèòEIZ	FALSE
udTXNdAnqIáTwPúVaPosòu	FALSE
wěurrQrWgxatqúuùYéZLàk	FALSE
xbYYJXUtUjRoruWdGhpuQC	FALSE
yvhLuǒǔwHěQRǎyuIkEfXnC	FALSE
ùǎAùaoaěQsONUTxaDACZósB	TRUE
ǔJvnDèMavǎIùtPXVóqazaFW	TRUE
áxèYEěIjpatjǒKaFèQvaHDǎ	TRUE
ǎKasHaHáKarKSPYMeqgǒáEa	TRUE
égJsuvDKaZǒJamaundèrilé	TRUE
ěWaěóIaahsusRuvGǎvzgrjá	TRUE
óvéaaQHvóJcajhVùadpmdré	TRUE
ǒUDǎPayóCtKPaqQqEXSaYvN	TRUE
úaminǎaFùHZAiaùDaeexIhU	TRUE
BEaqMúuazJǒnarWuéBpmùLL	TRUE
CkóěǒaNLěaSQuWaLióFqxùg	TRUE
DtěuòCLtrQaDóǎwhatmaIǒE	TRUE
FPóaaèKDqqwǎúGVVNzXaDPY	TRUE
GaGkNEuwxWǒOAsèvraaRKéě	TRUE
HrFlzaáwJgaJaRvóbUědárt	TRUE
IzavDAzxLCHRVnvaèaGéEzn	TRUE
KaBJElěAFanùNúHVPFaYǔhp	TRUE
LiaaaFǒZpBShFUèòděǔIzwy	TRUE
NFWLùEnPYamiAGsGaXzOaKB	TRUE
OSáasKaaǎwnBYumRbybǒwOě	TRUE
PaVwsYPAaúvzaǎcvxǎTèvsg	TRUE
RéCùYlJByxǎDaBmWaaePUlǔ	TRUE
SjXAPmFBVKZéatsWpGQMaaQ	TRUE
UCBKaSzSEtPIPVymDQòaqěa	TRUE
VaZMěZaqáapaáòǎYKǎUdLzV	TRUE
WqyhěOxnAaWáaavMBswJwNG	TRUE
YFéqtaǎXSǔǒKSavqYSǒǎLha	TRUE
ZVòzZIjaaáAéOqěPRKYakXá	TRUE
aéHàJPsVONahxMKDhzúTJaI	TRUE
aúKEMdwqaálaaUWFtjIimyK	TRUE
aGDazùlěwMKCPFhDCaPdùYy	TRUE
aOXGBEsyVZLoYEatòǒúoraH	TRUE
aXaFǎaocùErhSòbZfàDbUoF	TRUE
aadéJxpéogOPàAJéXaatpsQ	TRUE
alGXàBjzJxaTwhRXaséitàk	TRUE
askQaaùWSUNKsǒěGfǒnkHéD	TRUE
gOéměUaaMBksaYGQNrBSzsn	TRUE
hoILJWapǎCtRzaPáTadJGNb	TRUE
izztNaǒòaátJVǔrèavòIGRV	TRUE
kOVRègEHaxBévEéaDyatQoK	TRUE
lauuěNLǒyaaIkCMcxWOaZDv	TRUE
nàFǔPaùkLWuWàaWmuújàaeD	TRUE
oaaOàOatAWAUOukRéxádlòn	TRUE
qǒaRǎNǔIhaBisaxXfUKJoPy	TRUE
rQRoJéaěèaxRLPYéUaǒNǔBq	TRUE
sjaaJeLaoaéèWáDmhBrueQP	TRUE
uCEaPHYIěùaEoòéáOaSùqěl	TRUE
vQqaOàpmalOMlnaáLzLBcNó	TRUE
wulIZèvHaxzaVéaYXcàimSE	TRUE
yWxYápZDzǒaBVPrǒoǔxHaàa	TRUE
ùùǔGHtSSǎGCAkTRlǔpsamEB	FALSE
ǔKfaxdqgRPLǎIcDNěcwBBPA	FALSE
ájuěǎnITqěuúúBWlEGqXLCA	FALSE
àuqǎXGfFHéùLNQDTLdEókXQ	FALSE
éúXVdǔNUZKXTjoguódNoidV	FALSE
èRtFsoěaLàiòheHesěcòhxt	FALSE
ěkvjphCubxuoXJncHáQnámu	FALSE
òàHěTcBTóMblJOǒbIúpbvmc	FALSE
ǒóxNkNRKCǎUgwǎdUdáJkqNá	FALSE
úCufWLáexúbZjUnHupHgLxm	FALSE
AXMLrbàSaouCtMǒóábZPOéf	FALSE
BuJyMòqiwZubiitǔfYYHGQZ	FALSE
DGVjEqVDShPkRxBWotKNàuP	FALSE
EmSGsèěèMjFEaaǎPùcbeuáě	FALSE
GòEbEúmtcvICráwoháDTIJA	FALSE
HòùùwAQǔPqhxiwěEASzǒěnV	FALSE
IVIevóMPfnkBVMBóoKgYBQt	FALSE
JmEOTdrQdJěyútaTòIGXàCa	FALSE
LàáǒaVktXZúvTuChéǒPrKyJ	FALSE
MIgsYèzPgxrúYàXGvukBěBG	FALSE
NoWùbtújhaVHhZbéúgJéaLv	FALSE
PáùMmGkLèVCLgJòfhROúUjL	FALSE
QKlTbptUUWcZRhRuOòTmhmé	FALSE
RfùGǎNàmFAlmxnRNgLhǒtcó	FALSE
TAéòbhIFOTdoJySésWtgXòb	FALSE
UBfDyqèTSnEKOéSWnéqhJaR	FALSE
VeCéMXòWttDygVǔRaPDèLéw	FALSE
WdIaNSéàDòěǔqtWègvzèZFV	FALSE
XtKòJócDoètǒERawCUPJNǎX	FALSE
ZJváěDOmúCCMHYKpBǔSXúúD	FALSE
addxbǔahjIěcLpqWQqàEaFp	FALSE
bqnifNqiihǎǎimúyǎsikfQN	FALSE
děRpkLqǔòpVVǔMRWnIJaAWt	FALSE
eVIKěEùBHbbzússgàFnRONǒ	FALSE
feúAZFèzrúlajxbhBHvàěnA	FALSE
hàxgWBaEYXggRtùWSQóùOhó	FALSE
iIpItIivXkFǔQqjMáDQWhgI	FALSE
jghOtKóJǔMJǔsQòjjOOpzaě	FALSE
kugVáRkmyrmBǎLQègsoǎTHa	FALSE
móèúgmpUUgxTKSyAIwYZPhk	FALSE
nBkemifǎfàGToLtDKéTNmOM	FALSE
obZxwǒHIMóéVRǒnùěPdXnjà	FALSE
qéulěEKuTmjQXFjfeLRiUrY	FALSE
rHozCénKSYQǔjcjrsòhpábó	FALSE
sWYSlyqETúrikAégróTIOnǒ	FALSE
tkpQǒVTBdHXXèéFCBLèàwNǎ	FALSE
uskEZXPòQKfǎùgònswlDlQV	FALSE
wàèxGzòkOxeHbbcIètAnasò	FALSE
xSǒTWXàmFEHHpTELǎrǔNjWM	FALSE
ypǒLósúzsáǎFRVqáJǔfBTaù	FALSE
ùǔVuutWàiVlaOVaKXoIoaKca	TRUE
ǔSrCǒIwYayrapPǔMáayóRhǒv	TRUE
áoǔkGaaUraYjèGaóTpfltpcm	TRUE
ǎKàOaSóxarXHurkóékFDFaZT	TRUE
éajJKkZBWmoaFkǒACCBtysWa	TRUE
èmgóLxSaGéKrFRRgaěWagkXp	TRUE
óUkansFkiDzxPqkqavNyTaLT	TRUE
òxaǔtaéEqQéayMǔèYcEsoWaM	TRUE
úéSYkNoáEHToaYnLǎYBKuvaa	TRUE
AVjaEnBěWvIPgKǎXaaàCAúxé	TRUE
BaaiòuvqaKgjfQmTfYùáùòMp	TRUE
CpOEFpEaóPHMCaFáagǒòKmqP	TRUE
EújUǎsEuaàarèaàVApZREZòò	TRUE
FaAUjùLòrnèETaHaIgBxwgJA	TRUE
HèiXFǔéǔHazYuxéaOléóémab	TRUE
IKaPdǎAěWCgOěpsDaaúacWTp	TRUE
JjzavnCahàjnYZLǔBèabyXNá	TRUE
LAhtóiaeaClOGráCvSaarézH	TRUE
MaWUXJPLǔajlóazààutxjDWn	TRUE
NrQěDEJLaYpCaǎhvDXùěaiSj	TRUE
PCDǎaSěXúMXYaoěaBNdQefHr	TRUE
QaJJQúayOaJěCrnNcjJájBov	TRUE
SǎaáavKpolIBaěqPlěkǒAnrg	TRUE
TOúàaqxFaAèPáfEóaRUgUaHò	TRUE
UnpQǎatvàFiaqNěèNǎoBEAja	TRUE
WúIaAxQjBJaaàPǔeDFWmafkf	TRUE
XYùIWáYNjurGǎGaTqóTAhsaa	TRUE
ZXAEqáazaTARruushnǔpPNta	TRUE
aǎoIàaXhPVtéFkěAúBvǔavòF	TRUE
aBòalESaZvGáUúKGàDODSDóC	TRUE
aJKoaAVajBgFrYuéLpAoézwJ	TRUE
aRAlaSWQaSpNIKTyFEàHCoBw	TRUE
aYXuǎùpaPEniMywtQDYaUděN	TRUE
aaosRPOBPYzLséówǔaVXAFKf	TRUE
allBhapDaloégHUuàvhbMqen	TRUE
atVJiYSEkùCXaaYjymFóComě	TRUE
gTaMaJCJaQxúPhZQWAdkaPóǔ	TRUE
haqPahèùtmtàyXòóLapbáOěò	TRUE
izéoaEQrEěǒhagǎESpúzIaXo	TRUE
kGéLWqBRJMrLaěasGùàwěamo	TRUE
lJDlLPAxwNDAUNagaǔéǎGPáa	TRUE
náawǔDZaUǎEóvgóYUalNozTq	TRUE
oacQuaǎuautáěUUGMaǔsAAVH	TRUE
qCěahǒaJòhhèóaóWIIlEukRZ	TRUE
rkèZóXLùNrzǎYQgYvawDvaUa	TRUE
tAayaaJBdèRǒWtóěEfǒvHhPO	TRUE
uauGOòlùGaòèlsáNoùhSOuGa	TRUE
wùPCDaUnǔyǎHúsǔǒaPjKjQay	TRUE
xXazàkéeNhHcYaaAtpWùùaZE	TRUE
yuBTZéVáaòpxVaaòùrwsnxKK	TRUE
ùǔNTahǎéuobjěyeuǎIGqSOró	FALSE
ǔKTěqqàKFDùmcOǒNKcNáTóOx	FALSE
áfafbWrxuúsmáZAhápzáǎsàF	FALSE
ǎǔziNKkUcOLKteIydwUjRúZO	FALSE
éYrgyDǎúàěIyPVǒǔVCyvxěIH	FALSE
ègxTùRYǒyLjzfùKOYNqtdéAó	FALSE
ěuoEùiobeáctGHKCǒjYǔbǔtǎ	FALSE
óvMàuàVWǎKSduHmǒòMeXóBǒǒ	FALSE
ǒDààóeKDtaváOèPRlaWǔGzEf	FALSE
úIvFasLWOmoMxYFgaJUFxYVǔ	FALSE
AUmwwGgGipyUoIàèHSQfpGòc	FALSE
BTMVhóSsYlJǎtnóvHhGfdXSw	FALSE
CiěiǒwlnJiǒJCTwLibUFTryA	FALSE
EúCTémYAjiDHOUcIéGéIfROn	FALSE
FOǒiCalKEdtvoHefQxaeaòsb	FALSE
GWhtpyvgwòuUtKXǔùRCxóHFM	FALSE
HqFKbqXItLEqZLWfutGLúPǔǒ	FALSE
JòúYàtNWùXáazreáǔPěDkmkB	FALSE
KIvukéèHzéWBóRjAoLEHófuO	FALSE
LTEhXwTǎuoQeAòiZiZPOocXh	FALSE
MbJQIvhDólnQPihǎSáòéIbXf	FALSE
NwYpwgNyZCLéikjàDeffQaOZ	FALSE
PGFLkwDFfyjkùTnrPxàfPlùǔ	FALSE
QgRxcàpxòCAGóǎOYmHGCáRYl	FALSE
SèuMELvIFaXFYCKefuùǔaEoz	FALSE
TFUJxRUTèAwécvLYkXjáGmèá	FALSE
UVWEǔZnǎXwòMóHǎYCTFSúTtD	FALSE
VgěEDIBUGjmAúfYXéjèèPZcY	FALSE
WsǔoAèMiPqEIHFùQTpdòUFóV	FALSE
YQzdWòbWfáHdSZOaEMlDnXHV	FALSE
ZlodrdWVzMBvYuúSMǎěrbIcI	FALSE
bǒUsaJiúMWúònRnwArǎJXQwa	FALSE
cPǔsiLPmgbXǔFANZuDeǒOóiM	FALSE
dgoJlrXvcZVóěhQOéóVtLRKK	FALSE
fCPoRBgbMKùVQGUflPAcLúkd	FALSE
gWTeóriOKrFRééXNnHsěMfvó	FALSE
iǔsQUWDèěTpgtCOJqLáQOjTv	FALSE
jòámIgKCPlNúGazBVokKkIcq	FALSE
kOWwGNZmdOjcOIOUězùeJǎKǔ	FALSE
ldoěArrjyZeKXegàTKKtIòcK	FALSE
mmròAFǔmóHwhwtdpOLPJWFJb	FALSE
oólyjUGóiNZáǔTZBPǒTǎAqJz	FALSE
pFeotANòùèájkǔOǒWWccGcLU	FALSE
qirxmwcéúmPFbǎDsvbGOZqHF	FALSE
sáVdùDǒIxAéIlXHxiMoZàóys	FALSE
tIHòlcpUjCNYyǒRPNhMGWpfX	FALSE
ufHbWàlFwowgYFUqfzěěLwhi	FALSE
vuqIDóBbéOwNOábmǒcǎsédcp	FALSE
xCqCRqúYsuǒòCwaElAbMǔKVV	FALSE
yYRúǒiMzOCxǔoèsEóKúQOMék	FALSE
ùǔqtuéoaaKWiaLjWlùúchNǒdE	TRUE
ǔaCáDajadCdUrVjjǔvQréèyàQ	TRUE
ánòxawáǔPCFǔxósYiaDCJaXaQ	TRUE
ǎáOaSHLaaǒhpnrQLxvúWXèáwò	TRUE
éDaaHsHZPpFàměgeFvXaaReYa	TRUE
èjOZZaaABaqxEPtexTwXNLSěG	TRUE
óǎǎDtPttRpasZzaowYYPzaóNF	TRUE
òOTqwiòutiaZǔùǔWkaùBmVaKO	TRUE
ǒaLuàPaùNSvaNaszYfinèSùad	TRUE
úrNDFàBaJEWZiaékiaLqrGǒcW	TRUE
BIǎsaénpMèòRǎqaǒxùxPtRiùa	TRUE
CaPtóaHaàGMàeTGsdqwcnLArD	TRUE
DuóIlpatGUnaǎLaBǔNTNVXOZJ	TRUE
FǎAgxsnCTHWǎRCóLajCIaaGèé	TRUE
GCJKJyBǔzéaoaLèáóGuUǎSauW	TRUE
HUvaOEEěJrDaaǎarzGěCárbCc	TRUE
IiHaBFèǒVwrúFóàaqNkyhyahf	TRUE
JqótIáawZòmRMéóTEsaxajàùi	TRUE
LKgDaaàCYVèStEnacMSAxwjCá	TRUE
MVòCwúqKXighòaaahmaaftèdZ	TRUE
OéFjTEMwapRaCxWqaèNǒqùeKn	TRUE
PaEswZlaZaRoqtYLFěxQByDHj	TRUE
RúnYqYraǔsèXnKZOIYLaNaSwt	TRUE
SuzDǒNáaYqajúFNazàIUJépnw	TRUE
UOaǔIzaXPǎCiúgrkSjaeQnòvK	TRUE
VXCYhESaQXaQkmVDjzKSFPràa	TRUE
WtùǔwlòJjúàMTúaQaǎUVItqia	TRUE
YIvpaaHaěéàóiWGgǔFHAdpXVL	TRUE
ZhKAMIZnLPpóauFyqsyaaHMPò	TRUE
aěúqWùéVPùaěaLINIlLdDzpěL	TRUE
aBalksDMlTSǎMgùphaègqhYpò	TRUE
aKsǒaóqaZEVPěkMknqDtBOMRw	TRUE
aSaaytBIèpYDoFPhùEfclaěoV	TRUE
aaáóarqDhWBYSòtEnWxóaFyěZ	TRUE
agaúYápaLgxtǎMluáZGáGZLDT	TRUE
aqOǒQWóáérXVazPSZAaAQǔùlE	TRUE
ayaaIněBKDPezpTiKdvezfRMě	TRUE
hǒygrééPaRrNXàhanóOadQgqO	TRUE
iWSaJáUqǒSBVaEKqQkutFǔHaǒ	TRUE
jwaXEéQúulaCMHraYczZàeFwx	TRUE
lMQPQKHaRoIaQsQYaěSǒosjDm	TRUE
maaúúwMAYhǎQaěǒámqcsWqNdh	TRUE
oCBQLakǒTRaXXǒuuRaǔTVRYBQ	TRUE
pjAòYàǎiRZěaǒáOEnalQaúùùQ	TRUE
rRHaaúBKlpQUmǒZjYNáBóaYeT	TRUE
sngINkmCtlráFQNGaQinaáFHa	TRUE
uFaCPasxxàQSFaAPěuXùèqoMǔ	TRUE
vjaújXyaXàRSStùWENLUtiaàd	TRUE
xěěkóaHTIǎaaglxáwOóxěWdYF	TRUE
yYMgwoavpnPtzaazPMǔcérYsr	TRUE
ùùANDJatbGMcLǒplzQKcQDWfa	FALSE
ǔMgXàrysuowAùHTKwXrqzxnmj	FALSE
áPHuDWzzfPZòeUcoǎěUJLnXǒT	FALSE
àyMhuáUdZǒURgHuPǔhYvPbUyj	FALSE
éBGLúWáFeYZnyàUJcntlHhLLI	FALSE
èRPólǒGAMtùbùmdSòYOTdPáMW	FALSE
ěuTSVJàWNpqèSXaóseZkjiǔls	FALSE
òǔèiNǒCRZyiaKWRqYuóqlphZù	FALSE
ǒCěBciòcHQèóNqBúFSJXpOngr	FALSE
úWtgQcWzààfAdéJPDěHèHYnXt	FALSE
AnaNQpXffYvyJvrLtCQáGqkIP	FALSE
CùòéhětǎffǔKzUjcRGsPcNùuY	FALSE
DMúFoGěáǒtJKAHhounyefJsát	FALSE
EXlYyLèNáúYyLǒuNtlHóctěko	FALSE
GéCSRMǒǎbnoSkNyùéCuògFJAe	FALSE
HYqoěěùcoOòFǒqqPtEjKwFRzH	FALSE
JǔUOǒsxsHuáxVoSóxaèHpjAǒR	FALSE
KKòwTyesděǒùtBhZuZMtLáéáN	FALSE
LaxeoJrPQàóQFPpHKǎHàpclrW	FALSE
NàùuLáBZarAByRYHqéEQqsYmF	FALSE
OǔFDDJQSrqrjAbdhkMDsjniúj	FALSE
PATùjMàLvxezlVnúǒYkEhuSpv	FALSE
QUéǎaAlǔEdtùQǎPúúNDcwjCkd	FALSE
RmeàJifxWAHRNbàpěkYǎòZFgC	FALSE
TKntVsúRQfaPnkWRLanùtOsNR	FALSE
UjrsLcnAjRoYJóqaLudVKnmRú	FALSE
VyěXEaGóSMGwbUzdKèJmEFNVa	FALSE
XDdJUSDnVǎuDAFeUOFJTrOOTT	FALSE
YflóyPQBǒséóECzprmCtJaagq	FALSE
ZpgiuAǒǔTedàRǔúǔFuiàcrfàǎ	FALSE
bówééHmRùrǎuWóèèaXczǎmùcù	FALSE
cLútTěQǔlǎUrMvLúdjLgIUCáQ	FALSE
dYàYòéLěMxnkWfMREòopàncOU	FALSE
exjYéACtáúbǒǔàPǔFPpTKQOrY	FALSE
gǒdoúǎostsJuXǒgRzèyXqHCBq	FALSE
hJujLHcqéFcǎùnmòqàeeoUrCa	FALSE
ickBiFvlOóOLzYvSǔHRèhRcWù	FALSE
jfduXkvdIbGITdTOXNǒkáòDkó	FALSE
láuRfaYlaWgCtùǎSèHùGRvVnA	FALSE
mJCIúZqeFXOdoIRKàSDèMlgAh	FALSE
nqǒTDWùHCtCRFpǔMBmGhdǔZǔo	FALSE
pǎfěRWJDicpMdúzòZjJXúěěBv	FALSE
qIsécFáófǎKPóqjMàgbypUcSY	FALSE
rULcgVǔHlLYúKeKGIRóǒnúAvó	FALSE
sdeěUsyavkJDnmqYxMPuDuanR	FALSE
tvMééúTkDYéòVmǔèHkRúNVSIi	FALSE
vódǔROYZUZkuǔxEFOzěIjvéVS	FALSE
wACgKGDPJQhùcdoěGqenYěENǒ	FALSE
xVěyóJuYXoǔapouTéěùXnDěwN	FALSE
ydúYqěAFpǔDáosCZZáOǒúmdVb	FALSE
ùùǔǎFòBaaaygóktùwTǎTgqBjHe	TRUE
ǔQKlooXLavGlmDaRYPQBtaxqXè	TRUE
áoZúzǒauhpáaavgPáǒcxKàFWQb	TRUE
ǎóǎDiZIyvòàAaYjàqòauúzúQae	TRUE
éaàSiDáàHaqaòXyALkóVCnùUFm	TRUE
ěěSúaDnCéblHCbaaUMOQèaQYdu	TRUE
óTjqPǎLWRmXUòOxCtQnaupaLòa	TRUE
òauzòkRMiyXVsDpRXiPKaèJCva	TRUE
úCaazaóúkělěgsǒZRièePéRxyO	TRUE
AaipQyUYǔrPZaWEqsHrǎknqadG	TRUE
BqPòDaRěáPMasuFJènByaDèCóǎ	TRUE
DèàèKyaèǒaaǎiIfvQvDévwéxol	TRUE
EMHUaTMǔwpVaVSmaWCWCXqOnòù	TRUE
FqrDǒIUgDáWQupwagLaUaMmAùv	TRUE
HúraQuMjěajjaLoǔáyijFoojáp	TRUE
IaXiǎǎTEěDEALFvuúaYáaRiRBQ	TRUE
JoǔawpnàgtQHaAzpQsqSmoVagà	TRUE
LDXǎaBsXWHhCBImoǒEaèJxséao	TRUE
MmWazBZaqxNrpěěǒěǎYvaIbkcǎ	TRUE
OHmDóaaUúnanzejMVPáòùěǔóeR	TRUE
PiQazGNJpSYlgTUtoèMaqqrRaB	TRUE
QpRěJtQsMwnQúaqaJnFaHNjmKT	TRUE
SLVUmǔRtáěaJóuaZxxěaLòmKIn	TRUE
TNFǔaéZrǎHasaùyǎbxòěbXTpùI	TRUE
UZéěwǒVYYxQYlzkaIgajmTǔFùa	TRUE
WéaUxnaaPbervkAcdáIRyhaWjY	TRUE
XaHTURuěaǒNOwoBwkGaaǒyYéoO	TRUE
YxwLiaeACYǎxCNavaǎkaǔwIfqP	TRUE
aǔaHrEktLCyàaYJóèJxZWJkIye	TRUE
aǒUTéATiiYRMawvóUtACgáèWùa	TRUE
aFúBmtaǔaIbMYOqWzsvúǔgRNWG	TRUE
aNaZsMórúRVDGgtiTǎIùarFeHL	TRUE
aVwEJIQLFapsǔasGghLpèoOeYè	TRUE
aaayǔoSoysúéySMbwFZuDZnòmS	TRUE
amáVatRajNéhIWEWWǒáGkelěLZ	TRUE
avaóèHPWFǒaWPmoùúpcnáPlPrp	TRUE
gaaZHěaFùaYtOHVNmùbWúěrWiv	TRUE
iBàasizqǔWIaokiTYOǎhúǎZaWo	TRUE
jaǒEnpKqausaAGèUJáyStMFúHj	TRUE
lèkaúVUhVLJviHaLQRǒzaoHPBw	TRUE
mNàLjaXLaUJrPUadNkǒVCYjyóp	TRUE
nataBPOKZZijáIgISiǎaBhVOùK	TRUE
pMLóZBzRaǔRltBhUsCnCtǎaáXa	TRUE
qaHnlaHRěYaúrUtòhjVǎORiǒEp	TRUE
sèapDlaimajnzDuFòégOrZmèLc	TRUE
taóQǎǎQKvàěZhAáakghnBtTǔaH	TRUE
unPxéǎKwWBaáaǒaPùSRAheNáPX	TRUE
wJWqDjFúKOzóaaamnlúbàbVhsE	TRUE
xQiRjKùiěuQQuaòajhasùóniùD	TRUE
yhGàxhaAnVwùmNǒaUKLIQYaPěM	TRUE
ùùGjóiǔauěcNzHzbiTypqdFóuc	FALSE
ǔLéEǔhVUojAngTrgesrVeàODdA	FALSE
ákVVúRSgxuknCèdrYgWsgTKmMc	FALSE
àyGewIUWldàpFeKPgEQDàtqVZd	FALSE
éKéàIMiCǔtBZèúgTkàJRNoPIèX	FALSE
ègHnquéwaROǎǎoPZXAěRMUnèwu	FALSE
óèàkeǎrùSzIZnsryHǒóhssàoJl	FALSE
òHóFyèYwxdQCDPDreyIòbLymól	FALSE
ǒSnfciúKPkdUézzRHcàUVBlZcG	FALSE
úsJFmpXiryJzPQjgeóGtpLiǒdú	FALSE
BEUonyHBBurrEUòóǎvaHéǔHsúl	FALSE
CQISùknqNVEQěàLèVàHxSdòykY	FALSE
DmiGCOpnCHKxusuéNsZéxáFxóc	FALSE
FáegIUǔUàCùIfdhcNNuógKXǒGP	FALSE
GGwwxóbXngneàkAqSǔmkmIDmpV	FALSE
HTTaCvKèèhLaněiúqLRvébGǎqY	FALSE
InxehVLPoRRDùǔTtvRtǒIhyyIò	FALSE
KCYTYǎeNAqYBtnzRǎTHéwsXNGZ	FALSE
LBòvjGpYoRUFvHBFKPhWsrfLhl	FALSE
MLmdCáKiYuVdASòfMéúRfjaJóI	FALSE
NuFVIlVUmULtoJoIUnaXRvTtFX	FALSE
PòXyBYǒIúwBSEAwQyjùqóSěmCr	FALSE
QOwvDbosùWVPwlǒúsVzTHLèǒvó	FALSE
RoNǔgméspúQlQheozyUiWPMlMJ	FALSE
TébSeUAeMěáYyRǔéilóHéLáSku	FALSE
UQNèěDWjsTúPiàTǎTVNYdVxDwǔ	FALSE
ViǎcLxiWQǔZClrHxAUgJxwǔpYS	FALSE
WtnIcdnFjǒbǒǒòDǔTAKiWKáǔUI	FALSE
XxPèDGfèsBAàOgEdSTbJyTTvKR	FALSE
ZAVihtfpAcUFàKrTtnsSmoBiMc	FALSE
aOntQbWDaaxóPLcsvǒUAaéZHtl	FALSE
bdNrInXVǒIèaGGtRDRUPSàeděi	FALSE
cpuàǒKòxEBWOJoxsémlPRINsOp	FALSE
eàVLKIPTěHcuYcZjMUUáBhLgKC	FALSE
fKNàvvYòorrPuwHQKLkZZXkVNb	FALSE
gbJXBikYàjǒoǒaHòRxqQYtEgǔH	FALSE
hrNRòàegòrXAIZcóKéSdyjFnzé	FALSE
jFkYěsGěFbslǔDMTSFfIWdPDFc	FALSE
kmAvàjdDǒisBTjéxóRmBgLiZòN	FALSE
mèàtFgázàIQbviqúCùòcyǔvKzI	FALSE
nDcMAnúFCxcJLqCSěǔEKPàqVlK	FALSE
obéDsmwAskeeDXuùǒFHrWCOxTe	FALSE
qDgNáǔaOFwQpàjúUXdWuJócFMj	FALSE
rTLfbuéWBvLUNLIGgfeLnFLùeú	FALSE
sipUHOxánVMGáVqúNáeǒRkOJAv	FALSE
uàěrmoKzbocklTfcFěóEdVuETI	FALSE
vWùKYfdòLoFèKxtnLjLàrXKriR	FALSE
wcgkYUuòmSMqJKyEEdpcARZiJc	FALSE
xtSRtOkfarQRdrKóVTWEAòkwpq	FALSE
yyqàwIYXdwqòèniúaqěuFGrqBe	FALSE
ùùóaOIaùnajghAlǒLQsàoIPrFTn	TRUE
ǔNzaMtRPLéúaaǔǎděépdXòBèeàu	TRUE
áuàrWkNasdZéoùHnuUuaúaaYuòù	TRUE
ǎMBuFèhYaFYaNaGJgvkKégtWLyJ	TRUE
étaHKiZjYéhhAkupBIǎQaaCUNwx	TRUE
ěHgAárǔqèYyùyiTagaVjéZGCWEa	TRUE
óUaqMnoXHúùCaaTaAùqwòPhxgJè	TRUE
òqnxgaaaVSěNXgRavIXúàePebyb	TRUE
úVyaEYuaKIúlaRsúDWeèKANUoMR	TRUE
AlpwAsǔpǒaéGéUhsqqTaQInqhàa	TRUE
CBǒaBkOěkWGwIawHISJǔàHasvTs	TRUE
DaawaAPeXsxgIcGvLZzútNJgGǒY	TRUE
FǒvǒsnEPagaàLhVaPdbètEixóLs	TRUE
GTpAiWaúODyùúáAěXǎěNaAwaxeG	TRUE
HmóòayoJvěǔaDiOèǔagǎvkéuAoà	TRUE
JHWZYvaèUkRámdftmNrAaoaJLae	TRUE
KXúòmwùTCUyDaǎǎammCoEaQLwzR	TRUE
MCylqyaAaDEóNèHarEMésxèJǒZn	TRUE
NahaaHopuwDěòivgRàyzlpòáQèJ	TRUE
OmrGǒDsoKGóaoéQqáGaàEaEwIoo	TRUE
QásBǒóěúWaSMAaqEYnEUuNAztau	TRUE
RTaWAǎraPNDavXirfPdDóXCjXéǒ	TRUE
SaaqiabYGpDNDaHYBgpdtáèucAJ	TRUE
TrKFIKSěarNKoaByZtTaKVjWjěS	TRUE
VUrěaòwxstJCGaàjEBavMXPuihb	TRUE
XJJWaaaQǔBvóèpDěcHWfghòYezN	TRUE
YaěprHLlaNiàǔXPRMOǒqhLaàFyU	TRUE
ZsyaúypnzWzaMěLakeRNjcTGsCF	TRUE
aěoJoAmntaJàǎaeáhAMrfvxèaàA	TRUE
aFEapLsxuàùǎutǔqBgiwTaǔEESS	TRUE
aOovòhIaaOBthòPLzòoMoFIRVsN	TRUE
aXjURMSwaǒwyTanfXbqMQéFwMsM	TRUE
aanDùmAPtHUpaOIJáúbsPúJiNúv	TRUE
amMòèLǒmóEuDùQsòWYaexaMahJc	TRUE
avNwgǎaTyHavdqceOUVhbàYgUWG	TRUE
gSèOaaEèSXlqsCNóFéaNǎEùUvwY	TRUE
hkaLvóǒiiǒWOOmmáaWuùgDwadaú	TRUE
jóThpóGRaLTnaacèeamFHtFzONB	TRUE
kǒoykLpazyialDaCnEMfHbAlEYi	TRUE
lOraǎOaxúuTKUvBlCǒUlhlaěxMv	TRUE
moTRaasjmaSXnDdPMvěQXiRcdxp	TRUE
oálANáwaèmDaLtáwèaVLiHlJEtM	TRUE
pPmǔgKérKaLùarswvXǒHěaòòobǎ	TRUE
qaǔCTǎrlEZyZùǎlwaaúFǒBsZNKW	TRUE
sǎLUWGpAzAóaVéGalaoòJobGHGv	TRUE
tRDxaáaǎúizvaCTSBpHZuMfeUrP	TRUE
uaohEjsJaimTCaáfebXPxeěRǎtW	TRUE
wòYóCwaTǒavozzqaǎxpèóǔòVLeB	TRUE
xXvBKjmMǒVvPLCzzaaèDNǎòaeóB	TRUE
yalqWBaaJXàVBVtoIěudòNxǒPVě	TRUE
ùùébúHHěeCtLcXǎNivǎéZUpUinS	FALSE
ǔHLpHNuOujǔtǔbrqeORtoNúǔWLt	FALSE
áTIyzCSwxbwJlihèBAwhzGlnMAK	FALSE
àyBIOTòVNdgOlsZòèLmǔdvòugkà	FALSE
éǒnEsǒoùBǒLQgtIseYSYkZàcRGW	FALSE
ècFùHRsxBǒchsCwTóVdofXfQYqě	FALSE
ěnuvútJéPOxúézxxYPfrfQZLDvf	FALSE
óvHtGLFIyNrNèMfEtCòKhhFqcèǔ	FALSE
ǒúSMWhGJiBEbsdEFióHáGéújèQf	FALSE
úHNswèXNèkèOúJBoOZxYXfwBWqm	FALSE
AbófegYgòeNqZIúfóóǔochZuMbb	FALSE
BtDcěrGfiuXKaOHcMapEqòAyRxB	FALSE
DǔXAEǔqZWèNtjpSneaǔmUièúdVǔ	FALSE
ELvéGNqmUaàKiQpSnnAbàWcTpSQ	FALSE
FVpǒuzǔWOXòcJPrdXúqQóáèYòjQ	FALSE
HòufZǒdhBhrPséUúPYéxkdqItěá	FALSE
IQébTVqKnǒYcCtancfùàOyàòzNy	FALSE
JRIsUèùbgóVGRwHFibZjáIáUavs	FALSE
KgxZpVXoUXDVndKTiYkǒJòHYNgJ	FALSE
LpyóláuhKxèàcaodèOeShjFiéiO	FALSE
NBqDwUaMbNúòAjDúOèqaèǔkhTHǔ	FALSE
OWgBanANcfUSPiWWUjZèhdsHjXè	FALSE
PuóáZópóGLSgsébgáǒLsUxkMvii	FALSE
RAPcKKCRzMZpùxǒGQJvoWóvFOAM	FALSE
SWaaHcqhZěXrfXufpzGEPaWwKWx	FALSE
TaràwàGǎgèpCdNZódUMFoghTczL	FALSE
UvWySéúòNújJfwWVvoDzrǔOuvkl	FALSE
WEàvùsNcXjzckttLéqKblrBQAóG	FALSE
XhxápóuúuààsxrdDáZhxgòBkvbL	FALSE
YzlsLoHòOòoriàYapaètdXDèQúi	FALSE
aEuáábnóTVeRóepjcòxěóoRMwjh	FALSE
bZRsTlAwRTIaAǒrWsèwóhdùǎéef	FALSE
ciScéWjrgDUVóèjEǎZPNwaxàáúC	FALSE
dfZIpgkBIrànfgTěWQXSàOQzúYù	FALSE
fǒrBgàDhéěqIHBGMHHGǔYòVejeF	FALSE
gFSIùwZòSAàjslùoHǒjmúUvOHLǎ	FALSE
hbIYuOdóQěUxLPxbjfLIémlRhbǎ	FALSE
izáJqPqBqǎèóUióǎùcNNCaGBàCk	FALSE
kAheLKjaYwKnZZúNoWpFnghxéfk	FALSE
lOzRuèpPFmXkBéTǒFvóMMǎZbùùN	FALSE
mZKYMWhjXEzKNCùjydSbyǒrZgaL	FALSE
oědáLvòOXùLdòmufPqbFWaòZcny	FALSE
payTyZzóóXKKarvZsVrxzfhjSǒá	FALSE
rǔhzjiqOCrrHQZpBǒhJyráTryxC	FALSE
sGcpWnǔBFhoSveKǒUVyTùeNabxT	FALSE
tLVVoGcóLǎKzqlHDRbuLǎěXdxKC	FALSE
ubàOnzvYJZěéTTeYǎUǎFQěboqgi	FALSE
wěeYǔLEGYQgfèsǎAmBkǒVeHǎlmJ	FALSE
xTzkOKràLAmazpClqFùǔóOcúbMO	FALSE
ynNkpZnAAUowltwtánDBXfSwqTS	FALSE
ùùjJFéVǒCYNsiXauǔagkaégPkdqě	TRUE
ǔYwzUVóowtnáOgúQaaBDnRpWBapF	TRUE
àápavZǔaěJǒùaMkùGǒYóúaUOjkkS	TRUE
ǎFǎáúéaLǒaàZadycènLFèùkUMnTA	TRUE
érlZjUáòtzWVúktiZjjZuǒaCaLha	TRUE
ěDVrtéraǒVvXEMNuéaaWcSgbJDqv	TRUE
óZrEAǒShDaWvDaGGSǎXabáxěVzuU	TRUE
ònèǒWěBClDxLVamaaQYUgTTǔpWǎM	TRUE
úǔaaoGEězaNácoteOVYOItUBKóBy	TRUE
ATúuFěǒRaàQPEèèhsYlJǒataztyy	TRUE
BaVNFBEKXSuWHàFZYhaAFAaUIWKt	TRUE
CsIOMaNuùaèoZakSvJeNáYeòóùEǔ	TRUE
EBǔywywsóòǒPwòTǔXDǔOFWtCaaap	TRUE
FZOLjVQhóěèǔUhZaTVaPIòAXaSGè	TRUE
GtqCǎaǎRCMJLkwaáljNXěaAJZVúg	TRUE
ILOòHěàaSàVQMùTaZZáaIajoDuun	TRUE
JjPKgzaúéUaòqTiTUéèaálNǎjésà	TRUE
KwYoaGaúBǎwǎpLòrBKBmWagxVYEù	TRUE
MHáéǎóFMOJwFǔàUgǒaěWlmaLhTad	TRUE
NaaOòamàUàwOETAHáGúYbHvhctab	TRUE
PúuaONaaySdWsPòJSǒjáOáwjaIMZ	TRUE
QWnGjmHkgaIWùaiyòPBǔělHvTajé	TRUE
RqSazqoaèǔmrGaxHaDhDYKHǔLylS	TRUE
TCIOvǔZaéEQàqWUwaǒaǒZSyLMzpB	TRUE
UYBTBAayKáAFěITnGzùAxtaóiaRJ	TRUE
VqKkJěafǒaǒVaXLáuWznqaHkyFEO	TRUE
XBYairTPěvqBǒKsǎxOyXaikgaOmǒ	TRUE
YTJQaǎǎěIoLZKnEZZLqJWQSHaaWJ	TRUE
ZhxauSaaúRWcAybqeZkěHwvOHyhw	TRUE
aòèsàQyvEavaaAsMèKVwaWòlASLS	TRUE
aFrXanyqOmilMVwTauèèqǒCndCǒq	TRUE
aQXnaPǎVVoúAvěWGwpOaiúewlRoo	TRUE
aZéèOèWWèuóBKhǔYpqúaNlavHùwH	TRUE
aaxTǎKaUeiWòNYcuUǒqLǎGPMkǒMó	TRUE
aoùFáFQQHóyaUQǒFPwaImJvPCpWP	TRUE
awvlQvnDaaPGóúZBpHbbNXfaàeYó	TRUE
gvgYDXZyawWalOúǎVarzKúézóiùJ	TRUE
iFtpPàKivISipěaltMwǔaòvOnrBa	TRUE
jSTèvIaeaojzTǔaQkJaEAóYiùǒpu	TRUE
lùQǔòBPEwaaBuwiAJbUaWVNaǎùIY	TRUE
maThZPajYóNFgOgGlNilUmEERHWa	TRUE
oúKazǔuIaóFRCNtxláètutùSuaeG	TRUE
pGěkqaEěrMyTMàrǒOFNWLaukalFh	TRUE
qaqwmnwEsaXOuáNUiéuRiBarZtéǒ	TRUE
sǔTJiBiǎSPlaéROǒuBoaYOUaOLYv	TRUE
tLKhiǔǎòěFaahéPFèmaIǔhbPmTvò	TRUE
uilWáTWPàaoaIròJanxěpUjoúPmC	TRUE
wUaUzNvuiOuWSóVaówRkkTUahLùV	TRUE
xnZWzóaigùZZeúlaZazaéàPlsjfd	TRUE
ysNǎILaBikDgaAXOqJáhěhMlYraT	TRUE
ùùèófǒoNéEqGdqKbyGúǒbpAxáKGC	FALSE
ǔHéBpgLGěOIgIYBWjWJGQJmmgyjX	FALSE
áZfxBCáxADJqnǎcCQRLMqárvLnǒH	FALSE
àoùàèyrVJoIMDndTqPcUqWácsEEd	FALSE
éǒTtAULTǎkěIyvákuGSWKLǒěDdoj	FALSE
èQùYcgqGagaSKKFqlBcgcEoIZéǔT	FALSE
ěYyèǔxRúxWUpHòEUPJóLMSdHtèXG	FALSE
órHèCOyqrěOihQěBBǎDEtrXUoPKr	FALSE
ǒFHláhnjsUǒǎSHHyciúúóUQKgAmG	FALSE
úcfYEǒrBhYxmMWcfksrQEèrnbion	FALSE
AzxuhǔENVAcqǔnAPòmdOǎzóOkbmp	FALSE
CéYbneztfDuWeJoòySClógDjemSY	FALSE
DLezǔrGBǎPéuahtsjuZKWTbwdVMè	FALSE
EYIGùqreSòàzeCúpZAHVèimEěLKg	FALSE
FvBQktvQCwElvóúRpHǎurBncOzèn	FALSE
HGrEzǎWǒOákáúDdWAájOnéyxZeàù	FALSE
IXAMòáOCWRuHBéZOQszFlějěKHǎh	FALSE
JháqFQcTdVrTSfsCPsQIǒldNáPXl	FALSE
KmaécQèòqlYWfAáAAúoáfZaMǔhǔǔ	FALSE
MòLQgHǎǎByFJòéǔùGOGZáyRWětùi	FALSE
NCzGRfsEihPpUOǔVrUxMQàeǎruyv	FALSE
OYORlXhgqiGGvUGuUdxNPǔqopáRr	FALSE
PwDyuXgtgQǔgtKwgrgTeIwyYGWxa	FALSE
RèSeiDDwuLziéJWQHhNCgUJfmfǔG	FALSE
SSéYéYJOOèLFZàZzéúNDUiǔIgQùo	FALSE
TmPǎPcwcVuóvBudjJIcuYGcMfQNM	FALSE
VDǔFaBJLCnúhaeeěsòkQvkkáDxBI	FALSE
WQiXJǒRUNlhdyiDSěpbohúRYfEAg	FALSE
XcòsLWáèmVGKfHOWsvaOdHOdòpnS	FALSE
YkbǔycnRfKToSLSuRǔlrěpàùWlFp	FALSE
aěùbóIqtěaǒUòVbáǔZUsPAGxǒòhR	FALSE
bBzǔhoKQCYFùěCIZHXeUUǒèlòlsG	FALSE
cYloàTXǔMDúoXeǎiNITpàIcMwcǎq	FALSE
dqǔMRpeDQwnqIqbQqCmFtTǎàCNsu	FALSE
fBRMaàuèiYHàoSlenWVPBwàǎxMOé	FALSE
gPQvJIWqDFvúiiDèKTàiRdzeBoěN	FALSE
htPǎǎYldormDóAǎvtǎMǔěǔRúEqxó	FALSE
jDTéjxéWúkxecwicvfSlqXètCtKS	FALSE
kQgwgxèǔǒSEPxGGmraiCIVvUNpLé	FALSE
lgypbDgúòóKKEDVǎYiěVYJěIZála	FALSE
nòxmkàJBOtEATyLòUòCgbFddǒZtX	FALSE
oXEǒCǒòzmoiwǔáJZwpOáCbàNFóyo	FALSE
pjóFaSfjóǎPPHvdjóěHǎEPIáéXSn	FALSE
ràWoWMwIQJyPODBplKǔOLHvPgUáà	FALSE
sDnQHQECtòVùrBkExZwxàapdcTǎJ	FALSE
tHuěMmRésEKUúcOSxfKhùàrhLtFù	FALSE
ukdiVWyZǔNúMtawiUPnsHLLuReBJ	FALSE
wàzDkTǔfZòFnIěZYlèCBxAWPMXCn	FALSE
xRáèàǔUZpòjúvSFNNàplHèckPolG	FALSE
yjivmúǔùǔHgWèElJǎlIWlIBaVOyQ	FALSE
ùùLǒgPFAmLáOvQNEqyáǔyWzSaaauo	TRUE
ǔAHaHEVLalàòáaJOéXǒáCàKUGrZcǎ	TRUE
áraFIlKsùaaběcybǒAFRFdòǒDZJVǒ	TRUE
ǎIPUaqQqTóNEDprPYsBqiawZqǎaMe	TRUE
égMaXaUlGiULZRwMUNWKCaBfoshgx	TRUE
ěùPDXGyLěRrOpQaaIuwXváarAIetC	TRUE
óRWPayzHaMLHPatIyrWHrgWEXVtIú	TRUE
ǒǔuǔawrTqǎCAasmSBUIúFhaxwwǎBu	TRUE
úBsaǒSùwaMzYTYHMDévhWZwKmCBia	TRUE
AaokRiSLjǎòJmtsèRXCnCrVáěaakI	TRUE
CǒWlaǔCqarSuPIqaémTTjúPvifǎjR	TRUE
DYèǎqsOMOlvlCaKJHuòatsNAaPWǒA	TRUE
EoǎrǎXDpǎǎKaaNqXXgnacgěǎěbgěú	TRUE
GǔAxòRagJvJNhyǔXaòyáZhSǒGyǔaǎ	TRUE
HAEtgùJtáqpaKyóLmaǔaDNqesZoka	TRUE
IYéiwBaahBròwǒZAYtaWHSmYnFTqà	TRUE
JwFnOovSzmJaLomIzǎénǎazǔGpéLa	TRUE
LHaDoFoòaYwoaRòAfFxcnyBúMOuMO	TRUE
MUpLaWTaěrjánǎEwUOěEúwaEfúOIf	TRUE
NrHAmQóaKVaùqZHSOéakEYzyNDXěA	TRUE
PZkzBHhOǔhIQǔNJóJhMHaJYERapaw	TRUE
RèàqqaoSěwáYtNMwEiNaǎmaTDoǒDà	TRUE
SEèààaaaXEHFbDgVǒLpùZaUèIsánò	TRUE
TLaúXRóYHEMòVaiaòǔsǎMWdrǎtùxg	TRUE
UUolgtVIùòǔTjwsaóáanFMùqěaFDO	TRUE
VlDjaKHMIUSMóWaàěICFTaBkóXjWǒ	TRUE
XùTaKrjhpǒaaèsPjvéúfTdsèsEFEn	TRUE
YUJXUvLǔaérèmoLFanSDǎhLCNaygb	TRUE
ZiaYTaDcNúézUaLyMóǔYIOJDqǔafl	TRUE
aěǔnrBqGAaùklawMǎUnEUKpdjǒOpb	TRUE
aDgjYáOikFkmPàLIáHaDEqaXEuMYY	TRUE
aNzNèirBjwzJjaXumaOuàZOLjNhóP	TRUE
aYULxAHùaaCkémyFyàGIùzdrgpáòC	TRUE
aamǒótWiǔsmTLYPèkIéúalDIǔOaPb	TRUE
amOwáYWWkVUaiQaMIěòmúFǔPnxRIA	TRUE
awQEsòzIèDaaOněaxZNYRZǒpbǎiTm	TRUE
gwoShVCaBHSFUBàǔDjOaáaaèápYAC	TRUE
iDZFuJXWaTZCsZRHSMakvàanZǔěsA	TRUE
jaéhGáaóqěuWzABQùakfEzARèhGús	TRUE
kyTwAOǔaisIáFěèBtoBsNIattazmE	TRUE
mWlòwáXaZtHKCaCuasáùUNfbNèCjD	TRUE
nqéFépryLǎPùqTEAèHaaIQIHTjGai	TRUE
pàòGaaáRYHùaLzWaIrSMǔóInqdXjE	TRUE
qPWapMioóaFnDMNRTùàhFaYèTSyZP	TRUE
rwUúlàZBDLaVǔǎéWsFankUóéjKjYa	TRUE
tBaLazaXqUóxiMpIPsCatscǎSPèBǎ	TRUE
uTsEyZhaxIyvòzwAaQxAvaǒèfLRěY	TRUE
wǒǔáwGhaazNalkoDNtuǒGǔKbqoYél	TRUE
xNràaoQaóOIajICPGPglLKaJEmlpó	TRUE
yaKNaarúWIFvUóóMǔeòljzPtǔěPaá	TRUE
ùùéIòáYǒúqQHIwomhMvGSfpéábUzs	FALSE
ǔúOpfztCXǎQzQáFěOlNyxóOòInqpn	FALSE
áRuWXjHPNNiàXkOuEwcBcztlJǒIyB	FALSE
àcYSedBbkúóXXHóufxPKoaQaǎGoǔw	FALSE
ǎlǔdCúyPrgBubbǎLǔZJogLKzNJTùs	FALSE
éqpVoSJTSDtxwuHǎEkqUribJWáZLS	FALSE
ěózhZDMàzqoáYonǎoaDxPóIFMJǔCr	FALSE
óMKpúSySZGddCáKAJjwómaLzYUupW	FALSE
òcóyMǒǎWuYYHúvdrUIúAEISùùSaòk	FALSE
ǒydzbIHàrǎTTawbòaeòkǒOZjMfùUW	FALSE
AúgèqBhèmippsnUaSqmIyúxFRXpBè	FALSE
BfáVqèYmMgedTtPòFiIShDKXXCúmò	FALSE
DàQèPúKonEKRPěhvfVSWGMJStCwBD	FALSE
EHzdvREmgWǔWwéainPSCcXDziCBRy	FALSE
FoGssǒcǔJqméNRAdUùJfvNdzěCùXd	FALSE
HDQWwHPLaJùNyzEáòSSsKRfAPrèmK	FALSE
IQsuqǒfngùùYǒrEgGPùqAèZNóFVAe	FALSE
JrAALúMoPvZHMHkUòEuMjdùppóJóò	FALSE
LúZBBSHruHuDzǎuJpókòPhzHQDùeB	FALSE
MIéZCWKáfùckOokPjKHTgvwòaákRǔ	FALSE
NncèiàEǒEzVQfvVKúAeXóLwxTsLWW	FALSE
PáQmxsdxádBNUTǒTaUdOmkáfonyOǒ	FALSE
QFhàSlFgaYojàèlnHfWòTYdǔmhAvú	FALSE
RVddnPSQxèmqzNǎjoědjrhNllZtèW	FALSE
SrZeYRiòWLkGǒSùMiZfkYOrPeùFSi	FALSE
UéGzwfohlCúàELHyéSóbWǔgwmUèkò	FALSE
VLFEBOATòdǔoAMUBjnNúKbOJMóvěJ	FALSE
WeuAAuCkoQxzEàJěhdjoYǔerèǔmib	FALSE
YBónòbYsóvOúOpbSydHgoxcUMrSlù	FALSE
ZSXkvxIvmCaéqDGWCòoáXXNěiFXlB	FALSE
aeuvGEvěáZBZpIkXCSIyuǔVnakbuj	FALSE
bqadIékGěvùdLoikmboasòěBǔEǒrǔ	FALSE
dǔmjlOnMpiYHbvòabWCGMǔsLèmhGB	FALSE
eIQseGěBdBjKfyZrLaGúMFfaSdlwj	FALSE
flcnòafJDZCtNǎbJǎzèEwbkFMZoWy	FALSE
hCaBZùdsqoèbsEzèscúUIětZyěTvt	FALSE
iKúIlWJòdsQSzXHNUchGlYDNyNxQǎ	FALSE
joWKvVJLpzLaaǒGRvnRǎdRTBGdtIN	FALSE
lǒhnǎyotrGGKtjvyXLmmJyqtCOmvb	FALSE
mPIOjGórgéuǔJRJxRmǔúhǒdunJfPe	FALSE
nfRmdgKhUhùóuinenIzOzmNnèáóěE	FALSE
otèUyIBOYTNxHěOJuzèIěóEiCùvxi	FALSE
pxávQàLùǔgHYlKúDàèWeXbsxCKxBV	FALSE
rIrKISswTOYQghpwYcIǔofNvAráéf	FALSE
salěZtLjsèeDynúeùsáCoFknsnYAH	FALSE
tkIáQIQscǒókeNǎNJiwjsòaruórUF	FALSE
vèWCǎóppQUwLnòrDYJVfVǔpeXéSXX	FALSE
wXBàdCVùgasubaékaDNNGòxěóJǒBò	FALSE
xkéfkwjBQDKYwéCvfDbPqmpOǒNumN	FALSE
yutxwwUzfscèQsTRLkbfBMNIlMxDn	FALSE
