ùéDsfǒàǒòEYyaěnlwwjqNJiQVtqbZYL	TRUE
áQMbIQnTkúěváwyYYvZScjfeNGNCaNě	TRUE
ǎmToeBòsǒjBUdKNThrgjCúǎXcNWEjTf	TRUE
ěDabkEPHzXOQjǒYáětYlmAùǒtRùuvùú	TRUE
òjgdqLmBdyqSZuNhèDǒCJGJxfemǒFèè	TRUE
úkuAoXSZZCMtwówěZQWADUImxǒJóòYǎ	TRUE
CawUUàWPTojzBQoǒgoeóIsZǎvqiufdk	TRUE
FéGFieióSCàgǎéVHwCCPPuObVovàmwD	TRUE
HEdlùyxèRGVLMàOěǔHnOJmǔQcAQpUBW	TRUE
JhdUiFbApǒCǒXSúZGTcIeLPURSStETc	TRUE
MWupùǎIPǔkpwGPeAǎaBùnYéiùUdIóyW	TRUE
OkfwrYJQókFDPGHFMAWàhGyBAMùEjdO	TRUE
RUbéépXZbPtéeHciádiBummphěupzáà	TRUE
UǔàMòglBifcKXrmJIfRǔdCxfneIiegf	TRUE
WciBdǒqOéjBrNǒóFotUKeóǎóYójMSéY	TRUE
ZěèRgopkQFQzDǔbRxMBcnsUǔǒbDlHVè	TRUE
booBgVbuqùYúhZweVHtNuRBmóúùuóòj	TRUE
eTegsBGǎǔAcòROpHRfXLKjmuFClǔFòd	TRUE
hLuàòSěòuBQxmVmNwVǒǒEammCádiUrC	TRUE
keéJJágxjbbBrGUGYfrPěmYUtUǎUxèc	TRUE
nLqòàRPlMBGjNBLeVǔXSKěbDjQHéHxk	TRUE
qCfCàYActRJCPròoúǒoEnvDǎaCWèCsp	TRUE
shǒFqǔaHEmPohǔědǒbóXPGGzOúNMOKh	TRUE
usJKNJUHRhbFSùáùLkaiǔbASTsráUxC	TRUE
xgMpuNWúódftLYóǔycqKlǎuǎMòkHRRL	TRUE
ùùǎpbaThOoSBbaóbjdHjévoǔkiùhqlb	FALSE
ábEyTòúCzQvasKbZéJqayBobhbáoxAy	FALSE
évFbfgraQQbiGZankráǔvPbgGNiěqIt	FALSE
óZNSiabaKáǔsVitúuQàXbANǎǒatIgbt	FALSE
úYATraFqWhuknwBhHbCVàǎlaěLbbIDK	FALSE
CóYsYIMjaFtWxqàbusQXaJLYúKbqQgG	FALSE
FéAǎoPóUFFqUAǒwUQeababCáywiwéǔN	FALSE
HraRmBJiUnNbLxiùaiXbnxǎMTGdkIǒr	FALSE
KaYùWRblOpBYqSOFQavSbXjYsCdUěpS	FALSE
NaGOèVtàEóaDXùwèbóyRBmogpavèIbv	FALSE
QTsèTéqIAeJNAdLLaIbàazDbrùCgTOS	FALSE
TèGvYtJJXObaabèDzzǒaigoǔLRFbrZJ	FALSE
WǒDòléamTMKtbEnòàNaYXZLàhATǎbiR	FALSE
YiásulserǔaBbaGxbǔZfbIpYHGNbdpù	FALSE
aCLVéáLybrgùVJDDaLǒóEbYBěmBláGT	FALSE
abaàǎirébéwysNgJQùDlnjóYxHěRltC	FALSE
bKEóAnlaoéwbKixBaqàYlyǒàěbàlàxP	FALSE
eicěèVUyRoòCyJRsazbrNáWáaJěZADb	FALSE
hPèXhvECGOǔoaěkFábVaOSUèǒKrbRué	FALSE
japGWèNMGJbǒhHBDWpaqúlEàwròǎFFb	FALSE
mitNcFfPJziaqlbJJKabUSXǒmuXmzǎM	FALSE
pèeauǔòNèòBnwGMnUóbaZuéóHgbKdnH	FALSE
riasǎbkUalvSbNSqUFRJdREdahàrVeC	FALSE
ukAsaǎonèbEarnHmTtbNúrqoěaPòdyh	FALSE
xaòǎUuJòAǒòbTèCuApLniqkaGruZibW	FALSE
ùǔgǎttYQMzǎiXFEáZOJxoúdfAnstèqáU	TRUE
áWROKFSxǒvomgroěěWzfǎCrsgòLnTcvQ	TRUE
éǒCòBhBaǔGWWpDJúCetIbwALfVǔhfnWà	TRUE
ěhnǔKyEyěNMqJWuNcnKVtofuryděFOěò	TRUE
ǒěXWùUèǒiWKPpHzLeàxbǒEGbxàSKòBHL	TRUE
ASgtwfXXLsTQhMStRXaAsDbEtiXéTNup	TRUE
DDoaéěǔieèwCXjndDwlsHTsèbkACoEZA	TRUE
FléeTMvSylxyóIIxuVgǔàaòJkGHǎdúǎz	TRUE
IFzPkTsUKLVdòVSdMéǎPjCROoKXòǔǔYu	TRUE
KjJGTSzTpéèQRlEǔkájYǒGRKúdáGòóSé	TRUE
NsokLxcXhèDhdzǒjzzúéYDFǔZmàHljǒǒ	TRUE
QbUaJdMóJěYEYAFVqLEULYbúaAdxbmJè	TRUE
SzwǒOjgmozVXPbǎENKbyhǎvǒyáJmóQóK	TRUE
VVèbHIVúáeehxOěhjFgCUeOàMRzTgNéU	TRUE
XihWièSMóòCúmXùVǎsBnAJoVqéZOPárǒ	TRUE
aIójcKpGrMzàxXymbQǎbjràǎSZyihceZ	TRUE
cOFJǔebOEúbeoFúFéúmjwiHlXwekqQǎf	TRUE
ekDàěóúwwZpǒlééRvwTunducLBhenKFk	TRUE
hùBeZiWWHòYnLèHNkoBmèDqjtAIzfǔQZ	TRUE
jVDmpnǔHpcYDSDFTǎKytJQúhQbùǎdǒBL	TRUE
limZǔRLòpuòsùxxfMǎNwiénLItZeHàOà	TRUE
oQǒáǒiòudvúhaǒOIyDNJǎrtNrǒzróJTO	TRUE
qvoTwIàCóBLàMVbTàèěǎèNmAXbtLUweé	TRUE
twBZWèfùQRvIèXlǔěǒYRěYUYvpmùyiEJ	TRUE
whZywBiXzBàNMbGJSPqAiúKyzzFZKhcz	TRUE
ùǔěúFzspúaúTFKěqEòéěbagkMZùFbdBě	FALSE
áaúéǎRqoǎuLbèZásòvgXDabbZKhsVlWW	FALSE
éKNDèAabààmaobviwǒFJPodnaxěorǔǎB	FALSE
óGycSZxMuUovaúXbvRLMaégPFIzbáieJ	FALSE
úéǎKsBRUǎùabmaAzvihirkSbǎǔǎIMtùB	FALSE
BeUmúaFGǔqbúLIxjxaáiVMǒijKQǒqzbi	FALSE
EKabqkptěFěHsàapLFONWúRYsAXběAEJ	FALSE
HXxgsLSpIVKgùhYpvuǎCgjryaoRmVbab	FALSE
JvǒImFHaǎhbkaéYZblRitRǎLcexPcrJO	FALSE
MujTtQúHTqóBassDnYVjsòULbhrapHPb	FALSE
QCaUDwBCbzPGaKWèòbáYJhSoáOCNYunA	FALSE
TěoNóyDyDtiTVaustbJaMCuúùbyZmRTe	FALSE
VcHZusǎuOFpaVjQIěkbaXNNHxuybGǒHk	FALSE
YǒaaHòuúěkèLFQǔgZbEWTCKaúLbiRpxy	FALSE
aǒhtyFCVpxybHCHajUbGòcVHjlTYmfgo	FALSE
abCVNVXgDrYxǒěèǔtYGǎBJxEnBFòaGbá	FALSE
bTtmjúěmhPàFéèòrpHvabrǒhèòkaOtCb	FALSE
eaqxbKPBsàUzxèǒRúlCévaáMDòǎjUbMr	FALSE
gbùEXnMEdèAHcYFieóàoèGaěBbhǔaMùb	FALSE
jlPkBQsfaEbSóvpsěnaWMbúliSYúǎONQ	FALSE
múPòaSyvtYpbiěùVVaybHZWěTFǔlLybo	FALSE
pDkJééiaklPrxxEGǒjCbBSǒZaGbOTehz	FALSE
rcùaybaJòjjéJBOàzKǒrbDjrrnáVLauT	FALSE
uaǒhIùtDFAlHJtUbǎǎalbéxzǒFAErTtY	FALSE
xACaRUnstbDChěaQCqIáwWǔKRACEboPú	FALSE
ùùYtTàóxědxiTLúělpfrJvHkcTǔSùXAěK	TRUE
áMKuoYqDuugéGKUnhSNHeleZaǒyWOsvDQ	TRUE
éǒaàVǔúFmvUoGBOBWNDPóndFǎQRǒZěsCR	TRUE
ěqǒèNòkTWGOKzVIéǒDKxáuJQvzDáfynEM	TRUE
ǒNùKYjǎèRicUBEHBeǒLǔSDǒqODoǔcRlǎT	TRUE
BǔvǎjXFixzwLYFǔlLsHlTbwrHjGztǔóev	TRUE
DbYcOQwbQKhjiaUbzrwMXWruFzxdAzEjy	TRUE
GMwpèpPajFKUtvTVZutkvseútoSJDNSóJ	TRUE
IvúyLKxQwkymrzrYFfdVAúbZVèrNJpáyj	TRUE
LNQLCmmXQeFsSKmóAQvIùwTmlàXWhOjàO	TRUE
OóAoLúrHVmáěQQhtTZtǔcVRHLòtáiTnua	TRUE
QiáǔVqǔGAjYJLòěQkMwǔWuGǔHèvùhnvwU	TRUE
TǒrKDQcxóóybAsyviHSbiOǒWItcéXàSmY	TRUE
VqPBlCSQVTLeǒEfwnhúhcLVúWdúnNljék	TRUE
YǒfùIcrxEblYgJPgwAwKzTYSshBmZùIùU	TRUE
aLVKoàwcNJsěwTùsdicYHxkfchbVlRyQB	TRUE
dǔRQMOrHqOCluwéǎéěleZZgAǎvsodDEZD	TRUE
fSǎǎCXkzlhKRjmSǒKóóòkFòEQPǒwéaKuM	TRUE
hOAeyeǎnKAsQeZqDcHápǔěrcótBkXobcm	TRUE
kǎdoUǎfdǔCJcMrKMdpxǒOmnǎhàCyXodDV	TRUE
moácélghCtRTxòTǔLAbIùEQéSQuKXxǎVb	TRUE
pXǒJcQfóěVqǒěEaRrPgwǎóěGzUKZvhFCC	TRUE
sèdVGèNóGkvuHěygBzùěWYEHhOǎNEěǔmf	TRUE
uYǎYVIWgǎLPBCǔmáTYVLUǒzZǎédPAUieY	TRUE
xKGKsěWèHjkmudèùSzQOHZgkgDèOútzmT	TRUE
ùàlCuZamzKNzYRnVěérlbapFétǔybnúAL	FALSE
áUOagPóòjWbCCáiMyaéXùVuYnpDVǔIjAb	FALSE
éMmUǎVdiaNTEbQPěrISaMbsgDrCWqUqCw	FALSE
óZáWgYOèěxúvoarXTpbsNMjsòHaXUEpèb	FALSE
úbuslROóǔtQaTUSTLLrxbaqRmpǒEtuRbz	FALSE
CawúbàoGGipóEPùaKEváwyMòbmpJJGQwT	FALSE
FcXwASǒAgRowǔeěbNabjéaLTbóFjTnjèn	FALSE
IéSVaspXèbǎcQfkosahWPébaxxFlYthVb	FALSE
KokVmdgLPahòbaMOgMNǒGbQsbtděqkǎǒp	FALSE
NaEóbEWWPgkNwáEěàáHVpsNYQoqtahbDé	FALSE
QǒZRhcaéwhbàawzǎYGǒrBhSqCAbPxzADz	FALSE
TDaAwFoaPéGbjvGrKKnóabBIlZúRFǒòrF	FALSE
WúqySqCiTǎboHHòěaRkǒbGRùnXsalSCbT	FALSE
ZěqTStǎtMrèěHaǔGěmzqFmbaJWáCMtkób	FALSE
aGOPbújaúRèǔyNszbveYǔOtxǒCwwXbGáu	FALSE
abqWLiBzjùHavàSADǒbtSBǔóMxeagcqNG	FALSE
boDàfaMSuubRaHDèjbgóúúERcYeweXVQZ	FALSE
fèǔIFoéaùbXhaGúábMAòOiùóáeyZjKáPF	FALSE
hHtBiWórhaòòMgHzsHbaúIwkběùJyQRkz	FALSE
jabǔmasJóKáiXGéCòRTjYbsǒjnéWèputX	FALSE
mwaRRPIJJsgubúaxJhbfèGùèǎWenǔuKsà	FALSE
paJvpIuJLèPkyDtpMwóuLAbKYmjqXCnab	FALSE
sFqauIRàJMbGrssNtzzèyazPtóEZǎbùfB	FALSE
vǎLAPOmHórabazjbǔaFsALwxǒRiěiNFHǔ	FALSE
xWyZavlsvLAgèBQDDqIgRbmQoéaSUòHOb	FALSE
ùǔGDOóQYèGvòeJfYteuMvéuhǒItticDChC	TRUE
áfaǎywWOGZrQBCyttóghSTwáxumXIAaUFw	TRUE
éàIRavQobwPciǔcUOtHZOVtvǎsndéUhàqo	TRUE
ěAMPVSéJǔáǔùOOWTSIǒCuEPNAWDàaBAxBc	TRUE
òpěèNòúQQlófǎTvKufoúehècáeGwpggfǒL	TRUE
AlQNXUDHèwmQTéQCLQhnúbUYěGjEyKóǒVn	TRUE
DMUjwwùiokFcYùmNtogWshxuéSQèǒlwǎjo	TRUE
FrkQéTLvǒIYTvYwwLnSǔjěBòalAǔmYFRRm	TRUE
IErKHMLàUVùǒèKEúfuQpmncKděSóOUrǒus	TRUE
KaǎZdLbXSleVCUYǎkuwPxAXhGSǎpVhǒǒAě	TRUE
NMQtPvwDVóěrFEǒDOdsSxoàXdǎCzyqǒQGg	TRUE
PgázfǒòecZòFIFèěòJfKnkVfgyéJwsOoAO	TRUE
SptSGèbWiEěKAtaRweAfYBHNQIXHTKklWW	TRUE
VcbcfàkVphnSkUzCSKqUgStrShAmhTYpèU	TRUE
YCXyǎTbǒEgTayGaOCDEàYtúExdǒqǒIJzZW	TRUE
azhóúmèqzCPkFgVVtEjùHCéDúMoèfSJRUU	TRUE
dhctDlAàbǎYAhgójxALgijhltYMǎǎoFyǎV	TRUE
gVDfFEPzZòrSKRVèUsUCXùIjkkkBBsxòxG	TRUE
iwyIHgpǎdDQósAàdkJyLbYLǔFùtiMěFQJà	TRUE
lYòNWCDòWàFcpqCgiihMUAteMlSěbkúgèy	TRUE
nvúyZlZApfslefqVàYJMǔhUǔAměǒEcKmKm	TRUE
qGNgUqáúRxXKóPeCSLbNqǒGwyzěxǔTàǔCL	TRUE
shybǎrǒgBvadzpǎWuùggěAQòjojáMXnQtr	TRUE
uyJUxmǎjóěrTyqyPhGmTóèDkXNnlxKBLeW	TRUE
xJěhéǎJqmtǔBCsAUkYNhtRèvvpcpXyǔǎfn	TRUE
ùùNóěaòqjàToùbvPJLCWaZrúwwDKóbsXàc	FALSE
áIZxddabaǒjáHMbzeTǒòkrTjWaǒǔMXMsiQ	FALSE
éYPgaSLFéCRǒPIQǒábzàxPèaCkěIjoEbGs	FALSE
óNaHǔbsoaCùNZZbXǔKhMhěUQǔnDaYóàèar	FALSE
úJGrEPyJaéǎěYwiǔnLbzxZEXanònAiSPbH	FALSE
BozFǒàJqBybááWfmòzmPyCvabOXaWbkRQé	FALSE
EaNgěbúYuUùRmázNèYaBbQyéiOxitVtJug	FALSE
GlúQOaGmjúRhpúzXǔbaǒǔgyqPóFáybvniZ	FALSE
JOmjzaWǔYUBaQrOzGùXubaORyùknbáeYlb	FALSE
LqabMakbwùpolyuqWPFóojYxOlBBVkáújA	FALSE
OWHEZiLvdDEawtslDpWRBèúOLǔZbRaCMbU	FALSE
QuDwNLWàVoaMgESnLMtúQbaKkbcèxrusMt	FALSE
TiIvemǔútJisEFaógóhYjpbaóbjxsánhYZ	FALSE
WMIabZJzabmkBqtJnqpxǎfbtùfáONKǔxrC	FALSE
ZǎNUUcJalbJAvCaéAnEèinXbxYàCAXYIòQ	FALSE
aSJúábyhrTPaLWKFGIZQòVZSFǎòjCbbKTe	FALSE
atyWKbǒsarIbGhykiWiJmezQěQJèwXxoUé	FALSE
dIhúwVVZvabLvúWùěéAjzSóVHBaobáIpAá	FALSE
gǔcaoNPRaúòBSàNbuHQaVPábguǔzSSAXJǎ	FALSE
ibvkCCEéSazHKǎNImtqCNLbǔPFCYZXabfM	FALSE
lnNeSkèJuAMabFrvKǎaJMsKbyawǔèDdrSò	FALSE
oChOarSúopúaBJǔéěKwpzáoòbmiJaETàyb	FALSE
qyyyVDajvDbǔLkvàSEVJXFnzoIxabwwàùf	FALSE
uAgKyXBvóeǎKiQDbcRaèáDbàIàwaMxRlbB	FALSE
wxaPèArLColbAAěTaziEWDWMéboǒSuyóbù	FALSE
ùáYPyaMjPègFhǎswWěILyLOjNobIqúsěxvà	TRUE
áRáOEDimxèiěéáDnVRYàfNLuPàLtjèEDtTo	TRUE
éùohoSqáYpGkXlPtxeGkqáWgiCJMIzsoǔxè	TRUE
ěnMZXrLyYxUàgjěWSàBúYTàVtBZoUjlcbúz	TRUE
ǒsyQRGixpwIèZpdugJwóGTcxEnfFǔSLděCp	TRUE
BégCóòUBhXèBòAcGěmǒYlFcCfnPèxpaByèJ	TRUE
DYZijwHZXóZjQLàtAtEvvLǎMZǎZVtǎtvHLx	TRUE
FnLbǎSHSNèǔCxfDǔJKòKznclàJúXOsgosjv	TRUE
IúóiǎnZJNYhkfTjnměCFnèwyfCRòqEVAiXB	TRUE
KqEnSRGǔjGAHǎǔwwgHǒBloǎXvVMHQzZgTIà	TRUE
NugtadqnkZFNGyZnIJpwlrIeaèvyVfhUěou	TRUE
QYkLjOLéXrcoOMDkòAáXwúCnOéNEòǔWesbó	TRUE
SqToyvVazKwdrǒZmBwLóǒZCHkfjmóUáOwTr	TRUE
VóISNplvCqDCKàUzpKǒqidǎPQioRpbzMEge	TRUE
XkuùCxyGWǎhtěàǒéRhpReHttXWcJrǔjóeIg	TRUE
aSSilqPqVqayxQlyoéTMitQRtácolCGBRPo	TRUE
cxjVXMaǎehcUPsWRakùGCPmcHdǒgZEoHUZF	TRUE
fIWeAlúlEMfUsPkórǒGǒPàFhiOYwZpjéRvR	TRUE
iútǒavQhZHRDmfùùUaěkydzrWěghGèǒlǎsù	TRUE
klhàezZmXxiEJfóùfwQDnǎSSqsmóFSiXQJǔ	TRUE
nZyDǔktGssOwápLòmòúGZORllBXANqrPBàp	TRUE
qèǒětbòǒùěaxdqLSTgEpBcnNrdóDtkjhhTk	TRUE
sObkfUNéGHXGaùxpuàKWùcrSbkmǒùoMMzèt	TRUE
ujcóòǎdBbBqlQGsmOàwLfHGkbúVWuTXBóZU	TRUE
xAVcBòfXNvhqtHǒAǎúòěsXòBNvhooéKKǔBú	TRUE
ùáfYEaabaǒbNúDtGnYYsQlegFPèPzjCAcCL	FALSE
áaTbusmSahkiIěFbBǎiòóYinaěxObézecéw	FALSE
éYùtjCaTǔzEsXGOáupèNBVbgaùVèvNOǒòbé	FALSE
ódabójMarVtDèGQiǒbmmucQiWěóRlrNbfMó	FALSE
úèUrCCOUùPsòuFjzmjFmàabaIWbdyfiXtéG	FALSE
CèIbEYaSIbFaUùqbQeOsyúòeJgàBpBSoǎzU	FALSE
FànóaKboaébòxEoèǒBPHhVqeszIěZòsxamh	FALSE
HvFuWzVKdnnHúOaXnkxùxibTmaSXXábagGR	FALSE
LùghAMòxJPòkjabFFCuyoéòIaibóxHuFNam	FALSE
NToltkHUrasǎSUàbliǎLVqFaOGsbXèěèTlL	FALSE
QúaTrébǎkaRBPPUòébrǒTKwVáofésénLEúg	FALSE
TǒgèLuědifAaǒzzQvBjzbaYLbfxeLOdVnOX	FALSE
VuxSzaQǎYDFEùFVtDzJábCqazxEbhuuJhhé	FALSE
YDDéRoQtuàQTMYxaPóHPǔbqkaiBHbTelcéò	FALSE
aǒèbLUKawgNNbfYFDKjóòóChvnfEgSTJcli	FALSE
aZNQùbEGtTQòEJpèǎZèuAguǒaébdvákbyúJ	FALSE
bDXeabóqjgèSèARèùoǔuFvWPgǒáaYbùpsòL	FALSE
eéhVfwBóOBaybgxěUAaúZPóJAEJVRòuUBvb	FALSE
húLDmúsxCWbarWǔtBgNhMjYbVMWapbMóPěM	FALSE
jYAaRáBbMDjUFgěabRèOBOrSaMNrǔǒèbFoó	FALSE
lrRtJúyTútaLbnjáapBóiLSRLSbKuTpmNBj	FALSE
ooáKogWòěSòhqaǔmbPnTCajTbEúèèYNUzqE	FALSE
rfAaGǔQbaǒWIxóxVUòhékohFúWágòùjhbhJ	FALSE
uYúòNhfbWvdaLáqNxvóCoXbIaKbQkQJQwúE	FALSE
xBAWǎAVumzòeásMzRéazHCgjbNglaubFwLY	FALSE
ùùdXEòZOmzASmwMcpQEúZúyPRùKtMòALùRcv	TRUE
áOUxFCéOtURHOúCLàgPkRymHMGJSxaTSVZiV	TRUE
ǎqkWááYjèwSLaǔFSOǎgǎEUjéhJfBòèúyNúSh	TRUE
ěàAérgJQhrlUexqofòdNcZměBHéyBěXéqàxr	TRUE
òoòaiTGzmwnoCEdsǔúgàwèmǔhǒeWóXeYjZcK	TRUE
APOBlqekrAbnGEqěóOYkmAǔkSeǒǒOàsdIóot	TRUE
DěnkwézQúyNuOeEpBKMorBèVpdJEjtúrJówN	TRUE
FlHFDDOùǔFpYěBúùmudwWáDézǎùjèpNjELZE	TRUE
HvAOUynArxyàóělObǒlByájVnvaèèozúroxǒ	TRUE
KhoCpQéiǔqxNCtuQceZFhéqAMjjfLǔYOàgBà	TRUE
NǎTKBAIxěrgiPVDlNáǔuwJiwǒzThNUlDrrvB	TRUE
PXcúGǎhIrEúJVqTǎrvYèefǔptlFKUguWpmFw	TRUE
SàùEiXámèJLyGGuktwIYQepiAMBkBntPpUFù	TRUE
UmVKzanYjcǔDfoxsásuMDIncúTYhhepCǒZPP	TRUE
XZéfsdtúabhàMrsXpoBNPàhòèHmjsbwvNgov	TRUE
ZxGHǎiehARALáLCWkóetlIzMólVjéàYTMéTó	TRUE
casWèUCcóxTBSfTènróùpAWúvEáGrCkfYóGě	TRUE
fHhaágjMdmYCèǔXTUIlyywnuREúdòEwbCKúd	TRUE
hfèjJLXǒDGbvIEzEdjfiěǔgRqccTVGRFbhLG	TRUE
kJéédAcPWúVómKOmXawáEKqmvúOXEGGèZùón	TRUE
néEKYXVépFàFqǎSiwSèDVDxeyfWúaZàwvxsò	TRUE
qCfmkakMúEàkWǎcoùGòǒéàZejZWeáróLDhhó	TRUE
táVLEéáèqiWVpygHèGFmyéVFjhIjsaàkzúwl	TRUE
vVNkfJIVǒbjkrJpcYuàBAèBhóhumiWNěpRGL	TRUE
yǔDǔARTèOeuraAUPqZTVqZIRRiéjUAXAěsex	TRUE
ùǔUXXyvěUóiuaǒáGoBoEXKǔbGaikěbqgBùàǒ	FALSE
áWDahxtóIbtDlpaqǒsnbSoGZSBfàqábvLǔHW	FALSE
éǔdMCzùUháánaFwYàiTkNAAbVZnamQoHòDTb	FALSE
ěMcNOnfèhBBXQqlcVcEarEGFúlbàzkXqǎsab	FALSE
ǒLoaěEZéLWBvQCFiKwVAbFasibDLGǒùboorm	FALSE
BEèvPeDéqjaèkPvCjtáCaxxFJbáawbgEDXCt	FALSE
DqěkxgǔKYeTnwPXzaYbkèOéDGVLjaDiMNbqj	FALSE
GYUvaRbVóHasáǎSFtbYǒQLjMQcDpNTZsQjPj	FALSE
JblpúàQXlhKiàIǎWánlùqayGǒbǔaSPùzóbfC	FALSE
MvaPQBěVúHUúUxNbyHYxJLQǎvajúxMGHǔbHU	FALSE
PWòEJENOcKáàqaAMgUObhWaǒGyòbùiiiMBcp	FALSE
SepdAsaGRnbyisYéèJVCWtGSLòjambpKTkoC	FALSE
VóCóazDZbLAWXnPùèmnmVrBMtjDabxTáfpEq	FALSE
XněaèNvmCNYlkóSóLHěQHòbxuuěCèaǔCárbé	FALSE
aǎǒbtxIFěKBXTaùbégmnKǎsfèLqYcrlaǔǎhl	FALSE
aXmXPlNWTXbaxBUIǎYMBěbjàWòjQǎpéeArùW	FALSE
bCiIǎHinrVòBaPóySěǎěIEbVKTaXiowábYJé	FALSE
ddOyjEJFkhajRDùwùjóZFàJbDgaCQbSùZLUs	FALSE
giáEOwtRSaǔbkéùazkbàjMtPHààěǔATéàUYp	FALSE
jaNaàbmSlùAywahòǒvrEěHhMIJGboUgqITGe	FALSE
múhXòYSHhEùFFXsHaWolUóXsǎSybaEkRbbQǔ	FALSE
oxLzcěqiNsěyaǒiboǎIǔgyRmyKVaihvbúGPT	FALSE
reImóPaMPXIRRuěpsDǎPAúlbaqNǔPJyubuǒy	FALSE
utJbawbjMOàgaWKqéǎbsXHéúLLnéysàmélIS	FALSE
xOcǎǎBalèrRhAXQòAbTVnSUǒúHnaBjhGXpbù	FALSE
ùùgPxNHòSouvEhúPKqùáCóeyvjaéFfESǔEqzX	TRUE
ántpJRBWlmelugkwYáFlKsjPcRJRcyěaLàúhQ	TRUE
éAyluBKFlùDùIáIkFtókHúùóWWǔpyjùáhàcSZ	TRUE
ěiyYUmEfcGgasOvzTcNjhXǎTúséyDèSsNidmǔ	TRUE
ǒPěětufyWěPùGéòǎlCúSrbnǔjyTyDIénZrasa	TRUE
BǔRtBxúrWPeógùxQrjkóESJǔTrepeFǔǎHáùLh	TRUE
DYpiGJiZlATibáuoihFbsnUdWtBváHgoPaezV	TRUE
FqjNoàVrgmFèAALiBòBhMviNǒòvSIxFSeoàǎú	TRUE
IMNYMBèZnePxTUkDsvXózlsLéZOPEwQgCxmWA	TRUE
LěùOgBSpxèWeKJkǒrCoNfhBoEPofJdzWòoèFě	TRUE
NhMjǎùFEuǔMǎroéǎPGRNdNnBóSpfCpzKjoDzJ	TRUE
QDWMOǔòpéPWyBéuyyTkǒéYuLWRZivèaHddnzc	TRUE
SubLǔAyPquwKpùMǎmaWHCóóòóXóYuDNorkJhJ	TRUE
VedaWICiEaGWWWěóBbǒZLeqSNUBsWboyoéBDù	TRUE
XbGyEwóPwSqmKzVeǒǒBkSLnQitùymbòSGuǎcS	TRUE
ZrPllěUNJarbHPqBěAhjsqyòuRbRpnZéVZWUz	TRUE
cvppáúvHTtAmáSzdOùhkLIYTveQúCROdPepkǒ	TRUE
féKRgDLxNZHnFkXnVFAFzHètOfúùDpuiMxLGo	TRUE
hJGFRXZRDXUèKaéEfpNjbgjùRZwqPBTǎwègAE	TRUE
jkVLFNPRSkóCEáDfQCòLeUlzǒXnPlèZEcSjtú	TRUE
mJmǎzsYPèǔfFNMáFmwSpBěRǔZévBéǒhsVHAàf	TRUE
pBàxCjrwgtaǒdbYHDétXIjGVuTIkTuqzUfnCI	TRUE
rwstddjxMXéKtPěYUwSIrúǔqJMúòkzGIAuYéo	TRUE
uOFòuǔFmaǒntMypǔITPòvnpAéhNwriZJdèSGl	TRUE
xIJNěUùJdLMfùědEykrěWjDǎrtdàbNěowJHKG	TRUE
ùùGtJaàiPsribMěMKCaIótòbNVLBoIuGmmyFe	FALSE
ákQirèDbùWwNiaSVyjnFsbKtBVPNxMXIaWHhb	FALSE
éXǒvAOxYǔvaGáisóXouèHtbPMZQanbFkxfǒlà	FALSE
ěrǔqnTaniúGáXjPLtmAbǎPkaUMbóxkjfwhjkQ	FALSE
ǒMyluKTvaCrNRùhǔlbOoSGXFtJaěPmHhFGgUb	FALSE
AvoběRSJtóJZsDxLèabkNMěySvéaLòóYPùbjI	FALSE
DWDwaóúgàTSNqbqLktoCmauUùhgrbvcCáGedT	FALSE
FzěRpǔfGZgabaáSǔVǎZlHCUCmqSQSbunYmyEh	FALSE
IekǔòVEgaysǒFmvtOorbCǒOMòKIóabdTéòHmQ	FALSE
LWlQHxnLvFCDDLzpfWHaabùHrrgqLmSUaǎbyd	FALSE
OGǒNtaNllěehOiVáegZTHkmúofCaYzbaFàBbj	FALSE
QdrfFZáUDPzxjIòmTabjǒOajúémvbzJupKcbP	FALSE
TreqCNěGèMHRcnéděOǎqaǔbaBéUmkSbDnwnTZ	FALSE
WeěxcPbaYéèCǔéovbaéjDpALǒbYájFuqtáònY	FALSE
ZòLvtwálǒmǒnrGFanEǒJbJGaHvorhgAlLblvM	FALSE
aLWVuHHMéDJwwájXněymAyóbXOBDaúbàtIlKé	FALSE
apiGǎkkcUVieǎAawbHaésùGǔQJSbEXClùgNúe	FALSE
dùYěTùIioJFclasbǎVOWàxXWùkiylúaBiinbi	FALSE
fvYgéeUǒXNúEdáLǔǔQaGbsannybKEbEYGICFS	FALSE
imdsǔTèaAéQKqNVIbOMwuaFAlFqJQbNsnEKkO	FALSE
mCmUSrRqaWvCoúbaLPhwbnYóéOXjBNqezVwkK	FALSE
páMYDrTurMansTbOwaivqngBRbrCrxěxMTrět	FALSE
rwxisRvTGáVoRzIvKqZabMwzaNrMbGRǒǎapMǎ	FALSE
uXcZRóToKQTǔZǔaòòkPúǔPAUbvpaNùbHTntàE	FALSE
wylǔaoùYQbsVmrZaPsěGRbLPùMláZRUwPJfrK	FALSE
ùùǔjáúqLXmxMèàáqPCùHRXRxhYIèZoUYhWCTùò	TRUE
àébXrEkLIbCúOLuiIYǔejJPzjpiǎwDOTpXsVtǒ	TRUE
éxjAtRAVPtztLCjcQjhaaFqúǎVOǔuéUrOúCǎùj	TRUE
ósHAlccsKyGkSòzéáRdexáóUpujQUQAZǎěfwxM	TRUE
úěHáktQISoBxVFdyCgSotèvaǒNòJsgaFVIeUBè	TRUE
BwZsèuóOJXYSǔMèeCmùHIKVdeátùyAuoFIókGC	TRUE
FùòcdHJKěègtèúXàMqèbúBMJnpásébRvNwùKsá	TRUE
HMúvNáòGFxMǎáHbEhSáYGoffbXRltǒejnkavhg	TRUE
KAaPGAeeeJxQdLzRRèNCIdiOUótdYlǔcLbZDSǒ	TRUE
MdosibPnSlSXEFoBónvZbuNHLCéFeSjuCúDzLU	TRUE
PQPòdpRhDaCéjemúèJGkèicdèPfphbběgFǎgns	TRUE
RTmsdycofEsqoNáJgCFFwYziusJwhèjpéěSDzL	TRUE
UAóCXàùièRdLúcUnèièESUùTybóCQnEùYfElěN	TRUE
WihMevvcJoVepCǒOUcóhYqwkmYùcòhyviěRQlè	TRUE
ZLGZěycjTkOkwIEFrHùpMétéénrpúúNuDrkùDx	TRUE
baectKYàPfWoúúEtHgjorzVUóCóoslòóyENktr	TRUE
eǎǎVàgEKIěNTXirjRgFxxqdNXóáǒuzCpSdǎpsG	TRUE
gijBLVGpLemHǒhJPcycúITáXjFNTVúPěcHDmQf	TRUE
jRqkwJFlwbYngVxBǒYrèWTǎfDMnEQBYSSHZúUc	TRUE
lijGrQlXRfpǎIGPwdwǔIǒTkàwimSúUǒMhJǔǒtz	TRUE
oNxpmǒiiEAáoAhhBoetFrkVegKéǔbecTiYRAIt	TRUE
qaùhBWtòtèrNǔǔNuéXOuǒxZZAZRàógDTcébJéC	TRUE
ssANqoràlJJǒxfkeèNKFNTZoJǔNǎuiǎúCàUJaX	TRUE
vLlGóùQVWCPZàHhMUàǒKoǒTWCXnBsxEbEpdant	TRUE
xldǔjYPgeRMCCanòFjMfQkòǔHnéBEKMfPFwpaT	TRUE
ùùswfsgpOvaànOybaZěěéRbpbéQLJIúnorgàZó	FALSE
áraàOtǔuBSbqaQòUbpIDuZZbJáserRNùUgPwpd	FALSE
éJmDSOGJFuǒQéáBoBKxaàérhxbPGalpDbIyyFM	FALSE
óUIuZàmùóéJjaǒpOTyAqWMbaHnOkRQjQOnbRCǎ	FALSE
ǒqAcJéSPúǔJǒúaeèaibODjaOtbrXGYúIexpquy	FALSE
BtvzmkYKvJabJòtAèhjWCahVJybxXBHajteèhf	FALSE
FǔBVwJvěPYwòybeCSambgǔatCsXrFRmǎhokUbn	FALSE
HkeoQDAùaáùnhiàbqǒTAqAabUaUPGvCùyàǒpěé	FALSE
KMGOfǎkiuCGèúMsrpéupSRJUwKyqfǎzTabùZab	FALSE
NGKXáHxTjgncòpCájúsabTǔàqabZPLépǒuUIáJ	FALSE
PGdǔevzBhCuzQKpaǔběYQMǔiàEoOyMabpHfbrW	FALSE
SúèAoeajóEéuYbEaMXKCAjùCěDrURùMCàsXDèb	FALSE
VVXRyaUUbvǔMTyYhHTNRòmVYuHglèTSèaxMbuB	FALSE
YéòúgRASlpaMúBxbxiKkiMxOóOiaJzxlOòRkbC	FALSE
aBJajblpěYjwáZagébAǎJRěémmǒQòóuóDMwuéó	FALSE
abqMaèbhiJqùáUárhHDmyKqEgèxěúcjagěhaqP	FALSE
bYrBESDǔPNdXGaSAYRBTHáxBsǒbaáQlǎéWbǎca	FALSE
eDVèpècVagNHktvXUáàruézǒCèJbpWoaIbcùèá	FALSE
gtVSsFdPǒavóKTtYúǎhlLRbvVaoVubǔEnOPJFS	FALSE
jhPàèvkabGaGGbCjhrgKqzSxlXfǒPCSěezòáùǔ	FALSE
ménfVTNnbynmuaWmrbUsFTiZyatNSbeyǎntFJl	FALSE
pàwàVofǔóuaQězECjDwwbrǒúaJǔùQhnbptěhmà	FALSE
rhyabáAùEanZětHòPbǔaǎzzmdòUyIZǔéYtJOMà	FALSE
uJUJàOAVtbbDmuǒyaEbCIjUamǔIzlbǒpGèLéTJ	FALSE
wnjinUdZboéanbwaégZbuGcFǒéLjóaZéSZQLnm	FALSE
ùǔRyǎJLuNBYCvDtwWhXOZAuqshJǒdeqAQNYfUXU	TRUE
áTéLEzrleLběOóReěCfdHónHklěNBwNeóyoààxK	TRUE
éúóXjViǔěoaMiccVjEbrLaXtKZgVjǔhtǒQòrUoX	TRUE
ěGiùUWNuuWnUcPàxbxrǔàHězHnCuTPpvnwUawgT	TRUE
òZráúInupMùyluǒGǎDBYxYQujaerqǔijlLCWfYM	TRUE
APjuQrpqǎlncàwNNvFBhJrRuLéWoLǎIBZǎaǎBcà	TRUE
CUNDFmnJJuWcZsOòYAFEězupézwnAkfCLalAfLl	TRUE
EhIúKuQDTPtěfeFljApWtdJùWYcteúǎéyáDdlCy	TRUE
HèTHǎPǔòkèèUúqnvRyjmrokigMEAjZcYqBtgUjY	TRUE
JoLQónsEVóXFGXóiàqáwOXVxEVAbhXEsFInrNAl	TRUE
MdobKNMfguéJAǔwZpBtLeDvLèjùlAyKàcmIvVèS	TRUE
OzwdauzóHBwwǔrWOáóVhTLùSuóVoiAJjEXòEjwb	TRUE
SéázècáPǒiùCHòiWiùòáVcZUJXàLáoGyǔhúEoòl	TRUE
UBáOlUnMèYàOPRAòdswdgUWùàzwéMhHWSúUǒXóT	TRUE
WwHPORidIQXdaPmEWKQòHoeúóMYBèVzMwykvěoá	TRUE
ZQQczzqHnhZààǔófXKǔǒPdBSLMXxrrQhmkuOpWa	TRUE
cǒpohúvnuNSjjKǔydBMYwvMHáXPKNélàNknéAuA	TRUE
eUòGyeòyaNChnùEjknVsPGǔoQnCákmòèyLbfkYK	TRUE
hOKqvXJqukzYPbóXKǒeVUNWObjfóICJlIǎCyQHD	TRUE
kàkqJMǒBCǎAúSaeaadebEánòXǒùXHIHTPJQVoJv	TRUE
mjCvějbTIòXěukCtHWlAiONzǒǒzEzfgaèWDKMiN	TRUE
pekòjhoBqMlDPnmaǔPpqGjWcáyGáxQBAMiJRHbX	TRUE
sKZfHóuiZééDójúCmeiBDǎUJfJàXòFBHtúbǒrTM	TRUE
uzktlKlhěXnyTLNdúǔOftBtZjJrKVTéQXnliMGV	TRUE
xiAqoiǔIniccRiYANRcùeóeYúRWǒkWobérWMzùè	TRUE
ùùáSǔnXkGóXTaGpkǎaIxpǒESFéóblaòwkBbdjWn	FALSE
ádjDjfùǎàhVùwKsjNCMJaCèDUulúbPaùzbCFǒtl	FALSE
édtKsrsDpLchEJeúqLSdgZgtaYànóbabedEhYRW	FALSE
óRavopADéuFEApHqQgABLEPAbaòZSNutpEbTKǔó	FALSE
ǒWxUǒIurkrONwGèFaouBYuHqblankòmkxElógbq	FALSE
BUZódajaRúvóIááwNtZbǔàúòàǎàKpajtbòóúNèp	FALSE
DréYnóQaJNAbóòCxgaóòbVàKATMxltNczàhzòTp	FALSE
GeRěBabBQNRzoiaJkPqUpbFoOmVáMlsrBQGdyuh	FALSE
JUXBaTbahvKbùiSxYǎMkRcǎINRáFTPrmHàzyncS	FALSE
MJeoǔFněqtNaUYběaLOsFyRFéhbzEZBhNRFIJlO	FALSE
PEVànyPǎasOěYWùZǒǒILubabXLOufépSáBNkKga	FALSE
SúlLIèUXamojCtTSXSSVǒVTNYoXbMNagǎQbǒVyE	FALSE
UXTPúúyDZchěSnVOYSóaQúzlúáhXvFàóòbawDbT	FALSE
XJmYQqxRéóòǒiiBQtvabtéNpúSRpèTanúbHgòaD	FALSE
ZjàYěgvhnHǔAsaóUkUbFuuooshBaGbymKesóáòd	FALSE
aUIáqREwBqqQmtkTJZUBkRtCbgsWvSAòrtàúamb	FALSE
báPlOáSIéXtwuDYiNǒNǒOiaéMFěowbHaZáixbeP	FALSE
daubXaBùGpYsFUmbBDNSèBhKesQVYoFKoEPáUáà	FALSE
gWěyAaplmVQWòmHhgvbǒaǔbǎòǔXòǎòvǒòsohpBR	FALSE
jěclthtóyPOqáaYTNáZzbXWàVrparSsHmoKbòkà	FALSE
lssaúIbgxjǒQKaěPzóbsmjàVǎLDstYúóúYúATfO	FALSE
oSàpàrmǔòéjUàFvShYOehaBwOajòáSbrRXǔabQk	FALSE
rjctViàKleieQztQdXáHavbAvWTPaébCVSvyBCk	FALSE
ueěǒùahIDjXLbwPWKDLIMaNGMIMlzǔbiBúXiqbC	FALSE
xVtYaZbwYlsǎajLáéBtXGBbGùPZZwěmóòrxaKVF	FALSE
ùàǎóóZfǎLkiǒFLTeZcoǎlIRUaǒboòjěFàBVrdáEc	TRUE
áPsYóCVùSEWzBYKjqeèòNwtUǔfhyWZalfXǔNòáUo	TRUE
ǎpMLàǒtclCpKùTaBLZèdòxQbJnFpókqkYéUzěáaG	TRUE
ěVlLvAbéBXàGWHhkVnlúoYQmòzFáǔúùxbRcdǔZeH	TRUE
ǒFxXdJǔrSóxOmJvGHyrjhSTěCSaPtdbASDcMHocm	TRUE
AmwffVǒaDbehvdmXùáCNDEvàèóóclàiwDáùVtXcà	TRUE
DevXwUQoyiRtrGQǎtǒùRAIpwsEfIcpDùYàóZFTyj	TRUE
GèbúqóCnYtXúBGěVFEoXlJàJscBxèòótBQKóbRèb	TRUE
IWUtěùùmibBoZJbVixtWRGedǎewfUvZRRprItlHi	TRUE
KjmǒWSSěVnRjsAzǒXlqACMWbuoMǒXnvmInetkjvù	TRUE
NòòòybsKpqRěùòIZjúTldXNděKEarzúwǎyZspPǒn	TRUE
QàRIkǎóWùàLtZèzGvTcxǎwEYYNúRQfóǔUvěúucMp	TRUE
SmXékBrMòòSEpINFkumtǎuQSxppyulLMyWFǎtLlh	TRUE
VVehetéwOnǔvNóózóǔxaCmǔàéYISswhePAIrlOis	TRUE
YúyRávoBcZIǒPOhOAgáNòKRDuFQxéuúJgxrnXǒOá	TRUE
báúqnwòùMBXAyFhMyDkEfuèàASèqeàPZftcqVwcè	TRUE
drNnNXoúxuKdEYoSzTqrěqRRǒóSJVlbTmaYMPóCB	TRUE
fwKQasfkkshJwFmQjàaSuEQATxǒOěPùnwàCóBLuè	TRUE
icJcNGùxaqkùAsWFǎDOlfihTuǎkHLmaFgǒEblciR	TRUE
knpSFyEvéeCTVheKǎmBmAúSFvFàéqYXeùvèilVGò	TRUE
nYkǎfnRCEwfNjwuSrvlPlháqoUtSYBgRyvéXKhgp	TRUE
qSToMsTPǔjTQùEégMXOrIsyIYnǎúǔndYoyeeqoěd	TRUE
syěétrZTWaEaIZenfǒòZjǎgDDWǒUédQnDeapDfrù	TRUE
vXHLnKDYǔCxáhjpOzQXěǎǔRjbXmqAGIaojkpwkzJ	TRUE
xhSJPCyGJkcDnbJéezLidwtLNUAEcETáOèYRoePF	TRUE
ùǎoOǔcaboSksSxǔBǒséxaGzGbcBeGèǎlBrfdUhIQ	FALSE
áayéLáSqěVnXóézNyǒBJaklmbmaCuěěàbeujixmv	FALSE
éRumèfpsmLaYssèpbáALPmUaàbjEóGOHgKJmwùtY	FALSE
óEqAKLXgSàxWlLytoEMaCErúúhsbMagbZwZHlDaU	FALSE
ǒdKǎaQlBáàxéǒséXòAyjDWBwiZwóCNBbaSjébGRn	FALSE
BUWùVHhoZFdzQUgaiòBOwMhbAraMVúbòegóUiéRP	FALSE
DrpGLfběmBdqVTpóacufabaúǒéYgSuNzUryXúbqM	FALSE
GdDùRǒKbòoFěStshaUCTjbaKrǔělúbfǔozwjTlbé	FALSE
JalAbZjPHJaòóNHDVǒáúǔLáGnbBXTzqErATeqPnH	FALSE
MtsWFzwZfaějóHOMvjEbMaznFùUBWFivàbwKhZǔT	FALSE
QòakzYrBbmaHǎùXMmtxókévhDADépběéǔywYpěéW	FALSE
TákRRxqlBWrahPMxǔVoTǔěmOsbRaúEbmuyHBǎAgD	FALSE
VTXèejeJtfUnePHdmYRakObuaDBbffBòbgqǔhKBò	FALSE
YNtMaJlRbPOwǎǎúéHWWèvaAǎěébuzéRcCǎyQoniX	FALSE
aGrǎbkTVglFúCvǒúràZùHkǔJabúdkmtrMDcbcàòZ	FALSE
akiǔxVCKjVxTòWTǎsuVǔSAZqaXbwyVOijCxWzabě	FALSE
cQǎqSSoQnùyvtERFmmaiRBbaGǎxmáRoòHYxbiògà	FALSE
fRdDǎbYúòaǒěgnWbYYěléòZaIyDHxyěGbPBútAeL	FALSE
hqyavtbDYGwěMoTKUggzatǔǔpbRàéyLǒAMXKguNk	FALSE
kSSYivagkUrlǎAbNměùěRúNYIQFJkaplbrèANYǎè	FALSE
nCgtiàséoéúGSǔyaGjǎBSiubsaěwwxyBbynàTuVZ	FALSE
puáQNuGPqQàúrabnGGSpLTZaOèpEDvgbLndisThL	FALSE
sùpQěsPlèaQqxibVWoyZoáQAàǔQkùaXWUbnYKPHp	FALSE
unayROěǒbAsaBrpbZXpùgLUVǔbhpKbfóǔPpXcXHw	FALSE
xXabǒwvEǎOgǒTúJChMDǒjUHOáTlnzYamàòYMWblù	FALSE
ùǔTxhcpgIǎaaKdKYàovSàdVhGnfxéRǔóyeMELǒKCT	TRUE
áeomhtùPvxDkèPúpJXTYLBWǔqLyHTúFOùúǒkzUwgg	TRUE
éEVXYeúùFDrGwvlúěuTyjDsRYǎOzáJuúòMPVdEBxá	TRUE
ědkCTtǎLéǎWGbúǔfwjěoBeěeUáXdiBNvSNWLqZnYP	TRUE
ǒǎDpàuhsUvEfQáaózmHIrcOjEAǒcfqBnthèéǎéfùC	TRUE
AkduqzGYEgZSvCxBTOXDzhEgTFxSyshvSzuFLXTàC	TRUE
DhùBQDCeYqùoDNCdBBNYIIBaElXYúaáboyKYaXfHé	TRUE
GàAmLùmuupécdgNlCkbzvUAsxwKOrIěnPisdslIMZ	TRUE
IeTOVmǒQéYnónMIòoNdjkBlCLSVdǒǎáǎSmFòdàrqo	TRUE
LMsTpmVCǎaTSáZCzWzDrYIaPǒéúMfBMZZKòRuèeLX	TRUE
NuuyVrgMUeéIgdcEóBENpyGtZjáJQSoKQhQxdaVsn	TRUE
PmHrEnDJèUjPUǔWowǔyqDǒtLDfeǒóěmUùqokCǒpEz	TRUE
SMsàqálirWèpkhcdcCyfùbZDRtEBúúpDòěbúgEòwE	TRUE
UQècúotdrGBuQóRAxUaCróQnTKòóONòMgjhDAetér	TRUE
WdBDJbMYúDTǒsLSIhGWQáèBókvxOǔètCCQpFpùIFZ	TRUE
ZàxpjNoeKwuèbàRèèjúpIjYúOfoZóvFlfFàleTaéú	TRUE
bbMLwnéIóTWExYkUYKbtLZvznRLfYryLěYOyuARxX	TRUE
eGGlmúSqmuówKrǎKBáTRjgnǔsóHiRSBéXYsSòǎǎòm	TRUE
hIvwygòcúBùòDhAJELrEéxóohàmMYFyxuYXnjJúQg	TRUE
kérxCNyzcMJdtDnIKèZIZWUyYúáFosZwegUǒjǔkcN	TRUE
mWlVaJkǎRvdYOskYěMFQNYǒàèvPdwGHónsmZzGúSù	TRUE
póqgUVBǔèáQgKeáKRěRVpPVAáTGòvnpoSPSCKlYǔe	TRUE
sKgóTǒèpCCQKuQjYsaLòlGàviǔllXUquyBszDyxuP	TRUE
uwkQzOěcúlqJǎBqKcǒyQgUǒgǒfxbMnvQJnubpréǎù	TRUE
xOáepRErWkáòqnjAVJlLèNPWwQaXscǒMIZzoàFaId	TRUE
ùǔTKaPNuǎoěXEllPóopqYbǒOaTxFùbùCótXTémEoB	FALSE
áRsgláòcbrNdzHabTukihCúnBgUaYoxòoRbFbHuǎn	FALSE
éghùfavǒùǎbMèwulPayEQwSvSNKálOzbKXóyGdeDf	FALSE
óěIMfvùEUIVnaotYibUaAOZMIzVélUUubpàéJuóUv	FALSE
úèòUòKWVghWYDtDèiyóLǒXRFkaúǒBáǎbǎmVaQǎbLL	FALSE
BakWǒtùlòuúVBahZǎaRǎhbuLZéabngSèmpǔIrtòRc	FALSE
EoUcǔFáGěWbeJEGDZsùaSměHbáaTuQWtjiCmpbbOm	FALSE
HwFaNNCXtNwàqhLuVlUkBgPNpyjVòmybgWnWaCORb	FALSE
KZúSxǎlXpHóèùMwkǔèóWyMùúgaábaZpLCbǎUkóoǔj	FALSE
MsWǎoRUúotéTcqZaómbiaWbxKxèUnCZkèǒJTnWbhò	FALSE
PTlEyyPLaóǒOěéyiARǎUurNbióQàYhaFùBbdpOLèD	FALSE
RosǔRyǎdKBááWYěkmaùúoǎwbFNgWzlQaèZbUQéBld	FALSE
UaóMtèohhmJvSQAEZbRáDttaáàbxtzIXkoòTgiVan	FALSE
WaxbrúààiQOsósEauHFOQkRJbCFàbMúQáWRuúávjè	FALSE
ZáFtNDtkúějAaLQbaRnwtoQbQpKGUoùNJVRYxǎYSL	FALSE
aLYCuubKsLWZEUabkǒjriCtéGùóBnXàUǔPvljMjǔK	FALSE
arruVzúMwbnYǒjaèLFWnkbdkhNPAǔkPZGáHtLVégc	FALSE
cwwǎZVNLBcMvětèQCEnfACNjéǎmJyaPqúbLzǎáaBb	FALSE
géavxxbySopUAkDràjgaZUUUBàěáXǒbaOOOpyàNǔG	FALSE
jǒkEàùómrǎNRpaVFMòénbUXDèCQLaèbaégeǎYquaO	FALSE
mǒèLáabjLsajXDyùqxbfuWGtmCFòrěwHHIHMúVjvp	FALSE
oyKmmfnáDèaPbCaJàbUwyQRǔEtNKfOvbKǔóOǔTrúj	FALSE
rYfRQWcZaómMxbAoǎRzAuèagnubKmyóHggojLZzéS	FALSE
uNdvVjàcpàRnaXsNsPrAUZsZroZuBwbmyǎaběúuXd	FALSE
xIěFǒèTérwdWVXwPdjCòfaCǒùKOKbaOtKòWbdNzAd	FALSE
ùàLPEágmImcZadǎǔǒùibIgXCugbdZVpzIhuWysYZǎh	TRUE
áhGDVyúiFFUmztqúngrSkUéhFMFàǒqcNmàbVPědcúV	TRUE
éWwóǒmǔbwigxFAféPěfzeZeVaáBǒRBjòIéAsccáóqt	TRUE
óLèTyVBvècǒhCójodvKMxuogBcrGMkFdWúhEtbWòáS	TRUE
úDùnáxtCbdQQoǒǔHIGlUTWJwKgEmǎLǔGYJǎvVqZnAù	TRUE
BcBbPNyuSXBGXEǎFppBǒzRinYlLVILoHHlwVrSyJxv	TRUE
EáCWJòééFjouRBàJFBlVtfjLǔJRxErslbjCvMóótòk	TRUE
GpHPGéfdyǎCrNdjPGNuvròXàúNldúupdtduUwRtTIq	TRUE
JECIǔKàUckWNǒoóJYIfumhOcEúaQBùbdJuaGBúGxww	TRUE
LZGdgěrǎPBDPMzRqěxxJBVBvǔPtmljyiwěǒtRGFbwě	TRUE
NzVqRdilgLoXGvùǎéYnAxffùDUAuHvEEyóMǎùKqQah	TRUE
QmBJKItlIǎABéóěùTrShauuodcPYAdeBYjJǎWNwaeé	TRUE
SyxZaTtHèENèJáúTEětJmEvBbkzyEFOFVúǔMgfSJGh	TRUE
VLpogGQòPKxqéLqǔtWNòTToilDTRNFiXAkWNJǒbárb	TRUE
YáPLdèXJyFaǎrfFMZpdqǎKMouOuMǔoniBòWPkTHqpe	TRUE
aipvHFoeTsoOèfAàiWǒTUQvxEEzDWdEItZRpWSikWs	TRUE
dOòqXàCNoJmNǎNIOWAétUJpGxIZXǔéndácUěěMqLdh	TRUE
góalgǎǒxàCbGlCPyMxyJUAKUyTjArnkěqòRbVQěgún	TRUE
ifóhěfǒMprcóuàǒDúgEIhawSòHdáJbEFàBvZtǔVwWj	TRUE
lOcófNEplMteolsékovpJǒòéHymXyOnEPIfHctDsnW	TRUE
nqEbENòzAqǔóhFlǎAéeZòǎDIgWNéYúòYoGájUjpZER	TRUE
qGjbnǎpSBzlQòckiNǎǔXLCOVpKááèZjgFcIDoènfYh	TRUE
svDHGěqgzUToyDùoIMèkMnYtoalzOyLUnbIàpmvúlO	TRUE
vGháMóKúRfóeCJǔǎàMKNKujóFdsOlQrYLMBvJhRHla	TRUE
xedtRMNxGqDzqRfvTdúRZQGsaXmXjIPPnQYENFAKkN	TRUE
ùàùaVǎwCtFèéghmvnóVLAxClozáCgGǒbyUáRIYaMbg	FALSE
áqawgènàzsVupyIpbWaoQèQbgTéPúIDzwúósyASRòD	FALSE
éDamqFGXúogngNAúǔmFhàVésKbLHtaúèóYHbyfiúOf	FALSE
ěRiaběwyPNJWaúóGbǒUáZQnIKdDzcùeàǔWRnUGDéòR	FALSE
ǒSRrlYǔEDǒMùùCùWPNévTǒajèbnaǔlqbòéyǒsFuVrq	FALSE
BKGaoUugNRNEàpEbxkùOtHHOKWèXéuaYupZyCbUdfě	FALSE
DyEoRHOyDbSFHXǎaúybqCuòLSèaYǔFhbvdJTbTmnnp	FALSE
GaJěcGPóaUJaiVǒlxNbmxózpaǎAbKuèORWmowYdòhǎ	FALSE
JDIDúNvovòútWaàééNCèětYbǔQèsAáVaòùxuTbkdpJ	FALSE
LxǔBZxFagàbúVRZapǔǒyXrbaMoPAKwInUrNmfageNz	FALSE
OYǔnǔDvbwúFAhòUzaKZVbrjSyózRQPYTiEaUqbéwOH	FALSE
RYaPrwRiboLxPanǒěòWbhXhAyHAUsyPUeddǒgXBégF	FALSE
UYǔyqrDfEódLáAVabSQéěpàaWrblFCAhoéDWIQlIlJ	FALSE
XElSYbaèbǎVFGCáòlNDwaAGiJRvéǒbyPDIèúkIPkgS	FALSE
aùttBjEéSèèKTWGóYCAjTbSUCYoVěaojlbLàCnDSvs	FALSE
aZzwWRpbǒTùòXǒòuyaBxUzbfqùàKHùuxnKMsckáVrv	FALSE
bsHdaqJPIúGHǔnbènuYrBQoóAKPEgRjòMkDXRaybJj	FALSE
eavkzaǔKrPgvazbúJiVǔWmMPxUnuòXLpáNXaqtCbfE	FALSE
hgLsǒQmòqǎaàGsrIwbǎoJiDaéhhwWPbAKfàvBQqkWb	FALSE
kèpdsaòOóMfAzCKǎVǎqgajFzQwiNvbYabpLZcOrbáa	FALSE
nǔuSaGIěxhQlRVJBhměEbaMvàirééRbAMCKveDQssó	FALSE
pbǔHPAaóTbaTóbbJrOSXwsHwEǔBǒclèuOYxwMtyǒèǎ	FALSE
rqRocODémǎèVjPlAǔxBkVùByayWCabkoCnǎalMáòbm	FALSE
usAdVZfCrajbwOǔèxěaEhòSLPXěyéDěObBúyzSèigW	FALSE
xIresélaèóáAyqrǒbZaěTEónbfRKpLlcTqbJWntQRT	FALSE
ùǎhOjèLVvRXoaAnAnMikGàgùrsǒwóNvXPFJCaNEeifx	TRUE
ààòNkáKvQóMmJUmǔxZwùéàùIóFCóàWfTùdúǔáXoGNgz	TRUE
éezQKòNéèTJZXqéǎYùvfěMRZqESdòtBfGuvIObdOeèE	TRUE
óěDYluMRMèvǎópRfAuEmnkpqRmsǔyúSGqIzqfObJGrj	TRUE
ǒJnǎzziGeúaYǔNYqRBJjWèdEdxKiVyoVòZGǒlYúgIáě	TRUE
AiǎdHòLNqVóDYààLReQgMfětiYDeèWGùimGSVeygzbH	TRUE
DYdSfKǎCSWlLMmǔEcXúùqJViúǔKLGrQóRěKGǎáYàiVR	TRUE
GEǒFCtbǒxigsKLaáIfxlivqYRjcèúLsGNxàòHaéXrlé	TRUE
IqmùlcorRpyYTǔùOmhkùjdinRARwDRRDóěTbǎěKóFBq	TRUE
LSǔSnPrKdbHyshBPàuǒJFejiEwoséyyLyLdmùTwjzvc	TRUE
OOrBPpǎoXhSǔjXioUMJmùJKléháùDmǎftúijfHǎéChd	TRUE
RǎàfJǒdqdjKJúYuQlrrǔcayJúmzyhMKDBǒwúMQkMnuF	TRUE
TaùBLěBpòlVòwcmkBLjMZIaHóVYDèRMjSmuTúLLQSwd	TRUE
VjhjPwMtTsóIyELèHaNbGZyUTyHdkzAsiDIěGàRPlAq	TRUE
YQàhkúIyNQǒVáUrfrcfrsCHǒQQKásXxiJùOePLhyǔik	TRUE
avxLWiOZDǒeěMWpAjSàvǔHtěxgCJàPJurbèRBCásAǒe	TRUE
dRmqDXJhóáaJSiEKNBQKAǎPqTObàxZéIYstzécgFèRS	TRUE
fxǔéùOótmAgqvnáuòJeysIZWióolácUòNfLèdVCuǎǒi	TRUE
ifpaéIǎǎǒókCIXLfúMmqFYBWLybKlPácHXěǒTéqEwjM	TRUE
lǒùIósITWYYRIàtUALarèRóYArúJUZptmòpéDBhvOVQ	TRUE
ngvNUNZàsCqQQKndHvJsBéoNvEbGǔZRxòMWaUjRàJěn	TRUE
qZxCWèFHǎHodFúàefTFWxkKàlTJjùtmoMàWólǒJLofY	TRUE
snǒáKboyNUQLjpqkouosvQáNWXvpPWvqrIUMùHxmòET	TRUE
uocZObgWámYkzfYùKQWwHfǒèTònUàZUidFáKKtqfIsú	TRUE
xěmxXyzRItTlxǒěfDqnGǎbCdWdBwQWXUXLěkwáOùháR	TRUE
ùùHěmuxPathvzèbvLaábtOFfáǎNòzMAcRIMFZúúRhYJ	FALSE
áaIDEcTfkfifFCrXdqDéěabHxoakPùbfrěaCfJxàéwy	FALSE
ǎsǎǒùUovAyTetOaǎěFèjIbRiuLIOMKiabòháGǔIplZó	FALSE
ěabSěawXòbàéeěùhHǎěkèúéPPlobNyeHáZfWzBhASeW	FALSE
úáGVcǒGIjFCXaibKZtnǒRaDàjǎDjǎNJwZbGTIHáàyáP	FALSE
BoóAoDoawjakMRHmSsbxRóQgzkoáàsOzútxhklMWMab	FALSE
EnAVZàglaoXQKǎyúYěJGPápójbayBVDHNbcJǒTDQVco	FALSE
GyxǒCǎěódxàaòtPpEHékbFréǒOéèéLyaóCbàúopǒtsó	FALSE
JoOXaLqjTǔwzHmnHéAJǒnhNbósabRGtuùǒNQDǒFXqDG	FALSE
MaEXǎsVXjxbCóaulKxVhzwxhRàěUiùkáFbNúpaóxjrj	FALSE
PUaPbGéaYMTmJknibMYplwIJoAhGeRlwgcImthQqBWo	FALSE
SózǎDPlmWmPuaGibéǎAakóméSUUbBátgOOMGYBqsjEC	FALSE
VQpmqùyyIDIKabHskVòóaRkSEgjoOXèbXfmqGèFNDtà	FALSE
YBHfáòùáafcnǎPaVCbERiYDXǒaibǔùDyRéGnlJEGRáA	FALSE
aúLiěCǎFKEJUKVbMasbWúwómNTKfǎnbLSWwbvQuhgIs	FALSE
akàOTkòGkRWUbshWHJTEPùéTGShaǔǎǒZVGǔbCáBsmDù	FALSE
cnbIódzYdKkVIuLfPVOsahjUǒúbOaTbVRSgGGSěIěHH	FALSE
fCMaòEruQtAmaèIiQgbLaǎvLYYrFǎbùRépdaCwRVGEI	FALSE
hySnaùIiBqzVKPOxEOWáblyPzGLYaFùbvquCybááùAé	FALSE
kNúTtZImǎmyiǎYdaTvFaiTwHbWhEaDYGibpsTáNuIzg	FALSE
mxyajHèsěwWplopUKbaUoébNuGvpXMSDǎShJIJDqVǒu	FALSE
pTxIgvIVǎYDNǔabMtěUraDbziDKlóOKǔrbUaXQCyILt	FALSE
sEúGózaThwěùwDáǎwxǎbQǎWaqSwzUFbwAzRrAǎFEANg	FALSE
ummSaEZinWWZIvùWrbaBHǎǔxBMSPoújpjEèKiòùjLgb	FALSE
xXbSMeLabúùQAXzXěáIJBnàJDYzaNwvybAmKeǎcRLcZ	FALSE
ùáèqNTǎKqQSKDgAǔinJjoráUxgxxTǒùFuvyqmsCbPòfw	TRUE
áBqxèWYMvUyKBxwuJwEMDRlhcduLvPCkYknúfàǔffvFB	TRUE
ǎsòQgTyěizGauóùRǎMzěUQOBòOIzIZQHlIGóIVDLMoGǒ	TRUE
ěHoúwhnóiGXowejfúǒDǎvSoéSVǔesanYiIéYMKhzFVYó	TRUE
ǒǔESóuwéYRcRQWéRqěNDǒRébǒsqràFSOsuǎynèFòCKUd	TRUE
AmQRmHEZQFvJèHVElaSEhǒHyezòvùFayrěoUnCqxQKDǎ	TRUE
DZodCóóSQcSyFZúPBóěVxyXCǎXMmAjlaàeeègxSkàxym	TRUE
FwpMOvècaeònJNNIǔTkǒlIQéFsnglmúǎàUYóZWkwNYTé	TRUE
IElRRTùDgZèfGLuúddeGCYLHsYpcOKkLIGRmǒyJáaějB	TRUE
LévCziKhòTòǔOèJHǒrxvRzFàyTVJbTaiUIIxPZbXeòoM	TRUE
NcAnyzspTǔBAswzrFpZYHWLMrEhàǎěáwǔifjqDmaCùqX	TRUE
QFǔIZǒOYsMILOotááezyóQlDùěkkQhrayFiènàNPèAáE	TRUE
TùjZEómTMùǒàSavyǎvMtFHòCXuoeáCùzBkTBkjpxlLXb	TRUE
VSǎFéUaDeoàóGéPědaáYbdJxvtyǒrZITǔXIRXKIGyéNó	TRUE
XsIcNGUZzùVòpuúQWěǔEGIlIzciéZǔòXUuNIvJwCAlla	TRUE
aǒXǔpErLwXSyLwfyXkWrěIJaUfeiOVpjDúòǒsoyiwùqm	TRUE
cbFthreJpMYDděopáúètTbDOǒǎvóiwapDùǎjUkáYvQrP	TRUE
fèráqhúumcPpǎUCcioOLpLMPeRpTǒGUxiRfàXfpdEǎpǔ	TRUE
haNRUxfNóAOWhcJpùKùzKuYPHrjóéúZflKoDgJCmfěCU	TRUE
kóǎwDGcwVeǎDkěyrXěCěwhsmBsúQájoLkobúPOtàPùèv	TRUE
mDúvLggBěqsmKàQEkeoLfvtóěǎzBDZlNHKùKàBNUfUFD	TRUE
oWDdRǒǔlxYZTǔpúǔCùoóKykéǎYAbrWaDlzrùyùěHdZdě	TRUE
rúoAuSnfBMFnéXùgiùègcUèsOáéwvigZkbvtàgREsRjb	TRUE
tmaTHWDeXzOLxlrIeùěRròPǔhlǒúibuéúNèYǔVXeIIWC	TRUE
xáèPQQAeJSUCóǎgǎùssnNdnjwAzPTBCUCněKDOJzqTné	TRUE
ùùTǒXrkZěHúǒaGlbwGaAáùrnbibgěLIKNùYǒtIhúàFlú	FALSE
áQFFáTbAKBMZvknOXtágSúǔzeLúkfJèěèaDbaiTxtèPb	FALSE
éiùKúbxAsLLsbsaǔaEàWJlXbNSOEaRvbxHBByEWěUBés	FALSE
óéHRBùSqaTúbEúkKaNshbwZcObóqmBhUkxFàáIwPěGIǎ	FALSE
ǒKaMELbIItxaYbRfféIbNqLCLǎwcJmczXMyfaItǎCQcé	FALSE
AVaHnébGqJYòrRJěEUzzaYòǒábpbùJQPlOKáZmpǎmbaW	FALSE
DKqòuLBnSdFrùóHQtpsOOTúCtaǒaóbakbCKǒnooDygzt	FALSE
FjXDaiVMuWxJpbUaáéhIbóYóSDMěKǔnfrnNǒRtúměLzt	FALSE
IxéXszaVbmVMFhpaàETYbùIymEFozDPóèNtQACWOèǎKh	FALSE
LsSuwéHwOClZdMEFaòbgJVaXZiBbXnSugrJànLóEsFop	FALSE
OóYxǎOywvaKSAluhùáATICYsJrTjgwúFbLúaCèěGtSbN	FALSE
RàRJèmáazlòtNvmJKVùbavTěAmOmbtwofRzJàPpXěKIQ	FALSE
TelhabWCKáOiéaěJúVMFXrzVVRmQPAbCènBáKúǎúAXxB	FALSE
WLFtbtojézWPfTMáMlquhaGKvabóXtIVijabXdyQDeOB	FALSE
ZROěùumaJùnkecawILPbDPhkoáqBKabxnryCsgallYpw	FALSE
aVumRùIoègiWbanájòbǒLZCDxdXThúSxQZKqUpǒcǔàPk	FALSE
bfpfHGdxgrtèLrcByjxǎHLOZàENDhIVaǎsbUKaIgèúǔb	FALSE
ezGǒDeLaúvQQugNWpbabbibZPabDvǎaZYeHsòOUVrěFG	FALSE
hFǒálVKYhaZnàbnéaàNǒàzyFětQTHhǒAúLùpDQrbKCNe	FALSE
jyaàbakxrVpCLéiǔboIǎMùAèWpùvRrzpǔFbjuBmcSHVa	FALSE
mHǔehGuMHjKǔDaǒlkLyánbǒkaPGnCTgbùToXténTiWzh	FALSE
olgHgWlDoxpeIGuLùWNjMkúCsakZsájDààbAnxEǔapbc	FALSE
rTOWóiLumtàaZEGYcUeNaArǎmuDQkCbPalHlPjNlbiáǔ	FALSE
uayITIòlSEMZǎiéqmVWòǒNEóáápbzMaMgPIjJWyàlbGò	FALSE
xéjkxǒLtcPèabùLgOavókNibsHgxjARéùNùjqzzMzJlU	FALSE
ùárááRHOSmOèòébuólCúwzzegfkUěUàFGIwqLúJáVnUGn	TRUE
áRXYbdáhkOpááqsIoLYNAttZmòaBrEǎgYxMTqzWòxǎCjQ	TRUE
ééǎǒpCCéLǒQuyjéSùDdéòFEvkòXsIMkigXěfvòEèǒMCov	TRUE
ěcXqJtJpAHNvùgYééNǒOǔXpspuawVNBǎAaSiTzokzAjǒu	TRUE
ǒòxèrpQIBrfSóWqZcsOKǎùuàjHúèFlwpThqnJhTMllwěy	TRUE
BáoztéùétshFMOAcǔiKPtBsALSBfKuSutuXèZxDáPVYZY	TRUE
DfuKzàHjesvóUEaiDJxbAnphdYnEgaYběòQmUpWókGsvǒ	TRUE
GHxIWGRáANxRPyfbyéOGLOveǔFaCěféatùpsMcbGXekGk	TRUE
IhANtkEKàXyxzzbkcjWěWCdYděKhZBwěczzoááBúZkòCi	TRUE
LQóQwIséaàsRělátiójQFzáSsHngózWGeàGmùTótTFRLW	TRUE
NOUòdzàGpàónqYNDaEeuOlEGvjtKtéxcpFwUXDjǒhIaea	TRUE
QùdBhSěxaIètoinmoáxjAKCCYòWězúmùiOaLQhssIuoàs	TRUE
SMbQiTKǎpDXTzjiémAUoctoSUEèpYoFYrBWXLnmyQViéu	TRUE
VFUZǎJRCǎAěGniAnxJTéúOUEiLHzùNQBfoBRIVròTWJUù	TRUE
XUFzoLaUiwbBzcmjxtkYAóZLNGLPpKPWqyPNcAqEáMǒvq	TRUE
aèFúAuETkéQvupsqowgGnfJǔǒPgòGxhACHWWPDgvWwnDT	TRUE
ccèòtVXntGyjEáuǔLFwdúáFBǔUxaǎPjùǒkvgcqMkiETwD	TRUE
fùQnFfrVbwGgmkuYǎóbFMBèpéěNòVySqyǔàKEùveéòJrt	TRUE
hwàaSqZóSIèkwQWPeqIzdljǒZààfjěéòIzǔWMòXgúRhěó	TRUE
kQOxOZjúvufOMirVlDùKABsóédWmVTEYvǔùHuIakQDXǒO	TRUE
mnNlxOCòěqáǎTèvFTnJdPfnECJhixaYùbSǒPǔyxBóHKqù	TRUE
pLefǎeěqHWàqěrMěAAuTósQXxǔBCewYIǎfgěRecrPEjNn	TRUE
sPgJHátNmKfrǔZzWèòTXYeKUTHsǎewómIyZyyěǎNeOhHǔ	TRUE
vǔHmqewuúJǎWénějeythjNxnǒkFeqSPlVùbwVǒapóOTJc	TRUE
xFQsúòYTokàòLBWUbnòIòFrUrZéWTùněǎjrCǒlyyhViiP	TRUE
ùóúGIbJMRèuqXaoXeNMóóOwjàǎaǒbpOXazóGTbsRnZulV	FALSE
àéwgaYIbznRúGEuWawěMzèùIbpebqúyMVǒYCxVmokúdkp	FALSE
èarUVbòYqùaRěrTrtrkFxGéToTmCǒbuVòmTvGǒByèěVTs	FALSE
òěeiFáépSzéoǎUuRgnqTweóVbavINǒYùotBxqgbàWaǒbW	FALSE
úlcfGéjèáǎarCèxsbXaoVoVrbzǒyLEruUáùdVùlgǒCusl	FALSE
CcpNMvzanùjRhxwGtEáINJGjqWǎbXKatZBǒjDǒbyshéEp	FALSE
EuEUQMUyAfaIǔFrPbaKBiàǒgGUóEbmDPoAAoqhLmRStcT	FALSE
HaUksROáàǔèzqmqmlěWkcùEXaCbXàPqmUaèwsbzIWZgàH	FALSE
KCxéúLVBWióDRZibJXAzPZcAtáaDNMjbóaqbàNéětMloú	FALSE
MdKfhěbúaGsRNiMlèeWvmUuDSóCgSpòsaZLoRbauOZěbě	FALSE
PùfPZǒsuCLgéCdoaDimùGqNFpbuQoaàibdUGdTcznkcYs	FALSE
RRtOǒmvDdFiwTgzlvSaAUrVoùWbhahBálSFQFjQpFDbBc	FALSE
UPeeSUkrQěWéeaUOOzúTòbǎaàěqèKmnèmǎWEjEAGXábFS	FALSE
XǒpabnARInWAQjawqDZBZébPMàOduZárbLZKuúYqèJvgè	FALSE
ZotYárabPQByKtkaKZsIbUǒKlùUYaóNRǔzqDbuOǒùqáóM	FALSE
aWlAooAPiuǒMSMblaQKbòMáBAúèrcúuòtIRǔVeDfhHòǔG	FALSE
bhrabóhyWyùqakYHóqbasiUdbzFáàCábǔBHuEzUQIDětC	FALSE
ebéǔaUxbxBIInXróRaTLúHDAǎDéFhùRHEVsbuAFǔqàLǎE	FALSE
hDlàǔYaVbIUEXUzoaIMgéOǔùòbIZEBueHàdòRèéuTvstJ	FALSE
jrSxEMzěoDaHzQúOVbFwRěxsMùFUEabMòrdyLuhXKnJhe	FALSE
mpUQBdTQgwoShRBUAgǔQBAǒxóèIJaóbZKVaQEmxVXbrmF	FALSE
pzsPSlHQChStbwvpiwRuavwYèbaKgtěHúRǎyLtqóàSyAb	FALSE
saQbBLRXavSCZCrpNMPhHqCéáòǎbEǒoqnzkZCgDZrNCiL	FALSE
vùvòGáayfùhěaVòOnGèpoCǔbnǔaòSbèǎKxdoùzcXǎáwkT	FALSE
xRzóǒòǎǒpEmpVaéKRXQzFbaUvERNòblDEjZTlntYDgMVe	FALSE
ùǔyVowùroěfórěnCFsStkGYqMeXùxEěGuòZoAXrEUǔnéGz	TRUE
áZIpèúJKtrKHhBàrogsòPNfzGièNYAHéSGNXZyZHHKpfèY	TRUE
ǎkTěXúRLlùgLéeuèxFezWukGBZhdmVgIDitlPUuCǎǒHKěG	TRUE
ěTYdEaijSzBùEIJùóYEMxáELúDnòóDyěbějflCǔpgéǒéNH	TRUE
òhWyOOWkoLǎǒxNǔmVóCeEUPpWNNjlxVùbZQjGPXUxuYcpd	TRUE
AǎHoXxéCuYQgKOkMèKGwyyFpsmféSaZěóPMrěxòsrvTùQǎ	TRUE
CcYuòAUéeavEòxáPGNADrbcmtqèbTSCPMiHáKèOUSòědIc	TRUE
FiVClqràuiXyǎhywAJcQnePcóàClZPDsǎGèóojàGwqVáAé	TRUE
HvkpdyHiiTPgfpgVJhOcbGHnXXkǔábyoǔSgAoydévSùNIZ	TRUE
KKswkHUUmKAméóiCrdKhXGViniCěVaùGàqtóǎgnèQSúééò	TRUE
NěTqèQYSwàòvQéáMuMZsGěWSlEemóKIyQǔRRMjHùZwPùQw	TRUE
PTvjdMHójDPkWjMòRǎǎUiBZGMwwàGWsǔǔEJJbokcKPSIoi	TRUE
STliTPqXEJWGCàkakqQIltZPùvǒéodárRQǎehBFqtújpQà	TRUE
VHuévěIigPsfVédúòúnàCcBWbáMRPTgǎekcgBgǔgIǒnéáé	TRUE
XsLaéJsdidIxkǎIQnbSEimDDkDǒǒEbgJgHóoDeFVQwRǒvl	TRUE
aèéFrynVCóvwgXúbjúDkHǔàǎfnbNWióLADLFBdbaZqjPéP	TRUE
cHsǒbnfWmJǎbdjdBèNHMsǎimòhypafKzúúsqYDúgYFGBmǎ	TRUE
esmInQiǎfAZKtZNǔqèEQdrgkYVGPjcYRCHlxXXOxUfeUMB	TRUE
hdjLéEWnlrǒlaEBLpéKMVTcxúBtékGúmXItxgnRyrúòQǔi	TRUE
kAgVúlórvǒoazYsqjMǒKàhfFDnSóGXaMǎNhúuwREbàhqhy	TRUE
msjUUdóYjIcogsXáósfCUǔědvLCxawànCàYdǔEiHcxKsWL	TRUE
pkpPùjTHxǒzbPcèàAvsfcMOtVINòITVHJúBéùEIXMyǒǔAù	TRUE
rzLàkòtTERkPdKRdQguOnumXárdwǎěbcQWIàytDQkidCkR	TRUE
uuàeeiJlrxlfsgZPSUeQteBVgdjeGágáeQHyúédFéqrAsw	TRUE
xKdhbWCocVǎRěěUhèXǎpFUnòNfgHXQkbùǔVmssěeXEPqUv	TRUE
ùǎycanjFRCCZObsaonpFoiùnSGbhtgeJKgGfǎFfZlTǔDIù	FALSE
àFXabDěèYUxkuLóémúCCDNéèiRaZLWtHózzàRbVǔgcVmnm	FALSE
élùrzóbaFxrbRSéJLěùrVLWWWǎOùXMyYěabqàáHNEóPIVó	FALSE
óFoRùaèQGlikBymkǎhxVBWHtDnkMGhgwplbksyayǒPbJPa	FALSE
úǔkúndmáyǒvZaúyOTQǔiéúDtùǔMàbǎzarrHbXKsKrlgeǒL	FALSE
BbBOJTFAUaISoáUbatwwgXZuwpHQúpIèAWjgQbNGjPzXjn	FALSE
EDAXvlBkeAVIagaèkHsMQvUqòxPlbjysèàPabhgLihéMDQ	FALSE
GihóuuPdètJKQQFawqyǎbZrYòókvabóěGBvfòáqLYMtpúj	FALSE
JGnVǒoaǔbpEǎinóvyǔJàúókIauIlǔóbPdqàNyeúQSóxEwz	FALSE
LaGwòmGáuZUbáqwOaLéGbYOFGWkEGptdrěbcfZZWATRǎDò	FALSE
OUǔypogFeóBǔQroKBùZOaǔRPběàyuatJlòjbKjòàMtraòò	FALSE
RNYakVqúpHdéXNòAéPDhWhjtàaYéǎsITUbVMyCNabhàpáP	FALSE
TgFaXZbaékěboqldQcsSèJDqhDsúPèDmFjEDxEBwLPScRD	FALSE
WiaMuòpkkrJòVxOPQàOgsvkéqEbuAlǔtóEǎUǔFjpmaPǔbu	FALSE
ZbOjqzmùabzMKAaHKObóbXémXvxRssóZùRǒTuFpndtYDGò	FALSE
aWbFQxrvWEYqTabSjWQFZǒKHpvmDéDqAbxgtdjykTfàǒGL	FALSE
bkwwhLebCǔkjètWǒWqOrabuaJTHybLáqVHywoeRzóIwzOA	FALSE
eYFLaǒImIbsnvǎWabàzéXbNnLànMOiàǔaTAcQǎfGqLQeeS	FALSE
héqOYsyǔzisgSmwXtNGKEBBOZáGLRkaVCOvbxXpjCXGjab	FALSE
joxqsnHuGHCZJhjEècfǎkGAzRVaěQbaěXúbkXNIáòsMóOf	FALSE
mSizùablàKzàwYEaMZMèprlòigùbESnUxoAVfLKIrzlKjA	FALSE
pSWvRǒaMbimUoiVoygZoaRèUǎǔùHbRrpjóhpQKFjqUèoYi	FALSE
rhjGqfjóaNSSYOSǎFRIgOpIPiSGnbVǎaǎéxbctùLvPTjTl	FALSE
uFaxXóDSLtbAZJmUùZDěaòBsóuxàBibagbGqmCàXCEbynX	FALSE
xáqndpóSPxNPKXòdCaOHùúǔuGSKǔǎqǒybBXgupoBaóVòbU	FALSE
ùǔQtbtúáAǒDOyDfúWàǔBHqrKSlèltǒǔéIgShXcZTbhjRcuw	TRUE
áXwjóESùQóYLNRJfBuàiuhVáǎKeǎIàǔèHDèmmenwSDuějDj	TRUE
éHaxWphlhEGhnoaigLhUWONóXuDTzaéèiZDtLEEvQòèADrv	TRUE
ěeQěcPCcTqěMYrYQǎipqKqyaBiEkOAkTZfXàPèZkUwhAGZM	TRUE
ǒfpJéZbáLBAǔwcCJzSǔUéoEsJfPfóvZNZlèxIBǔNEeòǒcàp	TRUE
BjYHoóPBRMdqFULyvIYJZbdùǔTLKkRqSAAúoéYdyRmRjQLQ	TRUE
EKYúbjWMuLúJfqCǒávkMFzqáGǔlAGtǎomJxXǒlúLúNWoyse	TRUE
GgúóCaErvxlLúdBPLBJkVDcFáJèóCiévZdKcQFmWmTmIbòè	TRUE
JNPRhEJàúNKOeDVlJǔCJělczěpGvóòsrdúsáeKǔyPSyějqg	TRUE
MǎiěVfgěToǔbEXOBUCRpábpùǔaHKPhadcLkvǎèsfévUdxòZ	TRUE
OLsMgCCrzYxèpuegFBBgrrǒvàoùgGGéBèGTrùéHyVkEKIUe	TRUE
RéfPòzvvhéAPfgoǎrJFCbyWeǎéáOgECxjcgyVngToAuVKDQ	TRUE
TJbóGPLqjǎSLJxlnFYDMSúúrSUqEelěFOOuBKtnsMTuDǒgY	TRUE
VqSbnSWióhùǒèOKsEQjjúGàAzJXdXOatczBkdejoXhRSPyt	TRUE
YKvOdáfIpFOolMtvzWǎYGǎfàdsEkrdMzgYcFdàJLàiyXDQp	TRUE
bòHPbDxZmazLVMLùVFuGYBoěHRUVEáávupěbPǒòFWěCcIgK	TRUE
dRzlnògXIónúMJDdgdsWxAZIǔhjàěAóèjGGgpoqàFJBnvAě	TRUE
gùJlRqáLDHQùjaQLèGwBOrOOaxéóěcaVIixNqrkdDltWárT	TRUE
iOFiǎyTlzDJǎǔbDFúěàǎàsǒXòyaGutnssWáEǎwsKatFgOtZ	TRUE
khwèwFwjwxgáDlfMwTWPxTOfóèǎfnXǒèykVvoSzvpRQhǒùE	TRUE
nHSSsǒJèUèdǎRGmgRǔrǔTáǔjRCwúLuaěěhoéfgKafFókYǔF	TRUE
pVKPvXNUUTJLòzDǒǎpCLEeǒrsúuBOfgjǎBBáyslZyòrlral	TRUE
sáPbtKEwǎǔfSOuEFxTyOmòSmdJfcPiTábEnIqàYfǔùzKevè	TRUE
véSDèǒTpwHǔZvócIAùjBUpuJBZczòXkHPtOdudHùRábxuùR	TRUE
xHrcéhbvqKoHASAǔvmòJCOjaRǔwcqzxuxWixqyǒGàyùNLXa	TRUE
ùǔVRhlkvMabUǎnqaWWpEPGsNǎsbCOIipCUhǎQvSgJQózWGt	FALSE
árZgùavǎǎyLBNQaOaésVZǎAFAbùqDBpTaRúkHwmVbmzLèOe	FALSE
édUVZGpZhòèYǔóYjúqbUZhEèànójeaiJàBCǒGUtějbQaEbn	FALSE
óFéQeǔFhRóQAfòPtgJyǒóyUèbfzKaùRPMcaèbǒéYagQòábz	FALSE
úèvNěAlùEmJOPdóòPOhWáFXJǎéIriuvabqáazèHáómúLbLA	FALSE
BqIAoIvZóiǎHtZsaToPbsKóéxYXOěBBwlhayIjùèRàIóbZó	FALSE
EfyLbXǎúdMnIùògaKgèǔàèbzùiYMèvgèxaùWbHHSyvNúYof	FALSE
HKaàMyDóaVCèYsGkúbaNbRRJZcGǔúúUuAcSLǔiYájLúWvYQ	FALSE
JzsxwDóaRtCRnvmbWòHBwyqOpaěbpcùěnǎgmjllěNvHòGRP	FALSE
MbèwaktábagxKxvZDòhbèyOcTVáuIgyWabaáecwUèfcDáPI	FALSE
OzMJpaiwnTPùbBQpuTsFwPuwgǎnaCyLHblùfZytVéǔGLcǎX	FALSE
RasUOYoWéǔěbBFélLaiEmóǒUvóubqáyúFóòqkólOjZkMOóB	FALSE
UVzuuùhPalbAtaRXvTgHArhálǎbménmǒokǎBJsdVBKVàòáW	FALSE
XòRKrISzǔàWUnabǔúaDVLkIǒMMwrzuLshZǎbdnIgGtnFNPa	FALSE
aǔWbúvqěCswoKTiénSwzOxióWabájvvúGdigdsèéppHLshr	FALSE
abQoaJKEbǎARtBuxVxXúzcMHAeHaWOVùxhVùzèóuKYrwTEY	FALSE
btjCPrVàèàmFbóXfajakbOgrJLnuaXSbNKJtWrDaóLNàUOv	FALSE
esèólNakkmbmDHXǎaIAiǔàYVSbSòáQárYapǔòsěZǎhjUPsA	FALSE
háiXenSpdRáaOǎǔazxlbhzWáǔBLèFPawESàvěAvBbvkXBǔA	FALSE
jZúhQIèwxkiòPwCAQúvJBhpLBHcTěàxàabyauwIúbDoiPQH	FALSE
mǒLúUǔtuGǎěyPagZMébiuuOSoǔésAztPBùapuIGHimsǒQtb	FALSE
oxBHúhFIYYNqbwàfesaJHAvRTbrùagòSPPyěpVbADJěCěaP	FALSE
rzéFSXǒErYLYaTDIǒàùrióǔZbIiǎUysaxCyBgǒéRZéògsǔb	FALSE
ujUèePCǔHLOSǒAqpéaǔZlybxtaPMòXbǎéQzUfEuFlǎCólóV	FALSE
xDiwveǎiabjǎlVrhépTZlxzRèazéibbVVGòHugAJMpTjPdò	FALSE
ùǔdmueQbRěMrǒXègBgEXfùkǔneUxzěIéCmmóhuQLbrFèmnèò	TRUE
áaYRDǔDDDsdcItBYscFkpanDULIFǎoǔuDKqúBǔkgonWèèùec	TRUE
ǎjTvUúvaRdWLHsphIeòáěKLEnjkmFxàlEqpóèYSMQlBIèǔHt	TRUE
ěBWVqoDofúPiocytèLéVóNcSIèbrálSRyrmjèHAwEjMBiHǔé	TRUE
òcrczálzWneJhaěfCVqBDJQǔyrVùiBCuèǔJeǎOzjúIiMSEBa	TRUE
AǎilamǒQUipCèsUúfCuǎUòBUbFFdYHBptǒǎDGANeàpxèfhIè	TRUE
CcHmiLOfiYbQJiiODáJWkPecGUIiFǒQcDxòUuWmBUySCbOěS	TRUE
FdnTIóMdaDxaQqpClěJǒncěěTyjDikmpùFhgZmxáǔWZZgóLi	TRUE
IòKèuygtTxàgZlWQvPPgruNgbfWtfVHěǔàhTjVOveyibòiJu	TRUE
KZcǎfRUwGSspǎGcGKèkIWǔNVaěkjpQùyWaFIUěNfOmBYZèǒJ	TRUE
NWHuěKTXyúZZHàJǔvOdkoywáěcKǔoXvOsyLHDúěYAtAFuǎtQ	TRUE
PyùbǒfmMBEiXSYMLxqǒwClLNHwczefrAeuFòcoDǎcSǎǔqǎwf	TRUE
SWòyúGòpYovemTriùoZrvKvPkùetǔfnzjHuVWxrdcYumivǔà	TRUE
VEékPmKsJzJFVZKSSLKtYYDRXoAISzciǔAmǎúhǒBièGlOúVc	TRUE
XppwèNPEWDikEgLLCèqJǒwTcqYtQxGùuǎTwxQzúZLvsKBBww	TRUE
aLXǒuMùUòùYeèòRMWàYnyNRàùěNzUeUCoiuJZKQěXùhFxàIl	TRUE
ciHZǒRàDDAvRqLKJRYcbHóhjGaOúHuDDAZáOmrciòGWyAseJ	TRUE
fuèANQhKpFpúTcMyVBuéLDxzvrjOfǔòqLoúMáùfòMPjpVEǎs	TRUE
iPStmèGPrOuělMòéfbgLéurǒlJoOHJSVWmZItmieUBCPxLǒè	TRUE
kpRUaBèǒzgzFDBbWTqYdIAsrEmrùièmENúvuMBRpmDdzhEǔf	TRUE
nPtiZCfCěúYmCěofǎHuúcCNRǎQdpòrbDRKèHYàWXùRàuKmnj	TRUE
pfxPxnúUTjOwHxwzǎFJyoóùgkuNYKIùUnnowNZUUizWslMáU	TRUE
sJDKúKěorgMǎGFjókèJzHLAéǔpPVOfPòyěrzRáěnIedWùanJ	TRUE
uTnvàYKǔéNzypSOéèěánOéXhDhDùWQeGGǔtOczriDáGpútju	TRUE
xǔfUnWéKùMàsVǎnNZgmNmkBVàQeYvèTxkyqgpWfQpTscMoòs	TRUE
ùǔafsUXPgthaVXgibHyHéoVKèDúRěúoYàSwPmúsǎatoòhkbF	FALSE
áěǒCYyFaBwMTRsěsKbùzRabhOàEMMxéáBTzzhmNCNbaLabaf	FALSE
ǎnJEBǒTúqZóVaHujElboumZLvùúFkjGagvbYuQǒěywUZóeRW	FALSE
ěgCESckaoùUHòGshHFiòbMGExavbSǔEbaógjgIWǎùNapvKZY	FALSE
ǒQáǔyòebhoOxzQBaKGǎExbhQQWVéDmPBáONǒawgóbHcCwhMu	FALSE
BùpEoógiFyaYBHWBHCbBqNéáUMNNáBnugǒIraANtǎopqbmrg	FALSE
DuǒSNéWǒnudǎioMnMqqZIǒpatszGbmyiFTavóQbSeFpmYOùá	FALSE
GyabáJhǒpDnyMqFHIVpaIYAjjzPBùpIbdǔzqǔuTfǒáǔpxvNV	FALSE
KèVǎzAjBcyěéabZMUǎLqaIwSùiByxèòhDspIúàQYǔLwmDbxE	FALSE
NùljwhalIuKMòSbǎiujaSùèTágUEUNxàéObIèFàdSRzèJěpǎ	FALSE
PTNúqNnJUaFnErbùKMCláiTuUPUTXMaěòqǒgIèmDBkbGWAjW	FALSE
SàQyàóPǔnvdWaovSZEGXWěòATEZFtèMAFGbaxǎIáóTtvGTbq	FALSE
UXqTaHhobouáEUǎsmBabǔAyyòěAgZéǎGgJráKDnPùgSAViúW	FALSE
XNEribZDDgcxúDUaNèKǎBáuXRPOǔUFYòbFZěwoQaMbóOVòrC	FALSE
ZspEvǎJtPAraEzwJlbvàLhTyóksyCvuaqúbdéòSiJEzyséhǔ	FALSE
abuěYZònELtGǒaVúbZhSùMdùnwǔinGcZěáKěqqVtFGǔJIMZY	FALSE
cGrpcóTaběǒOQrgméWòZIyQvaOPbEDbAUrǔUoǎKeIPéYcǔxU	FALSE
edàaqaókObèaMjǔpbliVvGùDqěAOvvINNKorpAáùryYǒcRFb	FALSE
hARvǎzSDpLózàúaǔkǔsbǎaàěXáhjěbFxEmpKvuTǎzDQoKjfb	FALSE
juDyǔjdUèfnajgbOkkǒyòMYjǎaiDébEIwkwǒpNNioMVABAéò	FALSE
mRòúflèaQKeázNvlLGCsùdkztIbTUablWagmljRbǒRfùLǎóH	FALSE
pǒǒTǔKúWaTQáOCqàHèybMaiDBNbexUùyWèùbiuMEFòtùZVqg	FALSE
rrdnàhWfáAájvAIDěǔvantǒbaoYBqbOGQKIòTXVaiaWfiGQu	FALSE
vèǔúèZQXAhGrPMeUEfkMJIvphababjódvUǔNǔTǔYvWVoRdtZ	FALSE
xEuǒwUCTqMyévPTRSqéqWvgPàCuShSéěGSmlaARbàmVrǎaJb	FALSE
ùùeěmǒgMgZenòcEyěúǒúéáJIeértGTHféNJxúmCUěléavjVBt	TRUE
áeyRnúsifpHPoKxrFmbRZCràzYǔěYPgǎǒèviGěGtdyJHàDGNú	TRUE
éóbdjIXSXFJtáOqpCuuzósFTdzageCRǒùmmǎoTEaXVOzTúUNW	TRUE
óúJBIBèyhykóbrǒgBFZoRnoIRPqUDurEQaMJpMkedAZùLyFět	TRUE
úàTyěIWùTVeqBqQPxnMwfFòǔEóoOǔOnbáYJigadTǎxbgJnwǒj	TRUE
BeIúěJCkhCzRyéKWúcdkéOpRjdDcPNmeqfěIADfěYéAwrxWùk	TRUE
EmUummúbcSeavaOvóEiwvUiSRDǔzeVcKEǒXònsBtDMaùfnLfb	TRUE
HDPùdwLJògJioqHéùWuòǔwxèJòbFùRaXPJùvaúWlǔYNWnDHǒX	TRUE
JvKZCèàeBújHNjEbédMaLUpóAmQQúùCJrnvLqtěNQirDzùYPS	TRUE
MRheǔmúèRǎFǒDyúVbamicSbZtHCcpkigUsQCǔdeoiQoWvótèX	TRUE
PLJYDxwYǔǒzòázdKxǎRbQhheBMBàTNqDěDtANBJdNédZirWoá	TRUE
RqròyTfdaUUàyxjlLǒFpòhèEéWrúǎàPklǔvúMábùlYtnxlnIY	TRUE
UAùvǒQiHóUyFènóVlbéTHNQmòNKpLWTGiWxiSZnbdfóMciVUú	TRUE
WhbtnyèwuJwMaozVNàvtǔRIfCòXTSsKeRKGiYPbJHaPMMQjHè	TRUE
YsmaxǔdrwgǒkFejYlóbgoUuNZnYòCgHkcuééCuvhǔDPFoGlbQ	TRUE
bRKCTOěětrhxClvàPFzkCLdHPéKIaXtSbbalNbrWǒFtYXqéyv	TRUE
dlsèPLzáNREYúeZKázQnpmlěAùǎléQVYQàlinaIxùěREJauǎl	TRUE
gJFǒáBmqUPmUdCNdLyNeúDcfbroqRPěbGséàvOoraJRnJFběá	TRUE
iNùOéWDDoGǎlǎXHéoiWaSiSehùOcGěòSqùOCǒvvDZCODPDvzH	TRUE
keYkgyrDMqXjzǎzǒWzzáRBǒikhVǒKǔDeRpUeéZbchIbqdoǒǔé	TRUE
mnEúVUOaàeéeeHlfFgègdxlBPrfYcADěwQUONdNxGUZvFVKòa	TRUE
pMQIIAoóxxTDfàòáéěCGóWzEfVgqpQvaUyokwBlEněTwMCnEà	TRUE
rXAmpúvòfjDmfwéwCzFBjutOcbjmAtQxnHóJúteòàfóDXBòqJ	TRUE
uEòAúCněgHlùWNkNoGpciQuèòWlBRHWsèTRòVMuWAmEGZiàRE	TRUE
xZdUYlàBuǒàRpàLkkHHpfaǎPHMǒFyfVǔonmúIPAqIacnzSzěc	TRUE
ùǔDcyǔbJhSOjnLUǒèUUjSFtqXmoDXètncaPjvVbkǎěnaTGPPb	FALSE
áxbJqviGZWHaxzWTktnvsàvOgKèCxVGIjbabmàǎAtèyOKyǎWò	FALSE
éMǒééHaěěǒbǔòlCáDmǒiFxusahVAksmsZECRsbUMTGYAsǒiTé	FALSE
óPàUDáatRǎǎépOQúIBbLoǔtéDathZbLiakCkmcLúooèlomáfi	FALSE
úènàkjNyODiXALIgWxFúWcNBhcBaoLbkGOaTqpLèCzbexVàPr	FALSE
BqRǎIaEǎduxmtTaùIwTánǔàZFSHBRGVGèSúwyúKsbSWǔaIhbX	FALSE
EaWlGPSàOOBàERzqyUyjFbǒàsptnLtaCpnObKǔvéǔTVTùQwél	FALSE
HǒěhNIǎqùdaóqHèaFDmiYriùAVwQttkǔEbTIuawOCbfRAWVwe	FALSE
KèNMiXióCvúFabYEyEjyaGmJùFúǎqééáuSNmHúǒàbrxEvOcTL	FALSE
MTéYàOuùòRXpZpkǒRIóbkHBxògMXrZOabEyáQiMAnaNbTPàHě	FALSE
PJZxKHZqùUACAsòeabxaJXPQòvgTbCROúATgUxAwPJIIjmpúà	FALSE
SàBǒěKtókGmPèWùaùpJvNMgtOùéRǎXbàatzivQRKXbdǎgBMǒj	FALSE
UHǎiIǔYxKaóbToTVsMZtHòsEYsTóknYaAVCbnYéUvòPkEèifp	FALSE
WcGéaRěbNCMwZVjQUVělILyajPkǒymGyETxULXGnòàxzbQbsa	FALSE
ZIFòZaQInymbKSSFXpěgAiZukqTǎaǎNLDUgàDLZEZTUǔKbKgS	FALSE
aZBStKpbaEPWNóúrZlókǎHSDAbéúwNDHǒùnclxcUnEJypCùId	FALSE
bfǒZrǎtEùhCoUǎKěyǎǎaHséúèeTWǎIcGaUxXJXHwNbayYPbeá	FALSE
eógdAqùPǎIgIóǒENěvQZBgǎwLávóApLFMěaPojùgyTbyabhBú	FALSE
gramAáěwqJjCòbLwnEàxabXbǒqycéXjáWyrygàzhóeòplúyeù	FALSE
jPClWuaPaěVǎNǎDKéHRǎbǎzDiWgRabbwgèFlǎWXeǎveǔǎMniX	FALSE
leHkrUDIWavLǎèSxbBziJabǒGsáwDlqétGivqúfNǒòhjǔsuòB	FALSE
pùzcSBUoGǔQcZdaVGVtzrsběnWxMònugAaǒtěVrǔrbgwOXcZQ	FALSE
rzZFYrUòasGWěvǎhěotLǒmrvvGtZbúMúzuLrèmAaHqbvUiGhè	FALSE
uoǎLQwóminsoFNVEyNEuZxQzúdarxbjaKiGpkqěObǎùDxvUvO	FALSE
xKvoFcóáDGojEuǎúenEDcfaLvKbaIbràùvXlúZeOVrXxDEpvK	FALSE
ùéPUlhóBzpdQàVoàWGUòàáUmódUCǒQRclPVéayiunúófSèSiRj	TRUE
áeVeVDhARodZhèchoLhvaQCyǔdhWzieDoulIxrCfIVWáIXkékz	TRUE
éUeethgXbpfIuhCeDsXěsIsógòěhdBǔqnxǔúrLgPlILKJsizèZ	TRUE
ěkóùAàrQRytVěóCEgkdKlèPwáoiásLùZúKPóXúlXěVTěgóSWFT	TRUE
ǒSxRhǎevZmùUunuBPzLUSSSóiAzgTKfyQpǔNRInBKènJoczTdj	TRUE
BEFqLǔrbWPxěLllsàZtagǔóPkJkGSóKgùEěQéuiJyhDRcMGjló	TRUE
DiBUWlXǒDNwYěSrlZWawSJOZTZxùàRWryǔhLLLxnJwzIsGYchX	TRUE
GòEǎfBwSWpKONáeScǒrpwZZlDqàeiAQmHYxhcGaótCoxvVZròw	TRUE
IYGěTlkǎlzàCeèXmùaDMeùpLnKYěǎJálKMěbHAVpEPZiLQkuaY	TRUE
KlúééPǎUènOKvyUCzúvANabXèszYABWoòJsbfCWboénLidùFèg	TRUE
MxrnPkěXtdnMQeúaVObkKkǎQoNuúGdhLvXáhiHCKiOvbǎtPEós	TRUE
PIeVǒIhéJDHdèPnmùVàwYcǔǎaEvCcXntàáǎhVuofòKbhXódabE	TRUE
RgúfWànLDTAèkTGsMUOCZJJFQRjeIDXeùUiXxufOEXVHùùxkQò	TRUE
USwKaèNbRNcúYZjLQzòCèòLFCPǔhRmǒqégUlzNáěGINTèIUéǔj	TRUE
WyoCFIàMuKqfùElòtMYBPóPzMFùiLIWKéZJrómakKsNXQIMnWA	TRUE
ZPPFpsùQwYmyQHigùcǔFIccqúǒNRuLwcGbPPcQSBómVxàaqéhn	TRUE
bluTfOQùcKCYElJmIěwhlwéPfRòmDHWpáuYTánfǒmduepZvBOy	TRUE
eJUAmzjKDRnuYuKWéWezěQoZhyqàXGmWLemBViLCsiXZQMúgáR	TRUE
hUYòjóxJNjxùjClodRXàjVǒxhHlPHnědUjsBòxKPlHkgMyWIiS	TRUE
jyúyiǔAipKBsKyáNWcèPvMáRoiVbPòzièǒGWqAxǔNQJXúnófuě	TRUE
mPXzǒIfúVǎnWpIúOGǒúalCèuSǔPOfzááJZGSBihséXuvéDúVHò	TRUE
ouPERǒběSXvzablkWiVTibRkngZǒFpNiYipoòǒleBMNùgReoiǒ	TRUE
rjSiXúèQHTzòIkFézrvbvToYKòwIUvècpHYGmhyZMéúasěDmxR	TRUE
ubXúZMOCozgusHGcxSYYpSLYGèéjikuǎScdPyWZǒòěsSjWpépH	TRUE
xǒKRskouèQzuábbGFzòySeúuhmSmáEóKóBqRSIVEYNyEAégQOǔ	TRUE
ùǔoJKZǒMEAEEDXvOàJùqBnHYarùjAbRHóRàLDLBaihprèRWbúJ	FALSE
áNAjBeiKnúuaNmǎGIpbmióxGǎGyéFSmAkáSòaáxbqóBòNccYMt	FALSE
éMUùbYjaMTùAuwRJòRóNbàáHKaZèùXDRFǒCbRjmRkgàóéájégL	FALSE
óMIzéǔaNbQùuáDúùaPtwmFZbKsNbDlonbUpěóXUYbriStěrtvù	FALSE
ǒgaèohmJámEbFSrLaqlmhNOJDúGéXáEàětàUBObygǔòpsèoVZs	FALSE
AuàfrTǔkGsAabrèXùgmEǎúhpXKóúǎoCWúUXIaYuáábIZfwBYpg	FALSE
DdóFTúFfǎlspHQxHaDHHqBbZOXEvakòIbtXáXctxOZǎlnlwOYR	FALSE
GLgcZuPGQQǎFagǔXGbhnGuàsnKzMBMYmhYùéFalONKMMvAIgbù	FALSE
IxòOěQAOrlzsleaxǔéWhpOǒFbUCěEhLlUùoshàryawéúáUZbùZ	FALSE
LeufYgabiZTlGJZTvFyGaMCpOhXSrIbǒádPòóLshCIEùúkéèǔW	FALSE
OQǔvahrXúRUXqCDyywbeXooěapCǔGmMZèPYkéNblaóqWuKbmFY	FALSE
RLWhqéULyéàáhegóUégdYcaòuCNóMgIǒúùUzgaZimǎùbRǔabNX	FALSE
TtonypěenJHkOVTabYǔoRmitSsvDèQsXgOJIMBoièiléabTKCm	FALSE
WJSfjvibaèMMqqibqiYClDZESBOaǒkbTóTaryMXKdJnKIfdóCC	FALSE
ZěYLùbéPxJálzěrzEgBnVyCgJaúZrǔvmbLWǔYmAaumKZbgizEè	FALSE
aXbùxaCbjLmzěxKzévolxCCdLDPèyhúGYKFGDcPalwBFtùFJDa	FALSE
cBMnqKIápHAjabSXXlèvKáiuQgǔgaVNrùYzbYdnSGúlxúvǎfOP	FALSE
emǔWóyPèInRgIúriioózVǔòteSelOLWabùkCOUabVǔgRqèùtQB	FALSE
hCahhPGòǎSEPGbHYiaWEèCbkKpleiéǒǔdǒFKFMOHdLMMóOTxJh	FALSE
kěSGHAsogòtbXAóhoaAIlHnèbxWaniILHnYxàúuàTbHàrCTǒtf	FALSE
mrXòMOWTaxIpAvwlbTMoaAIXYbIrRENJshhYònfàzoLdFwBQts	FALSE
pxAòMéUyawZvtsbTtKéEautsyIWUZkBBrbJjeBUǎYRzRǔwJlàq	FALSE
sèhapKnǔàamaówaUoPWijNzgvéybqapZJNbPùěnǔSájéUǔNOǎm	FALSE
ufIpGUuhVòsAtzsNúGaYùaKBzbaLbHaCbKPtQiOtAVDdWljrJH	FALSE
xómwaméRoHdVWBáùséwZhSǒLaCrzQCbHksCqaCàAOébáCbgiPó	FALSE
