ùàtOagǒaěOXXèppBakaxNabhwěpXZwA	TRUE
àJywxhaLBVWAUǎaxRějqaéNaàaCEèPA	TRUE
éaYǎaJJyWNEahaǔǒThéùqUKarùLFBve	TRUE
óQzaPzaùaǒaZTòGZOUECkérǎGoXěǔxa	TRUE
ǒyYZǔEmtuXsCaòǎaaaVǒaULunIzéKAt	TRUE
BawěsXěǎaiǎóatǔaSasNwgPqúvLǔwXx	TRUE
EKSuJJaéWmMYEAGùzXkJaFǔSòaWaaàH	TRUE
GsYaòYaaóROFauLaeBZGDSěQJǒnlrWD	TRUE
JjǒóxNIDzPaTqmúYkàvǒqDaPTBPaaay	TRUE
MRùZoaHZNYQaMTyUèAaIěWZvaLWúAaL	TRUE
PaoyéXOaUQPmXàhvàaǒqóaQrAzJavTO	TRUE
SiuAGaosBaTavZùBUaoSOòWpaOzéQjY	TRUE
ValCHùzxzgǔWàTanyhaúJmYqzztaWùa	TRUE
YaYwǔaùYsLLauaNEIBKáRNixaMlelòè	TRUE
aóqwCOXaáPWCuztrarxvgxaCyǎkCaff	TRUE
aOQDLSmSavxalpjmGBaLLóFCwǎtpatm	TRUE
aaKGaWsnTwxqnWaǒiRXiSzajTkDoěmá	TRUE
apaNǎBFwiLouaSmMYRgPaRaIynèxáǎD	TRUE
gpaaXǒnaàOiJRǒaEYúYtkavkèouRJtw	TRUE
jmKYoaIoImaiXùèpmUKhVzMraYamZaz	TRUE
mFúymGaAUKaNáINjSaàazXukEkòMnTa	TRUE
owmhùěgěXgaǔrtaCaaxaMúKèǎdEǔiIU	TRUE
razXawjwGaNFùòXGaqtPXòkYEJgIOòa	TRUE
ukaLaoasGùaNPrSiXtBóoNWROaphMtp	TRUE
xaDlEjùnSvUYaèLKzFAxYaailwgCnia	TRUE
ùàtOágǒaěOXXèppBakaxNabhwěpXZwA	FALSE
àJywxhaLBVWAUǎbaxRějqaéNaàaCEèPA	FALSE
éaYǎaJJyWNEahaǔǒThéùqUKDrùLFBve	FALSE
óQzaPzaùaǒòZTòGZOUECkérǎGoXěǔxa	FALSE
ǒyYZǔEmtuXsCoòǎaaaVǒaULunIzéKAt	FALSE
BawcěsXěǎaiǎóatǔaSasNwgPqúvLǔwXx	FALSE
EKSuJJaéWmMYEAGùzXkJaFǔSòaWòaàH	FALSE
GsYaòYaeóROFauLaeBZGDSěQJǒnlrWD	FALSE
JjǒóxNIDzPaTqmúYbkàvǒqDaPTBPaaay	FALSE
MRùZoaHZNYQBMTyUèAaIěWZvaLWúAaL	FALSE
PaoyéXOaUQPdXàhvàaǒqóaQrAzJavTO	FALSE
SiuAGaosBěTavZùBUaoSOòWpaOzéQjY	FALSE
ValCHùzxzgǔWàTanyhaúJmYqzztFWùa	FALSE
YXYwǔaùYsLLauaNEIBKáRNixaMlelòè	FALSE
aóqwCOXǎáPWCuztrarxvgxaCyǎkCaff	FALSE
aOQDLSmSavxalpjmGBaLLóFCwfǎtpatm	FALSE
aaKGaWsnTwxqnWAǒiRXiSzajTkDoěmá	FALSE
apaNǎBFwiLoujSmMYRgPaRaIynèxáǎD	FALSE
gpaaXǒnaàOiJRǒaEYúYtkrvkèouRJtw	FALSE
jmKYoaIoImdiXùèpmUKhVzMraYamZaz	FALSE
mFúymGaAUKMNáINjSaàazXukEkòMnTa	FALSE
owmhùěgěXgaǔrtXCaaxaMúKèǎdEǔiIU	FALSE
razXawjwGaNFùòXbGaqtPXòkYEJgIOòa	FALSE
ukaLaoasGùsNPrSiXtBóoNWROaphMtp	FALSE
xtDlEjùnSvUYaèLKzFAxYaailwgCnia	FALSE
ùǔaaaàQkaNjPaúVynàúSwnpnòllǔáQeC	TRUE
áǒPpsDTvaPàQxLMauwàawJavPLèySěǎa	TRUE
éanǔUOXWFCUgTaDaLoXaOiDAòMJaOTǔà	TRUE
óWBPpǔjYtzhOGzQOaCaaǔSXaaUJOhfSě	TRUE
úSJhQLIwauéEǒkáèaáataXùóaèrNzàib	TRUE
BwOYLnòFHGaGaaaafHǔWOùgcnáDTSqoN	TRUE
EmxarUYuqVaZaVCùRPkrènapyiadWjTù	TRUE
HwaròèoaèúGjàkyhàvCQaaàappnNUknU	TRUE
KmMPWaazSjaFOhBoòglDQúěIXgmjǔaOa	TRUE
NRézTITěáDaéAiaXzuáaOFsèaadiePAà	TRUE
QYáaòyjǎqaoaaAvkéExěFúGkaéYagYsq	TRUE
TMkaKaDHtTXàkataàCqHYǔNaRlVpFòSè	TRUE
VxàuǎùmaAXòǒyaBaFaéZuaymàEǔxXzST	TRUE
YpQaZJwHoMǔaCVYLxWiBéoyaoUaóaulǒ	TRUE
aòOKRaxhOXhCYETkRRRantMXCajǒùgaú	TRUE
aLàAaTUakmòòǎLsvnWykoLoaEvWDOsaè	TRUE
aYoaqkaòuázLQoZélYSFaóTùèKruJaTě	TRUE
akswaèàmaVUokkRaaerKěéUvǒàBùXLSd	TRUE
gIjJjAXaaDgxéBaFaNQRèěyavhTǒòvKě	TRUE
iyjyOòVayCMsaouGyaaauùAvwàpmDFcE	TRUE
mèjéLLǒnúPùpktWiěpKSLaáayaaYVèJa	TRUE
páAràròCuzhOaǔGPaVmúHJKahhiarDaX	TRUE
rpèJtpuàEáaaKKhNGataPiaúUqhùUFOp	TRUE
uSTaFaZsUIéBLǎaaǒzáaqdmvwzytWXCK	TRUE
xóFSaèáosaéHqaVáaqaigGúTQChdhXhy	TRUE
ùǔnaaàQkaNjPaúVynàúSwnpnòllǔáQeC	FALSE
áǒPpsDTvafPàQxLMauwàawJavPLèySěǎa	FALSE
éynǔUOXWFCUgTaDaLoXaOiDAòMJaOTǔà	FALSE
óWBPpǔjYtzhdOGzQOaCaaǔSXaaUJOhfSě	FALSE
úSJhQLIwauéEǒkáèaáataXùóǒèrNzàib	FALSE
BwOYLnòFHGaGaSaafHǔWOùgcnáDTSqoN	FALSE
EmxarUYuqVaZaVCùRPkrènLpyiadWjTù	FALSE
HcwaròèoaèúGjàkyhàvCQaaàappnNUknU	FALSE
KmMPWaabSjaFOhBoòglDQúěIXgmjǔaOa	FALSE
NRézTITěáDaéAiaXzuáaOfFsèaadiePAà	FALSE
QcYáaòyjǎqaoaaAvkéExěFúGkaéYagYsq	FALSE
TMkaKaDHtTXàkataàCqfHYǔNaRlVpFòSè	FALSE
VxàuǎùmadAXòǒyaBaFaéZuaymàEǔxXzST	FALSE
YfQaZJwHoMǔaCVYLxWiBéoyaoUaóaulǒ	FALSE
aòdOKRaxhOXhCYETkRRRantMXCajǒùgaú	FALSE
aLàAaTUTkmòòǎLsvnWykoLoaEvWDOsaè	FALSE
aYoaqkaòuázLQoZélYSFaóTùèKruJmTě	FALSE
akswaèàmaVUokkRaHerKěéUvǒàBùXLSd	FALSE
gIjJjAXaaDgxéBaFáNQRèěyavhTǒòvKě	FALSE
iyjybòVayCMsaouGyaaauùAvwàpmDFcE	FALSE
mèjéLLǒnúPùpktWiěpKSLaáayaaYVfèJa	FALSE
páAràròCuzhOaǔGPaVmúHJKXhhiarDaX	FALSE
rpèJtpuàEáaaKKhNGatQPiaúUqhùUFOp	FALSE
uSTaFaZsUIéBLǎxaǒzáaqdmvwzytWXCK	FALSE
xóFSWèáosaéHqaVáaqaigGúTQChdhXhy	FALSE
ùáawòóWvSFzǒaaoNtěóZtoaXáoòEásoKa	TRUE
áIaǎaKgTADéTuEaaáaélǔKHOèITuxǎQBQ	TRUE
ǎtCsúOrLpBQUNúsònraaWaPVaǒabalBfX	TRUE
ěaaVòaHùqjěYDpnIHèaTǎZmnViApJFaVq	TRUE
ǒaZèBáěwLgaNAvaarhaAreǔgqoZmtjnJK	TRUE
BúagěènéHIúBoaUFaómHyQòapCDJQaàlQ	TRUE
EHagzJzapFjFMaàLyhRClwwaFBaEùpěWW	TRUE
HǔQSDMaaoasQǎqasEMǒaDFǔàrfbjBàAúL	TRUE
KCaYnaoXqwùNàUasHRZzaQaěcQùǒVěsZǎ	TRUE
MsaaaǎvéDOtUKyEaéBpCaGèbòRqtBúcLP	TRUE
PaaaAàǒVoHèoùKǔxrBCahEUuqrhaJhCtj	TRUE
SxAaEWàWěPoRHIXJEhaNjaamaNYtBeaws	TRUE
VgJaVUajòPayóLóǔaéHKǔxVjVàOjqlayc	TRUE
XrKSPèRòòǎaGCApaqgrCaaaoACJěnsOYm	TRUE
aèqPQHNaauSsaYryrMhyPIaómDGeUHCuu	TRUE
aKaUPXLxCáHlYvhasLpaNjaofKEFRuXmX	TRUE
aaAáMěaaéVǎúalGAKJbJàJAJcnEǒSúTyP	TRUE
akwàjǒBaRtFEgWěNátggslSYIaRxaxXaù	TRUE
géùaVayFǔaWaPnOSitYRaHlúóFYBUexOU	TRUE
iaoBuiNèIFDlaMrmauòàMwGUaGgsaYzEL	TRUE
lSǎRhLXaawǒaaaTǔyyqcPXrǎMALtCBsqà	TRUE
oaJHmRèKpkXAèWrDyuóaytaaBǒvgAkQqa	TRUE
rVaRFgǎtXQVjAèOjhahUaAǒmvZTaéàayè	TRUE
uǒKLUějCaPòaagaaeGIógqWihTJDUéUbA	TRUE
wuaSáolnǔtóMCkRWàqMWaaCaxLatwébGv	TRUE
ùáawòóWvSFzǒaaoNtěóZtoaXáoòeEásoKa	FALSE
áIaǎaKgTADéTuEaQáaélǔKHOèITuxǎQBQ	FALSE
ǎtCsúOrLpBQUNúsònrZaWaPVaǒabalBfX	FALSE
ěaaVòaHùqjěYDpnIHèadǎZmnViApJFaVq	FALSE
ǒaZèBáěwLgùNAvaarhaAreǔgqoZmtjnJK	FALSE
BúagěènéHIúBoaUFaómHyQòlpCDJQaàlQ	FALSE
EHagzJzapFjFMaàLyhRClwwacBaEùpěWW	FALSE
HǔQSDMaaofsQǎqasEMǒaDFǔàrfbjBàAúL	FALSE
KCaYnaoXqwùNàUosHRZzaQaěcQùǒVěsZǎ	FALSE
MsaaaǎvéDOtUbKyEaéBpCaGèbòRqtBúcLP	FALSE
PaaaAàǒVoHèoùKǔxfBCahEUuqrhaJhCtj	FALSE
SxAaEWàWěPoRHIXJEhaNjaaemaNYtBeaws	FALSE
VgJaVUajòPayóLóǔaéHKdxVjVàOjqlayc	FALSE
XrKSPèRòòǎaGCApaqgrCaaEoACJěnsOYm	FALSE
aèqPQHNbaauSsaYryrMhyPIaómDGeUHCuu	FALSE
aKaUPXLxCáHlYvhaseLpaNjaofKEFRuXmX	FALSE
baAáMěaaéVǎúalGAKJbJàJAJcnEǒSúTyP	FALSE
akwàjǒBaRtFEgWěNátggeslSYIaRxaxXaù	FALSE
géùLVayFǔaWaPnOSitYRaHlúóFYBUexOU	FALSE
iaoBbiNèIFDlaMrmauòàMwGUaGgsaYzEL	FALSE
lSǎRhLXaawǒeaaTǔyyqcPXrǎMALtCBsqà	FALSE
oaJHmRèKpkXAèWrDyuóaytYaBǒvgAkQqa	FALSE
rVaRFgǎtXQVjAèOjhahUaAǒmvZTLéàayè	FALSE
uǒKLUějCaPòaàgaaeGIógqWihTJDUéUbA	FALSE
wuaSáolnǔtóMCkRWàqMWaaCaxLFtwébGv	FALSE
ùǔaaGlkoAIòaaySJúQZàèrésaúDTúNRsoá	TRUE
áSECǎúQtjLaDNóaPùaVóTaoaNVóKóèzMǒI	TRUE
ǎxCaJTuCItàaNhspòèùàaAaafdtJUCObHè	TRUE
ěaqùùOmkaEOěCgsěLTMLRMgěaGOaòúHaXR	TRUE
ǒaRQWTtzjFaPnmSMDáQKtùǒajjVùxaafHR	TRUE
BTàMaPxTSWtúwQtKaMKóyghLoaNaEètmNa	TRUE
DvZaNèvaIEaǎěGèTEUóaósYIRQztmlHùDa	TRUE
HQvzmHahqFaǒJZúxoCgaEúMYaHáaHǔnAXP	TRUE
KChDpswOgEúJXVMaaCměSwaiKXHGaAXaǒz	TRUE
MvaYSaCzYanúEmRDáalOYòlRxgaZuIxxMé	TRUE
QàNYwKakaMpZILnPhOǔaóLCaaeéězcéNnǔ	TRUE
SUrnèCqMNaytaapkMWInNmpiGaSéapywwò	TRUE
VéaaYJgklNwàrúàsEkTaúaàoRéáMEóyaCs	TRUE
XMahaErNuaaWDiCjmagnUlqPGJbHéúEHVX	TRUE
aǔyaùhTDàBóCěDayJúWzavrQHCXwUjDyBa	TRUE
aEOàlZBǔóaǒáQmjWavWOaMzvlàaHcnxanL	TRUE
aSTWjaLáBOaOakrrXZaKixjfAPAhCyTCyó	TRUE
aatlèLoǎaCóYqlOaXapúpǔzǒQvcPnHKggi	TRUE
armvGZxRtOèzuahYamvyxNUèVOsawaeDWP	TRUE
haAQTaIauléOǒtwgPxaǎBWBOINvaLojRǎM	TRUE
kaoSVNiWhpyǎàéslSúaDwaawTòhaAàùZuá	TRUE
nuviMěaagVAùUZQyaǔáǔLǒRúaIaVSměxIt	TRUE
qYuéZaQaRrJakásSyóarèàNuzALEPacjúǎ	TRUE
těiùtBZqKZaUuanwRCJhèaIYraXHBnriáa	TRUE
wrOaXahiyòqFpVJCòMaGGDDjaLOzAZafxS	TRUE
ùǔjaGlkoAIòaaySJúQZàèrésaúDTúNRsoá	FALSE
áSECǎúQtjLaDNóaPùaVóTYoaNVóKóèzMǒI	FALSE
ǎxCaJTuCItàaNhspòèùàHAaafdtJUCObHè	FALSE
ěaqùùfOmkaEOěCgsěLTMLRMgěaGOaòúHaXR	FALSE
ǒaRQWTtzjFaPnmSMDáQKtùǒajjVùxpafHR	FALSE
BTàMaPxTSWtúwQtKaMKóyghLoaNóEètmNa	FALSE
DvZaNèvaIEaǎěGèTEUóaósYIRQztmlHcDa	FALSE
HQvzmHahqFaǒJZbxoCgaEúMYaHáaHǔnAXP	FALSE
KChDpswOgEdúJXVMaaCměSwaiKXHGaAXaǒz	FALSE
MvaYSaCzYanúEmbRDáalOYòlRxgaZuIxxMé	FALSE
QàNYwKakXMpZILnPhOǔaóLCaaeéězcéNnǔ	FALSE
SUrnèCqMNaytDapkMWInNmpiGaSéapywwò	FALSE
VéaaYJgklNwàrúàsEkTaúlàoRéáMEóyaCs	FALSE
XMahaErNuaaWDiCjmqgnUlqPGJbHéúEHVX	FALSE
aǔyOùhTDàBóCěDayJúWzavrQHCXwUjDyBa	FALSE
aEOàlZBǔóǎǒáQmjWavWOaMzvlàaHcnxanL	FALSE
aSTWjRLáBOaOakrrXZaKixjfAPAhCyTCyó	FALSE
aatbèLoǎaCóYqlOaXapúpǔzǒQvcPnHKggi	FALSE
armvGZxRtOèzuahYúmvyxNUèVOsawaeDWP	FALSE
haAQTaIauléOǒtwgPxaǎBWBObNvaLojRǎM	FALSE
kaoSVNiWhpyǎàéslSúaDwaDwTòhaAàùZuá	FALSE
nuviMěaMgVAùUZQyaǔáǔLǒRúaIaVSměxIt	FALSE
qYuéZaQaRrJakásSyóarèàNuzALEPZcjúǎ	FALSE
těiùtBZqKZaUuanwRCJhèaIeYraXHBnriáa	FALSE
wrOaXahiyòqFpVJCòMRGGDDjaLOzAZafxS	FALSE
ùùahlMQéjyáMkjNaCaasZAOHaWùòIwdjvHu	TRUE
áxaBiTHkCSayoajǔFDpDKgwGùUGgLyǒFaaL	TRUE
éaaSKruòULéKúùaOrWúKaaxbtóǒóJulQzèh	TRUE
óaQǎFPaCawkàxnBqPakàGnaRIzYděkěXSft	TRUE
úGòMOǎRvEóJDZěLaUXaèmxNáaaathcéòiTi	TRUE
CèaigmáFéuOaasEFaKWJákqTqáFBqXKaDxG	TRUE
EjxtHuaVPaqǒoZyoSGVvaNKaùàSúvBqBèva	TRUE
HWBYBaaǔznQanǔlàAZuzaMZhaXxCóFóHPWs	TRUE
KQKENaWzGhhǎnKěóěNaRRtDiuyáamǒaóatc	TRUE
NZTavàyIáalwaaIxHDWNaiLYáWXFvxZbyLk	TRUE
QFnNaYjùRkaéàTFèjIahxKaFáàoPóóFóhǒa	TRUE
TàalóniěòóLlaéóǒáàKZnaaUpěacqHCtzIm	TRUE
VWXàAyGPEgaǎoDǎJùrPěaXOmsaMUaPúgHúa	TRUE
YEYVEaaaalRCùmUSaWMùZmGóCrIlgJMANfè	TRUE
aěaKOsjGaqsBImJèqǒGLaěmaapJětXIZFSW	TRUE
aMéěèNaéLòLúèwaGLúapNaSFyDòàbNaIPMǔ	TRUE
aaAǔùǎaILntapXLygúùěBOBòawRgoKǔsfAu	TRUE
apLCimaYǎRhùúáamraěǎIMrFkElóJAaàùjW	TRUE
hDPanCOxiUòZLxqvàAvaAaNòGaùaóSpFOúA	TRUE
jpYòjzIaǒSiSKNMWWòěwzaJáCakayYLajNq	TRUE
mHNxAkPxEraACaCVFèapJqaEòXKIsafKVbK	TRUE
pǔVuYvaFryRMWaaUKALéǔAaaébkESAéPRúf	TRUE
rsMkvVwvnóaaǔáBivènaDXCVaěaomprFWRZ	TRUE
uhEVAFóaǔúěaasGVBaXaylěwHúénCXbMJlR	TRUE
xKttKGaLaAáYmkJwwaXaYHǎPyaTltùWxALy	TRUE
ùùahlMQéjfyáMkjNaCaasZAOHaWùòIwdjvHu	FALSE
áxòBiTHkCSayoajǔFDpDKgwGùUGgLyǒFaaL	FALSE
daaSKruòULéKúùaOrWúKaaxbtóǒóJulQzèh	FALSE
óaQǎFPaCawkàxnBqPfakàGnaRIzYděkěXSft	FALSE
úGòMOǎRvEóJDZěLaUXzèmxNáaaathcéòiTi	FALSE
CèaigmáFécuOaasEFaKWJákqTqáFBqXKaDxG	FALSE
EjxtHuaVPyqǒoZyoSGVvaNKaùàSúvBqBèva	FALSE
HWBYBaNǔznQanǔlàAZuzaMZhaXxCóFóHPWs	FALSE
KQKENaWzGhhǎnKdóěNaRRtDiuyáamǒaóatc	FALSE
NZTavàyIáalwaWIxHDWNaiLYáWXFvxZbyLk	FALSE
QFnNaYjùRkaéàcTFèjIahxKaFáàoPóóFóhǒa	FALSE
TàalóniěòóLbaéóǒáàKZnaaUpěacqHCtzIm	FALSE
VWXàAyGPEgaǎoDǎJùrPěèXOmsaMUaPúgHúa	FALSE
YEYVEòaaalRCùmUSaWMùZmGóCrIlgJMANfè	FALSE
aěaKOesjGaqsBImJèqǒGLaěmaapJětXIZFSW	FALSE
aMéěèNaéLòLúèdaGLúapNaSFyDòàbNaIPMǔ	FALSE
aaAǔùǎaILntapXLdgúùěBOBòawRgoKǔsfAu	FALSE
apLCimaYǎRhùúáamraěǎIMrfFkElóJAaàùjW	FALSE
hDPanCOxiUòZLxqvàAvTAaNòGaùaóSpFOúA	FALSE
jpYòjzIaǒSiSKNMWWòěwzaJáCakAyYLajNq	FALSE
mHNxAkPxEréACaCVFèapJqaEòXKIsafKVbK	FALSE
pǔVuYvaFryRMWaaUKALéǔAaKébkESAéPRúf	FALSE
rsMkvVwvnóaaǔáBivènaDXCVúěaomprFWRZ	FALSE
uhEdVAFóaǔúěaasGVBaXaylěwHúénCXbMJlR	FALSE
xKttKGOLaAáYmkJwwaXaYHǎPyaTltùWxALy	FALSE
ùǎVSkTkǔvàRùmOWqaéǒaxaLaiyMjtVóEYRùa	TRUE
árTǎKaavZǔioáùKLaWCzhǔLauoBCBPswaYXB	TRUE
étùSCnjYuZMDaárRéEàBaWjxzlArpRZaSaLa	TRUE
óSnGklsàasómYHaaIéaérWxǎqDoǒBTMBqúXa	TRUE
úTZLBwWFNQǔlaěnaJǔaWókaatOeRqOwuqááá	TRUE
CǔzaHvaòZsmNCaraxTòFǔREZCEaSjVgtrCwě	TRUE
EgRVkvBTqwǒBaPyTYwyhyaSausúéaaGCfKué	TRUE
HaEoSaEUpóSmRmvSvliaěǒáaBUNwvPDgZaěò	TRUE
KQùZMEqawlCLLúaaGPèJáQaFaXkDggrǎStdH	TRUE
MSyGahCROaYHJOLaRRasEGAióùMhàOKacIhF	TRUE
OtaàuNtaGjpvòEúrswWCOCaDJIaZuaEéppuy	TRUE
RhaRRaWǒXWEPaBXtHòOamKYBèMDLWyaSZpǒu	TRUE
UHaTJWiiBGTnIùěaógAuSaaaNtoóédKFgdpv	TRUE
XCZayopHaúRyFMOEàAAMóVISavwvaaNnJúAr	TRUE
aǔèJgaCzGMsatUyǎOǔnnyaWPhOLREaflUVsè	TRUE
aHTQakwniQQqàWzLaoKMJYhEóóaáYaVoZòPe	TRUE
aYavptyPIgZaXmLJGawAóFJkoQsANvlWaěěq	TRUE
amzaaYPLǒahaNMIVúXorPUOwIRVAǔJrYgǔnb	TRUE
goAFrùUwayUózYYéUHvYáiVéaaaRNthuahsù	TRUE
jasmùHgKEwQǒkNròaaTwùXAPRSEòCzaWEahè	TRUE
mòRIMnaaAaYzNWFagtYQOévGaWQǎllěxoúěw	TRUE
pòiltEaaZgDRXéGqXgixyHkpEzèRùpVaraǔa	TRUE
rzúéǒuwrmvuamàCZUaàáèáaVraúáaAlwwràl	TRUE
uAWXmaWjěPaazsrěěJéùmèlRajòivaZLdgLS	TRUE
xóPòaxDgúàJarátviAǎKmVměLHǔlaavNhagǔ	TRUE
ùǎVSkTkǔvàRùmOWqaéǒaxaLaiyMjtVóEYcùa	FALSE
árTǎKaavZǔioáùKLaWCfzhǔLauoBCBPswaYXB	FALSE
dtùSCnjYuZMDaárRéEàBaWjxzlArpRZaSaLa	FALSE
óSnGklsàasómYHaaIéaérWxǎqDcǒBTMBqúXa	FALSE
úTZLBwWFNQǔlaěnaJǔaWókaltOeRqOwuqááá	FALSE
CǔzaHvaòZsmNCarVxTòFǔREZCEaSjVgtrCwě	FALSE
EgRVkvBTqwǒBaPyTYwyhyaSjusúéaaGCfKué	FALSE
HaEoSLEUpóSmRmvSvliaěǒáaBUNwvPDgZaěò	FALSE
KQùZMEqawlCbLúaaGPèJáQaFaXkDggrǎStdH	FALSE
MSyGahCROaYHJOLaRRasEGAióùMhàOeacIhF	FALSE
OtaàuNtacjpvòEúrswWCOCaDJIaZuaEéppuy	FALSE
RhaRRaWǒXWEPaBXtHòOhmKYBèMDLWyaSZpǒu	FALSE
UHaTJWiiBGTnIùěaógAuSaaěNtoóédKFgdpv	FALSE
XCZayopHaúRyFcOEàAAMóVISavwvaaNnJúAr	FALSE
DǔèJgaCzGMsatUyǎOǔnnyaWPhOLREaflUVsè	FALSE
aHTQakwniQQqàWzLgoKMJYhEóóaáYaVoZòPe	FALSE
aYuvptyPIgZaXmLJGawAóFJkoQsANvlWaěěq	FALSE
amzaaYPLǒahKNMIVúXorPUOwIRVAǔJrYgǔnb	FALSE
goAFrùUwayUózYYéUHvYáiVéèaaRNthuahsù	FALSE
dasmùHgKEwQǒkNròaaTwùXAPRSEòCzaWEahè	FALSE
mòRIMnaaAaYzNWFagtYQOfvGaWQǎllěxoúěw	FALSE
pòiltEaaZgDRXéGqXgixyHkpEzèRùpVYraǔa	FALSE
rzúéǒuwrmvuamàCfUaàáèáaVraúáaAlwwràl	FALSE
uAWXmaWjěPaazsrěěJéùmèlRajòievaZLdgLS	FALSE
xóPòaxDgúàJarátviAǎKmVměLHǔlawvNhagǔ	FALSE
ùùéAxEùOlayasjAgPjtxazpYNpCnFuóaahlhy	TRUE
áazǔXaàuprBaJǒrRlCèMkXymaoaáYéàFVQvOw	TRUE
éNòǎYùLvIzaNBwjGáasxkCaGQwMKZuxEáRaha	TRUE
ówHRSJǎaazqhaHpHSakùsaRQFǒuFVsZImháUǎ	TRUE
úsóNoOOHMúagXàUhtèspaúYaatEzzùpaNùrtQ	TRUE
CòàyxěúraqNaTàòaVáQvnaBòéNěaFsfRGpezz	TRUE
EkoMyyaQóaahmYTaNqRKREmUTTúDaNNXǔAVBm	TRUE
HQzqJaxWsùaoRǒětqògaúzGOauLpjZabXEYQl	TRUE
JaaòùTǔtrJxFióTWkXǔOgùjǔLaRMǔTóvauaBQ	TRUE
MKZTLxùaOEǔèaqòSSVòúixáqaTlyAèrxoaabò	TRUE
OxGgmahTàyUoaqawLIúAaéGQsèǔBuúhalWYZO	TRUE
RvaEùXlDLIFaaFIàaAǎFEòàaCqFBéǒzXEGměX	TRUE
UaèaGQkzgLǎIIAaǎKyawZǔǔéijvvKáǔayJFiN	TRUE
XMEhaHǎlKBohXWGganaYjáRavqnavANbaNPrR	TRUE
aùGòaEVoylIspOOzpIJòaútrpUyaátaWLYuio	TRUE
aCAéáéóúOaanUQGwáèáHLaúaRqNèMlwòkpwúc	TRUE
aUèappalóoáùáFóSSBURǔjaùóQaOCkEYieeJR	TRUE
agRZaVanaoAQiKJǒJuCùǒaDwCoròvcǔOFúhws	TRUE
ayshuóZlamADADsqagyGhuhSèxaǎagThxùgév	TRUE
isaiUaùugnQZzqǔǎouTJNàavkKaaXéóGoBáxú	TRUE
laRCaTaHFzBxamgQljérBNIiNrnVóěajXoòaI	TRUE
oaòúNèLaaQaQyNpaMDxqMfCTèUTNNVgCLVcPK	TRUE
rzHaWrITòXRljTIKrwFǔùèalzsaPawNaévqJQ	TRUE
uYPVtJMěLaMJRaaaUSIopOFavZRPwmbqfzcot	TRUE
xèilUaBhmwahOùméagzjIMǒlaaezúǒIǔAVBYP	TRUE
ùùéAxEùOlayasjAgPjtxazpYNpCnFuóaHhlhy	FALSE
áazǔXaàuprBaJǒrRclCèMkXymaoaáYéàFVQvOw	FALSE
éNòǎYùLvIzaNBwjGánsxkCaGQwMKZuxEáRaha	FALSE
ówHRSJǎfaazqhaHpHSakùsaRQFǒuFVsZImháUǎ	FALSE
úsóNoOOHMúagXàUchtèspaúYaatEzzùpaNùrtQ	FALSE
CòàyxěúraqNaTàòaVáQvnaBòéNěqFsfRGpezz	FALSE
EkoMyyěQóaahmYTaNqRKREmUTTúDaNNXǔAVBm	FALSE
HQzqJaxWsùaoRǒětqògaúzGOaufLpjZabXEYQl	FALSE
JaaòùTǔtrJxFióTWkXǔOgùjǔLaRMǔTóvauzBQ	FALSE
MKZTLxùaOEǔfaqòSSVòúixáqaTlyAèrxoaabò	FALSE
OxGgmahTàyUoǒqawLIúAaéGQsèǔBuúhalWYZO	FALSE
RvPEùXlDLIFaaFIàaAǎFEòàaCqFBéǒzXEGměX	FALSE
UNèaGQkzgLǎIIAaǎKyawZǔǔéijvvKáǔayJFiN	FALSE
XMEhaHǎlKBohXWGginaYjáRavqnavANbaNPrR	FALSE
aùGòaEVoylIspOOzpIJòaútrpUyaetaWLYuio	FALSE
aCAéáéóúOaanUQGwáèáHLaúcRqNèMlwòkpwúc	FALSE
bUèappalóoáùáFóSSBURǔjaùóQaOCkEYieeJR	FALSE
agRZVanaoAQiKJǒJuCùǒaDwCoròvcǔOFúhws	FALSE
ayshuóZlamADAesqagyGhuhSèxaǎagThxùgév	FALSE
isèiUaùugnQZzqǔǎouTJNàavkKaaXéóGoBáxú	FALSE
laRCaTaHFzBxamgQljérBNIiNrncVóěajXoòaI	FALSE
oafúNèLaaQaQyNpaMDxqMfCTèUTNNVgCLVcPK	FALSE
rzHaWrITòXRcljTIKrwFǔùèalzsaPawNaévqJQ	FALSE
uYPVtJMěLpMJRaaaUSIopOFavZRPwmbqfzcot	FALSE
xèilUaBhmwIhOùméagzjIMǒlaaezúǒIǔAVBYP	FALSE
ùǔBmaaTǔataéIóBFhúatMfjěùeYèFáiǎxúWRlA	TRUE
áXwvazaIwNòMXèRHéhHHvOaTvJEADEaMGCaNDp	TRUE
éFQaièwèLàRCéQrTùtanáoóiiYTZùQazAéěaaá	TRUE
ětFaYVHaHóupNSiúhDaéàaXXpPRosrigCaělem	TRUE
ǒúIgSǒkèOvBLwSRaòvaTLRùqIMLatHXaOZXraó	TRUE
AyYTuahTkiàaòaLWqMayèǎWaEVjiěáYǔCJAUSD	TRUE
DIBZavaǎqaòLUòhǎúUJswQxaZQoǒhùDátǎàmaq	TRUE
GǎùZuaZgJKaPqQùNTZalalauIjxvKLVèǔěDGTP	TRUE
JKNKPmévFpaóoaPtaúCaBaJbfTbèUǎZěgéBWxZ	TRUE
MésNěAéakxěaulxpyJaǒRKDaàaTztuLpwàfěqr	TRUE
OiNpzMSXaGEáEanOouaùnqGAóuYvaXěkaékèbg	TRUE
RǎSHzgMgúDiǒFùKJáaBaOXaXRaZOMZaSàbAǒsù	TRUE
TayèTOghúaéaǔápPiMEàKòaasGxǔoùyOeYviqT	TRUE
WUTaqIAaoWǔojàèuáalaabZvoǔGdúfWluxolsf	TRUE
ZéyaqagYgaGahzlmijqzùDSYáCzKaKYiXhnǒěS	TRUE
aDaTHsaiSwSKgèKDYérMatOváaLteòdúyOǔiòǔ	TRUE
aVYjVǔuQIjaCajùMEBlmJWěJPRTúiJaQVDJZǎa	TRUE
ajSǒRèVaUnuòDapHyóZraWaèeNzKMFfJuLBCéP	TRUE
gDàaXhOaCoaaqYéqKǒqùIhLwanpGǔóRǒZcYojY	TRUE
ilUayDNaAěavtjHxTqkáOlRLlěFRWaJàuCalKV	TRUE
lGaTBqYélFEIKManBrmaaPùrFaXeNiǎpBǎJPII	TRUE
oóhéNaOTyPhòVáGtuFGaXpèKaaǎMaáéwAUXKdv	TRUE
rCJmOPqaRngèěSàǒNǔaùóvaSǎLVtǔaZèáKgKaY	TRUE
uǔaapǔpútNJvMaEBHosXQlIPrYǎraJQúPaEáAú	TRUE
xCOKjJaúèpIVóáèùAéZùowaGXBaóRjaIrVCapú	TRUE
ùǔBmaaTǔataéIóBFhúCtMfjěùeYèFáiǎxúWRlA	FALSE
áXwvuzaIwNòMXèRHéhHHvOaTvJEADEaMGCaNDp	FALSE
éFQaièwèLàRCéQrTùtqnáoóiiYTZùQazAéěaaá	FALSE
ětFaYVHaHóupNeiúhDaéàaXXpPRosrigCaělem	FALSE
ǒúIgSǒkèOvBLwSRaòvaTLRùqcIMLatHXaOZXraó	FALSE
dyYTuahTkiàaòaLWqMayèǎWaEVjiěáYǔCJAUSD	FALSE
DIBZavQǎqaòLUòhǎúUJswQxaZQoǒhùDátǎàmaq	FALSE
GǎùZuaZbJKaPqQùNTZalalauIjxvKLVèǔěDGTP	FALSE
JKNKPmévFpaóoaPtaeCaBaJbfTbèUǎZěgéBWxZ	FALSE
MésNěAéakxěaulxpyJaǒRKeDaàaTztuLpwàfěqr	FALSE
OiNpzMSXúGEáEanOouaùnqGAóuYvaXěkaékèbg	FALSE
RǎSHzgMgúDicFùKJáaBaOXaXRaZOMZaSàbAǒsù	FALSE
TabèTOghúaéaǔápPiMEàKòaasGxǔoùyOeYviqT	FALSE
WUTaqIAaoWǔojàèuámlaabZvoǔGdúfWluxolsf	FALSE
ZéyabqagYgaGahzlmijqzùDSYáCzKaKYiXhnǒěS	FALSE
nDaTHsaiSwSKgèKDYérMatOváaLteòdúyOǔiòǔ	FALSE
aVYjVǔuQIjěCajùMEBlmJWěJPRTúiJaQVDJZǎa	FALSE
ajSǒRèVaUnuòDapHyóZraWùèeNzKMFfJuLBCéP	FALSE
gDàdXhOaCoaaqYéqKǒqùIhLwanpGǔóRǒZcYojY	FALSE
ilUayDNaAěavtjHxTqkáOlRLlěFRWòJàuCalKV	FALSE
lGWTBqYélFEIKManBrmaaPùrFaXeNiǎpBǎJPII	FALSE
oóhéNaOTyPhòVáGtuFGaXpèKaKǎMaáéwAUXKdv	FALSE
rCJmOPqaRngèěSeàǒNǔaùóvaSǎLVtǔaZèáKgKaY	FALSE
uǔaapǔpútNJvMeaEBHosXQlIPrYǎraJQúPaEáAú	FALSE
xCOKjJaúèpIVóáèùAéZùowaGXBPóRjaIrVCapú	FALSE
ùǎòpBYááNkWXHǎCVjznaàèCózaEaaalàNhchóYi	TRUE
áaTLVknùTàaaCsKzǒsaǔzaWǒRDHytAOèLIómlùg	TRUE
ékéǔLTtLkěwaaSwaHHwBpvNmaXDWAáQRmaOóúdà	TRUE
òàkOTpèaaáèòkaynuITTCAGHBPpèsóaěaéěOLLe	TRUE
úaaéVUNFRlZrjIaiTóEiQJYFisuQazǔuHqWjùaL	TRUE
CmálUxaáiKaěrGúCaHuàOhlXwaxMLGpBMTaZObǎ	TRUE
FGQUouJJqǎlaUAzBRtaéJSgGswKaxZéaúwPàwpa	TRUE
HmahaEiqajúPEaXDoRaéAnFtUDJiUGELělnEaǔv	TRUE
KHáúwOTǎòǎǒVsSHIǎKaúòAaaGaǒrCUaxsBNnxtk	TRUE
NCJǎYauDaBGaKùamkVHwěvavtMNUkJMcCěCTjEl	TRUE
QǒhZAkxgPwaùtJzúòSáěuGagQqnaǔǒòagBahgyù	TRUE
SplaVaBmOǎIVaMglVwqěSwQjWargBhUòIQaRiqn	TRUE
VRLmRSHNTvCtvpakaBHaGsBkǎǔaXWIYlxǒòaǒDW	TRUE
YEQmoDOGCmnaaHlúsjaHaGAMagwxCMTghcQqHàR	TRUE
aěxVayiǔgTrHǔNkGaiYXaPxóǔóǎahbWQDǒRHqRw	TRUE
aRóèzavǎúZLIùqaaBEéógmùùpóDkqUacWǎòTàYv	TRUE
agYRaEhěúrraèTGCǒAYZqǎázaàùDCpIEatyáqkd	TRUE
avIZǒútDqwKFùMUasOéáWAtuMgúoùZApMyaaZaq	TRUE
hkaSmuatSúOaézKègěǎsáaPaSqAjiWecocǎGZnt	TRUE
kaYamjsúYMyqKMmáJCZaRjáaǒmèiaOùgdFADnmd	TRUE
mqVxLkXMUUSùaRaYqPDaaáTáAKlsFahgJmXJZSó	TRUE
pTjHèaapǎzFSIIlaatRXaZYkQuvQmQADDZpcGěú	TRUE
sRanMaaItáxaòInEzWUaxPqjDLùnúěDIsSiUáWJ	TRUE
vAPaaiyHCaBèěVyUtJòHOpGVèQhDPsnkUhaaáYá	TRUE
xRoazFAvgǎhGaMataJqJWEyGMyaIolkGBQSDNOi	TRUE
ùǎòpBYááNkWXHǎCVjznaàèCózHEaaalàNhchóYi	FALSE
áRTLVknùTàaaCsKzǒsaǔzaWǒRDHytAOèLIómlùg	FALSE
ékéǔLTtLkěwasSwaHHwBpvNmaXDWAáQRmaOóúdà	FALSE
òàkOTpèaaáèòkaynuITTCAGHBPpèsóaěèéěOLLe	FALSE
úaaéVUNFRlZrjIaiTóciQJYFisuQazǔuHqWjùaL	FALSE
CmálUxaáiKaěrGúCdHuàOhlXwaxMLGpBMTaZObǎ	FALSE
FGQUouJJqǎlaUAzBRtaéJSgGswKaxZéaúwPàwcpa	FALSE
HmahaEiqajúPEaXDcoRaéAnFtUDJiUGELělnEaǔv	FALSE
KHáúwOTǎòǎǒVsSHIǎKeúòAaaGaǒrCUaxsBNnxtk	FALSE
NCJǎYauDaBGHKùamkVHwěvavtMNUkJMcCěCTjEl	FALSE
QǒhZAckxgPwaùtJzúòSáěuGagQqnaǔǒòagBahgyù	FALSE
SplaVaBmOǎcVaMglVwqěSwQjWargBhUòIQaRiqn	FALSE
VRLmRSHNTvCtvpakaBHaGsBkǎǔadXWIYlxǒòaǒDW	FALSE
YEQmoDOGCmnNaHlúsjaHaGAMagwxCMTghcQqHàR	FALSE
OěxVayiǔgTrHǔNkGaiYXaPxóǔóǎahbWQDǒRHqRw	FALSE
aRóèzavǎúZLIbùqaaBEéógmùùpóDkqUacWǎòTàYv	FALSE
agYRFEhěúrraèTGCǒAYZqǎázaàùDCpIEatyáqkd	FALSE
avIZǒúdtDqwKFùMUasOéáWAtuMgúoùZApMyaaZaq	FALSE
hkaSmuatSúOaézKègěeǎsáaPaSqAjiWecocǎGZnt	FALSE
kaYEmjsúYMyqKMmáJCZaRjáaǒmèiaOùgdFADnmd	FALSE
mqVxLkXMUUSùaRaYqPDaaáTáAKlsFéhgJmXJZSó	FALSE
pTjHèaapǎzFSIIlactRXaZYkQuvQmQADDZpcGěú	FALSE
sRanMaaItáxXòInEzWUaxPqjDLùnúěDIsSiUáWJ	FALSE
dvAPaaiyHCaBèěVyUtJòHOpGVèQhDPsnkUhaaáYá	FALSE
xRoazFAvgǎhGùMataJqJWEyGMyaIolkGBQSDNOi	FALSE
ùǔaypTiBJDRpIèZTNaKaànaùPayóuHxàjKJòUOZs	TRUE
áWpwaaàBǔWaRgpWóspOSéCQmrSYùàYHOáCIQaPúa	TRUE
éGaaFVwSsIXzZNjváòqiòKaIFùSBBZzIIǔuaarlj	TRUE
óCLyúǔExlZBzaAHaRjTFaLoxqǎyaSǔǎéDuDHhaúx	TRUE
ǒiUéSpǒàatavMLZBPHwnVCèKóJèOwJPnVajaaoxù	TRUE
BSSǎaDLaéVUQvPvAèsIaèDùmBivCóEqaùIazmǔQP	TRUE
EraúLkTǎǎVrEóaLhmrlLaaàhGHtiéEoNFahiIuFT	TRUE
IùyDěǎWOùQòZqJIùRaPahiZginǎaǎAPangúaOèEk	TRUE
KiavxWgTvǎzYaZrngNaxiáYQǎXAYuaIuaDQAǔkDv	TRUE
NWMúarCrèOSvàBTiqalmúMaútsYOTWaZoavTsEOO	TRUE
QFnTXQwZECùaùarTsònAgXauqMYzaóHMsèkgTaRO	TRUE
SjtaakkzatZBlyIhmiWhéWǎsiKszmyùGnúaúDDma	TRUE
VHkèòPaNataaRHHiùaUlVsántsfXjOZrtAwROúzE	TRUE
XXaRaXzmavxaOǎZnjxzèùELwzvtěǔqaOzèSzJPǒd	TRUE
aáQakIǒIǔYFBJùHFDMQgsaPlOěwoǎmFaaKRmwáǔN	TRUE
aLOGJgzèOóǎéxtaHKlasEWtqmuvaiHziNǒDaFNFx	TRUE
aaLHtaAoDKáwlanKǎǎúTǎIGPVúAáaaseúOthMyGY	TRUE
auQóVOACBZDúzaòWaXRhCRaéhWxǔYóèahMfOvàaB	TRUE
huagFBKRaSVizóarrèaWlRYaATǎYcFrSHsóRǔàJW	TRUE
kǎGptJáaoóDJKuěuagHavjxJGaDmEaRpùéoámVùq	TRUE
myBRFDLǒmiKOǒètóDaTHTnaòaùùòEnaHòáPǎQQaB	TRUE
pMzrQXPaáèaEBxáMjapaAaNCssKOfCcEwZàwǒPòq	TRUE
sàQaRùkJRvRntJnAaXéùoxuTJgMmLDòaòawGaOtù	TRUE
uaLéYnIéHáòaYKvaFéQǔuyùEnGòWaTWéUZaěAJDr	TRUE
xZaóGQǒQwpoHáèXXvFáqéaamálraCǔolRòyKNaqF	TRUE
ùǔaypTiBJDRpdèZTNaKaànaùPayóuHxàjKJòUOZs	FALSE
áWpwaaàBǔWaRgpWóspOSéCQmrSYùàYHOáCeQaPúa	FALSE
éGaaFVewSsIXzZNjváòqiòKaIFùSBBZzIIǔuaarlj	FALSE
óCLyúǔExflZBzaAHaRjTFaLoxqǎyaSǔǎéDuDHhaúx	FALSE
ǒiUéSpǒàatavMLZBPHwnVCèKóJèOwJPnVOjaaoxù	FALSE
BSSǎaDLaéVUQvPvAfèsIaèDùmBivCóEqaùIazmǔQP	FALSE
EraúLkTǎǎVrEóaLhmrlLaZàhGHtiéEoNFahiIuFT	FALSE
dùyDěǎWOùQòZqJIùRaPahiZginǎaǎAPangúaOèEk	FALSE
KiavxWgTvǎzYaZrngNaxiáYQǎXAYugIuaDQAǔkDv	FALSE
NWMúarCrèOSvàBTiqalmúMaútsYOTWaZoWvTsEOO	FALSE
QFnTXQwZECùgùarTsònAgXauqMYzaóHMsèkgTaRO	FALSE
SjtaOkkzatZBlyIhmiWhéWǎsiKszmyùGnúaúDDma	FALSE
VHkèòPaNaftaaRHHiùaUlVsántsfXjOZrtAwROúzE	FALSE
XXaRaXzmavxOǎZnjxzèùELwzvtěǔqaOzèSzJPǒd	FALSE
aáQakIǒIǔYFBJùHFDMQgsaPlOěwoǎmFEaKRmwáǔN	FALSE
aLOGJgzèOdóǎéxtaHKlasEWtqmuvaiHziNǒDaFNFx	FALSE
aaLHtaAoDKáwlanKǎǎúTbǎIGPVúAáaaseúOthMyGY	FALSE
auQóVOACBZDúzaòWaXRhfRaéhWxǔYóèahMfOvàaB	FALSE
huagFBKRaSVizóarrèaWlRYBATǎYcFrSHsóRǔàJW	FALSE
kǎGptJáaoóDJKuěubgHavjxJGaDmEaRpùéoámVùq	FALSE
myBRFDLǒmiKOǒètóDaTHTnaòCùùòEnaHòáPǎQQaB	FALSE
pMzrQXPaáèdaEBxáMjapaAaNCssKOfCcEwZàwǒPòq	FALSE
sàQaRùkJRvRntJnArXéùoxuTJgMmLDòaòawGaOtù	FALSE
uaLéYnIéHáòaYKvaFéQǔuyùEnGòWaTWdUZaěAJDr	FALSE
xZaóGQǒQwpoHáèXXvFáqéaamálraCǔocRòyKNaqF	FALSE
ùǎzYyXéaOòàmDhJmaqgYzaKaovaAvéCǒCjFfhIúmù	TRUE
áVAlttéóxàaAòúáLFDagostJaèMQPtMaqlaaoórCǎ	TRUE
ǎwMQTǒlpOaAaězGàDAPPaWVLYCPlhiaùayGdhtLHZ	TRUE
ěDGúùqNqvqyIvaYPFYKAaiVxèVSmaMANWDmaxabMa	TRUE
ǒǔgqIaaaaióNxPDaWǎONàAXWPyqúMWAeáèzvHkúIS	TRUE
BòHTzUaòúgùóOJóujXwwǎaTǒósOaZǔómRaXaǒYqgo	TRUE
DZawuaZvwǒzvoSléuPCùPQóélǔaǒěHPěaaLěpóUaL	TRUE
GLúxàYSOqaòDàEpùEaVuZRjkwaNkéaùUmZvrzòwah	TRUE
IkaAèXěXóIVKOtNaaoaPiyèúOZtWacJxrxóHntáFj	TRUE
LFWgGWTXEvaSKayúVLWǎoǒǎtéúZzláiaǔóikaPQUa	TRUE
OXaTgxZajCjuéAtasDàaafběHoAúYzUǔZveSKěiwq	TRUE
RBPGZVQGǔkxJXahQIúCóGKxMxXaCLauOQaJUaáKWP	TRUE
TnjQsHatavaétlMgPWùǔxaityiauàKbzéBiiváCIw	TRUE
WǒazóvivEXǎkajNBòtaaOtMSàòaJtUPXCsGlàéMlt	TRUE
YgaWnǎlasaFJNǔǎKAQJwxpvRvUùRaDasZsúoǒybHn	TRUE
aěòpoQGóawwǎuMgróQJǔěàGùvqjNAawUIykaPWZab	TRUE
aOyěIáWètIuPJùEGǔahmwqtǔTàRYhaaWvxvǎaAjHU	TRUE
akXVaSrImXaRgkOuiqEěrPpzoEaòoLgNCUyaIòZkS	TRUE
gAyàòěúáaMIěWGǒRlaTEMtWáǔúyWVapMxUYùǒaayg	TRUE
jòǎéaǔwúǔèIèHHBytorǒTISDYalanaélǎEǔDatáir	TRUE
lyǎajùǎtxQgZsQFraǎRaJMIyTHFNaǒSMkǔiHJOaOq	TRUE
ooèǎúùlkaHyaasUhúóQkUúUáNFMgxǒWGVaazfIěaJ	TRUE
rYěàjalPéjùaéqitáǎyxAàMEVUPCiiwéúviIaaazr	TRUE
ujjOaFNùǔaqiqèZAPpaXaǎXwlZGgwúRyěUGaYyDOO	TRUE
xNjaRaùqLDBJUvaǒyJGUtigNxùGIKABǎaPaHABYTz	TRUE
ùǎzYyXéaOòàmDhJmaqgYzaKRovaAvéCǒCjFfhIúmù	FALSE
áVAltdtéóxàaAòúáLFDagostJaèMQPtMaqlaaoórCǎ	FALSE
ǎwMQTǒlpOaAaězGàDAPPaWVLYCPlhiaùGyGdhtLHZ	FALSE
ěDGúùqNqvqyIvaYPFYKAaiVxèVdSmaMANWDmaxabMa	FALSE
ǒǔgqIaaaaióNxPdDaWǎONàAXWPyqúMWAeáèzvHkúIS	FALSE
BòHTzUaòúgùóOJóujXwwǎaTǒósOSZǔómRaXaǒYqgo	FALSE
DZawuaZvwǒzvoSléufCùPQóélǔaǒěHPěaaLěpóUaL	FALSE
GLúxàYSOqaòDàEpùEaVuZRjkwaNkéJùUmZvrzòwah	FALSE
IkaAèXěXóIVKOtNaaoPPiyèúOZtWacJxrxóHntáFj	FALSE
LFWgGWTXEvaSKayúVLWǎoǒǎtéúZdláiaǔóikaPQUa	FALSE
OXaTgxZajCjuéAtasDàiafběHoAúYzUǔZveSKěiwq	FALSE
RBPGZVQGǔkxJXahQIúCóGKxMxXaCLauOQabJUaáKWP	FALSE
TnjQsHatRvaétlMgPWùǔxaityiauàKbzéBiiváCIw	FALSE
WǒazóvivEXǎkajNBòtHaOtMSàòaJtUPXCsGlàéMlt	FALSE
YgaWnǎlosaFJNǔǎKAQJwxpvRvUùRaDasZsúoǒybHn	FALSE
aěòpoQfóawwǎuMgróQJǔěàGùvqjNAawUIykaPWZab	FALSE
aOyěIáWètIuPfùEGǔahmwqtǔTàRYhaaWvxvǎaAjHU	FALSE
akfXVaSrImXaRgkOuiqEěrPpzoEaòoLgNCUyaIòZkS	FALSE
gAyàòěúáaMIěWGǒRlZTEMtWáǔúyWVapMxUYùǒaayg	FALSE
jòǎéaǔwúǔèIèHHBytorǒTISDYalanaélǎEǔDZtáir	FALSE
ldǎajùǎtxQgZsQFraǎRaJMIyTHFNaǒSMkǔiHJOaOq	FALSE
ooèbúùlkaHyaasUhúóQkUúUáNFMgxǒWGVaazfIěaJ	FALSE
rYěàjalPéjùaéqitáǎyxAàMEVUPCiiwcéúviIaaazr	FALSE
ujjOaFNùǔaqiqèZAPpaXaǎXwlZGgwúRyěUGFYyDOO	FALSE
xNjaRaùeLDBJUvaǒyJGUtigNxùGIKABǎaPaHABYTz	FALSE
ùǎakaFoawWKluNvùYAXwoWnǒngzúqQUaajOvyukQEB	TRUE
áHAJxAúùVRopgnnaaZIǔolaKXéjPqǔakMyrDěóúqas	TRUE
ééǒOnQOZàóaǎaaJèGyDVQFTITGHaXBKaǒgYQfIúěku	TRUE
ěyaBééxPBwèQaúPgxKaDaàNTsFsviSqaǒLòǔàèepaz	TRUE
ǒXJaVzpyDǒvnMǒaWEjójúaúVéajaEòHiGLliěvǔéuZ	TRUE
BCAUYuwYmnaěaFaáoCmVPaǎlVaVjcgmùAúchdèzDTT	TRUE
DwaQSǎoVxáDaaomaéòákàQpèvKúmJBòGǔzaOGvmwúI	TRUE
GqLavsúEaYaZHAwjaTùàǎǔkastàTvTXKEǔàǎóVepYa	TRUE
JZLDmaJutsuPaiasRaaiMlOJwMCuitǔéùúWJluéùqC	TRUE
MkéúxDaKǒùúlpǎNxkpgBZaHNyWajaFrúhAOòBáǎzaN	TRUE
PaayalXzWIxózèIjùEAaNjaQòDáwDGwMqǒàmJFtnTQ	TRUE
SHkaOlèSFaomaGOzpumKawgzMóhaLqMqzCrkyfKbuK	TRUE
UsIJDTqoǔaEkaoóTNsJsYIjWnSaAahójǒoaEèmPKUO	TRUE
XCaDqszóarKMiaECGOaióǒóèaNgXEùiLěfMúIgezKé	TRUE
aákXDvXéQuàWaiLIBmRPúaHNjulBhàagDOókaLDHDS	TRUE
aJnqgòIěaBaáéèMZaOóvWǎzqazrLUwGězǒóAbǒHRPP	TRUE
aaRzóoSODaúVjajMOuòTUòKCmCqOǒùXoǒmTFóoaǒvW	TRUE
asukěoaSěnJéqMnúaváXgGǔòWKsGZTyuLèùUaěaQvá	TRUE
hjlùèQvàkatùTaPúFózyZaBJòTVlaǒaZwLQXéuNúqz	TRUE
kFěvgiLaaUOMaawǎjQafZoròuSIzHbVOièiIhúcxTm	TRUE
nAHOaqKhiaáaaDabQzyǎqdeǔwbfVbzárOnIBàEkiCM	TRUE
pYlkYqDǒZZEǔXlQLǒZàLǎàyaòǔCǎPjèyavYasSaafh	TRUE
rkǔZzSjpwéavaǒǔVgǒgaXLùhǔpaaǒFqAkUǎYQuCERj	TRUE
uiqǎoGTaǒYèOvuailzaLZMrXvVanDǔúvIacXvBGPàe	TRUE
wymǒSZaLǒyòùHvùQnDvákiakgóéQrsVéaYOuaXRnxa	TRUE
ùǎakaFoPwWKluNvùYAXwoWnǒngzúqQUaajOvyukQEB	FALSE
áHAJxAúùVRopgnnaaZIǔolaKXéjPqǔakMyrDěóbqas	FALSE
ééǒOnQOZàóaǎaaJèGyDVQFTITGHcaXBKaǒgYQfIúěku	FALSE
ěyaBééxPBwèQqúPgxKaDaàNTsFsviSqaǒLòǔàèepaz	FALSE
ǒXJaVzpyDǒvnMǒaWEjójúSúVéajaEòHiGLliěvǔéuZ	FALSE
BCAUYewYmnaěaFaáoCmVPaǎlVaVjcgmùAúchdèzDTT	FALSE
DwaQSǎoVxáDaaomaéòákàbQpèvKúmJBòGǔzaOGvmwúI	FALSE
GqLavsúEaYaZHAwjdTùàǎǔkastàTvTXKEǔàǎóVepYa	FALSE
JZLDmacJutsuPaiasRaaiMlOJwMCuitǔéùúWJluéùqC	FALSE
MkéúxDaKǒùúlpǎNxkpgBZaHNyWajaFrúhAOòBáǎzWN	FALSE
PaayalXzWIexózèIjùEAaNjaQòDáwDGwMqǒàmJFtnTQ	FALSE
SHkaOlèfFaomaGOzpumKawgzMóhaLqMqzCrkyfKbuK	FALSE
UsIeJDTqoǔaEkaoóTNsJsYIjWnSaAahójǒoaEèmPKUO	FALSE
XCaDqszóarKMiaECGOěióǒóèaNgXEùiLěfMúIgezKé	FALSE
aákXDvXéQueWaiLIBmRPúaHNjulBhàagDOókaLDHDS	FALSE
aJnqcòIěaBaáéèMZaOóvWǎzqazrLUwGězǒóAbǒHRPP	FALSE
aaRzóoSODaúVjajMOuòTUbKCmCqOǒùXoǒmTFóoaǒvW	FALSE
asukěoaSěnJéqMnúaváXgGǔòWKsGZTyuLèùUqěaQvá	FALSE
hjcùèQvàkatùTaPúFózyZaBJòTVlaǒaZwLQXéuNúqz	FALSE
kFěvgiLaaUOMaawǎjQfafZoròuSIzHbVOièiIhúcxTm	FALSE
nAHOaqKhiaávaDabQzyǎqdeǔwbfVbzárOnIBàEkiCM	FALSE
pYlkYqDǒZZEǔXlQLǒZàLǎàyaòǔCǎPjèyavYasSaNfh	FALSE
bkǔZzSjpwéavaǒǔVgǒgaXLùhǔpaaǒFqAkUǎYQuCERj	FALSE
uiqǎoGTaǒYèOvuailzALZMrXvVanDǔúvIacXvBGPàe	FALSE
wymǒSZaLǒyòùHvùQnDcákiakgóéQrsVéaYOuaXRnxa	FALSE
ùéaFYlaVtGèOBèCaRHVyxqBǔǔyqaQYawcjIùòtGIGQě	TRUE
ájaiXVMaúPDYaDpQKaUykXzóùauǔyǔiUQebxódYǎPGm	TRUE
éiáISuaJUáQHmaaTTaěwǒZkaǒXútxkLmYueèǒZjFLòL	TRUE
ójRSaOáǔaaùYEèxDaiaoàLhúinEHùfUjWURKbMhOrlB	TRUE
úCrèOlCJJáoxǔǔVMVWNOUèaèIúGkpǔaqWaIaéRněaKò	TRUE
BróaSǒLUIǒnalGTZHUavěWwKMXupTwNWúaLZIaàHjoQ	TRUE
EOlòNjpěQqHayaLZǔxaNěǎiRqaǒwXnZěUacWAiRtLhě	TRUE
GViMuzǔEhhAùVaQauKJDoOpOjCaTEvéòaFalVějzKbo	TRUE
JěFBixNsakuqàavAaGéaváòhUTGqaSbGGspYITòaoIO	TRUE
MSòpNMéahěoXssaNaMRááxahRvIDAQMaúvpèàxjWPLW	TRUE
OjoaúRayIkVBǒWXoZètaaTaǔáxqVYXàwéXXJNeqFOěǒ	TRUE
RaǔKImaOjaZTXVǎóRaRěǎOSǎmPlmèaMFuRGCxàúùYrO	TRUE
UòǔaaúWDáèòaJsǒhaxJFǔBAnmomHskaXnUáiRJVqYiE	TRUE
WpěóPaOAaajUatFóiiWaòJHTvóJlmòZvWMThbGXàǎVC	TRUE
ZOqaǒoaOaxkǎAoěgnVúXyèòoQáǔKoThaéěgDěihaQyQ	TRUE
aCZWnGBaSéoyAozJěsoněwqOoaréSDDěùRaáaàǔCǒEù	TRUE
aTrJaKlJpàuaGGpEPtrùawèquqvvOzèhwBsDUvǒUéwa	TRUE
aonRgiWǒuEsěaèGóKygRlFaunRAapmgiPoZaàgǔnòxe	TRUE
hKkhhaaMwBUgZzémǒwQóoxoanuWùnQPěkaMaPEVmGHg	TRUE
jrzOaogqàQěòjéSnTaompCBZTpuùmgPěGAxaYǒaKqǔa	TRUE
mrmBáuwBǔaCúwGvqMlaUNǎaOanQuóahKQZváEǒMsMEd	TRUE
phmHaaFágRIùáéQtGValSěQaUsnaJrUQbywqFògTZàN	TRUE
sèDjraéóòvaIMlkEzaòhwsFMFxZVPégxémagQǎjPaIK	TRUE
uMúECvòRaNWEuaàsiǔqDaaaùAQòǒpěKppmàfMJòEàXM	TRUE
xDLyKAQIaùUantHúǎaTéáxRgQTiLaLámóZNòWǔaBEqV	TRUE
ùéaFYlaVtGèOBècaRHVyxqBǔǔyqaQYawcjIùòtGIGQě	FALSE
ájaiXVMbaúPDYaDpQKaUykXzóùauǔyǔiUQebxódYǎPGm	FALSE
éiáISuaJUáQHmaaTTaěwǒZknǒXútxkLmYueèǒZjFLòL	FALSE
ójRSaOáǔaaùYEèxDěiaoàLhúinEHùfUjWURKbMhOrlB	FALSE
úCrèOlCJJáoxǔǔVMVWNOUèaèIúGkpǔVqWaIaéRněaKò	FALSE
BróaSǒLUIbǒnalGTZHUavěWwKMXupTwNWúaLZIaàHjoQ	FALSE
EOlòNjpěQqHayaLZexaNěǎiRqaǒwXnZěUacWAiRtLhě	FALSE
GViMuzǔEhhAùVaQauKJDoOpOjCUTEvéòaFalVějzKbo	FALSE
JěFBixNsakuqàQvAaGéaváòhUTGqaSbGGspYITòaoIO	FALSE
MSòpNMéahěoXssaNaMRááxUhRvIDAQMaúvpèàxjWPLW	FALSE
OjoúRayIkVBǒWXoZètaaTaǔáxqVYXàwéXXJNeqFOěǒ	FALSE
RaǔKImaOjaZTXVǎóRaRěǎOSǎmPlmèOMFuRGCxàúùYrO	FALSE
UòǔaaúWDáèòaJsǒhafJFǔBAnmomHskaXnUáiRJVqYiE	FALSE
WpěóPaOAaajUatFóiiWǔòJHTvóJlmòZvWMThbGXàǎVC	FALSE
ZOqaǒoaOaxkǎAoěgnVúXyèòoQcǔKoThaéěgDěihaQyQ	FALSE
aCZWnGBaSéoyAozJěsoněwqOoaréSDDěùcRaáaàǔCǒEù	FALSE
aTrJaKlJpàuaGGpEPtrùjwèquqvvOzèhwBsDUvǒUéwa	FALSE
aonRgiWǒfEsěaèGóKygRlFaunRAapmgiPoZaàgǔnòxe	FALSE
hKkhhaaMwBUgZzémfǒwQóoxoanuWùnQPěkaMaPEVmGHg	FALSE
jrzOaogqàQěòjéSnTaompCBZTpuùmgPěGAxaYǒaKqǔr	FALSE
mrmBáuwBbaCúwGvqMlaUNǎaOanQuóahKQZváEǒMsMEd	FALSE
phmHaaFágRIùáéQtGValSěQaUenaJrUQbywqFògTZàN	FALSE
sèDjraéóòvaIMlkEzaòhwsFcMFxZVPégxémagQǎjPaIK	FALSE
uMúECvòdaNWEuaàsiǔqDaaaùAQòǒpěKppmàfMJòEàXM	FALSE
xDLyKAQIaùUantHúǎaTéáxRgQTiLaLábmóZNòWǔaBEqV	FALSE
ùùBKHoQIvǔMaGaaxoZKtTMáNaúǒxMkSSxiáanOHtDXXY	TRUE
átBZèAaaCaztYWrSùDMúǎwaItoaCUàóuthIhùEùooIYi	TRUE
éOXùwóayjIaóWaWIhEopAagZkéàDarVjqTFǎqIwLóùHQ	TRUE
óáaaqqráJaèwúměIiǔNGóétFòummóóJzQatBYéLkavfx	TRUE
ǒlTáqIAuàòJPOaaMoǔěOLurRaBpòavODAqFrtBxawěúN	TRUE
BakjmnùWMWYnXEXnZFtòNXSRYǎaaOaTTòatMTFHfEirm	TRUE
EVràǎsEEáǎèaaLXGalòAkHwtǒaUDéLymQaéiHVxápJók	TRUE
HǔgǔoàrVwIaěUJSSaaXOǎvVzEFLǔDaZPHaǎZFPvstQtC	TRUE
JZgHXùJOǒògZBxMXDǒqMòàFBaaǔBUaWtZQagmSBIkDar	TRUE
MFázCGmgTJBQkEóaziZgěOoqNCxúaěhǔGaSwàaqauShu	TRUE
PèsuOvnYRmàvǒtéawòVsógxǎTxAǎaDXgFóaálaYaDVǎx	TRUE
RjáaVéasvOaHBáhaKIVayPzqcKgRdtacùoVjwtIFrCQY	TRUE
UěvKltaaLwGSmjXDěkUaóYJQúUNaGùahhBaiPbgsdjèe	TRUE
WayjaQnUaBSlǒaJPpzkpuaVtjvjǎxDIkYKUzQyfuLhii	TRUE
ZUPjNMxYaaǔKoBzùǔiMaAOUFéóuQDQFtqùXǒKaaòNQpn	TRUE
aEaMQCRènèDanSTDKxúyMRPaǎVgòXùxǎaAODpfHXIIqp	TRUE
aXaaVàWaQOIvCágDěSVxAlabGdrryKáUOiúǔkSDenbCW	TRUE
apGàǒùèEtmzgKjǎVwEǔGnzaEXaDwaokIYaPwǒrIXRkVm	TRUE
hàIaSǒIXauaWaNEEaùǎEYyetácTvjWěbǎIǒàáVLcúPYǎ	TRUE
kéàaOaoaqǔólwmauksKthWnjǔxVSòLatěǔQéfàGcCTeǎ	TRUE
mkBàBIFwPyFúaǎLTGaJaTMJrqóǔyOùDjRqZkóaFáaCKù	TRUE
pTǔKNRàIahuxGOgyěaaUQOMqUtDPjZGàPaadiVěǎiǒzZ	TRUE
sòkwóúúòòXraaoVnnààHlǎrTvgUxaPtEaEǒàMgwáóaòZ	TRUE
ukWǎFaWNoiéaNHaFBxmRùjPzYHFCapGáTWǔHNaRèKǒAq	TRUE
xDxGèzRkáAèRúCǒǒaUaJěsMùFXnxDzaCKpPJǎanaúZoù	TRUE
ùùBKHoQIvǔMaGQaxoZKtTMáNaúǒxMkSSxiáanOHtDXXY	FALSE
átBZèAaaCaztYWrSùDMúbwaItoaCUàóuthIhùEùooIYi	FALSE
éOXùwóayjdIaóWaWIhEopAagZkéàDarVjqTFǎqIwLóùHQ	FALSE
óáaaqqráJaèwúměIiǔNGóétFòummóóJzQatBYéLkbvfx	FALSE
ǒlTáqIAuàòJPOaaMoǔěOLurRaBpòuvODAqFrtBxawěúN	FALSE
BakjmnùWMWYnXEXnZFtòNXcSRYǎaaOaTTòatMTFHfEirm	FALSE
EVràǎsEEáǎèaúLXGalòAkHwtǒaUDéLymQaéiHVxápJók	FALSE
HǔdgǔoàrVwIaěUJSSaaXOǎvVzEFLǔDaZPHaǎZFPvstQtC	FALSE
eZgHXùJOǒògZBxMXDǒqMòàFBaaǔBUaWtZQagmSBIkDar	FALSE
MFázCGmgTJBQkEóaziZgěOoqNCxúběhǔGaSwàaqauShu	FALSE
PèsuOvnYRmàvǒtéawòVsógxǎTxAǎaDXgFóaálcaYaDVǎx	FALSE
RjáhVéasvOaHBáhaKIVayPzqcKgRdtacùoVjwtIFrCQY	FALSE
UěvKltaacLwGSmjXDěkUaóYJQúUNaGùahhBaiPbgsdjèe	FALSE
WayjRQnUaBSlǒaJPpzkpuaVtjvjǎxDIkYKUzQyfuLhii	FALSE
ZUPjNMxYHaǔKoBzùǔiMaAOUFéóuQDQFtqùXǒKaaòNQpn	FALSE
aEJMQCRènèDanSTDKxúyMRPaǎVgòXùxǎaAODpfHXIIqp	FALSE
aXRaVàWaQOIvCágDěSVxAlabGdrryKáUOiúǔkSDenbCW	FALSE
apGàǒùèEtmzgKjǎVwEǔGnzaEXaDwaokIYbPwǒrIXRkVm	FALSE
hàIaSeǒIXauaWaNEEaùǎEYyetácTvjWěbǎIǒàáVLcúPYǎ	FALSE
kéàaOaoaqǔólwmNuksKthWnjǔxVSòLatěǔQéfàGcCTeǎ	FALSE
mkBàBIFwPyFúaǎLTGaJaTMJrqóǔcOùDjRqZkóaFáaCKù	FALSE
pTǔKNRàIahuxGOgyěIaUQOMqUtDPjZGàPaadiVěǎiǒzZ	FALSE
sòkwóúúòòXrcaoVnnààHlǎrTvgUxaPtEaEǒàMgwáóaòZ	FALSE
ukWǎFaWNoiéaNHaFBxdRùjPzYHFCapGáTWǔHNaRèKǒAq	FALSE
xDxGèzRkáAèRúCǒǒaUaJěsMùFXnxDzrCKpPJǎanaúZoù	FALSE
ùùanwaxLYXóéKOǎwEaXòOAàXJsgsúHahkakfWěkRvlEiN	TRUE
áusSaoéAxónkLFaaIXgáúzèóèDEAAaEPúAságéjùPJaèù	TRUE
éOKaǔZàmzkèǒZWaúàmWNalVUǒhPuèèPVTWMóuòFBaDavò	TRUE
óAzéaaèIaòDvXggqEPuqàépxèoPEaihrBǒóáEnèzaWXoh	TRUE
ǒaPaiCpǔxóWZqajHBkhCǒpOaCEafùiXPǔJěúkEImGkNIó	TRUE
BòùùaLúAònHKiJvXXygaòFwrnFxáaDWmaJFVySqéUPOaǔ	TRUE
DFnwaakKxEFRWùaELhnMApjauMZUCùBZjpSkáTQaYǎKKH	TRUE
GaZzátúahaápoMúWnFkHhaúáèwZkGéRUǔLgxémAaòvJRu	TRUE
JóèOoIiòvaùùaáwGùQrBPuFaRaHgtUúàěPǒhùanGnqjag	TRUE
LUoéyaěùGùiEJaPJBǔKvǒzLúàjHRaZPKkrjQEzaqBǎěaA	TRUE
OúCúazXhùáYaCáXWzilwIkLǎxMnQRGBXSsLaaaRFǔDFqV	TRUE
RBoǒCUFMFnmLGwtáFǎéùǎWsEěaLVajrǒùétqaèuǔaMXax	TRUE
UápAaaBIjkúaǒTNIJhIúaHvZtǒòQazUlXxCJtDàrlqwSX	TRUE
XDǔqùQPDBaéòjPJéaHOajqJàwkQaLAétaMBTǔxSǔyǎcRY	TRUE
aùòvèjJaimsNyBiQFkLKaDǔóEsCWsùatPoDHKVaSYúsoD	TRUE
aMǔpxGaUHPOmQNaJpaúwvaosdiazPsUYfOEDWEóceyEzf	TRUE
aaaakunkPnúsPèúiFǎamUáXoVdWKULQKzǒVPCxmdzVDQY	TRUE
axwqèáaùHaaiFCkǔNAǎxakVǎàAylfCǒfsOBFFVqzógePk	TRUE
hwaapZVVěZGSéaWàANúUgMapVVòJamcoùYHsYaǔMzWWNě	TRUE
kEVIlAsTgrKYéòYBTFaWqágaIzlòspaòàékXéaOéKavfa	TRUE
maOJxòaLCmaiQaùòěǎòYmTèxóGYèpkWrpjǔjaEbFùgCGc	TRUE
pFSyEuVúwzJaOúpxhaLUúJQIoEèapmKěJJuitIǔaHBgaS	TRUE
raapáuatúnaGaXěVbùZòuǎJHóǒEěácHMédùàOPGYǔQCaU	TRUE
uqUèBLoOóaùNiátèJYaèSBBpaxwǔòhwàóDOùLTBaNaEKM	TRUE
xávnGéwǔxXkòuwPěKèZaúyKávGkaUgǎhQuauúaGgKYóaF	TRUE
ùùanwaxLYXóéKOǎwEaXòOAàXJsgsúHthkakfWěkRvlEiN	FALSE
áusSaoéAxónkLFaaIXgáúzèóèDEAAEEPúAságéjùPJaèù	FALSE
éOKaǔZàmzkèǒZWaúàmWNalVUǒhPuèèPVTWMóuòFBáDavò	FALSE
óAzéadaèIaòDvXggqEPuqàépxèoPEaihrBǒóáEnèzaWXoh	FALSE
ǒaPYiCpǔxóWZqajHBkhCǒpOaCEafùiXPǔJěúkEImGkNIó	FALSE
BòùùaLúAònHKiJvXXyfgaòFwrnFxáaDWmaJFVySqéUPOaǔ	FALSE
DFnwaabKxEFRWùaELhnMApjauMZUCùBZjpSkáTQaYǎKKH	FALSE
GaZzátúahaepoMúWnFkHhaúáèwZkGéRUǔLgxémAaòvJRu	FALSE
JóèOoIiòvaùùaáwGùQrBPuFaRacgtUúàěPǒhùanGnqjag	FALSE
LUoéyaěùGùiEJóPJBǔKvǒzLúàjHRaZPKkrjQEzaqBǎěaA	FALSE
OúCúazXhùáYLCáXWzilwIkLǎxMnQRGBXSsLaaaRFǔDFqV	FALSE
RBoǒCUFMFnmLGwtáFǎéùǎWsEěaLVnjrǒùétqaèuǔaMXax	FALSE
UápAaaBIjkúǎǒTNIJhIúaHvZtǒòQazUlXxCJtDàrlqwSX	FALSE
XDǔqùQPDBaéòjPJéaHOajqJàwkQYLAétaMBTǔxSǔyǎcRY	FALSE
aùòvèjJaimsNyBiQFkLKaDǔóEsCWsùaftPoDHKVaSYúsoD	FALSE
aMǔpxGaUHPfOmQNaJpaúwvaosdiazPsUYfOEDWEóceyEzf	FALSE
gaaakunkPnúsPèúiFǎamUáXoVdWKULQKzǒVPCxmdzVDQY	FALSE
axwqèáaùHaaiFCkǔNAǎfxakVǎàAylfCǒfsOBFFVqzógePk	FALSE
hwaapZVVěZGSéaWàANúUgbapVVòJamcoùYHsYaǔMzWWNě	FALSE
kEVIlAsTgrKYéòYBTFaWqágaIzlòspaòàékXéaOéKIvfa	FALSE
maOJxòaLCmaiQaùòěǎòYmTèxóGYèpckWrpjǔjaEbFùgCGc	FALSE
pFSyEuVúwzJaOúpxhaLUúJQIoEèapmKěJJuiftIǔaHBgaS	FALSE
raapáuptúnaGaXěVbùZòuǎJHóǒEěácHMédùàOPGYǔQCaU	FALSE
uqUèBLoOóaùNiátèJYaèSBBpaxwǔòhwàóDOùLTBaNVEKM	FALSE
xávnGéwǔxXkòuwPěKèZaúyKávGkkUgǎhQuauúaGgKYóaF	FALSE
ùùanǒǎaNzaGgyoáIúqKúǒaErxòYSxuqOBHAǒafQVoxQhOù	TRUE
ánùBaàNúYaUQNaVQFWRòMutóxOaKùastHVDInMGWǒvswòh	TRUE
éDEěǎégnIqaOknaNXhónyamqpWaaáJLvbhQDpqsòvqòhǎw	TRUE
óHPrqéDòKpPSFunMRntàGaajVNtDROhwèLWhRaaasTbéxú	TRUE
ǒnDaQsMaSkaILGImUHhàòoaóPúmsFúAAěMGNǒláoWVaFVx	TRUE
BZmPǒshYCèóHtVhuěWajiQóOGTLaENTLanwGTJEùwaxKao	TRUE
EàmjVaDagJUHǔWyoaVòùWTFKxěaaàùúQeǎYjJptTpsǎOwy	TRUE
GtoWaljpDoYaěDáaúàanInàpJjnTMwTalùFòsSAqSQMPPM	TRUE
JoaAqáXVwyòoǒQaAtàWYZHpsiùDòmaDaHFTEamǒmwwPsòr	TRUE
MGKRTRsZvoaQaqIzaSòtBaLDóaoǔLFTóéUKgáIeHRJBǔln	TRUE
OgúFhúgéaZEaLkCVDmèXjRXvKGppPǎoaCèEZaJsOOèpaWV	TRUE
RHúMQuéSqaNnaDQyniVvBuaOaúYDètaHodgKéjTMjFsqki	TRUE
TmoCGIUwvFBǎǒǒauYEHmjYzPaúkùagyúaSQBNCawRPIXPú	TRUE
WTBrXFmNFaxnaBIyWYúǎǒaDaàJHlNKDBǎaFmǒPZYowILèá	TRUE
ZùWLaékaGjJLQKHúòǒkZaòFiěúExaOèǔaGlSpPRúUkzááà	TRUE
aCúEAGóǔMèKkaCaRpJChèaěNDkǔěYrHUIxòkHauukYDdZT	TRUE
aWHuKGWaJějaLlzYHaBIuYaDDiqévEèceòXǔZSyyJpOqùD	TRUE
atOěRmáWPǎùóKamvasIPrBěǒGkǔTaLèoéaiFjZnEùtXúWǒ	TRUE
hjaRRVèóǔvágHètàJtCtajGěagáYlèZOaWBItNmùèZYOóa	TRUE
kJzàhkaRTlaYXPnOHoaèNRhalùDSuSgisEVZHùěBKQùJXa	TRUE
mzTsauàPNlhRNiùáéjMPNaǒkUHóáTpaaǎmnavqáùldAàhH	TRUE
pYSǒkoakMFXqKxFǔIaTǎoǔáwnyééGmaaúEaréTKǔwMAYǔL	TRUE
sLxNmTTùkaahùqWrmòhéaòaCHHqkDúalcLJǎWoGěMtBsoD	TRUE
uvpCKsALmaǎayIFsZuOgmLnǎvEaWyMěpWǒaNaxLeLVGùFX	TRUE
xYaVléyAalpCTzòJàúpqTaTQLgIYJgQhjaPhvPRyaéXuhà	TRUE
ùùanǒǎaNzaGgyoáIúqKfúǒaErxòYSxuqOBHAǒafQVoxQhOù	FALSE
ánùBaàNúYaUQdaVQFWRòMutóxOaKùastHVDInMGWǒvswòh	FALSE
éDEěǎégnIqaOknaNXhónyamqbWaaáJLvbhQDpqsòvqòhǎw	FALSE
óHPrqéDòKpPSFunMRntàGaajVNtDROhwèLWhRaaisTbéxú	FALSE
ǒnDaQsMaSkaILGImUHhàòoaóPúmsFúAAěMGNǒfáoWVaFVx	FALSE
BZmPǒshYCèóHtVhuěWàjiQóOGTLaENTLanwGTJEùwaxKao	FALSE
EàmjVaDagJUHǔbyoaVòùWTFKxěaaàùúQeǎYjJptTpsǎOwy	FALSE
GtoWaljpDoYaěDáaúàanIncpJjnTMwTalùFòsSAqSQMPPM	FALSE
JoaAqáXVwyòoǒQaAftàWYZHpsiùDòmaDaHFTEamǒmwwPsòr	FALSE
MGKRTRsZvoaQaqIzZSòtBaLDóaoǔLFTóéUKgáIeHRJBǔln	FALSE
OgúFhúgéaZEaLkCVDmèXjRXvKGppPǎoaCèEZOJsOOèpaWV	FALSE
RHúMQuéSqaNnaDQyniVvBuaOaúYDètcaHodgKéjTMjFsqki	FALSE
TmoCGIUwvFBǎǒǒauYEHmjYzPaúkùǔgyúaSQBNCawRPIXPú	FALSE
WTBrXFmNFaxnaBIyWYúǎǒaDaàJHlNeDBǎaFmǒPZYowILèá	FALSE
ZùWLaékaGjJLQKHúòǒkZúòFiěúExaOèǔaGlSpPRúUkzááà	FALSE
aCúEAGóǔMèKkaCaRpJChèúěNDkǔěYrHUIxòkHauukYDdZT	FALSE
aWHuKGWaJějěLlzYHaBIuYaDDiqévEèceòXǔZSyyJpOqùD	FALSE
atOěRmáWPǎùóKamvAsIPrBěǒGkǔTaLèoéaiFjZnEùtXúWǒ	FALSE
hjaRRVèóǔvágHètàJtCtajGěagáYclèZOaWBItNmùèZYOóa	FALSE
kJzàhkaRelaYXPnOHoaèNRhalùDSuSgisEVZHùěBKQùJXa	FALSE
mzTsauàPNlhRNiùáéjMPNaǒkUHóáTpaaǎmnCvqáùldAàhH	FALSE
pYSǒkoakMFXqcxFǔIaTǎoǔáwnyééGmaaúEaréTKǔwMAYǔL	FALSE
sLxNmTTùkaahùqWrmòhéaòaCHHqkDúOlcLJǎWoGěMtBsoD	FALSE
uvpCKsALmaǎayIFsZuOgbLnǎvEaWyMěpWǒaNaxLeLVGùFX	FALSE
xYaVléyAalpCczòJàúpqTaTQLgIYJgQhjaPhvPRyaéXuhà	FALSE
ùàǒaǒajuRGqNWpQJèkavYGRBOènaǔIèzúKQZaomòkkésóze	TRUE
áqHGaFSajnérPstiYékgǎADZiOǎaIQéophLqGWuaWòZDéàa	TRUE
éVaBaaazòlùQVyXGhYQytěòWjaóbLǎHfTNhHUwjoetvAwáf	TRUE
ěmZéBWkmasaayùéazISsOaqNóYxǎOeaLAKdGJvngzǔaCwhx	TRUE
ǒaEgaEhZCOHúWPkCDaèǎzèNgvVWYúrRGóRDǎaUtkaàvqsPS	TRUE
BórZiPúóMyBaSWCCHǒaAǎKonSWaBaIFRPkùRRJWgOKThaAF	TRUE
DmsNúvKvDznKAxSIuèǔaagmvrMHàéóvǔàMaGNyDnǒPXaall	TRUE
GHpOFùrOaàDqFaiqaUěGoměuóGwaèAòagqgélfǔSlNCpfěù	TRUE
JHYTMiazxNaěaXBHèaJFXYUHaHOUtTYAóDFkLrzlZwaAePV	TRUE
LOlqUlnCǒwTDjèògmaYlmAaàxaCměěUaQúUoGBMaDWthèfO	TRUE
NxàQLtáXuVJBvnrěùgsHaLaatOyǎkMVpUFaClQàaLFGsàúV	TRUE
QtjjǎaazáóòquaǒzMaěòGqGǒzAuúhééIǒqHhaetzóLteYSv	TRUE
TǒùaVǎlǎjAHFtPyBvMRoòaYiENmZnaPasTuMYsoRaCòAnwH	TRUE
VqZaTDaòQazyOnéaOkpEHùHaoptxleèkIrbóRúětéJJOěxJ	TRUE
YKLéFVaǔúZljyMahYúMúaaDlěMaǎěYPiwJhWtuAbQǎrooeI	TRUE
aòagNEpaMVWMolLZQvěpkxOvToáLaàAHUEJqJùěxaMOmFAo	TRUE
aUmǔGZGaaěóèqxBàSgCǔECgpáVvPMlmxhaòzxòyaBKwsuSz	TRUE
asCùrnDéaaěàUaháòMmJCBěaXuSvLWsWcAeWácaOǎeEOhiV	TRUE
hLuěNawtùoTaMwkjVèKXBaQVzǒináaPazbuGbQLOQFrùyqG	TRUE
jsRúLúxèǔaajaiěvVGkEhòLWHEYLěEzaaxfJǎolqNKIndóǒ	TRUE
nàánuEEIpǒlhWWkmhǎzlVaǎGMXJaiuNHEaguVrhVRaaIgXC	TRUE
puàaǎǎBVOGMHCyFawaMagàaGòàǔIFRLVUQuWGǎěryYYèáBá	TRUE
sIùxaHèaaXǔyèaIùaPheOahYPHCQUǒBolAsjxzMggǔHgtnJ	TRUE
vèTàaCvqyxmTǔyKjBùCǔmOèyyéPǒLznHNaěyOaAhaúlmèax	TRUE
xaDnǒàBEéáTqRUnDnaóRaqsUaRpiaúQúéDgbsLVraoOrVID	TRUE
ùàǒaǒajuRGqNWpQJèkavYGRBOènaǔIèzúKQZdomòkkésóze	FALSE
áqHGaFSajnérPstfYékgǎADZiOǎaIQéophLqGWuaWòZDéàa	FALSE
éVaBaaazbòlùQVyXGhYQytěòWjaóbLǎHfTNhHUwjoetvAwáf	FALSE
ěmZéBWkmasaayùéWzISsOaqNóYxǎOeaLAKdGJvngzǔaCwhx	FALSE
ǒaEgaEhfCOHúWPkCDaèǎzèNgvVWYúrRGóRDǎaUtkaàvqsPS	FALSE
BórZiPúóMyBaSWCCHǒaAǎKonSWaBaIFfPkùRRJWgOKThaAF	FALSE
DmsNúvKvDznKAxSIuèǔaagmvrMHàéóvǔàMaGeNyDnǒPXaall	FALSE
GHpOFùrOáàDqFaiqaUěGoměuóGwaèAòagqgélfǔSlNCpfěù	FALSE
JHYTMiazxNaěaXBHèaJdFXYUHaHOUtTYAóDFkLrzlZwaAePV	FALSE
LOlqUlnCǒwTDjèògmaYlmAqàxaCměěUaQúUoGBMaDWthèfO	FALSE
NxàQLtáXuVJBvnrěùgsHZLaatOyǎkMVpUFaClQàaLFGsàúV	FALSE
QtjjǎèazáóòquaǒzMaěòGqGǒzAuúhééIǒqHhaetzóLteYSv	FALSE
TǒùaVǎlǎjAHFtPyBveRoòaYiENmZnaPasTuMYsoRaCòAnwH	FALSE
VqZaTDaòQqzyOnéaOkpEHùHaoptxleèkIrbóRúětéJJOěxJ	FALSE
YKLéFVFǔúZljyMahYúMúaaDlěMaǎěYPiwJhWtuAbQǎrooeI	FALSE
aòvgNEpaMVWMolLZQvěpkxOvToáLaàAHUEJqJùěxaMOmFAo	FALSE
aUmǔGZGaaěóèqxBàSgCǔECgpáVvPMlmxhaczxòyaBKwsuSz	FALSE
asCùrnDéaaěàdUaháòMmJCBěaXuSvLWsWcAeWácaOǎeEOhiV	FALSE
hLuěNawtùoTaMwkjVèKXBaQVzǒináaPězbuGbQLOQFrùyqG	FALSE
jsRúLúxèǔaajaiěvVGkEhòLWHEYLědEzaaxfJǎolqNKIndóǒ	FALSE
nàánuEEIpǒlhWWkmhǎzlVaǎGMXJaiuNHEagcVrhVRaaIgXC	FALSE
puàaǎǎBVOGMHCyFawYMagàaGòàǔIFRLVUQuWGǎěryYYèáBá	FALSE
sIùxaHèlaXǔyèaIùaPheOahYPHCQUǒBolAsjxzMggǔHgtnJ	FALSE
vèTàaCvqyxmTǔyKjfùCǔmOèyyéPǒLznHNaěyOaAhaúlmèax	FALSE
xaDnǒàBEbéáTqRUnDnaóRaqsUaRpiaúQúéDgbsLVraoOrVID	FALSE
ùǔéJKhkVaKǔDhUXAǒWMzúaoěaOJhsYaaLzCocfjxVAěSàNéY	TRUE
áqVpGàHpFNkSrnpùiAAGyFaamZaBòaafwQǎwvaZojcéèoJǔN	TRUE
èǔlpóqYyJMtoLjohjgmwHIUZawEiévaaDùrmjaěDqǎJZZùaò	TRUE
ógOZuaRHJqkUéYEGiàayksQaYatiòóayoAǔPBGMèjTdàùLòè	TRUE
úHVrxàaNáùaoyǔjvEYétuěDǔEztMéǎaúǒaóLòqnTàáúǎaieG	TRUE
BxǔGMVOkqJógòékaiCaahalatpQujUEiNwpmEyLhǎfQùǔSrN	TRUE
EMQRawrhPpàǒòaWRgSNèòXAkaáuapISYRéadBsuTimxDXXǎc	TRUE
HòBLCwNěTǔàhrěDiúWaoZaěèUMǒǔàIJgrDqǔaúzQaOJaNCzb	TRUE
JwVyBDRAAavaxAsàzěéUHJQUAjSaCéyyoiaDámauòKxBDsùF	TRUE
MWDPúQCZěZiǔamaZòárNTnaàUǎraúOKYVSatPudNDNnáaGǔz	TRUE
POGèOXkKzěaJBINZaGǔjwùLóaGùǒgùaVTNLpznKépjFpěaCO	TRUE
SǔPYupáátEǎǔéLzéhrDaáuJuJUamyRxRFjyxwaaòkwYgěǒMa	TRUE
UǒhkzsZúPkGtyMiDjéCuaECXuxOòókujsaWtoaèaalgǔDnpD	TRUE
WyǎSězlFǔòtyEúwzyRkǔlCKBAVWPJiauwǎDHaHYlaDlEaRaV	TRUE
ZaaǒòùXjjprUXUpFIavXQpgYHsxaUliiYrXzòópphPnzHěaX	TRUE
aGTazoLrCgàaěxnòZiJòQZuYGTTDúhahTarskJztIZwbsPYr	TRUE
aaǒEùaaGaàZúgYjWkěgǔQòNHtKiCgIuVgKdMZjkáòCfqnsJP	TRUE
asqéuAXOaHVTùiǒEǔAwaPWIEkBpassVLoGMuKlPSvabGApkò	TRUE
hDNZǎkèèKkHǒZatsOFkURàaMaSùkkqxǔIáPǔYgoHCZùPvNaa	TRUE
jXZhISǒABMCàtáDòOěQKOaNvaaDaQǒWqsVqSavvEmsDUjEWǎ	TRUE
llǒǎnkúyOaJǒVyKlqZRIvOHBóúùèěòCvèzqúěhaǎsTaěkaaw	TRUE
oiCǎlOǒuPwlzaEFECaalěGHoEaùmǔgúvMkVùEIaXTLSoIáOò	TRUE
rjAivIǎDpAǒéJaàiiAǔaOǒapDJèàsoauaoRggTǔàbUPugěNà	TRUE
uPǎaéPUXXǒUòoazǒqaCXuéagaWèCAúzkTuooxPpFuhqùGúGQ	TRUE
xàIuǔaéWaǎUqNEJěQaògǒIznlěyóǒDhXvúxyèFùlaAOzSaǔd	TRUE
ùǔéJKhkVaKǔDhUXAǒWMzúaoěaOJhsYiaLzCocfjxVAěSàNéY	FALSE
áqVpGàHpFNkSrnpùiAAGyFaamdaBòaafwQǎwvaZojcéèoJǔN	FALSE
èǔlpcqYyJMtoLjohjgmwHIUZawEiévaaDùrmjaěDqǎJZZùaò	FALSE
ógOZuaRHJqkUéYEGiàayksQaYatiòeayoAǔPBGMèjTdàùLòè	FALSE
úHVrxàaNáùaoyǔjvEYétuěDǔEztMéǎaúǒaóLòqnTàáúcaieG	FALSE
BxǔGMVOkqJógòékWiCaahalatpQujUEiNwpmEyLhǎfQùǔSrN	FALSE
EMQRawrhPpàǒòaWRgSNèòXAkaáutpISYRéadBsuTimxDXXǎc	FALSE
HòBLCwNěTbàhrěDiúWaoZaěèUMǒǔàIJgrDqǔaúzQaOJaNCzb	FALSE
JwVyfBDRAAavaxAsàzěéUHJQUAjSaCéyyoiaDámauòKxBDsùF	FALSE
MWDPúQCZěfZiǔamaZòárNTnaàUǎraúOKYVSatPudNDNnáaGǔz	FALSE
POGèOXkKzěaJBINZaGcjwùLóaGùǒgùaVTNLpznKépjFpěaCO	FALSE
SǔPYupáátEǎǔéLzéhrDaáuJuJUPmyRxRFjyxwaaòkwYgěǒMa	FALSE
UǒhkzsZúPkGtyMiDjéCuaECXuxOòókujsaWtodèaalgǔDnpD	FALSE
WyǎSězlFǔòtyEúwzyfRkǔlCKBAVWPJiauwǎDHaHYlaDlEaRaV	FALSE
ZaaǒòùXjjprUXUpFIavXQpgYHsxaUliiYrXzòóppehPnzHěaX	FALSE
ZGTazoLrCgàaěxnòZiJòQZuYGTTDúhahTarskJztIZwbsPYr	FALSE
aaǒEùaòGaàZúgYjWkěgǔQòNHtKiCgIuVgKdMZjkáòCfqnsJP	FALSE
asqéuAXOaHVTùiǒEǔeAwaPWIEkBpassVLoGMuKlPSvabGApkò	FALSE
hDNZǎkèèKkHǒZatsOFkURàaMaSùkkqxǔIáPǔbYgoHCZùPvNaa	FALSE
jXZhISǒABMCàtáDòOěQKOaNvaaDaQbWqsVqSavvEmsDUjEWǎ	FALSE
llǒǎnkúyOaJǒVyKlqZRIcvOHBóúùèěòCvèzqúěhaǎsTaěkaaw	FALSE
oiCǎlOǒuPwlzaEFECaClěGHoEaùmǔgúvMkVùEIaXTLSoIáOò	FALSE
rjAivIǎDpAǒéJaàidiAǔaOǒapDJèàsoauaoRggTǔàbUPugěNà	FALSE
uPǎaéPUXXǒUòfoazǒqaCXuéagaWèCAúzkTuooxPpFuhqùGúGQ	FALSE
xàIuǔaéWaǎUqNEJěQaògǒIznlěyóǒDhXvúxyèFùlabOzSaǔd	FALSE
ùùtNrókUQsNaPěEJQǎxqmtaRrěpuaùSaoùiCACYNaWxùiqPDJ	TRUE
áYòǎpZmèAjRIQaRsaYyvayǒnvXGVvQUkumKmrQPěòOaěsalJT	TRUE
éaùhRAMlIáǒwhEaCBBVòHpaaEùgnFqPaRcetKFUCMúòúGfXKà	TRUE
óǔǒHòDwIaaaGQKaXériùaMAǔwOjhsSFúAfZDúóoǎDsdNpǔZáG	TRUE
ǒaVVlZHaJgpsSòwùELataaAZěáhǔzVúAUygWmrJEgèzLrdóqf	TRUE
BèWOQvùèiNVFsaqaóFkrAuWàWFVěùqvgěLWJgòóEghaXóaaéK	TRUE
DaěGaVSEJKaèTaKàjCLOgèǒáètyǔihAHauòlWFVFUèUUrWcZh	TRUE
GhlYaGèaaǔzrVBDFVXmXòZqCgDSpJàHZUphwoxUzaXòapVàpp	TRUE
JUusBJnaVRmáaqùUXUYLTrCmwUapǎNMaúǎqǔKVaeTǎnMǎoeNt	TRUE
MJJGaDHraazpTSaǎzGMqgiTkèialTczacLZjCbAáPrlNéDpVC	TRUE
OjéWqaZwXTLVhúmErIapqHDqěPaYElmXPěahacoyHWILkogXj	TRUE
RLzgImPnkazWSUIoPuaXǒUovoIyNaàvoSaGóOEIHòxwpouáQa	TRUE
TvClGPapjòǒHOZsmTgVónóHèaDHèoHaaaGJVééWQtyYGVgUUè	TRUE
WaRǎaPuámǎùWTnáHúJPaVǒGOòxaaUèùOvCMóAzùOtjuhúJèàǎ	TRUE
ZùUMéáLùBwFěúlKuFaraYaJKrGXhZǎxǔaáhǎéèiWUSaxCDkǎT	TRUE
aASHáaayrzéFòpBPVoèlVhRakKèFnlWVsvvyǎMXryLwEXUOaé	TRUE
aUoǔpóaFvFJQaqBKyZǔqnòCMXǔxiajAXJDǔNsPQěòxàamycǔo	TRUE
asóovóúoùVmRnaBáAakqòpraiaǒmxáTWmOzhcPeCúUDTùǔeyi	TRUE
hinoBITéIaUKBvIViPaEDUaaòDIazbǎeéFoùFěstLbàtNPókn	TRUE
kěPǒalaFauǒwDnaéǒóvZáWpǎálzǎaǔnwQbXVAKieBcijuiópQ	TRUE
mSANHFáZpTXiZzswwyHIaàZTlěǒxnOQǔapéaǔnxihgahIanoV	TRUE
púZPjYEiváJxaviaCDèopòADěCvǒhGFIsǒěnQYèazqaYhaozO	TRUE
rowVPPaLCáùBàJáIoJxTppPaaxwiKkiùúhEǒamQITmioxaCRQ	TRUE
uKTiqtXLaiVFéjjaoDaHFòǒUaaiúxHiNTáòvYHBEYYhlěèkIa	TRUE
waLaWaTUPnúòmOrAIéqWHMMOGwTlFaFǔDhPSEAqaWDeLLmYgl	TRUE
ùùtNrókUQsNaPěEJQǎxqmtaRrěpuaùSaoùiCACYNfWxùiqPDJ	FALSE
áYòǎpZmèAdRIQaRsaYyvayǒnvXGVvQUkumKmrQPěòOaěsalJT	FALSE
éaùhRAMlIáǒwhEaCBBVòHpaaEùgnFqPzRcetKFUCMúòúGfXKà	FALSE
óǔǒHòDwIRaaGQKaXériùaMAǔwOjhsSFúAfZDúóoǎDsdNpǔZáG	FALSE
ǒaVVlZHaJgpsSòwùELataSAZěáhǔzVúAUygWmrJEgèzLrdóqf	FALSE
BèWOQvùèiNVFsadqaóFkrAuWàWFVěùqvgěLWJgòóEghaXóaaéK	FALSE
DaěGaVSEJKaèTaKàjCLOgèǒáètyǔihAbHauòlWFVFUèUUrWcZh	FALSE
GhlYaGèaaǔzrVBDcFVXmXòZqCgDSpJàHZUphwoxUzaXòapVàpp	FALSE
JUusBJnaVRmáaqùUXUYLTrCmwUadǎNMaúǎqǔKVaeTǎnMǎoeNt	FALSE
MJJGaDHraazpTSaezGMqgiTkèialTczacLZjCbAáPrlNéDpVC	FALSE
OjéWbaZwXTLVhúmErIapqHDqěPaYElmXPěahacoyHWILkogXj	FALSE
RLzgImPnkMzWSUIoPuaXǒUovoIyNaàvoSaGóOEIHòxwpouáQa	FALSE
TvClGPapjòǒHOZsbmTgVónóHèaDHèoHaaaGJVééWQtyYGVgUUè	FALSE
WaRǎaPuámǎùWTnáHúJPtVǒGOòxaaUèùOvCMóAzùOtjuhúJèàǎ	FALSE
ZùUMéáLùBwFěúlKuFarTYaJKrGXhZǎxǔaáhǎéèiWUSaxCDkǎT	FALSE
aASHáaayrzcéFòpBPVoèlVhRakKèFnlWVsvvyǎMXryLwEXUOaé	FALSE
aUoǔpóaFvFJQaqBKyZǔqnòCMXǔxiajAXJDǔNsPQěòdxàamycǔo	FALSE
asóovóúoùVmRnaBáAakqeòpraiaǒmxáTWmOzhcPeCúUDTùǔeyi	FALSE
hinoBITéIaUKBvdViPaEDUaaòDIazbǎeéFoùFěstLbàtNPókn	FALSE
kěPǒaeaFauǒwDnaéǒóvZáWpǎálzǎaǔnwQbXVAKieBcijuiópQ	FALSE
mSANHFáZpTXiZzswwyHdaàZTlěǒxnOQǔapéaǔnxihgahIanoV	FALSE
púZPjYEiváJxavdaCDèopòADěCvǒhGFIsǒěnQYèazqaYhaozO	FALSE
rowVPPaLCáùBàJáIoJxTppPiaxwiKkiùúhEǒamQITmioxaCRQ	FALSE
uKTiqbtXLaiVFéjjaoDaHFòǒUaaiúxHiNTáòvYHBEYYhlěèkIa	FALSE
waLéWaTUPnúòmOrAIéqWHMMOGwTlFaFǔDhPSEAqaWDeLLmYgl	FALSE
ùǔULPNuéYQKjDEéNaVóHaFLvBéǔúzKOzGUóáowòUàúěNéaaiǔa	TRUE
álqNlkǔoaàǒGPèmarKtaaamdSjGCeHdZLBátqqHpxzHPoúwqUK	TRUE
éVaèusSFTHgGAECDsòaInEùǒsgautǔúZaKaóbReMnAěúVpQYàT	TRUE
óWHéGBjGqojvměJpoYěYJaúIVOahpùrjkaPáNgaKlPaóèOjHTu	TRUE
úEEsaygIvAHFSaùxCTAǔàaQaFaònsWzEpgZodxkuǒAdMLuijTl	TRUE
BaěXàaònLtqùnXanUBaSYwqyJonǔIlaRùKOAPtIoállPDgsmuh	TRUE
ECaǔaLjYisòSylgxHaFRaabáúdòǒqRrùDPnaSmgxèYnaKMéRIM	TRUE
HǔamRaAZGjashOàaàUCQtwWésvákraUdZéXòIYXheOxèUYvmǎě	TRUE
JUFxoUyHVúlèIaanHsIGSPópùkSanziOEMúXaKywQmLvhTSǒga	TRUE
MóéaLDǔwaoIyuvèòàRjJqzSqAZòTXǎwDátCaDJHTHthRaaǒǔKǔ	TRUE
PùòaaúEǔGJNǎzUnéǔCqaxFǎqXvlIlqaúàaEXéLWWFLgdvVjVMe	TRUE
RaNèǒEyvAlamnǎOhPOòKoOnUoNúsaazàNthaMeàYxúèxLcětbS	TRUE
UkWRzHùoIwoBJavǎqOgjGaKòhaZOJDmqNólMCpatIaópeèXdéc	TRUE
XRKRaàGtBraDagNMaóOǒyaKnzòGúoHLMúYeXbYiVáòNEǔaèFsO	TRUE
aùjhjBvMFàvàSúAxqwoDaIGaásrvnUpkòlòAaaWLéuagépLbab	TRUE
aKěèǎnuTCoěǒùBohxKKUmNmthaKúaRQGANJsHaRòmGJGTiuyaP	TRUE
aaZrVěVǒnQYXmǔYalòaNéPanúǔDdàOmQPDXlHRKLxiPàgNVjtV	TRUE
gǎPùǎǒqJtaPúgyapvjkSàhsjlMqiskEYoáéaaásnEZùaùEzAǒm	TRUE
iNǒwqaNigwaGSxSóókǒǔOuqyTXajCBsMèTCKnOIWvSvZauGhPa	TRUE
lǒOvajqaaJǔMyúYNèBrUhWvUumaMvNǒQjXǎzaoczwǒzRǔAWUui	TRUE
naogsùIusvBTrMaNLhRQmFBQBBěéǒCZutaOBCàóóQCianrawǎv	TRUE
qěSjFJRaPHǒaasEajalTEwrrbyòǎUZavOiBDDkuaàzycàMAmCw	TRUE
sYNOwóàzáZxauaqěyaKHTǔzrYáaMjMNonZAjCaccsZrEkQlgny	TRUE
uxXúCQORDWziǔCuNSlóǒèHFCjKaJtúěúIaǎègaCaaMàrKáOúěL	TRUE
xLkpéóCaáRGTniàaǒěZěnRCéxaOMNnaoàsUNáLuèaWTLqFQZXj	TRUE
ùǔULPNuéYQKjDEéNaVóHaFLvBéǔúzKOzGUóáoewòUàúěNéaaiǔa	FALSE
álqNlkǔoaàǒGPèmarKtaKamdSjGCeHdZLBátqqHpxzHPoúwqUK	FALSE
éVaèusSFTHgGAECDsòaInEùǒsgùutǔúZaKaóbReMnAěúVpQYàT	FALSE
óWHéGBjGqojvměJpoYěYJbúIVOahpùrjkaPáNgaKlPaóèOjHTu	FALSE
úEEsaygIvAHFSaùxCTAǔàgQaFaònsWzEpgZodxkuǒAdMLuijTl	FALSE
BBěXàaònLtqùnXanUBaSYwqyJonǔIlaRùKOAPtIoállPDgsmuh	FALSE
ECaǔaLjYisòSylgxHcaFRaabáúdòǒqRrùDPnaSmgxèYnaKMéRIM	FALSE
HǔamRaAZGjashOàaàUcCQtwWésvákraUdZéXòIYXheOxèUYvmǎě	FALSE
JUFxoUyHVúlèIaanHsIGSPópùkSanziOEMúXaKywQmLdvhTSǒga	FALSE
MóéaLDǔwaoIyuvèòeàRjJqzSqAZòTXǎwDátCaDJHTHthRaaǒǔKǔ	FALSE
PùòaaúEǔGJNǎzUnéǔCqaxFfqXvlIlqaúàaEXéLWWFLgdvVjVMe	FALSE
RaNèǒEyveAlamnǎOhPOòKoOnUoNúsaazàNthaMeàYxúèxLcětbS	FALSE
UkWRzHùoIwoBJavǎqOgjGaKòhaZeOJDmqNólMCpatIaópeèXdéc	FALSE
XRKRabàGtBraDagNMaóOǒyaKnzòGúoHLMúYeXbYiVáòNEǔaèFsO	FALSE
baùjhjBvMFàvàSúAxqwoDaIGaásrvnUpkòlòAaaWLéuagépLbab	FALSE
aKěèǎnuTCoěǒùBohxKKUmNmthkKúaRQGANJsHaRòmGJGTiuyaP	FALSE
acZrVěVǒnQYXmǔYalòaNéPanúǔDdàOmQPDXlHRKLxiPàgNVjtV	FALSE
gǎPùǎǒqJtáPúgyapvjkSàhsjlMqiskEYoáéaaásnEZùaùEzAǒm	FALSE
iNǒwqaNigwaGSxSóókǒǔOuqybTXajCBsMèTCKnOIWvSvZauGhPa	FALSE
lǒOvajqaeJǔMyúYNèBrUhWvUumaMvNǒQjXǎzaoczwǒzRǔAWUui	FALSE
naogsùIusveTrMaNLhRQmFBQBBěéǒCZutaOBCàóóQCianrawǎv	FALSE
qěSjFJRaPHǒaEsEajalTEwrrbyòǎUZavOiBDDkuaàzycàMAmCw	FALSE
sYNOwóàzáZxauaqěyaKHfTǔzrYáaMjMNonZAjCaccsZrEkQlgny	FALSE
uxXúCQORDWziǔCuNSlóǒèHFbjKaJtúěúIaǎègaCaaMàrKáOúěL	FALSE
xLkpéóCaáRGTniàaǒěZěnRCéxaOMNnyoàsUNáLuèaWTLqFQZXj	FALSE
