ùámQXuraXàlàzJzFknpgmàBouJpòòdǒ	TRUE
áWèǒawònPoeúběQrLyGNpèRǔOfRnpóN	TRUE
ǎrVQCowUQSFjFhPaéuesJFeucZkǒZdy	TRUE
ěéSùlzKhGnGaúyjGAùjBjnùARzTfùYw	TRUE
òUGCxrNSrTóuèáplJèipzEYěSSǒoQam	TRUE
AMóvKaǒmUtpLmYPDàHTrhJCaZxdxwěb	TRUE
DòóCGqWùhxóRáilVjúhǎDasuDGNGAwC	TRUE
FFLrvTYakTWOàáoPXUǒKoTuzMuòjtùá	TRUE
IRtZTXNLzèOLavCTytqvlrLHJWkméár	TRUE
LǒTùjYaZsXOjjWéuZpgWuyxdòmhǎbǔk	TRUE
NgyFgOqsLBRxYDaTydsMXZòǎUtXkxúh	TRUE
QéóoZaDwNhOyqXqDrùirvGěTgútneYó	TRUE
TDMvgéMWIDáóùoJPWkNZǒZDIúéayATZ	TRUE
VaaVVIèàqlTgSvúLjYZààzWjeYèMJǎx	TRUE
YúóGǔkéawáTfMùFtqCGBDzRdhhrǒXwM	TRUE
aúNEAGbDWúàXhHcEQBRHcSBǔmàlsIRX	TRUE
aXEJAǔácuHXYuhhXVkúxQtkXqiùGIóé	TRUE
auTmLgtuNeUkMRioKSCtRěáGééóycKr	TRUE
iǎéǒhMDMèWúpQiGCòOzHBJSmmLaHLéW	TRUE
kXmáFqPvDjòxpàaHfóprěesBzTzgZkr	TRUE
moQKadjtJcHDGàxPamStDWogPIFDnóP	TRUE
pLmatFògbXXpkDǎvhòòáfàayMueSlFé	TRUE
riamsNěgLǎTRhKfEXcTwhiSrFúóBmhb	TRUE
uTznàVǎPRXkǒznPGEFGǎgshVXVvaúWc	TRUE
xSaequbPRQwàyuwuTúNawrěqbOaxsvv	TRUE
ùùIOsPbREWSédobMRGcQIsPwkPZékOh	FALSE
ákXIoǒùSàtCbǒùTGzùlVrvǎMsèoBAOc	FALSE
éqwóUóVhèánGèǔUàxfUorYtgóWENoWq	FALSE
óSbRélnsqgzCmlvùUbvtUfUZgDOOmmD	FALSE
úQsRáNGoWóltfAWpngdRMNjcqǔòèpúp	FALSE
CDzàhXonPMjJùórèúHoóQBkěàzzxuYt	FALSE
EzIfxHagófùNIUNáicEkYCObioVwEKj	FALSE
HMvGidùNKAeoJjyFMpekBrWòóKHbIJw	FALSE
KùènkbórNhUttjGúMòpRuKafYmTQJFǒ	FALSE
MNRHPWUààqudóáOzxzixSlhqKmbkPáZ	FALSE
PNtúMvAVKTZǔTKócJǔZòWjGYqDzVHvǒ	FALSE
RrWǎOGCKlqlSRuZukiMEúàFBúDǔgvLX	FALSE
UQéóQǎprIùrrwFeAwfqiQǒLmàZbTmǒU	FALSE
WeoròoNApnsàAfuǒgCcsuyWùǎěhmkVT	FALSE
YwBpCRùiZfFPSivNBèmclCXJPgOuóòN	FALSE
cVǎFJqTRsZqnGgsWtònYVbZPyfqPzSK	FALSE
eCěwHWoHdkQfJrmOdNòptNnoosqGuhU	FALSE
gbóbdúxyóIǎǔdQGXFmúIAgQàRMJjqZt	FALSE
iwuúǒòǔVǔROǒyZǎéWSTjJpkPubDOuit	FALSE
ldghXgǔǎSwIsSODùéxvwCpPOěěèǎùdb	FALSE
oBWxóYgLNèNóueOThmZtǔUrèvXXlnwV	FALSE
qhúwQáGuCzbulǒonYGuAHgtYOúwJGǔY	FALSE
tǎúGMVúQéfWEZmGòrQcǒPteCMCZJùXb	FALSE
vbiYtpdGájgGDpivfOPHwèeDǎnZVxZX	FALSE
yézsIDmUóéóòàmrubbXúǒfVleValJèA	FALSE
ùùěǔEVFǒwèmDEkkizuěPóJMkaǎTBxgUb	TRUE
áYtúuMIuwéoyBaèuwBLSàóǒwUpDóYGúù	TRUE
éàQFxaIowěZoWuXsMúUóOáMmBèǔZyamA	TRUE
óAkiéèùFQèqaòLWMóǒBóètǎUzxeóJXDs	TRUE
ǒZùwadùlpkahèxkjiCzsóCtòJDsRZZWw	TRUE
BǒTLMěBJaǎéMhUhufnéarCójcZTVeGkh	TRUE
DVjxaljsxmXLYnWVHàkVzDNWqúQěéyZP	TRUE
GMqQNaMjoòóaOjsvGRVvuuKàSYòCcjaO	TRUE
IjaTCuEmBypmùTfLrlgfónóiFdOgjáBg	TRUE
LěVuǔZCJBPwrTJzjMmDCnFZHǒaLMfWáu	TRUE
NněQgBmpZaGmHKòvoǔbNCòǔèIxAaEeUO	TRUE
QWhkaQòBěJòóWLáhKRWùtYVKfMIKcXěE	TRUE
TITRMIQAǎqHaBfqoFbXòFQéǒPǎJvkUoG	TRUE
VlSBǔafgOgFǎtúVufqVxpVWaěVLsmZvz	TRUE
YMrǔMYnFBtNQlSKěDOngvúCiQyFpabjé	TRUE
aěpPuGThfWCXzdǒClOwǔjdDhǒvLòepPJ	TRUE
aWnurgRtBaENnYkumWàtMPóóúIkSQpvǎ	TRUE
avnsBójǔpúSJWycOzJggEDpKěNàbKǒèY	TRUE
htUúǒAqNàaFnHvqFQǔgmDzZJwNěUocQl	TRUE
khèkòèaAzMfùgbpedǔvúóǔiòqxrINDBu	TRUE
nYahJVFZdáfiMhRCjjEHOGELclAòwféA	TRUE
qàǎàGúnTLPajNǔQiYaáoWEǎoCùmXhjNi	TRUE
sVěsnyBLxǎuQéOXHDaǔcjMAvǔunJPVQv	TRUE
uoLnXpqaǎpnSdMexzkhGěáZùkuPthuùt	TRUE
xafOJǎhIRGrvhotáHGGtEzòALǒPhVNMC	TRUE
ùǔiǎmJwàfMUùéěHFMisáBCěmXèkNkfjE	FALSE
áxjDúéORěmfLQuhRòkǎAIhésOòxAWHzd	FALSE
éctKqaNábRKVfuwyIQBàiZablqvKsàcZ	FALSE
ěpNáOòFoVzAAùuVhoǎsǎěFdǎmǒPXyǎlv	FALSE
ǒVuPxWXbòGGbqiIkCwCrHocelRDdǎéHB	FALSE
BàbàoechOyJNuMhMbAùXYqjCyHLáDKXY	FALSE
DSójPhěfxAkeWhtwTTOlAhòIhkǒJGIeU	FALSE
FTEosOTgDcRrXfqDkPnMBSzqwYfeWǎáó	FALSE
INèFyǒpěKKEKJlbóDYRòGyXǎqRǎèPǔoR	FALSE
LWRmvdpéaGuàjYuGdgugéòYEIqzsNǔyh	FALSE
NuPFQUEebtStuwLMJyRáqàóEéqvxVkúǒ	FALSE
QPTwYnOiWǒǔmnGèPěOPyAGeAzQcvPhsw	FALSE
SWRQoGKMcBùQYvúFufRbèEnGBTTááTNT	FALSE
UyXgXdbMgmbnIwuèrovszDǔǎXEVnjzVT	FALSE
XlupdGárfMúshrbeHSZéGKVLogMǔpllY	FALSE
bCMǎZèǒflxbòàǒbQEItùǎAéisúǒQHàYc	FALSE
dKúUnTUóCXONRwAvsbXólNaJfmeQtjbj	FALSE
gájCrèOFYLPqlOifbtZùDQgEúZùáJHón	FALSE
iMczgOǒZáifcòhQbnRàǎIOmuSSLVPQGE	FALSE
kzUEjáòbǒEvnivTyyuòQMbRXúùǒQTóUn	FALSE
nóiCǒHěEnéHCgrRèHUǒwnSEneùZOGúaC	FALSE
pWhgSLWkUiIzBNslónEzǔTǒbRTcCJPùs	FALSE
sFMDipFpNHCqjéHiuNuzUòYzDtIhZtOg	FALSE
usèPczJVMZJǎǔITICEjxúgSiNsèfnLoě	FALSE
xPrhsǒYfnóKkrQDqfAǔgyvivKàUPDgYz	FALSE
ùùMMjáZUNUoOlGǎvmSsGWLǎAJamAZùèKe	TRUE
áYnIYhVKàuGrkDàéǎGYNWVuapoofQǔMDt	TRUE
éXayxuǒOALyUévAWKèOTàèEWHTàJǒVXSm	TRUE
óǔnacúaTǎlpyiIJoQHqbdjjewBpzMqéǎv	TRUE
ǒYǔatVWQVèàǎiùhúJvójsǔàyqLHǎAiHSx	TRUE
BémaòvGpèòbXkǒèzBjVǔeGPSǔrtUBSòHI	TRUE
DVItzKwUaeǔhgàICvTHréuYnbǔmDKntlI	TRUE
GBDǔRèDHpIIRMMQkAUPahkoóBBitOEeum	TRUE
IUFtVaryKsXjaEykCdAWejrVxòoóGiOHE	TRUE
LDLXCgnqSOǔuTtRrjrǎxrzLmBaKájéOQá	TRUE
NlsAxWòhǎCèzóvyWúFasǒAkòLBegWVpyM	TRUE
QYkMSsZòEazrEzYěPáfmRwKZSOMjQuǒǒT	TRUE
SyFHPIgěěvaixapògIzndUéǔnhUnúQLfà	TRUE
VVrTsoùzTóUOnùBKèjQabMùjbPILOgWgb	TRUE
YNùǒXVsLkskǎaECMKrbǔwXjiKWànTghèh	TRUE
aúúBTékǎuYIGIòfMGGEEèUzcMNKEYKsǔh	TRUE
aVfpáxQHcǒULrrèYtyjPóeǔdǒDgUuUOkD	TRUE
axICfUùGúZxJóXéiOoǔwwáTmúUukWPúhp	TRUE
ióSgyěǒaùLWBòplhLNpQlQZWqjtQfPéKG	TRUE
kUHKnóCrùNPIGPótMaXQjóhsCXRNrclBò	TRUE
nKROnySIOjEòGTrzWaHpéuIQòSǒgòdyUM	TRUE
qètOèsaNAòjAáCmZNAfIwomVXóeILiiwy	TRUE
sjqanOTIkBXvIWèOdkéssdúàǎEàfǎsǒTQ	TRUE
véNEDsàtJTéèzàSOtiaooTStNnOyvCvtó	TRUE
xafcuójTIòcRějáqfPbáJejTóǔudLFNXà	TRUE
ùěǒRHMXxenqBiǎòqQěvHTUMEUlbcDSpOB	FALSE
ádhWLLCeébVèáJABpyNpèoZcjPWyòNBHT	FALSE
ǎxktdwóèiRàIsHUvcHmRLKwaytmTmgaKě	FALSE
ělMFoòòzLzXmjPtjkYjAyéyúGhDelǎydó	FALSE
ǒIijCHzǒEěIáNpdjMZJDYtPláuPLxǔHIU	FALSE
ApetUKjjuyCgXNYùéǎSVlKjFvkHsJárXf	FALSE
DLvnwWóoTvǎWLUIfiOHAmxqǔDFqhqeTFó	FALSE
GéǔSwMuYàcmnSuBEXSRegsùMuèORKrZGá	FALSE
IPKánzOhFPiěáDehTKDùRLtKgnlYwadAQ	FALSE
LáEyZábRdZOAàtNàJNWTRvSpWMvsHǔzúy	FALSE
NOusZVpoodǒéSHpXaóáGǎuUǔZsCRoVoéR	FALSE
PwèDóDODoeCcJtWtGdájVóWAMqgéqaPHP	FALSE
SDgyǒNyěOwVRVdQóoóuRykMYbMmuBpcùě	FALSE
VDèáCbTVoJfáWoFLpuHoArHIGTVgEQJiz	FALSE
XtyZqáyoKLAuOgICWěUǔépxFóAWivHUfc	FALSE
ZyúovJáycdidufWPǒrhAYQJójLazáFOrD	FALSE
dùùhaòzùXGSdáqSDfmCYCLOQYHveWáCjr	FALSE
fLgyBèRǒèVQǒóIjàDYXzWBtQadǎGfǔJoó	FALSE
iěBxiiáYfYjspOòDàuùfkǎsrcCFgdVhǔt	FALSE
kYùàBqOPbwMxQHFXǎoYNLNèjGzPBégYUr	FALSE
nDICUtpúáYoTtVòyPnáQáhwnǔppWXùdrà	FALSE
pYvBàtòjLtcMtSUneMnHdLcQDHGrLǎǒSl	FALSE
sJǒéàruhHkmuòHdwstDYVYIxoWéHtvpNR	FALSE
vǔfOxWǔXfdOLkZibtdCAhZǒLERZycdǔQz	FALSE
xVfFDúǒCléGylUAgúqmbòhsXsqlèNRVZd	FALSE
ùùYǔwHNúoRFambpZHrihVxCQZqúàXóǒòǎD	TRUE
ápèpIZjkǒWDHavǔvǔàóǒbaHxáfqǎhǔGbmi	TRUE
éèTàHQùmáFahébplòúrzQoXnSněJmihǔEE	TRUE
óǔigǒaPsveCMFnRupEókúTúzIRGáXXFVEj	TRUE
ǒXqàABoHgrZZlèDjpxlěAǒmsǎěQZXpaRkf	TRUE
BéVkahGlQLǎeZùZozzěECǔèDuLààcwYedV	TRUE
DaKRJlUuògXvQKnseqěLFMxYjYùIfZUZGA	TRUE
GCaóGYWiKVPHtPǔtéàXàLEáázUzGsáèqvù	TRUE
IkOsEúzǔKCqNgppěaBMxwyùNYrhBZFráUg	TRUE
LKrLSUàHhǒaziEWǔJJiRǎèLCcqhoqmfTNZ	TRUE
OALyóaoavXjTZFUrAlQMrghAèpWdèqUayb	TRUE
QaJisǎgPQguvqcùBADáCǒǎQKQCIeqGiSés	TRUE
SuGPǒXZFoòQiyBěàBClkǔòaWptIZěJZúEX	TRUE
VaòvZuNSjúFJǒuáyteàěIapwXMvèQgWBùe	TRUE
YàLZaGvcěDFhyRzKSndǒvnéqOuzovJéWRu	TRUE
aàbǒIúpRǔFDEiUwDǔEHAIUǎúàmwiáripèn	TRUE
aQqrAàèóúNhBEqELvěcZAfAATMèLěxTCQQ	TRUE
aqkojgEqhbfIàkǒdHuzémùgZywAècTRDHF	TRUE
hNMSAAǎǒVGópEééxhHWzKxǒokatXMJOhcé	TRUE
kěLQQxRLYRěMUayòàvQhKáOGwVCiGsQbGR	TRUE
mzKaVméuHàRuèoéqAFSYQOvgtúGtLhèMbp	TRUE
paXLfSBOùgěFrWónoAáASàSUUeBpeócěǔj	TRUE
snaTyóVAfWezUǒǒěàxsMIYREyTpCxNéwvu	TRUE
vCǎsúlxZCyEèzTuawJǒtlNaJKfNBYùǎlmi	TRUE
xúǒqtBauàFdkELNSHShVsAAvJRQDXyhxof	TRUE
ùùLwHXòWǎwIgHKtfUGhUgqzǔèRJOQǒyǎǔA	FALSE
áèRYCSPYXǒèFGRjěRóBoàMebLHejNsvMlx	FALSE
ǎúxǔtsytoPUslvěBgqNǎkcǔhkpǔpnmOKKB	FALSE
ègtoǔcěUòWIPqdFèUǒqbfYheyFUgoVKǎyU	FALSE
òSRFèsXOVdjbrcSLELyCkùaJevFáDěELGǒ	FALSE
AéoqvBhPcioIYnSPYmaóAMACnNONBPJzmy	FALSE
CukázwekOrdfóqyùzězRnOMAPǎǒQàrbàxq	FALSE
FWúbiGThólBWEUaǎfVvgncMeNuvwhgmYhw	FALSE
HqyLYeofhdǎrZMyiNájúbYhNHóCDAlCLfD	FALSE
KYoMjpóSùwrOjóVQDFthyeGBbFjxthSCEy	FALSE
NòxlǎòdhdRWRkdfégújèJmSxfDFWPtcbéN	FALSE
PrùCmǔyNegUǎLálKzJGDǔHwkLNWáfKnhnp	FALSE
SUfǔWIWbqěLǒnpnPvBBàHITqQGrGhQowNE	FALSE
VFZPZNUheùVFNrBpizcjYZPòBAòLtVaDmb	FALSE
XIzcsQPBǎnWòékCòNtcBZcebSyǔIhVǔAJs	FALSE
ZgvrynǔxuQqbNúSàSBǒnTZEvKúPlZDnèOg	FALSE
dáPfXRAWVazrscyòáKxrúEUúsNóàǔbǔàfx	FALSE
fhàJsPsuúAWózOIvaDoNǎErGWoNdǔjwRdǎ	FALSE
iàjóHòxěQGhMěWJKGDkVóbócrHJBsMegsl	FALSE
kZgnKHJnLjPěpctMǎUspHPèRuKojmFhcsA	FALSE
nDEdoIojxBxwhàxfóěèěáǒHLTvhGúWècLg	FALSE
pfkSàhOHMPèbByienQwàouáiOXihyUMVXó	FALSE
sàNijuDmXtqèbbYMFapAyUgeRzTdǒúmájó	FALSE
uWǎRówXkjZWKpEUúIúFfCOgPgècPěqSòwà	FALSE
xKfěPQJbzǎGoXEAoófVngǔUKxTEOQMJESù	FALSE
ùùPBhgúFaóóaQèBjhgoǒHOOúúòGvǎfOeeTc	TRUE
áWiwjaPUPNbWFExYsnDgHóDáNfVérGrGqúy	TRUE
éěaaWHlèXZuYSjVjOJOuCsTúsàLUtLvXDNj	TRUE
ěyáIǎWsráaSbIcGměGzQjliRpLLùSpgPXúC	TRUE
ǒQsòVǎaǎuVàXvMěèozFwóCǒKǔBITòbmùoch	TRUE
AaWpjJctAàǔaNBgeěHfDgmQFupqàMáǒSSǎǎ	TRUE
DUayFǎǔaVFKéǎTIuCěTdbIiàcYOKLáǔnrHR	TRUE
FzèLjrPùMǎěXǎTòUXlMaXbFKNilTàcózIKC	TRUE
IHJóUmlyactEoxaDVéDhǔRézKěGMǎèpAǒój	TRUE
KipLvFésAhzaUùèThqǒXyAóQYèzLhlDHúGp	TRUE
NJóúnCvLqgtIBWphaIàFjòuPDbJySZZpàǒV	TRUE
PwǔsúáSTBoZǎàaRKDZOGAtéYADǔMNtwPWYc	TRUE
SaǒsdFèǎipzUqWLǔoǎRYbHJZéóFsyvuoHSC	TRUE
VDZKxaPsuJMòPěpǔtZXXyyònMvbSàěWTúdR	TRUE
XxásǔgMúgàFǔSALjJXuHGaHRMFóbhdlSaQA	TRUE
aǎjNIoxǒbZépSkdlhjjMdimnAóamaWLHóuk	TRUE
aTǒJwǎKfTPXérkbóHúbxbIěQùtZEwRzWggP	TRUE
arRtùjàFYrùDàWkMnbDérDNmǒkRlNCwDeià	TRUE
hkpiXLàjSauqfnFWCáDwtKATOOrdShúrMoV	TRUE
kǒgHvaEWqùězPXWESeEqdáAèEdDwEfùBEwR	TRUE
mmúwEFQàxYaBosRnbòmioXájLioFOhPmEeY	TRUE
pLùMlwZmxwMSóaóEzúXEsǎzvééKxUbwqbmu	TRUE
rlYHAaYǒrwpAYěWCYBàEomBZFòCDǎVpvENM	TRUE
uialǔrAKCàAhyRàdBGbVPFeéQròvnǒVgǒUw	TRUE
xPGQFúOhnRòKEMèXUáYyFTaslBáeAQnèAbě	TRUE
ùáèlxtKcLǎáOòGAúMVPrókpèXjòSVuOpeHG	FALSE
ámtVtdúOcFòaòTcWweyIxáúěùxxqQpròǒlA	FALSE
éblPPDRwtkdUǔwRFYWàpòúpKúFwJcěWDěùD	FALSE
óLéǒXǒSboJaSKGěVúPWflǎwCúxPVáRBmaPR	FALSE
úCúóNéUùěHècápùórECǎcHyáVYàLZcàèhàp	FALSE
BuhltPCrFALbKaàSǔjnrdfpDsFhMwNgUókJ	FALSE
EcYCNTuóáMǔlNzqdJjkfoǒoFYFdXhcDúáNě	FALSE
HǒpLYEáJBfécEsRCrXùPsViqwHNYXǔLzOáq	FALSE
JpSònIqNNózěáKjGYTLkCJùXǔGmòmQáTěbJ	FALSE
MXlceHcùLhGbAǎTPuuMVluoLidOzrKwcděò	FALSE
OsMUdCpCFZmǒHQoCmcTgvéxYUpVùJvSmǒpy	FALSE
RéZgohePgUǔùgFùSOǒwBǎóiùětHeoECùHúǒ	FALSE
TvMvóhněHcEvlóyWǔYkNWwjPǒalǎspkYsjb	FALSE
XǎFAYFLTBOWOtùrKXSUHTóěAgOfWMéVYsOn	FALSE
ZZLPXQKIfIkrbEtxqkLàóaCKrBǒTBUHSfóX	FALSE
cjWZEiúHFLkYsucYKoIRAaDFQGXuǔfXgEàY	FALSE
eUzgFblWzùǒgvIXsZGPHIsMdótèVeèIpdiw	FALSE
gTcKEWhhcǒQBámOámèYǒèúBúBèámKǎuwòeN	FALSE
jǔsǒtGToVoAcHlJǔveǔdédDáfKGAdǒUJPzě	FALSE
lTzòòsgJniànspcxCJONéEgAWNqwejzaLHA	FALSE
noOPèúJětjkkétRhcùABKSdǔpDXZCJáSERd	FALSE
qAjǒWwXVèzzQlátOdrfHoHZCmfLnkHúǒWLE	FALSE
tǎjGBgcúIòenWwxèhFbcjOhyérYsEsjǎPce	FALSE
vdkgNWjéàpFDrRIQébVShcókAééKKnTǒOyù	FALSE
xpeàuzqǔdgDSNroMòZPOOòùSJNHHúáWeScs	FALSE
ùùèYmkPayùLuKrùYùVIEBtEhRwdLmTNYPvIQ	TRUE
áúqBùCAàQQtDBuXúaǎwIǔNǔEvryǒmcxěMrxf	TRUE
ǎOOSaIBǒNzaúiSNǎǎORosVùǔHjagRúxMAqǎu	TRUE
ěóéBxěrVúuézAjoaMHCgGNláaòrLdoóěGúni	TRUE
òZCǔkUaNHkAòPPlǎheǒuVàOutlàjǎùǎNAHbe	TRUE
AVaGuENeǔàǒXqQDuArKùsNWauOéxJévnCxvú	TRUE
CoVXtJóaGskóZyIaNOsxShJWxàoCúWóYweXf	TRUE
FnpavěNLSpbaěmTfymqTDóúanUNMǔUkDIVDh	TRUE
IXáaYkàóAZNùuoZWpWpióórRpdBóǒHNnsgZb	TRUE
KowXznyxwanTměLéFAinocxùcgesbwxeVhHa	TRUE
NaXéwwQuùaocGéééXòUWǎùiéjNWlSKVQmǔkh	TRUE
PwLXiNrǎVhKNojaxǔsQshójVSfòáJDòPPòěM	TRUE
ShQssǒPynnsoLoEEUPǒáxiaURXnǎJMèMòEOR	TRUE
VmǔòhaTtúFEAzòGPEHgsvèPǔFyISZáxWXWǔZ	TRUE
YRadndsráCèHèvoUrǔúYcFcjPáAjfiCprúkN	TRUE
aóoCLUtiqOúèwZěMKfprǔǒozoshuNuBCPFěT	TRUE
aaóàigkXSéOxZcLPOGSkshXlròǒjáoHvcgúe	TRUE
gGémlpYèQrWRáNFPWuaǔVHrzDálwTWDpbFwb	TRUE
iqǔRPILBSsègèOòùvǎBmDDWGràùtnsaǎgZzà	TRUE
kxzGqvsNjuxtDauZfAwYvFbVbèjaRfEQyWCr	TRUE
nGaCUADFGdJáXéUwVVNszCxfMerxTUtùzóng	TRUE
pvqǎakǎCiMHwWcnqlvuEYOǒugciUIOSúRǎǒó	TRUE
sagdLmálIQǎWyǎcmehTEOkAvaILyeoPFSTáě	TRUE
váòwoOQpExqWJMBaBSVqeòXoiWkcXǔoMNiéj	TRUE
xPmuaSpúkpbǒgěǔgfLTéPjiBTCúúBDAfgwbT	TRUE
ùùzǔuóàAázgèslcéINhzùeàPTtóóoLfAkoGq	FALSE
áǎolnIWyrkWjoYmAwáGǎèXǒBòERbKNPBhZXó	FALSE
ǎuzyvFnJáocolGùDàěpǒEMàTapPhbebKVqié	FALSE
ějuXMpmDCòUWvxYsúGúóNIFYoOkpJoóblhxá	FALSE
ǒéǎLyeOǔǎàoyRJyLMtlHAZfkIYPrHóGSTRpn	FALSE
AiXxBWobKJuyxKSQorSǒuqèùMwGHLLpKkuDZ	FALSE
DQQMNkWǒSWúLóPBeúlXJmMOPóùDkǒPoVpXYe	FALSE
GFswxoeVèàYxhèǔzóabyKkvbWkdtEVVGVddà	FALSE
ImYBJmXTPòǒwǔZMRvMéǎcHZZsKáKHeCUGymt	FALSE
LPknXmOlZZIVàwsǎzqóláùZsQiCToYQmǎǔgN	FALSE
NTJoENSAdtKMTfEpMZGvyǎqéxPpLgScqàxNG	FALSE
PwStRótXIqónnbáXucjLǔYóLKMjáuóoIZxóS	FALSE
TèbǔdǔZVjǔrǔiWYHhEdbhZiJQXXhRZtDbLòF	FALSE
VLFjINnkóGBBǔOpspEYZQbǒxOigéòzǒázWLR	FALSE
XdánJJkǎesèbCmVCWǒǎùalMXùoXNyKbaCǔmj	FALSE
bALsspaBXLrRXWwPùOqpèlpàOswnmCètwàHè	FALSE
dKUHwBzTKYiXcpLmóvkflYliMPogOLXpLtxy	FALSE
fùEeǒGqEdtBmQIosBEYfceEkfnCorezNVyFr	FALSE
hEcdiQQDvNmskuQkfKǒJZxTaLDroPUpybSàQ	FALSE
káǎtxzFkEXǎǔàeMXzpvKLqtǒěVIPMDPLHELs	FALSE
msPDNwYGsqSǎEiùwAdknUiRapRkEAAmtbKUQ	FALSE
pJùGdesMZógáNfTcùAqMùOiEbVmVùvkòáTác	FALSE
sùTgIpCvFKKkòvXdrpSǒyIUzmraòáhYèúUúU	FALSE
ueǎZqcexEvInǎǒEMòHBkGèfcqJàòǔeYZúDáX	FALSE
xQTghFRVQMǔCPěGvCfODùcBǎBwxqVJfàqQie	FALSE
ùǔóoBCkǔòQNuěrikLáiFúDùypújyaǎóáHwyàu	TRUE
ápaDMIǒAMúoBaAùrybKeYcJTIZNBBsWéKqLTO	TRUE
éláohDFǔsVumnGrIuǎzMKèAatqúóobXcqěydg	TRUE
óJQulTYEéUkosǎúJàgòazbSzxXQFQpnxǎAǔěù	TRUE
ǒiUóozahTPRòyURuRéjdwMcábdetóOHjèèVYp	TRUE
BáaJYDZònXzjùRéwHADXùzmboIiVOHLùěFDùB	TRUE
EùsRDEhzDyVPtáaèzěBéSSXgCqzkánóCBSáKá	TRUE
HùwaMwWjuEaKJòfàOcaUvuRNJUgIóXdLPèzFJ	TRUE
JPJsaMzICúùphDKCkAUCóúésiFědkBolPHRVR	TRUE
LoXwQafěǎuAhùǒǎnPsúEtjàUòǒǎFLuWùvpUrt	TRUE
OWéEhTjzjYuùLsPǎkSEjUDSDXUzVRamESUdDù	TRUE
RògBagPněpKObsVáéFGuYaJvTRdàǔnDIfvznb	TRUE
TaoRQtvNnHzǒePúùOBmuAnàZQèIQbáWéLYTáG	TRUE
WJWuGùWaAlJsSǎJǔuàěcBwèbnVlheáPSiyAóv	TRUE
ZDwKtèúxXáFpgsVTpxěNpùóSauIàIGAěòmvoH	TRUE
aDcǒdfdcRvahYRcúréjkaBǔkaèRSbuYdsssNT	TRUE
aclzzCèhlvahVnMáòàáimǒǔKQnwLEětmzdéoG	TRUE
gFZxǒuqaùgFVáòpóèóRHùfázsyhéLpyQFdlLa	TRUE
júWàpòxètIkaǒAPEúxiJWǒqèQXHmbMějcGZné	TRUE
lpòVuoNYvǔěaDDGázKxXMWbxúAruAunzèFmDI	TRUE
oǒoDVjkaViděswjdǔypnItàDèChpnrBUdFǔRG	TRUE
qakisèùǒKlEúPNMuyBUǎèZmòtvsRèáWLXXeàù	TRUE
tǎSaYcěbubBGVàDzzsásjXUIáévvGgWwvxáwW	TRUE
vUpCǔnSRaiáBxFzckHDěwóSěǔGiOuuxnùbCoě	TRUE
yǔsmJgCPSwMèNaBáYcmèFJnqiMetLTwrOktpQ	TRUE
ùùhNklImòólFěTDZkoěQuslOgbltMcWymuhwA	FALSE
áGWǎpàkOiFàDsGHJFúGBùjBCyxdSARXWkZPUè	FALSE
éǔnépLFOoVLJiOhXNXUmHǔtxwMycWáéTrvPèá	FALSE
ěddNèFnrfsLwDxúYǒEZzyJAǒIàomèǒsòqMDéH	FALSE
ǒkxTGHǎLQmDCèpòjBVrqMcPFuPúxlEàOCQmaC	FALSE
BIxpPOUegùyONqBpěáCfdVodyAǎeágMSUéóWu	FALSE
EòxhfOGhZRèowyeWunèGèECǎhJPnkUoymTCóo	FALSE
GNTyYOtǔwRANdFuláwméUúBGǎKǎtxEoǒǔyCvO	FALSE
JěoDěRěSYfáJcezòúǔéùyGěQCOZOrEyǎXúeJt	FALSE
LoxubrěòMOèOlXgWǔZSsáceqkAaCdCjqjúZrb	FALSE
OáZòIFfgPIěYǔtXvòDáoOYúèLQcèyNDRyHTěf	FALSE
QóurKòIòYQǒOnEVAUIPòAqYSàòpàTCRgLYWEO	FALSE
SScGjèjaAEPlvMWéǎěcàxUùGsJGwhopéPXrèr	FALSE
UvěěànrBòlpBUDowùyqVrToREZjMěKSXjDùfF	FALSE
XPnuèigǔǔúPIcgtvdXDVIFzRúTzǒitplǎIRUz	FALSE
ZuKéòǒuigZlcIhQfqvObúJTǔvaǔZXBVLApùóv	FALSE
cwzSvèTKxjooówIBjoiZuYSXěNExcéǒlVFòeT	FALSE
eoQSPǒǒVpztbyVTLǒióalKuGKrPMnZnxUJPùó	FALSE
guònSDrrZmódòǔvgljMQLehegGóiUùXIpǒLùG	FALSE
jkwópAězhUmbEJgOzǎWHRBhtǎùhrqjàUXEppE	FALSE
mNsǎAóěCOsXIQwEmtgùwZOúqUUkákJMzùIéUU	FALSE
pěsyǎǒòKDkIOPlFGqvmFGmfserNǎniulYLdmá	FALSE
rsGdqbkOáSAvwkuJQIHJsoUbbvPjtYMPQaDǔK	FALSE
uYwFhnúGOgmKFEHǒRuQPyǎùOdsMáùUNNěóveZ	FALSE
wueǒlxfAǒóàQCùTòZQfAKJzSLǒthyzWMújypt	FALSE
ùàǎaYuRmWrVúsNTlikèkfDTVcXhKfkfDuPǒpGU	TRUE
áLùámuYatǒguvAxokièkǒdyǒcLMpvRQpjXziBU	TRUE
ǎigRGVnqEEZSFaxKFZTTFlěfcGWcěkùàǒzuùjn	TRUE
èaRáQěFIGelQEvXCJgUVZMDèOAQDraZUVúWkHX	TRUE
òMxipgaJKvYhBpPpENòvbPLótzcHdMDSòcùBPD	TRUE
AúǒMasiBHDlayǎDUYlNkSbtDùyRbYFùàhqǔyKW	TRUE
CxGHWKytqnǒaTonúsXfBgdHblSmaTjBmMuxcRY	TRUE
FaúZúlONaPǔlXóPéxèAqJcsáIxAhXkǔMlMééòé	TRUE
ITèèiMàyǒFaNuyǒmhǎOéQguqúsSiOnásnúúnFè	TRUE
LáTrǎmUxyáEIJOháRYGàùxòiDwnǔlUQWWBaéNK	TRUE
NMZaRqHrTéKàegldLtHSxáccdTOUúlòàbKahiI	TRUE
PzrljaWáSLQItZqLehtdtùáùnVSvùLfIRhAàWo	TRUE
SUáhaàujRqiaDxZKeGózHxróàLezlJdDòZBksO	TRUE
VHHéGSCabYJnwUJòqpajáVITtoKAúàhzaXTěHM	TRUE
XxFQKèáǔMjèéyèaiéCqvHfxzdALkJZHBQmbuuǔ	TRUE
aǔroBPLIǒySǎHeggymTyvVǎiJgqǒoéargBvZxK	TRUE
aUNxDZcOUyòoaféùeDeqIdrKGVfbnqúFHhbCMt	TRUE
atfrYSCBFófbFQEpCnnǔxLusàyXùmqTTwyFtuu	TRUE
iIohjpOéǔMsSiaLěShshGwRNVAòòxkgzátEEGZ	TRUE
kogèMèWáTTYGwVǔórOmNYiamnBqPèciNVKgJLl	TRUE
nYěsgNxTwUqZhǒjTòPRYrtúwǒnBwQENaXXxdMò	TRUE
paemqDxSetYohOamSXYGuriNaShEBFohskGAúD	TRUE
sǎrTMKTFoghùzqrǎùLVpǔàwàjaRSWxCóHohǒbh	TRUE
uhhaùgòUuOlùffǒéZaxNèFFRóǎLǒggMsǔXgbéX	TRUE
xLEéVoGérxhgùMJCzJCoaFeBǔYhDvkDAgSóPyě	TRUE
ùǔCbVèuěkYěètuǒéòAFáQzVqYhNóxugnbNrwsc	FALSE
ánpǔǎRzgGhǔCyàrNNJsTYpàmcPTuCúúXfFàZZh	FALSE
éEdóěhJoBqWAKicàYeXxǎdnRázBJéěujǒJcmHǔ	FALSE
ěFFvwfZlVCúaóěPnKLuEUèSúmèXqjgZHwqzaeg	FALSE
ǒMCDdFTqmVǔvNǎMzhéROFrWwgSxiQǔébwGzkfu	FALSE
AsyjúHGWuòóXrofyǔmhryvǔChyAsèFèèDDGGéW	FALSE
DVNdOQVyJIQJsaLázàǒXKHSZRáùOóYGQeRhekc	FALSE
FUuMNóEèdqOjmWBòEDǎoJoGmlFCúsZàSkjòYEh	FALSE
HiàPuLǎZSuádCvéǔAzHpǎcsOiMAjJfdIKcDuqA	FALSE
KǒlélmSyUDCGMoCáBmvQEeùLúisDaTbeCùJQPK	FALSE
MnùcNBǔéjFfdpzJARKYkNúeNweèrQeryddoGáU	FALSE
PUgGEbkáàxdànèòIBhóaǒUcRLAxúàxětǎiNptó	FALSE
SúvòědNYQzNáépRIEéogUpiDtǔWJQàǔeFhàEèX	FALSE
UVewUoloICXOóPSgèPPpXěBRǎYHáDovyHduǔze	FALSE
XbNWGOKDuVHUOLHěQàùKazVrzvéDHWkZUzvěHv	FALSE
ZuQsrVjgLTUESBhRcHmWQxǔóxNxppCTMNwǒbIá	FALSE
dòNxlDIViFOéáETSBfUúapSvXhěèEtOVMgbOzc	FALSE
fKlSxCǔàCwAAPEJciANDjoáKyéyYeSǒéKyelRI	FALSE
hPImǔjfXggáYlGFhDnXǔHGWMXqùvbWDǔkǒDùeB	FALSE
jxǔèVòirnjhypZúEàrrǒvàáxMvkRlBJqèxRUcG	FALSE
mBdwywvlpfBóMkmAscXtNKAioàVmzqdaKSQlóZ	FALSE
ovShZgnRLfRóěèfrTnnOmkRěHuUràjNSDècdlw	FALSE
rcMzYQǒTJwgrKCQEeNvòZcYàZjFtPgMùkHpfTy	FALSE
uběgwNcKdrEwZwbvAzǒúLQFùiáQkBBXIqgCInk	FALSE
xDsQUwùùbhàúYFáHǒHtrCóMmèvcVmnpcfrmeQò	FALSE
ùùNLFgnaqFzpeákQácRcuJéjYòAèZHEEZJWsCuw	TRUE
áOoOàmoLQóatáLjzQLZqTSǒioWotXúeRjCOIèky	TRUE
ǎmQnóěJhywzCóaaOvGwUiUácDàSsfxOxoòěěùtp	TRUE
èxhòBIEalUgcMǔàFǒGJóólbIùrǔgèuzElǒTNnzl	TRUE
òPjtZXMtaZbwpOYhmTǔanǔàWhéVDUFǒXUěJIWzp	TRUE
AúaJXàfǒncéTdAúghYVòtKGggApEmòòùSKklqBE	TRUE
DómgóǔùǎéavVpEMQUuPKSéàJEtIběǒNGeMXǔúòk	TRUE
FkNkEAWVTZENIoùIQaoKJvuhWoqòǒuJqǎADciFj	TRUE
HmIgaRZFreXwLQǎPDYèiTzMcàUjUSiKràUdǔúWp	TRUE
KTtzkhajéqeTLfNojǔWSZhgpSKXjFoKYkcǒEvmá	TRUE
MvUZPqGaooBǔUHóXQěòAdOeLhlGAújLEódOǒDyà	TRUE
PGǒHDWVikaOefEvBTDmrjéOòRúùjvnyaEZfoVJp	TRUE
SǔKzIHNSLCNCaóálCTLBjǒIRICUǒGRFǎědoZòjg	TRUE
UwSFLOgDKYaARcávòXypSlpgOFǔPvMyqáNCpGcu	TRUE
XhvOaINěQWyěpPàcEkDóskXZKYOòtRǎNDGàHdnN	TRUE
aèǎgòOsmexczIIàRUnàáUeMZUPHqvàuWcXHiFDǔ	TRUE
aTfARáciúǔvEěFòúrznvRnókeESMgOvaMUèPtHf	TRUE
avbSOKUasCybBfgkQZvLHpWéfǎèNMJòeJǔiVoZǔ	TRUE
iùYWiFpgraihxyoúeùòǒLaZZqHBHFVSjsaECOèq	TRUE
lǔsàoiHǎvaLNvqFóàLMcgúxPègLòòěǎuFóGLMEz	TRUE
ngǎàutTsixwzàxUiFùwsěVWqQǎhxPiějkIaOWrs	TRUE
qájPsENáǒuVRǎMFěaUǔpjOqCMTheikùytZrPfàV	TRUE
skzVslOjNèúVinFXòǒàYilJěrsèGùYapsórzIGó	TRUE
vPoónRhjFanufórauqóòSòJdyrYGCCHiMRUyèRL	TRUE
xarNobzellnFfèàKJbGJrmoRvQjéGkUFpRGDDlN	TRUE
ùáyǔPòJzqwrCóLsOMEmáěeizTGvǎUéOvéqPZǒfò	FALSE
áTNtbWókYSFnaarjWfuClvHyaésàEVùócWVfYhU	FALSE
ǎmuPJJDròěcsóInHTovHdaaVHpòpgáxaMMaNáěU	FALSE
ěXFZqérHóclhbbàXfǎógwǎàBWjvNhcXVqGYássh	FALSE
ǒDcPùSovMeáùgSbIeUprvIyRǎnxàǎXICNéJdPHa	FALSE
AkGtXGǒgsKòppèuKfnQgCzhnHeùDYSwFHhozJRR	FALSE
DBlRsDǔOCVèěPmSAeHdqgàěCEBPěHXTUǒǔèOPUD	FALSE
FtiòLmOjdCǎúmonREoYǎICxěmkaSevLzQèMsJóm	FALSE
IMóOAAuykěySPXydInfeYbàbǒabáufQoPPkJuJg	FALSE
LCIGpdǒUcBQlHmMyùmwUxMatRlARóxlqVQóvcǔg	FALSE
OHpIPKùbivVXoPlfècRHnMSQJupHYbqOmǒJUZxO	FALSE
QnSPIFhǒMPèIesENoMXJpuAYRIWevicIóEBúJly	FALSE
TJěvRRHJRéǔoSPUkWfúUsSjlxéYǔònGnaioóBèM	FALSE
VrNVLùJduNPAprǔqUcéOǎxYFdàemZvGǔzPǔyXWx	FALSE
YòAHbWzǒXpdòdhhǔtpabSHOǒqWyGazKIóTYQnZf	FALSE
bNdǒadPBPǒtVudynXǔèXáoèXPKzhùórZVICIDǔZ	FALSE
dhpchKtfàyPfpMTbZGXǎltSFóFXZèǔrMvTJpDjc	FALSE
fxEBFàYKgaYánmftxyàkèXEǒlZPEsucǒVfiiòQw	FALSE
iBLóébbújAFùUǔEHúhOèǔOhZBmólBSPkcLGrUCQ	FALSE
léùòèXXòkmàDòNSyblXǔUHèúUDPjQVRqDaKSWjá	FALSE
nbGcTOlJǒiaùóǎIùfRMjJxmtvtǔQpzGcrEǒJpFW	FALSE
pyXHǒZZSBVglǔiknnMbisǎxrGyTjaRàKtéSùHzm	FALSE
sKjWWyèUiúúdiòFjWGǔúmhbévòXMHédPZzVtdmù	FALSE
uuhhóèAVfcèúěxóǎúcejqSxóKzmhCKǒyěfgaěxq	FALSE
xéGěAwGBiAHzYzhvnZQNiHwwADkcueàpǒòbOIka	FALSE
ùùóhRtuwúájDTBiéRQhpMxapOPYjsPcNUKFZDeSJ	TRUE
áDPCQlaMhIiodVktjyvNVràymDLjevtiLèFQHYaw	TRUE
ǎrJaiéwyXCeFYXrQuGjWtwǒTèkbyXdáqùfqnTjwf	TRUE
ěěCFLúùyEEaAXxnqeFfxLgsZéǎaòGwxéyGxxòUnD	TRUE
òYaHrgkǎlZúEěnLǒéòùWyǒèTtuQGtnùGǔeEòOǔuH	TRUE
úqálTaXCòKtaúadémISmázmPWMsRàSoWkùDSPlRó	TRUE
CIjnFǎzòzEXǎVTBaIéóQRǎOkveúJHWióVésdliPM	TRUE
EgPRrxPJqOzahbIaǔǔCeTOwéGOMěJJǒpzwPókJàV	TRUE
HCiEKérabèFKNbbeOPBàlViǎéátFuZEVóciYkVaǔ	TRUE
JsMzwXvTankEúǔhljkěUkógúéTmOwhFpóǔRTpsGs	TRUE
MnZǔaHuMLHXwwteQDgěALcsǒEygWjllTWsxbBòdn	TRUE
PvaGcdhIěiSéGLCZBámevGóyǒóráaùXuDLJkMePw	TRUE
SQějZyaYAéagXEKxwEExMLhLxgxkkěgáWtoGosòs	TRUE
VYCǒwSUèkKóúaPAáLòcáòAVpòHulyyTqKWIkmnnB	TRUE
XsuWǔzCkmlaaqúéDkwJǔyjFdǎddgEfyMjBBcǎBAW	TRUE
aéLǒgtùènAebǔHpHxyàjQúTJvMptlePEChpdfWEH	TRUE
aVrIèMGtvlUCwvNhtwHámhiZDOtJJpoIBCCDúFúh	TRUE
auVǒIOShTǔúúSiZjBErCèHbèbehgéwlFuàúǎrLày	TRUE
iúzàǎlBswaCkiDClǔàXYViWCSkǔKDVrKovvwKeDx	TRUE
kVǔTùamxúeWImbòáǔXòúYFògùBegNZǔvMGldvCdh	TRUE
núòmkVǒoWurNKuakIKsqsèNoSNcPùHypOwqAzhno	TRUE
paèGtllfFBiǎáoFwùfǔPFóyWáWàzjqoeqDDrAVcu	TRUE
sMBáIZrZwWégèaZPbSGHàzQGrtujNàúyShWYqBma	TRUE
ujarxewRǔFààahVNkFWaùàákHkZEtccMsubǎVImò	TRUE
xNryuBVMúIGjJQXUpòjàrBJGǒINsjéjèafǒCBhhé	TRUE
ùùòhQfEJlnGcBPIfùJciQúOVceRFcFBùrqCIaMTb	FALSE
áCjXTOáBnóxùoěvělVáQùnàǎàPuYPbtZUdTsónGR	FALSE
ǎVjJEfòIùFddqHwixBbyddoPBhuPtdRkuàKaěJéě	FALSE
ěAPAHbnDrěpJwWǔěbúdèMfDveArRfuenpZbkmAKa	FALSE
òKǎYOqUlúZFTòmigBgráUBXvNlKTùKrěXmTJXZFk	FALSE
AáùHóbAódyrěSùàfIaLxUápǎZdEftRDǎaásWupZg	FALSE
CoDlOdéQMHkwàédzěkpScjQóngláscECwPUzǒěmá	FALSE
FJVXqVúXrsOǒOfnvFdsZlSQéSYnáCBIóMTjéóVFU	FALSE
HZRuěWáúUZGùPPàZǔwWWjǒcèYNǒGBFRúóMwHcMJC	FALSE
KDáyYǔuhUfYǒAztYuoURvfQrNyiODóMnóMěpHVsN	FALSE
MiZbFxIuHEmaMBèYělMFuǎAǎhéEluùerjpsrYRWá	FALSE
PdùMDztuoǔsaòLěEúdOǒèxúobjvhFdMxqoǎXxyNM	FALSE
SSVwúǎSFVglJRxhQmcsUmnSfBGVldRCáóOcchbfJ	FALSE
UzHmvwVIsnǔèQZdnePfěetěHjNuvsKóHPwjhJǔvJ	FALSE
YǎuFLsùKèǒesQcTjunaCdQǔkjKOKGTAIVqVUióòs	FALSE
bujnTsSàǔǔùDàaYyeVWNfUkǎMágZzpQKéskEnfèI	FALSE
dvHMfoùERULSmTndlDúPòaCmùVtJdtwOrevUzyaY	FALSE
gèPdféùkěxěiàJgLàSJyùxAtqeIǔPàrWúcǔJQJOó	FALSE
iNbkMdfLtJéfapàǎCuuytiáNMYRMTYjhJǔiòVUVt	FALSE
kcYiRJmPzǒlóPcCHàvLTiHizJWKHpiTAdZUtùFKT	FALSE
něVSfApZHtjěMUASǎGrGsLKqJOPnóòfMVBèTgùyG	FALSE
pnMònfJǎitVaACěQigeàqHshmùfpFtCràxPzOGLV	FALSE
scǎěCqàNúUéWyUěKdàIErěAoséúmRtèǎǒǎěěàFOó	FALSE
unqgKJlOqsxosPJPVbcTěáDSǔmèApdZJEHgKǔCǔu	FALSE
xPǔpzrJǒYkyHXqóuHViktTGXlMQyzUǎéTǒěGybSn	FALSE
ùùOoamImeèlJMcQWxRGScajWǎWWěTVòdPrǔéXZfkF	TRUE
áavZTSIxisǎHWóóCwGfMòHáejCRócqtfòqèpzsKáD	TRUE
éFKmzIǒuzmFéNléCarTrùKXOCBAMqUúZLkRMpupez	TRUE
ětPRNayùvmdOKùhPygXIZZWǒBNeEqGnpytqIKkuvu	TRUE
ǒěYpóǔǔkòaWVYàEéTCwxàpuHKǔSniGBurWùádMzUu	TRUE
ATyZoxéwTFáǔgRaqNGǔUAgkYHjCOrLǒBǔLHNdàGKr	TRUE
ClrFqùhklsaZBCuaOnnWZNléNXsauWúKkcwYKjArX	TRUE
EqqúRTgěEùaXOóuoDbAKUhKCwfEBaLxdhòǔJèěmAC	TRUE
HUúNàEsPtǔjxMqntJaNWMUFleěYSebbǒvújEúǔQqá	TRUE
KóWUUapRHVGhYpěnCUéúnMùAvGTwMóWǎàHQPNǒHKg	TRUE
MméVTmikWGxuWCakNdòsFDXPxMkprnZǎéUbdyYXAè	TRUE
POsYèTqóùEòYěaèViVDkfúgWtltortuKGzròIDòee	TRUE
RhMNRtǔjMLáùlzòúHCaFJSgéBúlBcgéàBtmrxQěàS	TRUE
URjCLMxUaèyóáUJPRGPúúNPpraFIgybmkMijǒjOgè	TRUE
XGzyOQaRAsfIjréRHTAJévúcǎeaUmNMHXKWYàùPùh	TRUE
ZyòLqloǎJDèGiOàAoǒGaòuàQvzIpYfIKUGfxWhiPv	TRUE
aQMlWfǒmpLDáWvSAwqǒziáwdedQǎgháakvFARWjlA	TRUE
arfjzgFRTgIOVSTTwsSzěhXsrUSFùlàVwpǎgnàEeH	TRUE
iěZawhepUòzBOauGúùmscǔVcàWsyMYzQàAUmMcWUP	TRUE
kWKkPadUpcRlgCcyCòslfjOnmòEONTwqRúEkjuUcY	TRUE
núBiǒǔMěJZZqadděEpSáGwùGqòiIgòùJzRBcfěúzǔ	TRUE
pwCVFwǒàǎGtuZUézZáyǔvayMVrkèoAǔyegkJhjQxè	TRUE
sHoaYERKMSYgYuYDPéupIěXǎWcǔnVwWǔájJCAnBhp	TRUE
uaBTVáòOwKEfKFstzǒBUUěydvPJPajfcǒyGFJǎxwZ	TRUE
xJǎCtaswToáNBxlaKyéFRclBYCZqfgRlTYMDéyKGj	TRUE
ùǔnRfuXfolsdóCiùIYXSuFexlOàVhlUpuHNWjAáké	FALSE
átPPsEXuxúoBNàvGěààxZKhopǎRCLpHmàoOXQgtàg	FALSE
ébVǎFNóGYqAùóùzfNIFěUegǔMǎCwwwAyqfYJdLgKè	FALSE
ězCòepXgBgtLSklúàTExfǔbzNyqbxgfbòújUzaǔDD	FALSE
úùxeCOXUbUsaeflkTIJurórdǔúèCsKjVwgnRDfjóB	FALSE
BUǎHGBHVzWáǎxwvǒcayòéivcdZxBǒTHTkèQwòBcWu	FALSE
EHLCdMUdjKbVWAcjuTyblpyTCmdéǔySZWGèuLéBjǔ	FALSE
GróIjQWǔpàDùoiEbrcèayWǒGhǔuxmàmAblPèǔjiàF	FALSE
JACpeVUMàLIáLápGhJánjSǔWnFjVMzzqBnDBXajWu	FALSE
LUPǎulùxùORhyjOwèxLYSwAiùRdXYòkùcgaqzbsJt	FALSE
NohumpQHBàfHAJuJrFxoTBFaQméuTwFjVǎrxúWIWr	FALSE
QPnSvuYèkásbFPTzvòVUtnsUBxómNDucmYkQppLmò	FALSE
TWlCPzYAóPmiwJHBǔfiùdeùeopòiàdEWěKTEZvZáG	FALSE
VoXbNTGxYoáNsaeèqóPHòqKXSfZLAbǒEǎFlQaGvFq	FALSE
YVěVǔMeǎiDRBuZòIwèMúùúěSTVLGXúǎsùgODvpGCl	FALSE
bgVSdVLYnxdxlSaúRIHábQǒEǒzQyzrPhsebYrKTwc	FALSE
dosmeUgǎCWècDTUóOCqféytEěRǒWqQáGòuiéEěǔkù	FALSE
fjEgvXǒcQǒVzVFrěIAiciArLCJDHUidhěMóvěpnWp	FALSE
hpwnljogYNYbiliIUuCkKnMkWiEdBzkUJǎáUGwǒòǎ	FALSE
kZǎhrsbtěJSBMaùQóěwJKjeónékNJèlISuCIRdǔgn	FALSE
nKéǔUUOqPWùUZteIVgèYKWSQěGBJOFNyUǒKRFyIgC	FALSE
pZMHumLAIlàéyèYZeaDoUGBDaQLuòzYùqOBTKRAsn	FALSE
sáddFùěgYsùòuEuDSsURsúEauǒqóEmswhOvTeidfL	FALSE
uSBkèTTZefrùtjKankaSNóADgúzòbPáQézUáCuloW	FALSE
xTyCRlùǎǔWRNiwRPchQéPVoFéfQùǎnGbDZhVohoOp	FALSE
ùùòUOHǒJraǔEtDeKNHúREcZězBrUMèFkOLWUZúuèWs	TRUE
áWKúrǎvěááYQTmèújitavúběhàoRZácESqFNhúkGNQ	TRUE
éěáSohVrhásǒHxaUwrnàARNsDdIZiZàPqUdVXTZahè	TRUE
ěXTǒxáèaKZXykòeXJtǒZèuqyáǎxkàèjlTYxHKtqGhF	TRUE
ǒCTUgIzzYàèqèWUQTzvpmùBTvaUwIBtfnFéEFǔbCèN	TRUE
AtFHztEhaáfkTXGfZIěLYeIBqYùmvóvLRtxlpèlgfd	TRUE
DPtúCúǒǔZEIóDVúaùezábǒpásTGMsQtQzIRkqrNVCG	TRUE
GóòGUùoFVIhòùaCLKèùDUwCqnclrcIbWxxJuCkKǎma	TRUE
INǒWVxGZgafEAMBéiWQNtWaVKórExOROVóuzxutǒQǔ	TRUE
KzanǔXxàASNVtAoOèBMDHOdroEbjǎkHáOBbevlUolz	TRUE
NawaGiYyjhCQwòhgqòaKsvPǔcùBlgIZfQHúZiǎvèMH	TRUE
QQXaYaZJótnǒVVAQfVǎSǎNEKéMǒEKWOtFòwHǔXVzhr	TRUE
SsiqáaXsQIgXpNqAàoPALtǒGWVxfEMZKIawqàbVqqt	TRUE
VRwapRVCàǔbCnYMihòděFáhbKYsSYywfFùEgzrYomx	TRUE
XsYrnYJYJMjèCAaǔxùtJcIOmOxmYúZxSpzPUqǔfftU	TRUE
aàAcnhyedóJnùEáLVswBJieùZjpjtRTZrzónXdAǎhǔ	TRUE
aSxáPIGfBeǎáǔAyBLBSdèNfóRPFùXnvSslOuBMZǔIǔ	TRUE
auóllgdóhZèiúNFZòáQckuqcryáóGYàEùéQErtAGSC	TRUE
iǎěOùwBèGstóoàBǒptZEtwQLUGZOùsFzLaEcJJXédA	TRUE
kNòFVáuǒtMaPZrHTbeěǔcuEMCeúRbMǔKszěpFsKgMC	TRUE
manótnéZpKkqGwfǒGGóCfǔwrSSàjúólWwuǒegImaáě	TRUE
pKswPgraDKEOYwéáPwWBzbzNǒfěKuGhdbbGCcqMiPT	TRUE
ratvxdpèLEkRnOLZenpoXGàveSCǒDOiIhrwrYlAFZM	TRUE
uUxmèKhADùkǎtEYaRNKòajajLǔuyOCàXóToóvnzèdP	TRUE
xǎáCBǎéinaGeKjamlfzrǒtbuàHeSqvrvEóXAwaèáěM	TRUE
ùùjPǎVEfHCǒTODGDóJiKkNxZUNMtúpPFZòAibXWǔvn	FALSE
ádǎpSXOǎàpjGùDèbXnéùóǒànmgzheobǔkǔwmyzxNAI	FALSE
éNXeLmNnnúZěúxěWvèWLHiGWǎlDGròúnykóosaStyq	FALSE
ědgjPSàóQùZugpòKrSoTtATálGcpPHbdwOjáhCAédR	FALSE
ǒDJlDBbRMhURǎCBFyqiydaSRlùIAòuHXqJSfNmǎVyy	FALSE
AiǔFááBjehéUkNcqSCRmqcuiDúǒèWjHùǎcRnèlAcqY	FALSE
DFTǎUvWUBwXúbǒúàjczxwoYuùVERABglfzqgsǒKHfq	FALSE
FpTdGòesHghǒfǒHaJoIZUJBDHǎáKòèPUǎúfFCEiWNC	FALSE
IoUvúáfdJǎwAlinQWpUWùNPXUJáCMuSyělaVSMudaó	FALSE
LNXisHòuKFNLeZEsóWvcNYsòQěoúmcáěǒOzChfxJef	FALSE
NQHzǎúòDEnAqáfcwǎèhóFAAqPIègZnVEdTǒhoCgDóá	FALSE
QeoyWzobDvèDǔgáhIbFQvKOaehTgOFEǒVmàBàbǔvún	FALSE
TMJzPCěvòkzqgSkNUTvbGhUvOxkHeJYòvjZBpYzQXD	FALSE
VpWytNTMLdPtwcIzfiqrFNùOUINMXHaiKWǒoávùBzó	FALSE
YIKUNqFwltuTjGbǔFZJxiaèǒNlCIoaUéAnyudtdxBx	FALSE
bcWéhJKeágZBFAcKóàVúbhuTǎfuVZlǔSàEòhtTIéze	FALSE
divSKcǒSgEPáKYEveTFZWnJThúYsAǔRǒxoWuRTBécd	FALSE
ffglètfSPtùmvHgqkQukZSepBMOxmǒzIbDtLǎóKùST	FALSE
iLmrLOědVoěǎǔKZúlNǔxyEbRUyHOYùpGLèQàáǎúěfǔ	FALSE
kpgjQòǎPAgòHóYlǎSVsóTWǎzpwěwnFKUvNdpRtbGYS	FALSE
nXVVHxáòWqXvóLEǎàáDJqMRTHXXYWYflCFrrxEFdqo	FALSE
pxbBUiyǒdWmxXùRǔdYaZèMGQEBlsWwvGiilàěNakTǒ	FALSE
sTháOvùeLáBàQuSgSiJLoDdJnxòZqéAópVóGvDWpgV	FALSE
vJOzuYkzǔpyJǒtSDNUèMHemòxZIBDocVxuMgYXNRun	FALSE
xfnǒQvKjVúZzSùdYùSrZóSQowehaěteNyRóVOòIGSJ	FALSE
ùùáxIěvoxppkàFězFǎqéòMYkóruuxrixRèuoXmzCatè	TRUE
áúhxòjJsYWúNáipxkKiQéCLxěáawGggKRxLWPòLyěWn	TRUE
ǎakEvGxftOqoOqpoJǒaXSKstcunqtKSOrUCvùtEyZUZ	TRUE
ěGaForAFèAGUGwIuMkwfzóaBQgJImbǎjRrZRPZWéBXW	TRUE
ǒázzǎRaéFHeRaoJrJFEcUUFoDwXDzDQqhuqOsjwùKóT	TRUE
AkLJùTjOBaIgESCúúrLSvlYZiwKTgvàòelóqTZǎWhsM	TRUE
DEKǔnzpBxQkMNUSarǔpěòQúǎfwZsYfgIsfTéèTrpxǒO	TRUE
GAPaKiXHGséWtYǔǎFzNnFJtDùLMdIUQDvTUeLRXKěěp	TRUE
ISFaǔqSPpUávTCcgBǔxByHVLèbRFjCNSHgVěGcaǎVfg	TRUE
LòMvFYqFpiǒIěLLvKYSknhaǒmLMáETuAhmvèHqàYfǔǒ	TRUE
NUjaDSJàqlzAcMtxsQCichàvzUDWdNěOcoWxWGliuIU	TRUE
QèàyàIǔacfUějǒikIufpWlsdǔPdPxKTsoMáxPcQùfDà	TRUE
SòzWKxQzàCùMrzlIEEkKajbSSgvkemǒIXDQMPEecHLF	TRUE
UmgqKMQxNúNaǒPfmjHbSlùiúePǔHLGXéphBKǒsTzpvz	TRUE
XPtUapcskzòHZUdCKlfjDVSPjhàpLLNFCXbUeAMGěwR	TRUE
ZtXSHJolmaLCáóUèQcěcFDàXeGǔěFaykNáUUuAmHǎUH	TRUE
aVuOSfUCěhǒQdFAósPFbTsNlóKjěmzYueeYncwVdtTò	TRUE
awRèOuUtStFiǎKLITǒoKàahJEvBhVjTetiIyUcěLBal	TRUE
iTpaYMVyèiunygǔNbùBpdOkYóèMDjTOfúMúxiuDèaFw	TRUE
lènaǎzEkQGòSlMvHyòuURLáúmǔcLFhGfǔlěúGBuFXco	TRUE
nHplwVMtaǎXCLFWávodkbIósoyjSmAóoúkǒRvEkMúkb	TRUE
parDdaHtǔǎěOWXDKEěGPóǔtPDgúùpoRégHKèzolZnfd	TRUE
sUsUgLOAqTuSIVhBOApIǒèówozDESǒNTRaKRVnjjvpQ	TRUE
uzSzáFIGCMqiWéRRXQQCtpTauBeqthQNtUHduGsNYéo	TRUE
xǒIKqàqruMGaùcHUóiěGzǎnétoYuǎUěáǒnhFxqúXNlà	TRUE
ùólàrSSSzúUMepWWKjDcyrvùJùyjviDCàiàSPSldǎiW	FALSE
áMziéFWXEèmJyABéóHJJJǒNààRpBVqrCmEVoóssuyHt	FALSE
ǎjòAQYnyDPǒyKàYpccXblyèbVcàEIxwIDéǒSAǔgùPGe	FALSE
ěEbǒEwyGcoLGmljyZXpQrGCǒmVSúIuDFMjTRàlozETE	FALSE
òdsZOIZvàCógàGalmkErJKALdàWCeèAtuáyúIqHofǔH	FALSE
ALQVeDBZoyIDOiǎpǎvlwàAIàKZekKǎNèèSoǎxòTéèàG	FALSE
CsVJgcáFUvúXRráJzgSSóGǎbYbvcùúqpoOǔqějFXqzU	FALSE
FLóOGDfODfJěuMsjmicWTCàkycChùwMsRaxRhiMKRKo	FALSE
IJzJxNmYoMfǒHMhwvNdSdRqmirbLpCbijVXxLkigXhg	FALSE
LGiǔJùWùKàHlEXwSrǒsuǒwúKWTQVBHvmJDVbtsysèZF	FALSE
NriGDwNIMDbHkùúAWOIRiéCiúOKUlNnznSHxWIéHoQK	FALSE
QbZYěUtMppgEǔwsSoStxáMRKekfygmQyWóUdKFòMZYò	FALSE
TSBcbǔVBwéxfgExájeacqSéǎfhJVWǔExocsTaYǒùrCh	FALSE
VnOcQYmVAtbHVrnmwEebfnWKGàFzǔszjywBOXisACES	FALSE
YgMfVwZBǒNkjvBVcntfOǒweKHYSyvdLSoóyǔvxWgOAv	FALSE
céigNsNlRtkCTnùKdotcioxEvgAUòLQXcússLGtMbue	FALSE
eǒfUmaLúYMjOCgynezqfèojèHXpcyijFWlvGZgUpmgU	FALSE
gVUvVǒTněMENWcjǒjjfJOLtesMOKúRrkéwzsEwuTxǔY	FALSE
jCěTáevcytUPeEKtCměiaHDAyxoFOQsYZMowOMuxòty	FALSE
lRlZXzássrglTvǒkótòSeǒwDMmjSàǒuhàuiOóvZáxVo	FALSE
nzLáVzRQTizuLáéáéePvCóBáJUùwàdErǒhAKEǔipbQQ	FALSE
pySsónPwsQálfésFiFqZmbgeEMHYuQpPQbcúNSěBIǒǎ	FALSE
sHueàéRNGàHnèOiRGBNWjxúeBhATPòVCèjwdgǒAJXGò	FALSE
ulGuUFScěNcbFGHVpéakyaSZrlyékXyùpdsBúXmSGhA	FALSE
xFmYsméAvòilhBVrOYsZkGOvDsbYLùǎKsǔYaLwHCQùE	FALSE
ùùěVaYnúSOyùqryKIlákINxVDVáeYWzSùdézpimUjOuD	TRUE
áúxYyyhǎqBòǒGRZǒùómBgPwaDPiqwknONUfYZOòHùgDG	TRUE
ǎpnUgkAappěyràáItMèòBòHuèRěJIEKzTSFEoPYuSyfs	TRUE
ěaècàhaCWGAVaosLsǔXùrèKQǎoéJOǎTRdělsdLqpTQǔE	TRUE
ǒěVSMpXmapúlvJTLwOMFùUPlictKxZHsJàhjZvǔZmOěě	TRUE
BéFyǒBHvaMLzBfǒǒCpwOxǔěkMvgiVzHFesHpùkràCVéT	TRUE
DZaHFYDQCóúWJoBFnSgkejdAàRabèbYHGHkfvVBǒYǔòb	TRUE
GBagdDeYQzbJKUjqèTCEuMQbWisAANnvGúXoéOSxMZHc	TRUE
JBRlRHIGwBaěoHkúOZjyùěhqXPJúùeaCmAZmiUTUXǒQg	TRUE
MàEáGwùiěǎkèFUèǒZxòaZpóIòfYbMúǔGóùzwèávàcmzò	TRUE
ORQtOOaxkepqòHèeLKféJiuàtJoaxiOQSiWYomǎDsmJY	TRUE
QyCHYkDLVBlpǔměCéùépaeáwcóBǎtVlcdGKbfdGDóxVT	TRUE
TLHLrUwEYLAnHhaCèTVKRélTsvúpvUXZZòměQyěyvCZQ	TRUE
VráHYCkFonZJRLààiǔazYUWNBkVòǎJWǒIǒqlCnùkdòaj	TRUE
YLSMuZVZàéáAabpXPgǔxgNfhzQǎPGèògSáěAsqfPjbSu	TRUE
aúNBzóAdLwTVoàáSbHJmYgBWtcSZútvDùAiNbQMèZWTB	TRUE
abVRúNJePǒáàxéRPGoAWSěAùZMdOEoIdkZSCóQJBtfvy	TRUE
gIǎTlxlDaDxDeuáǒpkxkxYftHbJcvXǒUǒǒlúUvǔgGùuT	TRUE
iněFjaòfaDvcéèjzùTzjXFǒhàfbWCerǎZPKVAAHAEDàò	TRUE
lEHaUqyùgòyetumNéǒèUCrKTgYskPVPRusJoSNǒwslMP	TRUE
nlmBZPzajálcéxgYàscYuyYàfPùrěBVéátúcQGLàpygl	TRUE
qèlRRYqQBóSyuáYpawùFbyiIbXJTWhHfèaálòZDJiVkE	TRUE
sNHòJismaSbeqPGúnNBxksLBxgPbéxúuzDAuzúkBZJTA	TRUE
vADCmnUjAMPSIOraókLMiMGMXuúioSEDInbèzzMǒmfèǒ	TRUE
xnWRàzvmaGèyWXúéGávǎHěpjOMBSéúRòǔáCácKHVǒgnǔ	TRUE
ùùXghéZtoǎkUǒPòèěXdaVjmWǒjffPDvOòQAgwiZZúiuW	FALSE
ámtdmhóutjvetzàfgèòEoBVOněYowěkDxkǒèQjàrunAè	FALSE
éFAEXkboDoAqbcmjLgěgoYkJǔqqùéPRjOkEùRàdXgGFL	FALSE
ěedòqòuUAnnbUOfiWWáFǔcVdUFGWǒjobyùMdCBkGXENé	FALSE
ǒHǒXQEwLhfcRǎéWnvpnxxúWhSZPbiasDhǎǎVEeòéiagm	FALSE
BéLieRYprwgmǒúJUJtwǎNOOùbóòFMHdúGtSáBúnNIoEr	FALSE
DdUCzěCnQVmkCHlLGUoravpWědnWQǒsenkáǔZǒéeáNPO	FALSE
GúCmQZHùúǎEsjYQZáEronlnIQkihjěBtiiéAHSùùSXJO	FALSE
IklQIyzEǒmhhviEàkATQCNmJrǒERZZlàLyzǔPǔGeosyM	FALSE
LHǎǎièppZǔpéVǎǒjKùUiyTzáKYrqGdòQEzcWzIrXciaT	FALSE
NsUIkòPéOHsLDdGWOJDMteoLMEPyQaCòVuàClnMvmGKH	FALSE
QòVRfKátùuWnhǒrJěJǒNOeWfKkNFxIHáBXCZWqjGNsiU	FALSE
TObèáquWSPNéèpvuyZmxnoěfHRámAGWǎùúIiGKaFvAPV	FALSE
VmàgvédqXWIqyáěcPáhuDoxǎjMxkLLpòzBòawKOvǎoéú	FALSE
YZlómXqAIRhlBWZúgtUéeòěbǒMélòqYOHKtCRòDLLBXǔ	FALSE
bisUVCèuadúzágnimYoGDZAzOAoqyMóVxKIFgrxóGBPě	FALSE
dxXóBzZdrákNsjǎdTRwfáwzhuoDóǔBOSNgSqVOǎvMǒgJ	FALSE
góPgJLǔNLStXwDdotrùHHuHOjphrUTwóórAvWóNùéToR	FALSE
incǒwazItzqUtaXǔBjIpòHGdKQeoAhAéRcQéIǒóiCrXW	FALSE
lǔOSóZhxěvǎcNWótWTFnQNpfǎOCràFàèZóoUbgAJdǔVQ	FALSE
oàPiFHFùFIVQrSibgJdHIRCpěDFoAnaWaàgTrZnsKúùU	FALSE
qúǎòwpéJsdQǎoYRlIwkPkǒTúwjSStYVPxaǒKfòUěàBNe	FALSE
sOrYoùbPHSèsOmPFkàònhUǒǎdyeIWOmGwJrTqicqGáYǒ	FALSE
utěǒqnyokàúgWwvCùóegtBMxmiQlúAvagTùWháDvWiFb	FALSE
xnKlkGQfQKèOUvouAèhxOùmWtcIVNǒàYYAfyUWAWNùNo	FALSE
ùùòJLKǒxCCSùyúSguéYqǎBRtPliARAgXǔòàWuǎoawuRSV	TRUE
áMMnjWAWUǒoabjXqbkETXLòfODMzǒJGYědkiběbxxTGǔu	TRUE
ǎaJOǔySsocUeSTbǔiWZǒzàUNEcxáǔylòlsúTLmbryTdRS	TRUE
èuyǔXaWTapNXVeǒákáMǒVahqDDpQdLQFàvjXIJInphHzF	TRUE
òZDZěILLFulgèNmaEfjDrDddoRwUBófàXeSISpKDgDJEf	TRUE
AMaSTeGMmPJsUàúJsEoqcǔNsHARpQOibMlGJIYjbòvfxò	TRUE
DáiWJéǒMSǔZVúaHmǎDXKéZgRGéLersDaiFeIxbwzjLUWj	TRUE
FjCjLLyòFaKfjYdyketsǎcJdèPKpVuáOmHyteDvXèmǔcQ	TRUE
HvrAZěàmTXóZǒQyǔAaXyTtYBcQArVKizSntádáBylVóit	TRUE
KàTǒFaVséěóPOsfúekiuxVJGQOuhBáiuakuMqdeàHNnNA	TRUE
MrFazAòeMOxTiAPéATXCfrMuybtZnxDVmpYLAQuNlBèFQ	TRUE
PkOHMxTXKMBoéaYBóJHǔThqòééXywzGhpodzúáBPsMIzd	TRUE
SKàAzǒSaxrmWsFLRaNyàYZtNjrVèAWóPoǒfTqWYǒóáúóó	TRUE
UsDvvjXvUBéǒwxakcTCǒjòeMNSzhJMriǎmiqsjePZǔFǒU	TRUE
WrSZǔUyǒnǔFáméyPBIkOasěXKyégCunSuAYZAklěeWèMG	TRUE
ZanqáktPLDSvòcBCpsúǎpElěEzpǔzVixOymUVZjMDǔzeu	TRUE
aLdEyMlàrlKwHpICNóbfWtòjVQzqúuZaecmǒkDpOWNEgK	TRUE
akóǔǒbéxRJiLrnYhqVméawZTúkGncREZáBèTkXWVezqMP	TRUE
gpFNaHhéaOHkkVsgZoǔepéPKáThsSYkbdKncùOěrWdWǔZ	TRUE
jAwFuaBǎAvpkcópàécfjJwǔTiEXkPpEFúMOZóHKIéPXEK	TRUE
laHFàáAèXudxrcwXlFDTěivReRsùXǔgnNDàiMcvéwgǔze	TRUE
oanzfiReFóèOZǒOyYaěxláòcógtzJhqpLputAóáejèrǔt	TRUE
rStAùaAzXMyqsáányazmòCètMóuJQlěiuZVTzUxqjbZOE	TRUE
tiQAxLrGDuBHkGúWaǒpDEkxěyMmXAWerjyHWéJaglrVBm	TRUE
xICàTaJSǒESDóMwMénVyJTTazéBsFYóUUxsRIóTljXúZn	TRUE
ùárxzùcPqámàbdmjfzkxAéWàúxǎCděéPQLlbynáúGtriè	FALSE
áUhVgTKrycLHLóYòGxgòECdbtyeCǎóTYéKeRJbCQWBòAL	FALSE
éDvèyéǒQěVfpENèsHAQèGTVMJKUIèFNàQlJCúiMǒxdtmt	FALSE
ěyWqàtEéZshQǔzEǔWEGzwDlHXǔEfDAWHkbFQuVùtǒFèbf	FALSE
ǒbAcNcpexjJhSorYOárJAéXhaNchěWǎpTlGzoèzoEnDKl	FALSE
AhQozéGJIMBLHrqoQfBmPúTqáEcèYCnJAéJúAFùVdǔGǒX	FALSE
DóèRqJGèèPrFSEROáukVUàhèéǎNbBDwěpoóYsaCáZKǎJj	FALSE
FcVUEXwSxRùvbáùdGePemùodCxCHéGXozFXétǔAUfoTCè	FALSE
IEBCbzkzyeGEXzTGszèeǔǒǒdróvDǒJVǔVdiKUaěanQǎfa	FALSE
KkyQvrláèdòkInCwKxzòEtCwiáènZdtjǎrYhhOàWwvlEx	FALSE
MvDBFHVolJěǔmAqznDèěLJAPhBROeAméóVhZyWǒJpaqún	FALSE
PXZjióQXrDQZLCKikAViòcDGtclOYJKVLaUhzóATLxcZù	FALSE
SAGxouLSulǎSsěQqvǎdójEówRAbWdrlIzěóéGXimTADěù	FALSE
UVúUTkgNtwFBéjcCBZBàoFbǎZtDákWVfVpUnbwnGTsXzp	FALSE
XQVdAtiujBhakNCQiolQKhanFQeOCèBBfFáuMBfXrUWrY	FALSE
bAMjolaPTùCbAóOBǒEěùkǒSjsUWXlbRTtjǎraEoǎSYsZq	FALSE
dIuYVexúSěGISéwRHóZKxRaOòrEaBǔFCòAdLSHgǎqúRán	FALSE
fIgEùyMOIEeèiǔDpemOjzKseDyOǔAǔvùóYEEXiàjàImNH	FALSE
hiVòǒeóǔdòòsàspPIáDLJbRDǔǒNfěéeTěAQǔèsTDlzrvs	FALSE
lùivàdsEurluzáǒOcghàgNótiPùxpPtdǔIkěatBgSòKtN	FALSE
ntItoIòFMuNjKQPsǔǔvèzgTyAPAPhqLeeòǎfTTZRJntUg	FALSE
qJFFgteKuqUzǔVEOYCàRFCpCáXjòuERǔEeWyvkVriǔěfu	FALSE
sTeěáLKtróhyYénjzzúvynnèumxDBaFěUMlHéEacgNsnW	FALSE
vIdftZpǎNsèXòjLOlikDhDyUNFJYtODzKZUuróóNǎěsZu	FALSE
xhXwHUFRiBxDhǒXrimàzNúXEèBNàQeèPrrPOǎzSéPwězH	FALSE
ùùgGDEáòúáAóDHCHAióǎnPsóttTyasrCCVLlhnésBògéCè	TRUE
áVěnhsDOmOùǎXWpuùCBuPCnèzhóJuǒAALayTǔroxeQzúYu	TRUE
éCKUnjnJPgnaawEgMòpùòoxáqcEǒIZéóRpEaEsVANTèUYw	TRUE
ěaxécwèzGòlWwhcOnzěRTmnoEMaLemVJsKxqeǒwǎQǒirěn	TRUE
ǒégSnkmMFJoTIEZtkRPùkúváSznDvMaRavóXfHjwdtLPVa	TRUE
AgLYGLgYXWvùgKMěunDCGBjǔRàpHúǒCMXXZWáxaárǎXěùR	TRUE
CzTYkaJyuǔèUSǎKRZàáQYdjclBpKexJBzbEEòoPcěùtpSS	TRUE
FCBúVkjkzaǔCCúǔZkòǔNpMzJTRMmòjjpLWHzRPdùsfèNmL	TRUE
HVagDKqfAaZWoACYdIIQDéqBlLJIdaCKpǎrbKáUǔOǒxJeu	TRUE
JiwLKshxKlaéadaozpVunuǒgQEaùonZeAeIvPFmúSeeXkg	TRUE
MaKAwFbngǎǔmMabhgéǒbLúLNtQPóCxVSyIǒbófjUtmJèpN	TRUE
PǎXlQáàòùZpsyaráVOúNNWekcFWLHVMYědrétǎàrLzkobé	TRUE
RCMGlWORITiCzNQoRújasyutèVZGHgòěJèSúAGǒFòuǔjFW	TRUE
TtNxaNpǎIKǒVXfóéSáNgǔdBoeKópzqPkyowyàlQQVvéàcO	TRUE
WqáóZaIyhRQzùbMaǒqVAMnPuRQDpóLúbúángvbaXvsjiaJ	TRUE
ZBénǔRěuRNnkéVDpěòzéYaPiZDǒǔédàèóXHéglfwmHJòzn	TRUE
aKITTmVJQEóKogkEFMòXZaPmNǒBLǔBgvxNǒQWěOèeaNPKU	TRUE
alRKbFwhZǒéWéSrxóJǔTfekàSAZvWTwijZcAòòtfMnrfzá	TRUE
hsàsDáMVùjprWCIǒDxNòQGIjàòxùONabiGhzKwmPCQASkě	TRUE
kLyàaviuPǔwzSpLfúéIàèHTéFKHFzueXùHòvqfDáéYTdoà	TRUE
mgtkaòàdFǔYUCóáǒYdIǔjxěùcǒàóAàtSàvojehGWIùTpID	TRUE
pòXǎajGFtRtOjNzóóCPhnzTmnoMXtaEVAfUwrYpFocxciQ	TRUE
rtyYkXQiHmuPXvúKMréZRqUxFèǒInBGSGvanluMMQwqMcY	TRUE
uIàěZaXoSHàǔehxùucgmLwaTpòIbZóNělěSúEEHRVBImXJ	TRUE
xGǒtYèěDěUCaǔXdLAtdenRhpohYwdNnXúlgwAsXymàDfǔù	TRUE
ùùkvAYVCbyùCUhqgqǎòZòěRJwǔdáǔoějDáVbWhHSivOpno	FALSE
áVWoEǒQYYòédXaùPXzZiùLWjyNvlBvJxEWùnùXSFǎgXLùx	FALSE
éKùWlgjAiGjàTéjǔCúyéQàXnwbaCOèsKuyWMǒWBwQrnwvP	FALSE
ěnPVbzkQlnwarnfptzgcTVpVxLTfeàǒǔwGyCQkelAnxJsó	FALSE
ǒQPúPúòTNdKùsPBóRLFbRdrkvtTyGtPóèéCASòASnáNaǔj	FALSE
AfeCóRLUvTgsGaàféZCòFKRMmURIblJpdàwKcciGǔfDXKe	FALSE
DǎurjPSQjqxlqcrkKòWNxcJxaKhuFrZfusUNMǒsWWfppmN	FALSE
FgyFlYyFKǔrVCEIppcèAJhQvSkrvAcèZIiúěǎRNwMNùaěn	FALSE
IRrdǎbcjqfokèeZMLeaǎQtDBsRǎxPùgIkakpféǔIbrFNxL	FALSE
KqgBZHlJAKeWUDRuráòHósBuZAàǎBěěùzEgaùácwHwljOě	FALSE
NgùlZGTFvjfhEVùòàMUvóANKvQmiWězwBBjXraJDHǒBmaǔ	FALSE
QWáélLNJLhuNNQXgHzXócrnxeFMcQPǎòtcéfǎgaIafùúqh	FALSE
TAúwIXfùvylRéTǒasòCluaAfFúKTPkBxOěfǎCocǒcMyevá	FALSE
VnùHerZpjònǔUoTSLhMkǒnaoiYUyMrGùbSUALààNayǎTxM	FALSE
YNWòěǎHouéeIjqZǎuKtyoQQúelMúrwSǎúàaRdSěáRTǎFHC	FALSE
byHéWápMkgJAùeCrBDTkdRěMdwǒóuXfjbúàwBdiDEǎyùGó	FALSE
eǒoOeTsgóǒdBzàtKIEEděAPNNuSLKQEfàghfoYLXQcnmúY	FALSE
gWoéósSSǔWzědCòutGWhòPHorlaVKJSWGeqljkdfvlJzág	FALSE
izSvwQXrRiOUBǔUèCgǔNRclfnRipětXvWPvxKPdnàGfOIl	FALSE
lRmWCgǎPYsKèINKěeouKǎIadtLbSwǔTsébXliGèSVsǔwyB	FALSE
nZOLěKRóoSzTirEjUmPADHUAFòwbóhGONdOxǔóGaKěrigp	FALSE
qHVǒéiWJǎǎbRwVkóSqqBahBvǒǒTSjGóǎǎǎXxXDaúklèKJc	FALSE
sLDXHiKqùBúiPivBàxvEdtZfgyVUjAnSTpsugdúZVèLhnr	FALSE
ureqNoOmWuFZunJCygyMbRàPbTOAwdTJjoJWDTGphǔeyàp	FALSE
xRYǔsRuvEfCáNvFEXèsDMgtǒeǔZúóHFIeǔTbeèKDNqwáXe	FALSE
ùéàAaQASǔálkVWAPZnAóPIéeǎǔuQlOxbuMLǔWcùèKPàùAmK	TRUE
áNaIowKxèaǎójYHnOLIěúsVAòAjXTEkaewrluYGZsFǎVGsQ	TRUE
ééNàaMtwhǒxPnvhqZFMarUwNJCdPBmThgùtZanyèàhǒyZyr	TRUE
ěZSnóòàabzHiYtUkOOVkRTzVRNǎěAwMmfzékSáuccèěěOàI	TRUE
ǒVnmiúǔIéQaLǔùèErVFwBNHEPNMpewǔIzérsFXhdúrJHdcf	TRUE
AaljyqedkgégqBeCtǎqoálǔlnǎǒdarKQcTqAxcXUdlUxáMW	TRUE
DúvQDVaSxyWiáLTLUPvIxahzjǔIóFgBJEAènThéèSioZCQǔ	TRUE
FWyPXèaNǎèMllǔvQXIDèRlpHèùàLLgbHGSBáFqGwǔzàuòáy	TRUE
HwVFMZPnPǒèNaùDǔfǎùnuáRxNoUgxCvQQbmdLkénTèGèhòM	TRUE
KMaGóéYmXIALvGNòúuPzúCSFJsFKzbCOrJFqěrjTDtniiùo	TRUE
NYwEUúWPrěqGusEIYXyàSxauSOQYNZǔiUgSòTFPùTbcBǎJv	TRUE
QBxHSVVxéMxWoXagóRPòTQCHNtNWWBLzóOMjLémaBxVgUùó	TRUE
SyaDTZbIéoAsèsSvdzFXMjZéěàmNCwpOrLuuúLǎAtoMaPǒc	TRUE
VhéwiYpyEójZiétMpqhlOFAaqDGùLmovgjLxeFGjPVKàxNB	TRUE
XwlàBvzǎvùiakòHFèLkWPgXYóazGZkqROǎkBgyěNKěvIsva	TRUE
aàúihJúgvHiQTàDoYzcúgHKèNBdǎǒàFMkAmuRòqNtHQaMCS	TRUE
aSFǔlVúHáuuèuàdnHRoqúqwaqàáàXZnfkěǔdùnpffHpJjJy	TRUE
ausYEcOFXtfZNxYfKóéwsbSvqGDàóDPVYgTWsáVZYiǒǒgdQ	TRUE
hVèMQaXRfóUPomùGoWasjSFhbctZcRzPqiùòXaéccLhaovM	TRUE
kèQTXaTpOhtiehjMxgIqLúebaAeèlLAǔGLǔMúZriBZmbàóU	TRUE
maeěLDfaSMHKVSXholláèbuHCRspEQǔeCiěwIBYhMzqgAhǒ	TRUE
pJQakàCDèOIDyǒgFèóúǔEFùCuěPeáCòBwEàPLIàvbVùputě	TRUE
séaBXǒyBJVqěǎòCVtkqaǎHěJJMéZLSòQerèqkSFěWPdDDet	TRUE
uYmOCHZzǎQlměnkvhOCaěkyjǒjTJeqrěbmwdZtèPfkoQRúC	TRUE
xEUùHěMxàRmyaIbrqúbnKùwNurAFHRǔapFǎuzTVàUlcǔpéx	TRUE
ùáUdfiWjǒvguǔbUéTIséfjxUtTmDIèBǒHWDzǎSǒHssFlzER	FALSE
ámsTvJzèǒXkYKgSFBǎknmsLUnóeEgoFiQFgjNPendFFZuòX	FALSE
éèkxbXéKmhrǔovpYúWééIqwXIòWZOǒDKjTygqrDARtoZuNc	FALSE
ěǒeAsQuǔěFuwwPAKùsWàQAWxepSáfgFàMqKUfWmOJDSUExR	FALSE
òPQmZGmghcGhGDóòuDxsàǎháGZAloydUSGsCoxHUDMjiǒrt	FALSE
úoWIQpWOeeùenqVbGbaǔwqFǒYěGAtómUglbátJGgUiVpùpL	FALSE
CAscZIHnGJhjmùwnPjMLJWharóOJǎFiSnhróěiScOqvVkQy	FALSE
EXuòáàǔRncuFFwCLLiKZjWHBCoúQěpKmTMwlINTzGfWQXmé	FALSE
HòOòGxSVOygZKòǔwsvQSsDpbzoènFàdRzZtqóIàoNHgnlJY	FALSE
KàNYòúǎRópvRwSOqjmǒàbTmCúfěExIqPgzMYsEtnòhSeWyB	FALSE
MrzèYDmKáWdhHsoKDWméòǔdàBWòVRIuccPeèdsdJǒrwsFǔC	FALSE
PvACyMufOTjǒstyiJúqLqfBbWUzUZggégáàUTáěùvVEqoùn	FALSE
SMYRxyIhPjHdóBHaóhTBsNWKKǔótDEUCFàéhóHxGGQBǎkyě	FALSE
VóàoCqéIjǎrèCXǎQGòǎvQezǎscCTsxxvnddCmEnqDcmHkiV	FALSE
XigtcǔjóǎúAYWInaRkNHǒiZVbaUuwnZádnOHhJLlévPaHNA	FALSE
bAYúzsfJHwxáEOútkZǒMZòcEfGXLkwǒLqnSYòQoWuáRHàWt	FALSE
dHMHùzWoZpěeSvPjǒNòNiágúàLpàEEZzSPdESáZTmeQNuzz	FALSE
fSSVòOúyóGdjRkwǔGoòYsEOxOǒLhGFQóeliàKfjyQJYwYvH	FALSE
hcWDvkJěòáùLcvnlBsbjuéZègamééyWauěùózSòXuvnKsnJ	FALSE
jwàrBNQàQOQùODOvàTOszGjKvyGásOLggwPgHJYpúòIAAut	FALSE
mRNLvfyXdhmòDNóOǒXRhQubWǒxáQJHàdJqǒtKxBWiánuSòy	FALSE
pùeIváònWUFDieNéJvWyzKMNUòlLkLdmHCoefkCKòRùJTTO	FALSE
rYjIvFàèpǎKósǔWpPbjDèǔéCIYàcOzGěPdyYiǒQFzúOkNóp	FALSE
uUWéMǔKBKfLzFòBXmkmsrkGEVròǔeXmlselcMFCcégoSNHE	FALSE
xèyJWǎSnJrdEMjKpxóHuyrOOqckMSJfXyqLbxstDpPPNáBv	FALSE
ùùXlpVDpmúCgàòùhrEQvIVyàrIěWOěùxwaNèARmBqujEǒHxò	TRUE
áaXAAIEUòcéǔokyIxmCAěcIiǔWDěSèYTrEWxjwPsWaQhwùWè	TRUE
éPòpTjknURJiPqPAATěSXPnUPBYxéRQacklLúRarodtéTFNF	TRUE
óǔWCohArxAwtKSnAisénKnòpagsiǎLRùMDSwAYjcjcfhRǒyv	TRUE
ǒaDàEapvTdùGuZVHVòUeizRwadYúYVkLRGmTCpBǒááúanFěJ	TRUE
BùOtoayPqFQDFLuùLGǔàómcmpVdxyUvHLzuóShrTVnNIxuǎà	TRUE
DYáappògáěùuePYyúèUàjBXPxùHěctéócIsèlHúSqwzSvnpy	TRUE
GCPzahCàJTQzBúFJtǒáBwǒOulAqJǎwDàrlFMIpWAwókéEyJo	TRUE
IaVOvFZPaikZkzXsúlxàKèèLAúoWyKseěiogcCeguBSIofTU	TRUE
KtjaYuUèbGEěbNZtafZáePIqióSpxògCěóBáTDMMtSDXǔFbN	TRUE
NTáWaǎxáGUǒuCsbpJSùOóSLEoocYmFBěeèǔIqǎúDpugnEzWV	TRUE
PoQXiMMǒúhhǎTPTùiaWùUǒmNMUjmIlpgzreáLáèamIPBnkdl	TRUE
SNèIéùOPslINHtǎgGáakSWvluOFKxlXooMCciwYqNLGspzmP	TRUE
VěùùuqVòjòQxYNtúIélǒèIjséUMUIIXigmqCxjFZOXLèlDsa	TRUE
YóhEXNaóúùfLàpózzshèúOmYTuǒvèkXDdwattWSTtóǎXěQta	TRUE
aóFNyfotZZǔEOwǒliùxjVwYMDǎBqxEfeùMXjYPtcgtfvWtof	TRUE
aUtǎwLhUkFòàQNNecóGèiTwgVěRùwvDJòsGnJwIùGauQWXkS	TRUE
auXMibfóaǒgóOINsláNeYMǔsakùMOenSKQáafǎneNBjFlòǎk	TRUE
iéYàViàzHtWěZwpTtǒZnmTàadEqQJǔǔwguZgěSBJstICùhúq	TRUE
kKxILttxahkcjnptDHjVǒjpócdkFruZúòobUiùNQqLIóAkód	TRUE
mjaPIòriXaWXèNvdVklsCbZwBàGOúPsMFDUJGNKhgRrvLatE	TRUE
pgǎaRGcNDLhRFipDFMCrSsXrYEùnTùoIeJkGǒmlEIIDqkxeN	TRUE
sǎMaóhXgAáuěáNòlSDrǎyèDzòHEpZvDHIOVPjRwSléqěbxfY	TRUE
uaùóVZúvEjVllSFVijTZyXSYTǎOCúscgSNéDbqPǎtAOúaxPg	TRUE
xIUaúEǔAzòpytOwàXEYQzèydUóǒěèJYFXhJCxhèDlsUklCDZ	TRUE
ùàLBéTUVXùLBTǔGnrPóxQQIúnlsěfcZYěyáGBjjreFzEdpèd	FALSE
áWEòǔnwkǎbuzEPpnèZVèivgǒpàYJàJdZuǔàBlnsLrwKsKgHj	FALSE
ǎwdHKoMfcáróLxHnGuteCòztvCTKywDihLlùnHèUqTWWoXkǎ	FALSE
ěhfèPNHeWkDnbCeoQpvRboǒzàoǒQHgbúVBOmIWxHnmFXSùga	FALSE
ǒDMBěBLRHéYUgBLkěSGuBDJǒBómZórRǒPáMWKúyfzOoǔVQcM	FALSE
AGrzVfLWǔOèàlHAOǒCyOZgàHFADEZAByEuiOfVZsNoctǎbsX	FALSE
CvMQhDKVkǔkhdáNùwOèqěágUtNòZsEòELjEMGJIùmsRjáCrú	FALSE
FJhǒmOùpsQáwdQRAǒXYnxDjVCDRkKBYzyOssùnJFAcVmPQPX	FALSE
IùlAeámduóKlàhópysyWxlèátxHoiǎSófhSoxnDneHUomflB	FALSE
KlútvúhdGbúáSiRDNqàpdeQwǒcLIséSVTgóǔDhLsěFUjbYpV	FALSE
NǎziSepáWvòlfHOvaùáyFGZdnSTuPnCrlINGdXvAcBNRǎǎnA	FALSE
PRqorVáKWXGqkCNtguPeUvatùgPSinfDuápJmáúYdàúfKCEd	FALSE
SLctcbsUqéQvrqTsVázKóHùVlBSbJQdqHquǎJYNUlLnGbnVy	FALSE
VǒěUNptyjěKvpóRwòynppqeTvěǒGnDǔpGotZBcrKHDtjOGsV	FALSE
XvFsZAJóòAkRzccǔAVǎiwkCTrzKǔChyZSPRěéUěSSxayBěèò	FALSE
běěBdwZǎKBQJSúnrPKDǔRTóúXuypmèFgdNàlYJrUqdykHéòP	FALSE
dEàmjTfnBEZxNEgpùQbdHNuǎrxdYDYCrúwGyudVUFuqhYaZe	FALSE
fHQuKITmMJipubGXaknBcéwcwoOKùeàróMidZóixapCsáVSx	FALSE
hmEtIUTvHFxhYwèRsùrǔǎpNgwUBNuUEdaCzùpéRXèIǎnmBòl	FALSE
kuùǎàqJWbqFYégDòytsAoFgùijáSZěóbAówèǎóǒǎFoIhVbhD	FALSE
nQQbfiyěǒlWǎHóòópVaERzFuMIaǔǔǒtèMqXFRmCǔóhvěRopi	FALSE
pxòormtNmOUtùAyúgǎEǔJeazǎxPvzRUóBVaEoaJnDBǔxVóhs	FALSE
smyèlIXcyOWòwqfmpǒóLǒEwwvUENRgJQAwUǒyPWUyPúójfHC	FALSE
věXèikRXDCjMunCónùccJlběàSégGyèněmjSdCrKplyuièwg	FALSE
xkqmBǒóLDbVUjtnòywUwmrěsyxYWfAùZèwrtWdqóróKúéjHb	FALSE
ùáóSTHǔJUrotixgǒUXáVéXTǎLkRmZóDhXghPMPǔtǎQtGaolyZ	TRUE
ákzJXMyéákgVaáRKKǎěědáTPFCmǒtaJhNypMnměNùDDsicWpe	TRUE
éSàhòzóMámWZwǒúQZrtUmqhvsWxJqóùJMaxpUwfJyVùxLGipb	TRUE
óǔrQáuKùQSFoaùKRxǎQIIfHSSgǔòáoFCACKLàPZTjvókiseGR	TRUE
ǒVòèéiYWTCtJUXàòǒǎàqtnéatTSsfpWTbQáWBrǔcklùDěDJPN	TRUE
BěWABGtéTMǎLxàSxDantóWzHúCTCBufgǒobHWFpABQYWEHwěJ	TRUE
DaNàcúLóFfSCàEǔáqIHǔBWáZèKHIOǔACBùCryǔxhovǒéúǎaáǎ	TRUE
GXatERMwuhǔUniDWiWpeZGóòfXHCOhlneVWóǒknegKqsnràvC	TRUE
IuNùErséNPRǔgzDéǔSPLósjxQaǎěNeCbZSVùǔvEdwyúSáVpAf	TRUE
LWǒVuaIeryaELgJàPKMòkAòDjvDǒaglIwbCwIěPpEACBWGTJN	TRUE
OXJmziaQWxèkòbǔfěǔàFRóvxbGeeTDmǔtNáUHóPùéKLéUrsRc	TRUE
QynòaPDCàtovdsMiFPUCúpgóvGkHaJuúpkmbáAXxTzPLùybxc	TRUE
TkijWFNayNǒISiùzMNiéǒPqpyoIsRgǒdfXèóiǒVvIémòktaio	TRUE
WaeSNTqovwgmIdELYRkǔyurADáQóYùkéPGTvnòqDwAlnaiIlò	TRUE
YzèZzrOqàpFǒuvósěFzǒWwaVulUǒUziúWgǒoáMZaZEbygdzwú	TRUE
aCónMlYKJóPètJXSIZUqlrIlWěGoWMiǒqBqcInNGUóèuéFwNd	TRUE
aeùShǎIOslKRBúLèqeǒzNswwsjTtVXCyEúDèòVǒeǎgèòǒWTwr	TRUE
azújTwbHpǔwInCěFèZoǔdlgXpmHBNalOILǔSzGWNàWNjCTdMQ	TRUE
iCaPqRPoǎRRBrLHvenNqrRUèMǒMWCyhDUJONAOXěOEàLCáàBD	TRUE
kaěórLvcAavLsǎuqZUkfàOpěàBwěwàǎnCdùjfáǎLQǒEǒHsDVB	TRUE
nKéQyhBaAtqIóZFàXmuóAFsgwtMsǔǔDiGǒVóiJǒhǒHPzsěóeE	TRUE
piixáAěulaǔHàKEvEcǎjRàRxRLúúmózéQfhPǔiHCIóDgeUDcJ	TRUE
sMùéaxbTKùsmhǒaoUpHFùBIǔcVkhRSdjgónJUjMsIFǔeiǎqdy	TRUE
vàěarsěxIróeWúdbLAeCSsksCèyTólmnóQhǔSTǎdoùàNùóCúQ	TRUE
xVhMéěYAKRlSájúTNvaKKěyRauěpǔUeǒòUuqDCNófVjMsèyùn	TRUE
ùùWùPAQLOLAxmJEùóǔjIKàFàemáóèCjákKICzptTWiksBùUGà	FALSE
áKrXkiJhKVQájywdGFtjèuMRrScǔYgeǒWùezhkRIwYěkVWdxk	FALSE
éòFSǔfVegcVPYfTKOFJnkàIbǔùGJVsSpéFsXzFCáXOiǒTztáX	FALSE
ěhUóbxǔCúuóGǎǒMOVúěCǒDhǔóGTedòXyHaSyjcGYiHǒǎWwwjè	FALSE
ǒSvWBWwrcEnaZówěVwUdNgúěrfDhouozIBVhwúsZZǒsTǎRrUF	FALSE
BBHKcbwIKUVgǔFyjkQóAFKǒDfREpfěJSniFIGhXzHVPcòEMkj	FALSE
DskààútáǒgAěLVǒFóóPNQWglAguKwyboóLFhXztralòMCVǒèD	FALSE
FyùIfmǔoafzWùěTáǔbhOSáeiHzEiPgàcrswhDèNǔuvbéVBèEy	FALSE
IZòóòRLqáKzJlǎáRWoMkftUiExǔZrhlmkùmpRwYjpkrVpěGBC	FALSE
LEbGǔSZIùQmběUgRcmRAJmòPipaBdàoTYcǒctzeěfUáMOgmúó	FALSE
OQDojxPezEIrèèǎhqKkPKcXdYwZáXááMèPóxiqǎwDrOcGVWgK	FALSE
QtIKWgxPmNbiOBrOVBImotysfDQCǔéúBJùfáequRmaJtWGhòz	FALSE
TQRvòcAkDQKIQJRǔàxòfcvtyaqoSTùAtVfùRlěuAXòròSBvHk	FALSE
VIHEěYkNěHhfcnXaTòGyjmbxǎSyáwòZAfrKXèIvSKIxàWlpgF	FALSE
YFRAtrdùLgIáXWTxOOdèxPiZVKKuqRNúGòbERǒvOmdcǎVǔdKh	FALSE
bYIfVápùàjǒùóArúSZjNMVlInWwxiLCvNprěòjcèáhJkùbiZF	FALSE
dMZHTvúMZǔàEJòǎnxFtvaǎébwXhWcLhdxeEUunúBělSBVVBùl	FALSE
fJonqùOBqmkNpoòzrIgYWAYAQràúSCrJFSnvwhògyjbWjoBxX	FALSE
hQHfLefúdèpaOǔNóhěNògóǎjànSSkcoipjDéàéLJQzTXěqUIH	FALSE
kòLWxàFxSéJrPWYnmtálbgYxdLVOdisHéwawyxZǒměèKxeVRb	FALSE
mhAvshèQpchòùǔèóGeòFhdlějGviyOnGàoqúGefǒYAthzrujU	FALSE
pqfRvQDiEGhcòWTIWieTwwúslgláZoaVAKAKjsccYSoèAùkáa	FALSE
sKzXeSBGgóàUùUBTWAqcGYkěGLQWágSWDycFiDdzKYbAiiXQj	FALSE
udmHnooRSgRvjiIǔSXàyYsTRtAjFbPwQfgáljWàLXcqMèàviǒ	FALSE
xRNKybùbeǎlXèRRxjIFansPǒIlMcwCóǔfoEmúvǎǔóCǒèjócGh	FALSE
ùǎmtaIhoDuVGáoBCiBYwZdvIzGWSXaKzgǎoXaIǒoNóèátScPfá	TRUE
àFhOxésNMoWpsGDzJXLRàsxLaWèeújLgYNááTéáǒbKOágAKTUc	TRUE
élnznTTFòaSbpEHúěisHKDtRMxQcrIolrútINvfóhèdegǒeaQó	TRUE
óáHCtWHrJarZzùBImwozuqsbuAébfóWWòqdkágvHSrSNénrUWǎ	TRUE
ǒúNJNógtRpBPMOipswpBIàpùnPiTaUyPDiQWǎǔgZmAùWCòjǎzM	TRUE
BòmPyxUUSùěTCyàYYYóDPàyOèQNkaDjhǒMtUTAùIpjlcQKmkéH	TRUE
DwòěimBZěTxPgGNOEAaǔwcQViEǒIcRYIeKtzMYZnVzsroiaORǔ	TRUE
GanǎéjThMNěaTǔmúǒToěNYsuIěRfěppdcǔsàsHVMiòWwHybotN	TRUE
JùNàúǒaLQBBKxGCyrQǎWLxwqRKMǎbDaWòSIfXRáǔèrtqrctJeO	TRUE
LǔkDáNNaNwpǎOlDwwLzurGùkopiWLGùXLLAXBròèFàěIiaVSJè	TRUE
NhMkSanhdqHWHRmSDjernVKnxáěPjHVJfUJrǔòàcHǎIǔdéIuXJ	TRUE
QáFzBhvǒǔuHAéákaěáSúvQHèàWlAFtTlMNosaǔvSùěudǎwvvtf	TRUE
SnVròùéUnmiVWhgLLèQQgSóVóSKFórQazéBXfRaavRǎTděàWtf	TRUE
UrxMésàXWlQapěaBXxmeYezrWXéhPYcùóVǎáùOrnórlùOUJádě	TRUE
XiSzRJiAlASriMaVtFqHAùRǔVRQEHóUCMěIjKtWYǔbfǔvòǒDnU	TRUE
aǎOAZanQzDǒwǎCesGPcNUpGPrKyUùCéGZhSZodWzSmEaúvpdUH	TRUE
aOtBnZwxèǎrLwMKLěcòNeMniezoXKUqǔBòbfSNhZóKmPězkòNW	TRUE
asàdpLemXAúǒgKVaOpǔnNǔBěNòJdwbyúǎùvRRwěàáSDDOèOyaD	TRUE
hthiaáeqLùgXǔgurgJáZUlROǒdùkfǔkhùZKAuoXtaurèElVNǒk	TRUE
karBAhaetùáBBùěǎǒúZwmytEqǎUdbáwǒhùélTNùSmqóigsUZòV	TRUE
núKTMyKXJUOhaAfPòcàóUCféIAbxWáedpJpgóikKIFQLoǎWVOV	TRUE
pMéěTUIHoatdkáǎBYBáPiéXlMMhGèxkifRIsǎgLmNóeeSIǒLRc	TRUE
sNlǒiaofEvCESNèùáǔJNDIrNěèobuqBeběSqòBùGéetáiINIkB	TRUE
váùDaècOèDaLXKaOutFwKKcsKGJkěVàmǎJělèDěAbgrLPUbúle	TRUE
xgDGmúAaòOKèúěWYLvtXdZXBVAygXQèNqUkyEuaRWǒHtrrJUhu	TRUE
ùàtXdZNxòfWáeEaǔDábaSuEéQěPláXyxSeálXipVtBběltágkz	FALSE
ámyPIWcduHsOTpUdeSóòòàMkGǎuògXKiFetMtqFSSǔaxTvROMe	FALSE
éùààdácWUZèdyvufwSáOǒhkéNǔVDyIoàpdioDxYziLbkNinIqó	FALSE
ěTfGwfTgEjjùóhNsjymteNTúhùfyoTQmWfoěqbxTlzSWWpLEBJ	FALSE
òpzCèbèVGRIsNénǎeuQǎpQSòNJsfNPvxSgǔxExCMBxWTmzyòǎé	FALSE
AMQoBpwjnZPeGèxaàmMIsGědxJáǒBàFxègcèoLTjViSgNayzic	FALSE
CcinùJàXóQSjJBkayMúHiǒJèdàwDxéfAPDIGHDhéxjsǎǎWZCDg	FALSE
FéqxclEǒXúgblgnLhsàòúmQcǎGwéFLǒIZDpYàgyFRUJmòúúWbc	FALSE
HplgmháMzNonRùàáuEEmLǎZòécPGfǎùbáyzdoéXQbPcKdRzBǔà	FALSE
KGqòUúRjlAvAixLxOYMéZbéfáǎMzlùoYǔQZHgǒDWdDbuǎDwBFq	FALSE
MhgNWfMèKHùpMJuvyhlévKIěDvbSoèWéDxtMPonGqrBwhtyéóà	FALSE
PInHqgcǎqSyHuxGEQdWUfjóICVhXàAzěBpTOJZéJǔcújaACéjv	FALSE
SGeQoojǔYHMsGtNzlMUùWǒYùSGBZSǒRwQóOFyěrklKuIMKèàdr	FALSE
VFoKGcktùdmóútóǒdCcéègsEkGòdLozgáVyáyqamCzuSkmtbǔu	FALSE
XndHráJnqhRYrFjkàDáwvǒiwvqkǔǔvUéǎěCLfiQVaEhHAEVnfM	FALSE
bUBněòZoEceVUIkQpLFiduòsbZùFOBAVHévFVúaócěǎAoěYUzm	FALSE
dTPuKRFzYjHqsBeǒgJlLéVGPpliKòjoVáYEáHJVmguǎpcDyZGN	FALSE
fWzIUàPǔòádááNóvIàlDbNZKmhfbMvGqǔfRzrKMWWZvmdKéBcM	FALSE
iHbbǔpMOoDYǎXEFMAójmIaZWyjuANVODǔWùOdRuMlùXoyPDrTd	FALSE
kqwfàJMwǎbiIǔNbXtlZdéáùGómPVsEysYwPXmBúUFAztExbfbc	FALSE
núLHzlèèfGézNEYáoèiOmLòrTylYáySvRqwfálcyATWǔnùSMRe	FALSE
pcCHmAAièsIuGuMóJjroCKèqyuCvóAPFǎèjqkxfsZoáǒǔVjxEV	FALSE
sCgppKZQrǒtèbòPsTaJùeYiMnyBYlHuNPVvěěóǎSasmǎFUbMWt	FALSE
utJdfucFAZKRWqVǎAWpuFEyyjdHQXóeLtpEMYkKtQáIwhGèxúH	FALSE
xofáDdaòvfElrpcvNvZúèJbUeòhQsQéòUUdBTUHDzlBOSHdrǔn	FALSE
