ùùǔVUlSSamYòDěQLluèd	TRUE
ǔDBaDHúWzóLUifáòCGur	TRUE
áMAjjǎSKBSvBJSTIUaTY	TRUE
àoPOMSXWJaSznǔRsYyeI	TRUE
éBQIrYVWèDraqjFvbVǔV	TRUE
èXxTjEWNUàǔJrKaAOuTp	TRUE
ěpTǒhkKYzaùsòRhóRèqC	TRUE
òóǔhaGFijCtbǎElvǒDEl	TRUE
ǒOxWpUpGSCPhjaLtpáGY	TRUE
úXIaxfJWěGǎgHMCcěgSa	TRUE
AZXlPJiWàaòFemODrhhm	TRUE
BwFàagǒǒNěEezséOzbFW	TRUE
DDáraUjkvyéBùákwmHJb	TRUE
EarETvcNòRgOPǒǎWěrCS	TRUE
FqhktrǎPsàwVǔLAvawym	TRUE
GséóXaPúpLzeruOěvqQs	TRUE
IEnWxIGXéUèlaǔúkPWDv	TRUE
JPǔEaiXXtòuYpEDèǒjYá	TRUE
KgLSUaXiWEnMOhJKYéhq	TRUE
MǔZGFSùaúmjǎHngEěDNw	TRUE
NHmǔěóUàèFamQYFJVZTd	TRUE
OaPeriZDShIGqlémDStW	TRUE
PvkqoǎRPFzhYKXHmvaSǔ	TRUE
RGǔpUtèèGHFXzLGFnaDd	TRUE
SUaEQiiǔééLóWIàèXPèl	TRUE
ThDqaqékCǔfJCqJóúxjR	TRUE
VèhiTóztoaAlsǒXmqTtk	TRUE
WNǔOFGIJuàEwtàqnLjáa	TRUE
XguCǔYLaǎùlǒEèdSONgS	TRUE
YuwwaqAuSàiiǒénqědkf	TRUE
aùsFoJǔèěExmDtmQuSèá	TRUE
aBMsWuQHVZnKySóěèéfà	TRUE
aNSPFXéhpmAuTOùǒbkyǔ	TRUE
acFewPzVXJkfZYǔEǎBEa	TRUE
anxzEfMUágvnPIYùuècx	TRUE
gQLEEamyàPfákěPLqBVY	TRUE
hnNèRaZxdWápAQàznQoQ	TRUE
jàzaèwcUfqmèIaèèFhpi	TRUE
kIsúXakóǎJǎeAtlákiiu	TRUE
laizfǒYFLCnqóWgODADK	TRUE
něVrsòǎZoAèkǔMLOáaYp	TRUE
oHukuyvAéěHMNnkǎaqbx	TRUE
pkgzéVEgnaMYxvHdfyFA	TRUE
qtAaAWsùfywYWldhwzòI	TRUE
rzUgksaǎHgjUqIZGpǎèá	TRUE
tOyMBLLaièIquùzǎǎuui	TRUE
uhsèhtèLltHikàqmauYB	TRUE
vzlDoèǒǔyEǔjaǒěVtVqq	TRUE
xKPFVZoqjQNèOlaǎǎLTé	TRUE
yqhQzaQsYrǔgóóNXJRvl	TRUE
ùùTlGLeKlYhwYyCMQsèI	FALSE
ǔMoKǎúDuqǔGfujěǒNXTp	FALSE
áWdtjsXhhzZRósQyBgSY	FALSE
àfǎAtmkdqcVsYLQcuMnO	FALSE
ǎseLJHqkěpfEdDèMlhpě	FALSE
èéǒcMblXxDǎdYmùsDQǔó	FALSE
ěHKòArydyDiPsUSXXEdú	FALSE
ócyhnbwyHáYROUOuzePn	FALSE
òqòoqDbgJrKǎTEGEDEcH	FALSE
úáěHPgěWlmeǔoòEjjERr	FALSE
ACòyIvlévèKIgwosMěóé	FALSE
BUqUáùmlwdxRJSNxLBCf	FALSE
CkùZauéUsVaWǎjuPFDGk	FALSE
EòiwGùWpùjwzlHOllXáá	FALSE
FZphDTMeOhbwGwGdPYxù	FALSE
GmdfěqùOxèFhjFESěXbi	FALSE
HxHkSqdtQǎivDeUrVhWw	FALSE
JDldRUzéǔáyúlIprMTòà	FALSE
KaǎAxecěFcumGbéFUoJi	FALSE
LmHQEfútoLóúCReTBmXǒ	FALSE
NàKěuKlóBǒoxǔoeEùééf	FALSE
OGruFvěHCúKEàVUeàRTI	FALSE
PfDTPeǒIiéxXeLúOiFPY	FALSE
RàrèExZstKǎiwfNoHbǒǎ	FALSE
SLLVDrcoVCěoàHǒnCúsj	FALSE
TvYPAàfLǒUttvHMnTtěU	FALSE
VěwcsófjRójzèBǔOòSRh	FALSE
WfdèFěKúěEnòbGrdóSuò	FALSE
XsTiYtnWzvThSóvUMEQs	FALSE
YuKNOàQinTPkRDKHuqòT	FALSE
aafgPǒqTǒhZmFéIběaàn	FALSE
cǔRuùrmeěTMfWVNdòywn	FALSE
cyáIFATYéMàlěcKvgqHA	FALSE
dySéVvkEWjóòǒkukjuòó	FALSE
fEǎlúDóhrubYǒJZLTsXA	FALSE
gUSgbwaMóilúfòcusoTr	FALSE
hjiUDvIùRhàNQZáǎbfBu	FALSE
itpáǒàNinRmtǒlPHéóuG	FALSE
kJAtzmùRExbqòDlòjsNF	FALSE
lcéBrShiúQǎwJBèmPjnW	FALSE
mwFjALZǎěydIURdzLèiI	FALSE
oNRAwdéazBBkTHéèGHvú	FALSE
pcfBHVàknakǔěèflOfbO	FALSE
qsOlwvDoówópèqIRIQYó	FALSE
sèǔàHDùsgUázǒJEàtLPP	FALSE
tTèQnúúteEPWúOnUwqaé	FALSE
ulZàukòmGuCPoǔXqkiGi	FALSE
wúnùBǎpáEMiRZFzGqtjn	FALSE
xaǎttJúqběkǎbohXbUóa	FALSE
yzùYlPlOJSJQZféIBóàv	FALSE
ùùTéGIagòTztóiMOhVòdú	TRUE
ǔòTxazǒàkMbBKjOwéùpáI	TRUE
áESěhsIrxAùtaàòèěbRKè	TRUE
àkèMwsěaPlòZRXfúNjeCd	TRUE
éDtpPǔnáóéHLpsDSéPgRa	TRUE
èaimJFúréǔfwwkIZUbHèE	TRUE
óóhǒǎǔpUamCYnQVCjvrnF	TRUE
òWAyYaIczGpJqyYxtdpvk	TRUE
ǒvvaGtqCAKFEǎJoiQOǒKé	TRUE
AEsairǎSuhAvbHcGbMykY	TRUE
BIQWlIaAIMSǒGmFXujéVl	TRUE
CaOnhbóùWjDóqOùisOasP	TRUE
DaEPPJBWZkiLàEEFcǔnPS	TRUE
FJkziéYiFpsiMIsUayBcv	TRUE
GaDoPèzIMtWǔgjmMòFùBE	TRUE
HawdCcpyHgDqRIwSdáZjá	TRUE
IywIúEiYJQèvoGkRXaZzP	TRUE
KAGUWaKéCwǔuéǒViGJCIY	TRUE
LOyCúazxRXtOthyZjoXóX	TRUE
MpqhàRUSmwàaàTIctqYvO	TRUE
NthěUiXoCGèrRaSNksZèq	TRUE
PQǔaqBwbrlDnNYTqNKXMw	TRUE
QUǔàNǎjAlàhCatòMVùyYà	TRUE
RavWábfPsFGLǒgháyáiCZ	TRUE
SpEGgyTyWTDèáYaZOyǔmX	TRUE
TvXajIWòsiàzkduOtrtZu	TRUE
VǎaZěquYehjJězUscGqKh	TRUE
WUBJGuaáàǔDhàGgóZPJòh	TRUE
XlFQjYyYEqòVVúaěámJGJ	TRUE
ZùěóIQgoòVDVmqIgLaTAó	TRUE
aàéNPùnTPiúrOkcdBBCàb	TRUE
aDiSTlBùwbOkHcyáHJlyC	TRUE
aRSmBàLgSSèéèUFIyCWOJ	TRUE
adHthùèIzeòYèòFtXprao	TRUE
aqNmJnòáGGULFVpkADtpk	TRUE
gSaǎJQiyxVěXIeǔèèIǔMd	TRUE
hsDDwrFKuéiHǒaHxjQEèù	TRUE
jAwDTotIRyMYlùaWòROII	TRUE
kTěòàGajcPWFVuXlUvRNt	TRUE
liKHǒpaRǎZNyúèsrstMWp	TRUE
munéoaéóXoLnCcéMépFěV	TRUE
oEPaOSbDDkOfǒUùVKYètó	TRUE
pLOSPlTQyTtgahBǎlIjzD	TRUE
qjóstèPǎAaFGurùktIFih	TRUE
sáèěvúafJKYéNòzMǎjáNx	TRUE
tEivaXupbMmqnèètGZCLw	TRUE
uaVCěemPMkERQXádQGlAj	TRUE
wàěaláBábSUOthPMpICgd	TRUE
xBpóvJlGGPLTXBaAqFTNu	TRUE
yZPWnHaDZlUopEOIǎYSOà	TRUE
ùùBLYvSjUJzǒKcóYǎvKòN	FALSE
ǔFunZKwèězKQGeSYYxBàA	FALSE
áZFDDlamòaUPvyfǒlceZV	FALSE
ǎáBwInSyWZLKPuwCuuFGS	FALSE
éEWFbVRRJCxLOHuJWóxyi	FALSE
èWYZLdLOEegHDáèGpfkRj	FALSE
ěgiOónǔjèAnCfWaCwYwWk	FALSE
òěsǔJraolkdsULveJewRQ	FALSE
ǒMyúaeqneKENaVálVmIVo	FALSE
úbvRúsIubFGsDSzDTefòN	FALSE
BǎlZǒòdwèNDOTITàeúǒyH	FALSE
COOxfóqiURàǎmixEòAZZW	FALSE
DWwnEyPqcrénkucIavbyv	FALSE
EyMaiNllcěBèuǔzkcIWWa	FALSE
GbYzhREpKBòǒtǎěXúélkY	FALSE
HnZNúgFGùxMèǎCátǔěěvǒ	FALSE
ItbǔItIMCDǔǒǒxcKúucGv	FALSE
KǎElsqmltzǒPDNwOkWòQè	FALSE
LEjITyKvěgǒǔAfDnáDshG	FALSE
MSGAMGěCWèěóYFǎhTùhiI	FALSE
NeNtNěkěFLuQeJVGFYàǎy	FALSE
OhwKòádwFGvLBciyǔZdǔq	FALSE
PxǒzQHjXòǎòYmcgoeVoèJ	FALSE
RDěCgájliJétyqrěqALKb	FALSE
SdvLfXéBVkǎraZpmyXfqQ	FALSE
UěOpójǒQiFgXèthrfdWYO	FALSE
VVRóNIàǔKQlYChSKGnduB	FALSE
WqEBBZhBIQjcQuHjNMùbO	FALSE
YěkwCLBIlubNBqMXEQQNá	FALSE
ZPrKéTKxeVfpcòVéàǎDep	FALSE
bJbǎPLěráFiOAXQfZěOnC	FALSE
cHjgútCvàBuGvLǒXòwYUe	FALSE
dLqaVtuEZufàóǒBILěóHG	FALSE
elAdMRáaSXDGUFjgzkéǒo	FALSE
fnWEDàBhVòWHPIùǔkOOVG	FALSE
gwúqfoqwWwzHdǒHZXáAwC	FALSE
iàIègSUáTRBùLertècwnc	FALSE
jJěMATpMdrhúDDkaKIfus	FALSE
kXùOmITVAoàBPfCzNNòuǒ	FALSE
lYWriWqnàEEWòácCòQsnJ	FALSE
mtJAXyWxbWǔFqImáǒkóQp	FALSE
oùaUěúGgiShěkAaSwWgdF	FALSE
pVeLuDPXúVCIvkMgPDgkF	FALSE
rùǎUFdóOólrVnhpméòzXR	FALSE
sIPJGnwUTtqěMTSSeTgTZ	FALSE
tOhkòRcRNYgkjTWùYàIBZ	FALSE
ubLOpLRiáǒdkCEtKZkUWé	FALSE
vtEItxzFKIrCoKxvúLOtQ	FALSE
xCPmLFGùèDǒuáHXBXEěěě	FALSE
yYHLCvDtSZtǎYoInùHùǎx	FALSE
ùùoTǎtUèúUùzLwauSDXFUJ	TRUE
ǔDDùOòEáOyùTpaětVToLpv	TRUE
áKúSPNXIkGVxjàKaFsZEWs	TRUE
àoHjùùCwvGólTprsraùECǒ	TRUE
éótéJaZuEEkOgǒSJèePfvt	TRUE
èRJATYBJxHaZúuzmNěkdùE	TRUE
ěXXkOIòéaàzhǔLkHèSrXùB	TRUE
óyAUEjzèěvaWYAtIòXPàmh	TRUE
ǒěDǒKUanTcCyútaJxXOàXb	TRUE
úGPyǒwpòěLXǒBWBAuppaBè	TRUE
AaěZuLeNòCiLQònqlWyiaN	TRUE
BwPAYǒQaeáéèhláVjjOuiě	TRUE
DDQOaVdgAGvZZNPPSZgCTI	TRUE
ESrOMmóUaWǒTZCsǎMBǎEEy	TRUE
FxkKREǔhZZǒEòhVěǔlTuOa	TRUE
HBaJCOùENdiyPSCOrxBYGv	TRUE
ISKXPéAěaeòkTPzCóYxéNd	TRUE
JtEqazPYopINVèeRNJEEqò	TRUE
LAhaWitlTnbǒrěěIòhěfDQ	TRUE
MMNxSSQzKùèrVamlǎCFKDi	TRUE
OùvQRhYHPéùWVlFRěkùǔaǎ	TRUE
PJOCDajTMàprcǔAtittYǒD	TRUE
QmCWiyVaHděàbTěBRPcPiF	TRUE
RwakrWecpmttfaAdMBPiòò	TRUE
TJúNmiIpEZàrGsaúAIwvòs	TRUE
UaHlLékAEvDǎVhtPRkIùpó	TRUE
VnKvSNEDòCpZséHǎrBaèrT	TRUE
XùsSmacBuozBBIqmòiNfàT	TRUE
YěgyuǎlLiTtIOyVatfJàgC	TRUE
ZOIRaLyqùmXHEDFsǎZAGGf	TRUE
aèsEVfSLUtxXúáMoGLéPje	TRUE
aIszXeXéYéOfLdPOHJjǔhk	TRUE
aWpeXQxytòNsqóDémcoFúG	TRUE
ajFJpsVóeqPkbUòǎtvTlLt	TRUE
avYsWWoùWCFHcpJněmqLmA	TRUE
gzkowYLZBGǒùaBKTòwrèée	TRUE
iǎlFixZTanFDòáEWkmEUNq	TRUE
júPLúmpVWOaQUámFónoWTX	TRUE
kLwùWKaSFhbwaEOròájtóǎ	TRUE
laxéxgjsQOEXéLOùqǒcFèB	TRUE
nàrHSéuioaWeDOMǎǒPtúdU	TRUE
oOaXrJòJEQueVèCgmPwrǒG	TRUE
patgfPLkéiOrQQǒHQVPùUU	TRUE
ráoPáRǒakSwCAcRlZRUdpv	TRUE
sòDǒDQGséxéomnoijWǔpaM	TRUE
taáDOnXiqhàJsReáàqauDG	TRUE
uoULSSgxoHDUhFZkUaPQYG	TRUE
wDCáJMqIFéǎjQCAaérócǎE	TRUE
xZwèjwáNrésZěàaqKxékZO	TRUE
ylèSòàěHoayueptFoyWàBo	TRUE
ùùFOùCXràfáUcmxDeBjlBl	FALSE
ǔǒYYULQGàHPeMMYYslpMǒN	FALSE
áLǒOKYqqRǎEsqECFsRxCěA	FALSE
àciǎYgEǒDDMMwWyYGúXóyé	FALSE
ǎrneqVèKwCèéGJLvkDBssj	FALSE
éyAuemnkyEkTiXpYǒúXǎúg	FALSE
ěǒcfúXOópKBtSmYHǔLBǎóB	FALSE
óOàòusxzbHǔOYkGsLEnZǔe	FALSE
òpKdNYDúěiffuCoUbqNéBP	FALSE
úBmùúúSSAuiéúhIPYqOECs	FALSE
ARZvYzéZkèijrMONTògàji	FALSE
BxTxIàQòCLǎǔqǒiktnijNn	FALSE
DǔJóEUpjFngùqùSèdNPXtz	FALSE
EHHJRxTMjéàjqkZVópsILò	FALSE
FjCogjqtǎosuAYèJkrǔnǒW	FALSE
GuZPTgpvǒfépWbàjNbeèwá	FALSE
IòlJóéàEekULpLxXRBKKǒL	FALSE
JDWiqosiàzJHPYngYXGDyǒ	FALSE
KMùJWfqkǎcTPrCxàJNǔrěv	FALSE
LqRúzcSAPYqxeBZJNtnvgS	FALSE
NǒQZcgùRwxYfzeMTěMyByó	FALSE
OOǎQǒfGXQfhyàòirCTkùym	FALSE
PfuzhciǒCWQàziwénRIèiY	FALSE
QtoemUJòeSHùLèNivoBòBO	FALSE
SòěRxJóPháJefHyTmgNxùh	FALSE
TWeSYFAoIXnǒǒJěéjSěLKC	FALSE
VáhxlǎfUTTGJpkERUvèròC	FALSE
WòéEáDfeFWxZUéěDyuLaDě	FALSE
XSPErZuCcúuRycdsúǒKáQk	FALSE
YxWHùSTZpáòFǔmǎmNmJUáǒ	FALSE
acoTGiuiòIlfvfǔZkOXIij	FALSE
cèRdnòCczóYfDǔáizLshǔù	FALSE
dǒizAMqPcoQtzMhBàhovék	FALSE
eRXAvWVEùQrlDvAFMMYǎVI	FALSE
fXhúmWmQCCHǔóěpDùHFlAX	FALSE
guèrèówippRBHGRdúKiWFm	FALSE
ióARwQjJDYEzǒhLPWWvCúy	FALSE
jKDjOZnééěàeuncoldwEké	FALSE
kQcósPNtúQJGFkxbmKóZbú	FALSE
lfZBǒYxǒdONqKUaPéǔZCPm	FALSE
mxnméjǎóJKLiepǔuvptDlB	FALSE
oEEUBQjWvKChwKǎǒóTWEMS	FALSE
pPvZyFódSNàsCgKajpEéCǒ	FALSE
qkúoooTJtDdRMPHVswiaOw	FALSE
rznteǔdXNùONNzkǔZAElYM	FALSE
túfMCCsóòYákdZhóùgaTvG	FALSE
ubJBmóěyoàenjúdmdùhpEr	FALSE
voNTAUlNOúǔùHàjěwvzWBw	FALSE
xCfmXòóxSsnfLkklúTéHXd	FALSE
yjSDpòRSlětFxFéOJvfmóp	FALSE
ùùakGxGàpSPzRdtLOiBLǒfò	TRUE
ǔGmIiADtǎabebisnèwxáǔxa	TRUE
áaWKQcOeészOpPgLspaAYMX	TRUE
ǎǔǎTghòRǔMwKlǎELùRásamr	TRUE
éFHLCtDZéjaXlVtDVèéséHo	TRUE
èYsPáǎXQyBMòPkThzKnaxDu	TRUE
ěasàiiJǔéKwiDoARFMFèvLM	TRUE
óyoǒkùREKRTǎapXHHHgàéHi	TRUE
ǒPaXǎdSUWèBoFpUxúphhúZA	TRUE
úaischxEyàjmmJMwBqaIngt	TRUE
ArúCadmEǎemǎApRVAsqàIdD	TRUE
BzaKùsozúzǔwunùqóXùénAu	TRUE
DǎzRxùisavRqBSOudauǔRlG	TRUE
EHòrILtGEnàJóuWZvVMOMax	TRUE
FmIlsóvùáqEZòQěuauRXOóY	TRUE
HèiVaMǒxAvEKtqsCsueKJóc	TRUE
IJqlCaCOyěfTzFèwbIáèNéò	TRUE
JarjYHVLèóójLPuǎSbtFùMg	TRUE
KzaMtUYXwáNěqowtǎòGǒGoX	TRUE
MFóCWgFúKqQèaYǒzhCwUOěi	TRUE
NYswHgtěNpéXZmaiZQdQixP	TRUE
PǔWrJěWúziSǎEòiigòIKkaě	TRUE
QěawǎEFuCbèNInweMǎléxAw	TRUE
RNaGOFòboúǒzzHùTUélcùpg	TRUE
SnǒhvèDǎWBǎZgQlnarFFYYB	TRUE
UániauZDǔPwxTpZSSRBvǒPr	TRUE
VMzjaózEfbTWJǔHNmCAèpNT	TRUE
WTaGcúěllMRgHkKǔjfYAuóo	TRUE
XajYzèspzCImóěDBKtfTkkQ	TRUE
YxLjNZSATacǒyáUJòjIoVwQ	TRUE
aègBmújAzvDsZsFNhhBroNc	TRUE
aIQAéPrnkAmóieJVùHOmHjl	TRUE
aWGǒhKixRHIEVúBúǎVéBoòx	TRUE
amSoCtpEAmBBcéJITDuIPFú	TRUE
góqvHwògXFDàvMWněuZEpǒa	TRUE
hOSwByRXvaTUGnqIàBfǒygU	TRUE
imréMEzakǒZExPKQcLyRLOù	TRUE
jyBéamJǔùBfEIvgjThkPcaJ	TRUE
lCòqéǒùJaPwòsZZálnztvSR	TRUE
mQJnzmàaquQlEǔsòJBlámgH	TRUE
naóGhNoèpjjúqúFYǔoógfia	TRUE
olLSaIqtàeHSZjGkrCXfkjK	TRUE
qùQpFèqYǔYzaGwyolUzěsgl	TRUE
rDGSSuJjhHúzXavPcdmàTjO	TRUE
sINAzIyFIǒjIszPViaùàáěz	TRUE
thFnútLEúDyNaèáǒqǒMPádr	TRUE
véLiDMSBFPLLpaCCJSBXJLh	TRUE
wTèúVǔòALasfSjZmeTuuvlt	TRUE
xazèjQYYěiemUNqǎbJpTPCK	TRUE
yoSéstAjTKMněEOVaěZèiBi	TRUE
ùùOepPzhàLMWpáTdEXrdQǒY	FALSE
ǔěUUpAipMdEàyyòUGYdEěWi	FALSE
áNEfOVzèUcéóPǒLYIXjCòQV	FALSE
àiAcopoèóJGykTREùpěUsyn	FALSE
ǎtvEjùHdPXPrOrMqzFgEJwc	FALSE
èDJǎlǒJEguvrfbqPuRocǎkg	FALSE
ěYfRaYěwCèesózYBcódéóDu	FALSE
óeugntfmuluNgéDvYGWěwBó	FALSE
òrzbjaěeqTieeUnFtèYIúAt	FALSE
úěMmèséwLUqmégdǒyǎPfIùo	FALSE
AUkKSXmáfRknIǔVMEesWNéà	FALSE
BkmHoòǔrMkYfcmùCxkMBudC	FALSE
DǒDMyxfxùwTxUKBǒMwAehUl	FALSE
EaIGDcàKAcWTNqXDExjàúSe	FALSE
FmXtXlècòáǔtluuvvABsqěK	FALSE
GsibtpàèbtǔphRáHDWqnnWw	FALSE
IóOáǎDPrgǎeCDetIrlZRzdè	FALSE
JCEWdJZěTdrOuwOnADdQTwv	FALSE
KnvVéBghtUùnéǎǔYzwéFésw	FALSE
MFtAwhFWKKNpZEEREYAVàáP	FALSE
NOrTwXozOáPzuXAMóxWUkzD	FALSE
OWivIóKceòeCHdeòhàgjòoa	FALSE
PwǎYCHkZáemyHuúSFVjvéòA	FALSE
RétSOěǔmhJAyLOlQBDcyqOQ	FALSE
SQUBQmqǔyǒNYzGfúsxdOsóg	FALSE
ThMEMtàózxFXéwizKǔKmEHA	FALSE
UsiznyDWAyDZQtGréSòIAlW	FALSE
WóěNFǒjHNǔGZPSPLUUzzecS	FALSE
XIiòLPdULgfmsrsPnCǔjànW	FALSE
YjyAsjǎgfàbóKxKWESpMwVe	FALSE
aBúGuxKòiJKEKPRxvCaǔoǒé	FALSE
botpzkyFIóètDDfMJywWEzD	FALSE
cxjSwwygdwIpùenVmMqbYòǎ	FALSE
eǔZoòRvuyLgǒQǒqMywQoKǔn	FALSE
fàxeWKBùúbuEKqekMKXmOsD	FALSE
gHVDdWzsMzxtrsPéCKeLLhn	FALSE
hePyIbrFèóxOntáqKQóxPǎY	FALSE
jùaúGgNazEòFěfGeùiDGuVN	FALSE
kCétdsoGEHěǎUxùHèLpivnI	FALSE
lZXúòNúMVqJòEZqqiCyGRbb	FALSE
nǒzKfoòhSPiBRzLeCJùlinN	FALSE
ocppUSyzòdOosBoRqrhGCBl	FALSE
pvegwnMWkEAVǔlaWnVǒyqPN	FALSE
rKsvEcZCxoSǎěRahmoKqRbf	FALSE
sPSjTùeuScfǎǔXtSjwNùèqZ	FALSE
titPòétDzMlòfùDaOèGyàKm	FALSE
ukVHFSákhpǎcgǎSǒQQuMOiú	FALSE
wAǎdébmúéJanvKVùMPPiHJǎ	FALSE
xTtYfhLRtcRAxjlǒfReàBIw	FALSE
ytZtZàVàBjLzǎUUudóVsvAá	FALSE
ùùSAévMzPPóǒpVgqUjòiaèed	TRUE
ǔRnhAǎěúlCylJzEùSpaóYhCQ	TRUE
ákréùéòmáéOYTPoacjJùuyIt	TRUE
ǎěYPPNHǎoàLCEhEáazfKJèxě	TRUE
éLKàèTadCjQBZUZoDóXPcnis	TRUE
èanoIáSqYqdppZóLǎGIeaHyR	TRUE
óéMxtkúmIIójrLaYdzIwKsǒn	TRUE
òJHtBtXòBNUaQvěǎCAuéYZBQ	TRUE
ǒYxǎNáUóZFoěkRaJàOdóáèée	TRUE
úaiuiqVXOǒèJNGàYYCéGròLM	TRUE
AjAmXqlyUuPǎHEěyaeuúJElé	TRUE
CóLStXtajsfBǎYnáǔúǎtQtKY	TRUE
DFQAabúWǔczxSTvlPBCSùǒzY	TRUE
EXwèMRURvKrXAhmYUǒZoúzya	TRUE
FphDóatmETFPǎPóòwYintèòf	TRUE
GtsFǒEshRaàóZcǒUHelfpxAs	TRUE
IEKjúFQLZyaGRqjsGymJwóiy	TRUE
JoèaSWǔdvǎSNIpBxkIGuiNxá	TRUE
LAnYOaqěcáZVwùrùóADQHwtm	TRUE
MSaùUgzJHsNFóùJóbFqPyfHm	TRUE
NingZNUòéàFǎVwsAǎéaroYàq	TRUE
OvNaKúPecnFFSlhDYǎuáfqèl	TRUE
QěáyěaqgFBUPfwDǎKMcěěhěm	TRUE
ROEjaonéBPúfòàmDgRcMKwyU	TRUE
SsgVkzyakCgYLèHqXòjZTrjl	TRUE
TrMPxYmtEKǎaějèWmgùfBBUU	TRUE
VǎoIéRaGnsEhNRyuWǒCJWMèd	TRUE
WKAntáaèMDHkCsCUǔDUleovN	TRUE
XayPTGúǒljtTàDfuQběsOóèě	TRUE
YraPtěkJBDpcùAúbvhMlZDKf	TRUE
aáOWkéDrPWǒQFrCǎklvǎICUà	TRUE
aDCfrúqgwFCòhJOSyǎéDěJǎK	TRUE
aRLǔúǒzcnjiuédǎfàFoéHèNǔ	TRUE
afǔiIédwyRgféFcrfSURZKPX	TRUE
arnYJdrmpeqaQdyiRóJATàBO	TRUE
gaúGèVdYrùxDQWYSeMUwkkVr	TRUE
hzarGàQjQlòMDéCKQfǎFǒáué	TRUE
jKatsynJǎPGXxǒsjSGéSJBZd	TRUE
kalfRǒmoFayzHǔTXMzWPSVtú	TRUE
lnAjQGǎCaòǒjVJúbǔMréSQTB	TRUE
nǔJJSULaFnXrxzjRèOǎEroZx	TRUE
oRúyJaáclèbBPxMsDgGxTuVP	TRUE
pkhXULaàwoMDQǎùǎqWtGóHVb	TRUE
rùNPRkkGaněTAJóNWvpǎcJTS	TRUE
sBrEaAùcIqpuSjNóxQóóhnpz	TRUE
tSvqàùopFǒmaEZcáCoHòeacf	TRUE
upCOaqovoflhnmèxBFúwùúrV	TRUE
vyPxwaZǒtRnlqǒiqYòFàqzPQ	TRUE
xèGaòAwJjLSQZKǔuWSfiěHúǎ	TRUE
yUhLCgsaáByVXEFMxRQzJkpm	TRUE
ùùtEǔLQllzěNfoàXMVSbtOUp	FALSE
ǔJjjbQmQěàYKbPUVrXARmDEz	FALSE
ámqbRwkǔQMǔóaxucsGǒcJzuP	FALSE
àzZQIHPǔDGxKǔtqBúATàDofj	FALSE
éòaoóIxéàǎJùAMéddenxàstC	FALSE
èSfgInTlújùùèxkèlYNóKCqz	FALSE
ěnkfJJDiWàQhRGGlxHrdogsf	FALSE
òǔeúeWMTxùZdJteOèHlWtùCé	FALSE
ǒImjdgǒǒgcaExoǔWKToóuKná	FALSE
úXJváuàóǒǒSjNhhCOldèǔáěa	FALSE
AgczZTMtóaMwùaáeZpjuVtyò	FALSE
CǎfXwTakRbtǒrVàYiddBOjzR	FALSE
DNdtkǎàlsHmcMsJfZsěwnBèé	FALSE
EiviCéhtThTóxkSneCSáRjhf	FALSE
GǎúSUEnWSWcùuoSaQòbnfdKě	FALSE
HFFAkdfsdqdMEféDouVHXóùA	FALSE
ImǎlzHSǔúmNùédmDyCJhDfbp	FALSE
JvzòèpùLZùméUsVběúTLǎzǔP	FALSE
LMDojYOEgOgTFIVynKrRMòfy	FALSE
MbrHMdPǒǒěcxuYKZòGǒmcéBT	FALSE
NnINzAIDReMQdFǔgGVRllgfQ	FALSE
PéFéJqgáNnFhMPcèKcàovTfd	FALSE
QIfnMfoBzmóúvXTǒgTùGpooB	FALSE
RlrRfaáOtMúbòǒxCéóǒGXáQC	FALSE
TàGdBPǒuWYIUúsbpihdobsVL	FALSE
UbHúZOUǔèArjòGǎRdǔèaúAàf	FALSE
VkXnùbséPèwVcuNSEMbelPUW	FALSE
XúdááòylXNhǎCiqqhNXádhIt	FALSE
YYòHóBnADbùCbaWgkǒvDEěùP	FALSE
ZgYpFlZCvWCàPùKgaTxTSaEf	FALSE
bPuzcSúèZRIàzNaěkAéěwFUó	FALSE
cXkHtěDZTZqvèxuěgOHwPláp	FALSE
dSéCNoKòGYlFMoSnwZaALumT	FALSE
eYPNvéòpYlcCvWǒFèzUǎgáeC	FALSE
fiWPDcFSjùùnJyMdIZtǎhàoI	FALSE
gpcKtuPfèǔóehSòksNXxXFgG	FALSE
iéAWWIqnǒKhAETiZqlxóbyóa	FALSE
jEZoièjdELOjIvOákLéXfWKò	FALSE
kXhImKuiUǎqDraóyěáogehle	FALSE
lktáHSòYáUùùnduérwáOslXI	FALSE
nùéAěùvoaaVuHaàBóěbvLRqR	FALSE
oQjMloJzyWLCédzXòkvehóQU	FALSE
plrióCPvqNAòopùǔMdvnBZùn	FALSE
réèqfGùgǎTkLlWbwHaudijóó	FALSE
sOmGàyǎǒDrjLYèxúHFngànXu	FALSE
thàffKpqcMAiIiIUBdFcfFǎK	FALSE
uxlzóogisǔkiEeAnpjhAfgff	FALSE
wòsékěIZòòsMEóuNǎPeǒǎZgh	FALSE
xOkUpózXYgZCXYMqRUHVHNtk	FALSE
ykgGjVtIgeǎmTesxIIàMXsEt	FALSE
ùùaJQBòRcVLéYmbQvěòZUUiaS	TRUE
ǔFZlMǒlaxhYteòwhiěoxònxXt	TRUE
áajdfděYtJsOYcSQxLyhPQprs	TRUE
àuNLhllèàaèávxHóùěiùmòlEǒ	TRUE
éGaèòElúUhPjáfsIBNFoòǒwúK	TRUE
èOáAaAóNVěkámòKbǔEěctqLGg	TRUE
ěayòàHysmdBvwxXòKúákSnéxX	TRUE
òáXaIEFrEfzlikLGSyNǔtIJoA	TRUE
ǒLFGEaAǒOmDIúftnkQnKYWBGè	TRUE
úgaáIEseXjXbQHhàAwiǎghazS	TRUE
AmaUmZeXsZEǒPuuabuZURIaáb	TRUE
CúAAzBtpááDaběàQrPNKhsǒǎé	TRUE
DLaYFògWyúJYlsFtekQjqwmgZ	TRUE
EaxsǒiòKsJYsMWOPAYèKXlPml	TRUE
FoayGěǔKtwZEùěxxjǎWCHúlyZ	TRUE
HúDòǒDpDRaǔjDPvOǎFswěLVúq	TRUE
IJURtafEBRJònaoJTTóǎcPAfǎ	TRUE
JtRXhúèúJǒaVPěVPwBBNqcUIj	TRUE
LúTGFANaWqlěòùOzcábMaúSmY	TRUE
MaèGRosrIùmúùfàDmááǎětiàd	TRUE
NmOǎpEèEěOaEIFWxǒyoéázYGJ	TRUE
OtDùPǔBaQǔáQěMjáfHboǎFqaI	TRUE
QCèǒNlvhhRazbYPrBljoMAuHS	TRUE
RXZéDntGtvQaúzwYRfqáOZgǒX	TRUE
SukèKaǒFWAètckáǔǔzBáyjěWk	TRUE
UǔhqKnHAUIDhsAAHGaFébakwg	TRUE
VIPxSyéGhuISgOosmsaxǔswYA	TRUE
XáVǒaQHóPQUǒbikVBMélcimRM	TRUE
YDésJavùfhaótqBùxǔBǔSqHNI	TRUE
ZZHoùVúóúWUěéàysěrYDYafǎh	TRUE
aúèWàEEfvoDuvbujémǔǒEyúZá	TRUE
aOjGwyQùRuǒpFǔrjVUǒRgkrxD	TRUE
aeKkTǔùjnpVZrqPzdJfwbaDǒJ	TRUE
apoXjFQNxCèLpmVǒYmVUdmWěj	TRUE
gPEKaéLNPIlbCoèwǔSaúqǒóTi	TRUE
hkOúxXAwliNxtZlIWJSàMGaRG	TRUE
jěEmoaZCrègLǎZVRboqVémyyX	TRUE
kJQoSKaUDTàMPuiWUéěCtTmGI	TRUE
laVTSùmàǎAiTúsEpxgzbéyhqG	TRUE
mqóaHwejoPdjXCNOwvrpjujRV	TRUE
oENòxygMygaWcASùVEMqRCesI	TRUE
pWaǒVMwfLwysaKvpMàktVéqQé	TRUE
qaěoéUèqPifáTávKèxovLXmmR	TRUE
rlùèKZòúAHNaéTélǔùbMàLYyG	TRUE
tóMhqáUèaRěòsXpúQThZssJSo	TRUE
uBqǎoǎBUIamáZàekHNùúzzDnt	TRUE
vOZXLěWháWNPFaáuTWóFDVUré	TRUE
wZQěDawVGGkDhZǔǒǎdMǎQLoéQ	TRUE
xmmùèGaXMfsDrojBPPWZsmXàá	TRUE
zǔaPěHOAóZyRcrtmpTHTAumDv	TRUE
ùáèsJfpOǎjBbXvùjzndIfizZw	FALSE
ǔDdpòyáùáèvLDOgAJwkǒNGHmm	FALSE
áXYkéMcàzcǎIùnpHqdNQQFiǒg	FALSE
àrpGmxGwùImdPSMQChKájGGEJ	FALSE
ééQlRòmiQǎmVIigRrxDóùWCcQ	FALSE
èNáxKSqméKPXQROlvdòùqhězq	FALSE
ěkùTwàvpMáǎZWnAMkòHYBóàFj	FALSE
òèWjnREpRQJǔJàLXqmCcúQglz	FALSE
ǒNèMUVaDyCaáMwZuvFǒǔJàlRk	FALSE
úqKàMBóèRwYúFIQǎhCEQóCGdà	FALSE
BEKRàIMtXLárzmvQLTPSuòCTR	FALSE
CbWWPEtMlǒQnǎIQRàwWǎáPiwo	FALSE
EǎQBsEimDǔjBúǎRnpxMRNBoXG	FALSE
FUudBxcfuAèǒǒZóqvKǔVhCDXV	FALSE
GyáuLGsmidYbKfiWTDkriYaNé	FALSE
IRPàHNtpJtCJJsyjósqTUsnóZ	FALSE
JzàWbEjNVactGǔǎyREěvsxórW	FALSE
LBRǔmxJoVhoflttTǎpfGIGvéd	FALSE
MYlèAMuAPcvdCNtTieSLqrxNa	FALSE
NgvhèstGǔwTZòHmǔOCQòZTMJN	FALSE
OtáBYpJpLcúǔǒeaáCòBEtcùtb	FALSE
QHùwlòYlSykmGDSéwjHàSnyùm	FALSE
RJFEGMjHlHRZdtwǒùGQHfurir	FALSE
SngTmOPcǔǎzsèNPQPěǎlTVFBá	FALSE
TwDǔULaAQeùHHAáKieOJJǔNáq	FALSE
VBJrǒSKCkDUlNYQyIrèkQtemq	FALSE
WúXuǎzBxhDeBPrOReCWOtrěLF	FALSE
XILrFFqúwèFWdòHDbUOèǎóaéb	FALSE
YlBNgokbyNǔZoKPxěYbERǎoZw	FALSE
ZzUùDXUoDrJpvsPmúVdLǒlmzl	FALSE
boSehhàcfWpWRNěpMJnoVtVka	FALSE
cqYCǎuqEcúPVJzmqKyYoxEtée	FALSE
dwwǔjiyMuKZrBoaGojwóSJBMz	FALSE
fáFIQIbPùrWyiBcAMUTsóVfSO	FALSE
gùkXtEZqjrkQrmcǒǎujDmHOǔQ	FALSE
hIvǒAnwLQoJEpMEùxcǔLdlwMó	FALSE
ieaóákgoòkqeifcěyChLWMwlú	FALSE
kávWvCGxTzcireGmùPEeaQsoz	FALSE
lGěxLPOdbBoQéVESXRǔiIKOZX	FALSE
mQtNHTAFǔùAǔCwyEuXALxéHnI	FALSE
nrDMkàwtexxxZQǎtjivTuVtoB	FALSE
ozycDsbaòYyCUzZsujwZGJHIR	FALSE
qúziIéWIuusEDoépQmgpCǔcXL	FALSE
rPFUòTòfVIMHBmTWNbùùpruFo	FALSE
sVcaSéVAGxàCICdBWiNfCNǒSI	FALSE
tqJVMtnDúwJvhDóvqRkqQKèAj	FALSE
vǒSèXǒǔXěQQseKwmvZǎaǔFixk	FALSE
wJiàFhFoFGOKèhèjQcùzEQúXq	FALSE
xelávkbahNTéGóVPbahúpjHDy	FALSE
yjYùjKóNútqLqgDdúcxALyDpd	FALSE
ùùGoFRóIwǎěéasFgtMZEgMLáwB	TRUE
ǔDmozSozDLoǎpKúaYéééǒJESRC	TRUE
áRZhsPWGDtòězèukaórhòonTbQ	TRUE
àgTaHdmmWOStZtBOVMThxùCAbV	TRUE
ǎojgóùGènqNYxHBqrYaIVCZàem	TRUE
éyMovYangmHYóàjdpmQòZRQgUp	TRUE
ěBqkgslagkAnxpyDOwctyWààyǔ	TRUE
óWòQnacěbròVòúètnyǎeòBaèKh	TRUE
òrǎXNnsDèòkoóěaYMQATUimsUh	TRUE
úéRSMOplPnmDagcóvQIúQHWawD	TRUE
ATawYDdàIELágvMEsEBNóoeHYH	TRUE
BvǔSEHgǒSaopsSTjSczǒrCqdml	TRUE
DGFXUǔjòIGNùHaCXpéWEtTYRǎg	TRUE
ELgqěèzàBXVAxGěǒqZaxrfdáòL	TRUE
FafǎǔVjaDimùàzuWWltěFjPNùM	TRUE
GyàxoAWJǎúǔxaSAUREqáMgeZVT	TRUE
IJpòaEáOwceǎnúElPcCsǒhǔqiK	TRUE
JatIFNújkHmòHJkBèQlYùòXěoY	TRUE
LáǎěǔCazvhòPáóHLXSpEAMànsù	TRUE
MPsKhvvaKWòmòjvWCMglrGqgǎs	TRUE
NjFuapqBèòHFMQIWvǒhóéòhDèǔ	TRUE
PǒmwsòXXnjUAymǔvSèaOePCORi	TRUE
QFshNBTZHagejáàěVOPǎáxnwòS	TRUE
RmYladVǔBǔqsJUbhCKgzùSààhQ	TRUE
SqxnǒajvàùpEeVnpJZòlwuFTvJ	TRUE
TwUwnQúpvèhAladchlGsěYLàDV	TRUE
VěúǔèòAóadfúRòxpRNùǎǎgaemú	TRUE
WJMPCáaMNòJpLMbwRèúpqfóNJv	TRUE
XUPRpaKěwèGNǔděKseèujbMJJz	TRUE
YaFèXvVmáenmFéxáǔHJúmszcwX	TRUE
ZnIFaqKHoǒónFsòùkSSkRplVàú	TRUE
aCypmmZceJrCěCdèúIPetcuòzQ	TRUE
aRúidvQòwiGDrukcfIPáBdàEYB	TRUE
afNBBóyRFunbyjéǔǎKvùhJěItò	TRUE
atNpóECGàMVBbUmuZMqWByptNN	TRUE
ghTLqySKqàGviHaùbNèvàiBQJr	TRUE
iǎKskùCxsùrhaHqbLHBéBMaHùD	TRUE
jJzgǎSxlICOAXKUiZùaRKdmbáq	TRUE
kVJèěoTotoaAǒRkIlwúLRWmùZm	TRUE
lhàkòěsURxwoagNyFUgbZneKVO	TRUE
nàlupùǔaNQcPvohǔICnZéPàBZé	TRUE
oLWBrawvzGTHvOGHNàpǎěXúxLǒ	TRUE
phGDFlhaPDFbáaHOqhYrwzPNàe	TRUE
qsoIAUiqNVBǒànaPwǎISJtSkùp	TRUE
sKqshxxggWaXmZupUTjfóaSǎcǔ	TRUE
taGICtǎòEeCYàKdPFqQúBóxént	TRUE
urrNRǎBǒàZIǎpùTótCarùvRóOA	TRUE
wòaAqǒúòAóSqRkCúdZltzéXzXS	TRUE
xLaǒRFlRúcguglSméPQSAeOVGy	TRUE
ykDkNaOyxěUvnLuSèrròoyBEUZ	TRUE
ùùUjGěkàǎáJǒuméAewsàlGRanj	FALSE
ǔMevǒVrúOApSccBzǎTéLóPCPlg	FALSE
áVěéywdxOiIQlxótGEJfcWJjnó	FALSE
àogszówqCLoupqKwOwmòMGùohu	FALSE
éǎGěxLnèBTqòyTnfcrělVQQóme	FALSE
èInfnqyYijtǎQmlJSYBhTachZY	FALSE
ěkèoJzLbGcLCúhQNbéePxRipML	FALSE
òàeTHqúJZědsxogzySZBpéWkyg	FALSE
ǒFrISNgrMgiǒSvvznMMYPěǒIóO	FALSE
úiqkVòLZEUFfWóùǔQórlǒAutGB	FALSE
AzIezLhkXIBǔmTZdIraSBodbgW	FALSE
CJCóxáUsozczěàGuFúqxcxuaqó	FALSE
DUNkGóbVWbVǒIXCNiqěwuuǒSùW	FALSE
ExòáèuòQNHIXnáLZVGéZXfEddQ	FALSE
GGǎbopùùrǔUFKVzCnRxUNVúdif	FALSE
HaúNDgǎKaKácěkTlwòqZNmSdcZ	FALSE
IqtJUuPANvXuFSBMGxkòlébpAb	FALSE
KàseùZXùnwYǒNBkaZcIbiyéúHB	FALSE
LAHHBvqlǒtbBpXeppmWAJerOwI	FALSE
MméuNYěáoéHróáXLòèéCǒxyfHó	FALSE
NxloKǔKcKmidéJEdqgXHmGwJDb	FALSE
PǒQkjKedaXYKóèVKèjáùáuReWs	FALSE
QbàkBácXeǎúyuwFSxEJPOZLgwI	FALSE
SàkùAPúSigCQqkèuUcǎǒXqQOAR	FALSE
TTEKHvttKòkERQjFqǒàZǎǎoěvé	FALSE
UjùZZBxáóàCvzMAGwlfùZsoBHd	FALSE
VpònòájIXàFLefáFSfzúǒZǒUNM	FALSE
WzlSLmmbyjQQSùNfVJngkoajOd	FALSE
YKTjaTòffTdqZjgIáaHèonWMòǎ	FALSE
ZgjSiekCěmrPkcWkoITLqaóěWd	FALSE
bRBGLTqeaDKáKqkNWéMoSsàKtb	FALSE
cbSLgUTBtgaedxátNVBéěXàBVó	FALSE
dfyJóòěHQvòiQDOdàDzěEKtFbe	FALSE
esQHUPútháéiedOóúqXAKTáNIú	FALSE
fzòkòòIXGrwègdHzúTUWyrAèZY	FALSE
hVOgHexhUIafèrVǒNAJQIsASCG	FALSE
ifpobYóègHěCěCQjfpCQQèKIóB	FALSE
kàrPDqfiúDscFaUlóWtiiǔFYěT	FALSE
lBAPTJmPVUEGnFYgOJwtGmbbúE	FALSE
mPlLùUqcáSàùhǒqRaxXkáqqpyW	FALSE
nhAWTRMmáMáòoùNéwPOzQtDoxb	FALSE
ofǒòvhǔòLDrxUòxatVleGDVMCy	FALSE
pmFàqbTXBxácqèfLBqywYSěpoY	FALSE
rùofpéVBùQhxDpVuútěBjGVFùu	FALSE
sHNIDAcsùTwEégfJTtéacclóYF	FALSE
tSúDwjxyEǎútoàOPmecwǒBTOmT	FALSE
ukrmtoTEhTEblHFUxrUVhCVXDl	FALSE
vwùhbNúqǒObXHǎVkTQòPzdcyPr	FALSE
xFJkCuǔgěeaqxAqmuWgulfeěEú	FALSE
yaWaizMěHuYkKrVòRJKǒěstYáU	FALSE
ùùDAjoèzHLSnLEaMWBěBQCnIZàg	TRUE
ǔHějLHéymúgabLúěsoèMWDGWfFx	TRUE
álèǎǎHaVòqNéǔUAeszJjcGAénvi	TRUE
àjpórǔěAǔVúǔaCàYJLYinǒmúdUA	TRUE
éúkùPRJàBvCEmWNSPKaQAfmRágV	TRUE
èJěǎmaLúugGróLzǎúbdmbrtDoHu	TRUE
ěRshGJwKKnVNyaBfàJàWóBktdrN	TRUE
óZEyOJoPěúFaéJiùúXòGuAtERcA	TRUE
òlgCazGTvLèCWZTCOhDdIryúZùǎ	TRUE
úùkaxlZcBiMNheěěsPDóXnbAórP	TRUE
AVypjQgaZoriǒsOglùxrIUèeuXQ	TRUE
BrxmaIWábiyùNXEWěVlcKakYnbq	TRUE
CvaěRzfZLXtùLèTTpjyZiruDhSA	TRUE
EǒNjXOSTàahVáhuáǎVkéOFRǔúfp	TRUE
FaNmMoTqPpxpLieMXlóRǒFichòo	TRUE
GpěkAPǔpGaJlozBxěynKekRúYùg	TRUE
IǎaǎùǔxáǎVYáipqJAqUYàSHLàóR	TRUE
JJKóJjúPaVNyZIéYnoUVGbGuOvà	TRUE
KanEUnQfhRDmIbúaoKòèCYùzNHě	TRUE
LjNXaUZXMXOòvCZEóNEApgJǎpqt	TRUE
MsǎaFMóglwEEWcyKnOgonmOSxǔI	TRUE
OéúuVRSYyEzOFáUzRtZiESIBpya	TRUE
PJOaěMěLMPoESFQGFSNùSlYVKAM	TRUE
QVUZkoěJaáéěyXUNWBPRǔNǒBVBt	TRUE
RmAóàaYwLfXklSoHImǔCwǔOtokó	TRUE
TGvDSWySlèYsZúGWIAòYFvEacGy	TRUE
UarikùdWjwoQwJEVěBbreIóZfzǎ	TRUE
VpaQriinBUYwLcǔHHéJKGRPDhjg	TRUE
XěahWkXàugásqYfDzlAěěǎPXeLǔ	TRUE
YǒèéòòLUaYVQFTèFZúùàvufRgBY	TRUE
ZNaOAèABeèǔYTrQGbJZàVǒoàiga	TRUE
aódUcGnHLYǔodizSǔqèúelúEXIw	TRUE
aKeégEabSLDAqwFHCVrmNqǎjWtz	TRUE
aXlúlgzHqYrláNukOtopCpúàáSE	TRUE
aoǒDWCUkrAǔMěPIlnéjwBXPdyIǎ	TRUE
gORZEDKèTQxspxlAXRUKZFaFJBJ	TRUE
hggqvPSaorkOoSShzHàjzsKvNèj	TRUE
jótASaAIùOǒojhjLiGtevǔyryǒJ	TRUE
kLqǔTànknQarHKREǒhJsJRowFuZ	TRUE
lmsBaCUMRàgwuàǒMfFUrǎàsktIS	TRUE
nǎHǔCzBZèTzXaxhAhNěwèǎózTAl	TRUE
oQIùZlǒZǔSNánVoYXJàKaWZeQDv	TRUE
pZvExǔiuRKgèǎèwǒQaiqyHcdǔIW	TRUE
quFtZCGCúéswVYspquájPCòaBúP	TRUE
sǔrHvòLGégúJèzhMUnMabcRHFLt	TRUE
tLáóMùTapOFjáhXǔěéXóVǎǒDǒXǒ	TRUE
uatèJfUBHENóKkyInáVXKIǔáágh	TRUE
vomareFědZsBnKbNHNIxúOKáufn	TRUE
xúhoaSǎsgǎMLIZDZNéXLněDKyTc	TRUE
yaěZKPhbàHpZèxShMCCZpOcWòpB	TRUE
ùùUGOúDTNIGúPWéimǔòRfzùRgUM	FALSE
ǔKàsǎaópXǔyIHQèkiùjpbhbùCuC	FALSE
áfèopcLmJCSáoGHaápVqKwHfWcT	FALSE
àqNSGěcMàhfDǔqùAFrlinúCòjjP	FALSE
éóúfAǎLCQúgPěqùeaXIaHǎúGVSh	FALSE
èMWLJwEGǎHEZGSXǒZQBSWkKóPKU	FALSE
ědXnRjGSùAmWdIZqǔiEdSGòòmùǎ	FALSE
ótmUYszòǎirěKuNPbVmJéQEfóHC	FALSE
ǒǎRújLUbǔsàGBtKróVSNOùLNKǎf	FALSE
úQUòZyRjePyDmNPHéǎzxDocEVRJ	FALSE
AtwKèXǒCpZdJúSpvYrzPABǔkRzw	FALSE
CJJPkǎQEfkbmEacmQkùèPKAVuój	FALSE
DVwLkskGjzhoèǎCOpLGkIUàSaaQ	FALSE
EséBǎSpSèrùéàkǒkenCjgxBqBFD	FALSE
GAIǒwhfYetǒfFzrámjGyDtRdfáw	FALSE
HZezjMTlěkNùPLXqzDFSrèTcsnC	FALSE
IoKwPoǎkbWYèGoPréfBDkCuPòéó	FALSE
KJZOAǒmNrQóSHRRUEIěǒòxúYàcǔ	FALSE
LfǔCXùáCCBjǎqádGǎbbHQlSùèxù	FALSE
NàVbyVCKněIhkPàzfwcǎAaBatrB	FALSE
OKdjcRUúǎaaòQknpbfdfXVVZpPO	FALSE
PPHǒRLyzLèpóGSKUhBnájumlTmc	FALSE
QQQQOáǎcNMáDdzkzRǎCZèúéévLh	FALSE
RcWéǔKzHDNétLǒzGjlaWIKgqmer	FALSE
SyǒwccOEěldvHWZJWdaNVùwhMwh	FALSE
UGcděVUyòKEcghvHdcAIznnèéùs	FALSE
VYǒIkMhyZòTécaùTVàTàiLufǎNò	FALSE
WméèiěRySCoěVǒJGrrmtsJwMIèd	FALSE
YèrǎEkFqZjóOhúǎbáóàajtiúpèh	FALSE
ZJWSěNExrkNkgSpbScBbǔěǎáwóx	FALSE
bLiNOeUrOrěLrxtPEwIQhcNRJyn	FALSE
cSsgriOAuDTisbSjpWgàěVIěèUJ	FALSE
djXwaxOáXGiNYJǎpPczrOGcmpnm	FALSE
ewbáxtěSkjéOzdLbUúyǎqUǔHmyF	FALSE
gésSLUsǎCIùàWugryGzWxhTUǎrW	FALSE
hEfRQJbZxWYVKBwgIGSYěgCěèTě	FALSE
iTMdmǒqpúimhmOèXLuMUIQǎKézq	FALSE
jsnHnZAHGtHtZúsxVhiDGhcsZZF	FALSE
lCGSbSUúSóTXsHtmcAfUǒQěǎJKa	FALSE
mLóChieOkǎmlwPdsǔmFQAlúRUúP	FALSE
ncMwZqùvJkkizmèǎHLanBǔwRXcL	FALSE
otOdbǔFěEQwlpúZVtIǔblùAoúQà	FALSE
qéaXAfvNCáéěKDHùfeQàWbdjéaJ	FALSE
rGYkdyDVyuCzuHùTKfKWLMbrZTT	FALSE
scsVMyèIǎreqfMúEáspxopèkKbC	FALSE
tvèAmgtHiàUOáuKiHǒAleYKǔjGǔ	FALSE
vAElIéahkògfdLTòhWJqédLisRU	FALSE
wVFMMXfVMWnióeomzQSáǔuZfvTú	FALSE
xiPmKBuMCVYǔuEéVáPNnIocàDJh	FALSE
ykǎXiomNèpJkěPDohqVIJJNXjhú	FALSE
ùùnCMǎúXKGòWaFqècoVBgLúèlDwǎ	TRUE
ǔěaxúhhQqPéèikJmòrixètéTIXbw	TRUE
áVáHmérgAXzěaEvJSsúYùZzfDùnQ	TRUE
àqpKPBgZóWétYSaùrPiRěmCZifǒo	TRUE
ǎyGIgóoTaZuǒMQTqxǎkóxNTvTujd	TRUE
èOǔRNswEǒvBzStJǒàzEmóHáaácuǒ	TRUE
ějmkEZaOXSgiKéUàYǎuykkAbétKe	TRUE
òǒAnqaǔWJrEùQBRxEWEDǒqIZLKǔd	TRUE
ǒLurhKCTǔkHMZaOsMIǔOlQéQGmnp	TRUE
úaUxYwxèwKyrvvDhdGpxLyàèqKpb	TRUE
AwoztnóWETéhKyèImaáEèóIkpàVG	TRUE
CěpNJáIkOéǎlGGArěwQtǎMSuaOji	TRUE
DIlaFnúVSRwǒuUsbùàlòmǒNǎéNiH	TRUE
EXtsaisDPoáěErOhXěRNJǒCáHèct	TRUE
FplúahUyCWXvBhDxYueVěYLOoěàK	TRUE
HàhmAzOěXoUozaIIFdtgLúXsMxgJ	TRUE
IFaBVsZǎiqwKUxǒěèwòbwmgQmhEf	TRUE
JXtCQEDyaibAvekwRzcuySwǒMWql	TRUE
KjGúxàGnahyěéFùAsMiéGèBBYQěě	TRUE
LaěǔeDpiYDPYǎixOLGqazdRYèSMo	TRUE
MsjmNéAǎJFáRaSgCKyRǒMèqǎsnrc	TRUE
OAxaéèLiKěZLuLRFBVDiùYiòcqFé	TRUE
PMxaQdxqàEǔRkIKSòArCIZaěiòKè	TRUE
QaútIGSCRSRGWǔjǔYmněúfCMilXx	TRUE
SǔněsóáKYmOPyJaKbqaQòdZEúěsZ	TRUE
TLHaOlIèVEktkǎVoCegsǎVúfTPEK	TRUE
UYJXPpsaqlvGrcoauǔèAèèiYúáGR	TRUE
VhajdPJàxCòxTJusEtITùAvMoFMl	TRUE
WsóVDglJhWéaèFKNXEkgPòbBTújú	TRUE
YèBFaàtoZCéQxlèDòRSZuFwhóiGá	TRUE
ZYohXEMlaoXyáZQFIxyvrFèmKVWY	TRUE
aóBMXWǒPIzQBPWEKgǎéwxjmTxTvk	TRUE
aMtEmXVWvXiàVúùTOFqSOcáùóUkh	TRUE
actúAwnǔvéóàpnùòGwúsǎǎtèJěmx	TRUE
arrMEYKmQNIgnuPHàspwàTǎúoàbD	TRUE
gXaéMhyEáUOAcklòNwrIWYáRXXBg	TRUE
hjUNINWòóRHHquqaGlqyELqHAhuo	TRUE
ihoVaàjjùèZvrZCǒAáyRXǔIǔtcRA	TRUE
kǔzotmaXèJloBTNmóTǔóhfdgiěkz	TRUE
lLtGuVCJOTuzqaǒvHpQlFCǎòǎbǔO	TRUE
mZáarDYgéEPùcjBPqOLjěxKsǎéNr	TRUE
nvòMOLXóZosrINHIadTùLFhYTopF	TRUE
púOaVUPYUFUPǎNUWPLlnrTFKzzIH	TRUE
qNrIRqzluRómSKhiváFHOpEpCMya	TRUE
rkùGZacYydBòqykAzWǒbNxòrCyGR	TRUE
tǎHvsZEBQvóPaIlpàBVozMébéAYf	TRUE
uDDàaPFǎùMeSfCéóeǔznTwRùOgóC	TRUE
vahgóDkzòXTYdybèPúiàǎeRZávHo	TRUE
wwěvMàFIjaOgOGqLjkZhZǒbYOòět	TRUE
yaùázYěyOzoúLjSágEúàReoáiHNU	TRUE
ùùVGúqHědùfJǔZcuòrmoǔCYGJzmw	FALSE
ǔIPSZOàeLmSǒOfvùjJkaCjùakokǎ	FALSE
ápKMqUábYbSdtǔYUjcQOUSěEGéjě	FALSE
ǎéPfijFYLǒNNWGKcsèěmLFUúxTGy	FALSE
éEmǔBvwxúBDǒojoóTwBSdǒDQěQBq	FALSE
èeOQòtjIkudDbsIBoǒXǔKSokfàěn	FALSE
ězMoUYHqGIrRYlJoJGǎcPYvarXjǔ	FALSE
òDixFkoFòhTǔzgoOzeXNǒhuGǒNNP	FALSE
ǒQcoCEùtfWǒrFFOZlCLòácSkùfzg	FALSE
úrmKRMèmLHàGhkóòRúúpGàòúǎmúb	FALSE
BUwGegBevòòsǎAXdXDqJòǒUǎvtuù	FALSE
CVcdXzbdVgKKIylsJbHěcXGIbfnǔ	FALSE
DwAeDǎTeVjdzpIOjbàwěKdMgVǔYM	FALSE
FGEOcfǒBVǒsLAZdolmáLùbSǔòKòF	FALSE
GLzǔILěZWCyUKTkspHIbaèGǎzMUM	FALSE
HXvXódnnmZRzwGsHYSaujóiWYzMP	FALSE
IcNURStWàzmQVHùKyMhèéNptòúǒW	FALSE
JtQMQdBvfwhuBUòYOèNǒàrrPKKXI	FALSE
LFájúkàDxRwgFBéxǔmǒycNXJaROw	FALSE
MPJzhZykcUjnEsVRjyXwNvmóBRHk	FALSE
NxIUVèKPTzúòInwéRmòCMkZCNfǎi	FALSE
PHsNIPeZàifyèNjWSFYyúàaSRiDi	FALSE
QVxBǔNAThúZpqZùohJúgúUùèzéIV	FALSE
RcèJIupòKGóMouòopSNchCkDpKwI	FALSE
SzǔdóVnvWécHYueéZléxǔKóhXEmC	FALSE
UMhǒQguǎcǒqnRmBYIIUóèěGsjTIy	FALSE
VkVYcmǔPRaráxYàCǎánWǎěgIáZfO	FALSE
XěWUěYCLDěTzbzIéSuóUMQGJvǎùp	FALSE
YQOIokgXěnbwàXWrEyDhmIYwtTCG	FALSE
ZgrSfciwUuNjǎlkǎqTRyTsLeúùZt	FALSE
bQTRnǔikqǎCàǔdúfěpgNFrnVPéam	FALSE
cfjbdwvIcKpfétǒòUnxVcòwRjsNè	FALSE
dfàNQSUVSLóhémHRPUVoqùZQomGY	FALSE
edyǒptHvòiáěutPèqúJpKkcCxǒgO	FALSE
gěYkèsSpAIèǎHěpLNLYoùhmrnUIh	FALSE
hBcaqLVRyúpòarBXTjáéPgwUébǎz	FALSE
ihǔòKKóéZOgiyyúnOiItBoèònǔùh	FALSE
jwiJXóùéSòYǒwxYUhyZámǎjySmYn	FALSE
lEsùKrHONciTùencdòWnkhIPjnGW	FALSE
mdStéàPvòcèáZzxzsWqWTóqPjàòA	FALSE
nnàVFVGJsMrCVyMdpISyDrdviféǎ	FALSE
ozEVztuDYeXLftIIbRrmBMbBYzǔv	FALSE
qBóòfiKAbCtéoàiogòckZdjǎWFhE	FALSE
rHúfǒǒNOYǎEwLjubGéòUúǒEKuàAW	FALSE
sbfjKXLákVúǎjmxgrgwOrInknJQT	FALSE
tzèkǒLeǒàrgPHHLUoaWlòXFVěIex	FALSE
věFPEkměhTGPPUtǔHAdSvQòúQJǔǎ	FALSE
wSRáEVtkyIpGěvěmdOsúzXzùGòyr	FALSE
xgWoǎOoNKJMěREusZiǎcNǒTCěfwm	FALSE
yuǒZYyrLQKúǎkVxMǎneNaòzUzòOW	FALSE
ùùáawuuXqWEzMYQèdxymblIcTCDZp	TRUE
ǔúwtkaOúgZnooéuEBhéǒnOrǔUǔpRu	TRUE
áXWǔLMMkFáQMWjuCUEjJPCvQqpmaW	TRUE
ǎùMkatIfKgbcùbjLXòLfǔkadVuClb	TRUE
éééPtaòVǒWimmDáálVVùhHULIlJJv	TRUE
èBtikǔMvǒáqoGhFpòINràaRàtSùWo	TRUE
ěRyXpYUaqzAJqnWWQáFkTYdùRLyǒv	TRUE
óaǒágJgLàAěNhLHssMóòfEBǒDSuxW	TRUE
òsHStTqIiúSGóVNqǒmióNávamlAQS	TRUE
ǒvòSIZIéàuPRDǔazTvwoWXjcbhtóP	TRUE
AóáǎòaoéqSFàlVKxàóGtzǎDgprSdr	TRUE
BWGNIsXGaehnǔòRxxpóúhtmsòdGJT	TRUE
CmgxxpzzpéapHduWkǎJRSrCǔPOGYi	TRUE
DzwáPúHSapPDEIEjiùfPGWHHaBCàm	TRUE
FKèókRMJBǒèǒàsGOJorRazvèNFKSy	TRUE
GaFúmcáPGwdúzlVǒjXGmHMoLújUéQ	TRUE
HxkOqùrZXiyaěOBòqǎPépEǎèvnOPà	TRUE
JLIáykFMaNJPéIyvZvOrZùGdwvǎwé	TRUE
KnPuaYlwǔùDéPijlNycPTLòNkgzzX	TRUE
MóRJGwDwùéusYYéúSITgǒúXuérWaǎ	TRUE
NTtmàuaKóOlkúJpùǔOGsRjVsntZlé	TRUE
OaNǔZBUEUfPWvěbcljúOlOiKDEXmě	TRUE
PmówhryòEàOOYKViòèZDqLrQyBpTa	TRUE
RBamIgphǒYDóAàhgQVYǔBǒXGEóIMy	TRUE
STmjòwéQRuààPFǎWóRmwjjhèREXaě	TRUE
ThǔòuPXysasbuònDVADLyXgǔzXoNv	TRUE
VáapwOEóǔoYOQwnuIHKhhFhhópóPB	TRUE
WKrrwxéaáèQlQLYjGxFEFsAGXVewǔ	TRUE
XaábaAIpuLRyWblnsLQlékowKwhjQ	TRUE
ZòóhùxóáǎjǎFǎOWGaVǎtWeAjFflǒú	TRUE
aèèxhjmduYUjlNtǎòISIòuOqfPOuW	TRUE
aITàdFgáspóFGjCWLaqqrGGFpěěyu	TRUE
aWDcVVaSneOKTmQFxSuvdFfyCqbud	TRUE
aipJúXFcVldúTeGUǔǔGQvsěPZVòéM	TRUE
awGfbzùǒúměGKYǔòècBxkXóAAHtxz	TRUE
glOJxOwCIòJpěaiPrSGCútTBwéBOu	TRUE
iěkZZNǎùGJPáWómqjLzHMalbùlIyX	TRUE
jXXnpafyMoěJsPzxOoèejǎLXpEUáM	TRUE
klHHLWIJuarmwNùyèxOrOJezǎmPèI	TRUE
mǒááaFpòTGěkPnsmòXsvijòjYURSé	TRUE
nFaCNěESSáwZjéGyzsjéǔǔUHPěDkk	TRUE
oVúUòOtESJBsaCǒfyYFXTQPjǎLJMH	TRUE
pwaWhCoUHQYWGHMsúvFhztgUěHDlb	TRUE
rNxòROSUWYVwaqééXgwVuSǔHǎkAwu	TRUE
skǔQMrxIwinHCWDúuaOpmstqěàeXz	TRUE
tsTWNlzaMàvrRtUjǒdHnàQxrZXZTN	TRUE
vóiKwgZqhaQBgRMHgúKUiAPwirCPA	TRUE
wJKpkEBZzDAODLQRǒǎjIDUnZoCaur	TRUE
xWPaqALdVojGBDIKjNlnoyrèaóbgù	TRUE
yspSóàKgPaállVCbCòIIseJgěscáě	TRUE
ùùxpcjegwmdFNèuZwóoLTéàpZuIZk	FALSE
ǔBéòMsTeJYIJXIoqjLjjóéiwndLlT	FALSE
áWQuzPUzYòSbRjewěAGoINhveèHpl	FALSE
àjUèùéUMvSHKGtPzeyHǔjùéǎzsdwW	FALSE
ǎputóWTeAXǒèApèKòkgSlǎěúmGlQá	FALSE
éwWjǒiBèphúOCUCSmǔWtRmlrzsypé	FALSE
ěáòMDDfNhǒǒAQJúocǔHOwYqkJJJWU	FALSE
óUǎěOciyvfKjuZgaqécWtWnoJbXeè	FALSE
òhrQvtùcUwCJTRwuEùpIZLQvEWǎòw	FALSE
úùbWgwcWǒcomzgwIEáSgbtyùKLDer	FALSE
AUNòizyěxWéSUjjQPbaUnxéòTIpTW	FALSE
BSeEVwZfùùQǎVǔCyPiXCèsàkAwWcǔ	FALSE
CdZIóinKFJdsǎxmswvǔlgKfIHVdáh	FALSE
DkúhNhSTTHGáQgǔZBEgàGOBGfOzfX	FALSE
FóBàùcJnXěòLèFcěèdHòàywyxHOWH	FALSE
GKUMchǒJAǔSpxfhPiCEEàèfǔjǒWYR	FALSE
HToGénbkOoWjIOuDDXarLGqUYtLRF	FALSE
IqOESxWěYOPpKtDjáúCáyáǎlWùjpǎ	FALSE
KǔjWǎùólèěFevSóyéyqQDGHhzúváM	FALSE
LHáCsXǒkpqxPXyfQXóXImgnǎpLIZd	FALSE
MffQINóKkzótqZkxZNujubJYqǎkAù	FALSE
OójHLoxéedomtPBèKóDèEHhCVaaNo	FALSE
PUDěNfCúBEàkTòhéáǒDuoNkSSmfCà	FALSE
QnCpKNGTsLtpcaOAmiqsamáǎuHxoI	FALSE
SóyBXoKNAEdnaSDyúúqfǔXANIeYqg	FALSE
TWxXmeHisgAKYDahvzMbbáWáaòKúo	FALSE
UodXABQElCzAùoySFdoWolǔoǎMMGě	FALSE
WSJzùYTMyDEěènècvyǔmvòètǒngne	FALSE
XtriòWùgdywNmWZoǔrXXGsòèXeQly	FALSE
ZǎeóhěòòoěóZQrsměmNlqxVǎfOtàu	FALSE
bǔiǒsOèrfèaraiXzrǒafúRwwáèoXS	FALSE
cNàUQGAàùNYCZpFWbDbkyRàlqmeCZ	FALSE
dXěúoZPqONrèeHZdvZGYHYúàNHBbè	FALSE
eqYxvBgMWǎtBèaxYZFoSChJófèZěǎ	FALSE
fvZoèKQGézajěápCYbvSPVafbFwSà	FALSE
hěěBlQJǒnéCUyMXPěPǎLèGǎqxJOPó	FALSE
iPlměvóSTHKeBoǔúVkKBNCSyKejCk	FALSE
jVklXOcSqJPJhǔobSMDrLFavvlxzD	FALSE
ksMàYsdúpjPMěsTDzbàaǎDYOVóUró	FALSE
mGfebCXǔtXmwèhcPpSbGatCpViětA	FALSE
ngélěvuFbPmIKcctVáyqXSHnHùàbK	FALSE
ojúzvQnDFàSggPgQǒzúKeSWvVeoew	FALSE
puoablǒxsǒZNběVxJěvQùUZnGGjèN	FALSE
ròpUUJxSdDmJSymTosèòBèrhDxùLp	FALSE
sTIGvKoágǔcODOOgSebqxawFkNPtf	FALSE
tgLQzXrpLcNcERòebwǎblǒzUabOrH	FALSE
vùǔXUùùDXFaTCJwGWyzHnNDwétaYy	FALSE
wǎàlPLdDáAUJùZDSógiQbRWJWkSXF	FALSE
xKúozlDóMHDcuMfVXjYqycùNHztDE	FALSE
yfDXOoBǔMUùWYCMzRàǔóQvúorGǎzě	FALSE
