ùùQKacQHpYǔkeǒgqFěHe	TRUE
ǔCncZrúBzKIrUSpHRzkq	TRUE
áXMMEpHXèhIrǒfUxjǒpú	TRUE
àqDǔéKgúǔeAuBFIGVpYq	TRUE
ééòkebúvJèNRmèhèXhǒv	TRUE
èHEOèaúàzEòEvmzPKDNO	TRUE
ěWPòkrDnDLPNolZHVlóǎ	TRUE
óixXZReQqppVnòǒSSǒěr	TRUE
òvWbcgpòDdazTrnnUkéH	TRUE
úFúLTHRoǒBUfphjIBóBy	TRUE
ANUcyhǎtqgwEUjòSamLB	TRUE
BhYsùàqdóuykNhQgǎèFY	TRUE
DáKfèěBàmLlyyùaciAPQ	TRUE
EèFTIKDMSàgsxTxblTED	TRUE
FASLsjRQJlUBYAxùXvǎf	TRUE
GYzRePIǎViuǔMceǎòwQB	TRUE
HjwáexibsdQèùvCmkHag	TRUE
JǎǎknUhùlGSzòǒcttěbù	TRUE
KRBHkèDPimáAùvèBOwmǔ	TRUE
LdǒùóljsqhBQWKǎCěàèL	TRUE
NàuoLàYnCélBaWIVlNOù	TRUE
OIXAúóǎgǒIRLmkcVhwCt	TRUE
PZLúúfgwèlrMFxsqXhdk	TRUE
QjYúodKKmǎfxIdIèǒSQC	TRUE
RvhǎawHmWjdILULǔriáǎ	TRUE
TBqVkúòúsbdWvLuGHiGw	TRUE
UYFCorbJdPmoyYAùxlǔǒ	TRUE
VtzLZkzúpAúGgMAMoLqú	TRUE
XANǔgWneòdǎèJFxQNpbd	TRUE
YPgòǔòltBTGéYěJòrTKi	TRUE
ZqFsNnúòKkègǔOFGdxgK	TRUE
bPPWGFMvfùdHúUQkiǔmC	TRUE
cuvlóLvUǒmkisMgMvéao	TRUE
eàPtnykGmCǔLwoRRfězL	TRUE
fNIJBHbxFwIQAúQVxVxó	TRUE
gXQzòcmVxúAéVFmdOUns	TRUE
hqJúIwHùigǒyIUggUpCú	TRUE
jàGJhSqOSXlEUOfWqqbH	TRUE
kLLYKCZEmNmxplnúòWoV	TRUE
liUCDǒǎruèMOslxibJys	TRUE
nFbpgmMphcTTxVNAWěKs	TRUE
ocúAhóòdùloSàéHJDklO	TRUE
poMTkjvKGèCvUeOèiHvI	TRUE
rǎuqǔaáhcjiQǒNTODlwH	TRUE
sFǔaéyHdèhBohMlgOXjd	TRUE
tOjUVǔsfxOSWǎIMVRvàè	TRUE
ufùKfRItwIRoěǔKzZéBj	TRUE
wáxSQUYmóBóNtMSyQvje	TRUE
xNNSgeǒAwvvUúIHóSEqn	TRUE
ycmyrwséHZykrpLhwnǒG	TRUE
ùùiUUúYLàTaéaúWCUpZE	FALSE
ǔJGrgUblmaDéaTPvnUzD	FALSE
áewrǎTLaoóaflXébKHuZ	FALSE
àoBSókDkaězmǎaAOIccS	FALSE
éIAapNǒCkwaUwFglkZdě	FALSE
èxùzNkoéwMzTaúSHjKaM	FALSE
óWGkaRaYRràWdkliěiBs	FALSE
òyoèNaKvGHRvaMjěhMSl	FALSE
úVǒMHIxGfàJYRaéxaěéó	FALSE
AjěoòGkXHamaBoTWbHKU	FALSE
CGzpaúùúhRZYiadAǒEpQ	FALSE
DaOMRhEwFGyèèCoaXpLL	FALSE
EtjUaTHMawAaOàòAtSgc	FALSE
GJaNTCNBqacVTáòuKsDL	FALSE
HicVfúúǒyQhCjùldaaPù	FALSE
IzmqóFUcpaOXOàiúZOaP	FALSE
KNrtaNBvaTjIGèKvwCAh	FALSE
LktupaZEKáaSYBěětrMl	FALSE
NáESkCSúqfIpKIgIsaóa	FALSE
OGPiiaXPrUiCaSSBowpT	FALSE
ParaaWzBTùpkJHdYKIFc	FALSE
RòFàèaxuPCnatrHnxVyt	FALSE
SYWwfuDǒXTHTTaúaEǔBG	FALSE
TwóuUzimùAwAgwGàaaZz	FALSE
VúòqScaWJatVSHéstqnP	FALSE
WZEBTèǔnáNaCéRGyamzh	FALSE
YéHUdatXQMPaaNóàrnPó	FALSE
ZKkaSiaJùQqTBòlGnǔoò	FALSE
aěLaoèvEojèárEuBTOze	FALSE
aHtlvóIòainFAvùUiùSw	FALSE
aYNVFUyRVahéImléHkVN	FALSE
ajanDUǒBAFhhwSZpAǎèY	FALSE
ayIEDǔjHiǒFtSáAaqDCN	FALSE
cPTTzNùraynaúCipRfSǎ	FALSE
eáaGitmǒéaLàjuDJDcjI	FALSE
fbCfolUtkodKgǎaěEiOa	FALSE
háTqúVdGcnnarKáiúaNK	FALSE
iódzsmUURZǒbúèBDzWaa	FALSE
jhkòYAREùVaáúamnmMéò	FALSE
lAáWaaQùpUDàáFFBuRóu	FALSE
mcǔbgGPQsLanalQùPSwj	FALSE
nxDpQwakDNjǎPulHTnKa	FALSE
pHtiOoshyǎpwédatòQAa	FALSE
qavRSFòUěúZxwǎYoayeo	FALSE
rzěEtZizraMMRgkagèxò	FALSE
tǒzBdOkǎmtvlDNfhàaaq	FALSE
uNLeqapaěéúAeEùUbeKY	FALSE
viaQaftMNnzkTélUosxm	FALSE
xBUUGvVkòLzSODatBaIà	FALSE
yUWkvhlXèQnàUMZITaab	FALSE
ùùúòěptKlEYAxwTósǒéǎE	TRUE
ǔòUjtèlElnBZJcFVQEEeè	TRUE
áVLPuuEgTAjVNBMvyawFS	TRUE
àmxTzhyǔEWuzCáiqoQKJd	TRUE
éǔòUngùCloògEzAXAǎhwy	TRUE
èTaNcEXtpZTFAblyNsòPM	TRUE
ěolypCughmfdAàólblLQK	TRUE
òNóùUaSZRAUvZùJLùZpóó	TRUE
ǒRUòsYéJkeZumǔAJGméJe	TRUE
úxWKOMHsAFFùHXJkvGMWw	TRUE
BǒPRVěodkPXàOoCjTpmmb	TRUE
CUPTIjepaměcKTàOnhǔNa	TRUE
DabvgNóKǒrezInhárUùèn	TRUE
ElxkIxEYqáUdWYěóuǔxrC	TRUE
FzBààHwóDGèAUùòyxNDǔe	TRUE
HEiuoèMwWVKbztszrcòùK	TRUE
ITKWòksDiIéǎDUmWRwRhB	TRUE
JoHTeAéTPFuPércwfjIAG	TRUE
LFDaPnǎkwrKvzSIǔoyǎks	TRUE
MZǎǒCXzoWǔXmcWyijGnDú	TRUE
NqǒurèNKrrQòuddóWSdNè	TRUE
OroHhOǔeGVáraxěvAvnmw	TRUE
QécòòjPkXàoxpFDcUàgéb	TRUE
RBNhèkěSǒWxàqfWěòJVzò	TRUE
SLDéuòáeMáPDnzlèǒeǎUs	TRUE
ThNsjviaGQNnbèòeWwOoC	TRUE
UyLbàfvSWtèRnUhxòNjWf	TRUE
WàWaLóYsDbjilGDaMnENk	TRUE
XMěckòVKNGiSrúútFUxǒC	TRUE
YiézLgKáRJwZFAHéúqLff	TRUE
ZwǎVéFDgmRRùvAAcáLsùK	TRUE
bOosACPéàgPtFgSjMUbǒq	TRUE
cmDbiwUCthǎtǎòUYéRǔàK	TRUE
eàvaěRkJhùCvyCcfxRHvD	TRUE
fFfAQYUVúàèǒklXcCNEBF	TRUE
ggěCáLLwIQcnrěihOKzěC	TRUE
iàDèIegyaèLNmARZMIBEn	TRUE
júESrěCmAFIqùseáLàEYl	TRUE
kLPZcwǒrěgBlPAyfQiSià	TRUE
lZimYDKayoúGWOXòBomòM	TRUE
mxDéjyOZǒWEVaqnDfZudA	TRUE
oJhóKzDmCkENǒLQtSqaTX	TRUE
pgjxǎDaeùSVAPVGyAixiN	TRUE
rópMibvoLhàǎORmiWBZVT	TRUE
sHTZVJgiXOThbfHSwIsoI	TRUE
tYgEùGbGOetxnùpAjTnèE	TRUE
uvSòèyWHxqgbXZodZáqKK	TRUE
wBkǎgKéfáSjJFNàSnkzyk	TRUE
xQTTUdméǎáXgaRǒONVdXQ	TRUE
ykDéLǎiJiùzyKVvúséPeò	TRUE
ùùòQàefSajFonLYQaItBx	FALSE
ǔOkRùFówSSaděaUsùYhTa	FALSE
áesaaNùcYAòěqHgéVnUEQ	FALSE
ǎǎozegǒùxuávCaěaúEziw	FALSE
éPǔSǎCwjlnoBvaHǒvaxSx	FALSE
èkióJjASǒǔWaQaEetKmpe	FALSE
óéáooVdYoDdayaCFlGrcx	FALSE
òaNCJELlNaDnsZLyóXrVC	FALSE
úKpáFVZXWLVGVǒavoGaSd	FALSE
AWJispaYZiYAùaPgbkIQO	FALSE
BoGQbvvktFnatnaàèOFWc	FALSE
DPúaCQaeBǎEonRoybLwéx	FALSE
EoOaxOZxauǎtZgiHǒTáIb	FALSE
GCaZyuVZoBOhéEPBvmrab	FALSE
HZluLriKaHhwEmRkapNtp	FALSE
IoRCaURànmwgCEawóYbYD	FALSE
KIYélaRùKoiyóaǒrGOSTh	FALSE
LaEBNvaEBJHGZZóigEQèL	FALSE
MsXóKSAioqaahOuRlQBAZ	FALSE
OXgaàhOqPsrkuCJùuhaOy	FALSE
QáùwzLùArFRéòoauafHVs	FALSE
RéyěUúcMǔmIGamBǎQaǒwk	FALSE
SREmJEbaZVBClZNnaGBDj	FALSE
TzTFkmolmawvóaZúRpIij	FALSE
VòlABocSsaamCóOeDUúDX	FALSE
WaHaECGAéGYéjeùǔrjiup	FALSE
XwfMKowcamSZShRzáaáDb	FALSE
ZXRfǔecLmPLězKwBFbaap	FALSE
aònTPaéxIDTfHóVITǒùhu	FALSE
aQWrRǔVsnztgrBlFjZKna	FALSE
aaPǎǒwAFmcótóunócIaon	FALSE
aqxǔaKCbgRqèxcéfOAjXL	FALSE
baóIwBaǎNqáRàALWGNPnj	FALSE
cqDxEyozPǒaYǎvxAóIyZa	FALSE
eáLehCaǎXěaEPWBwfdLhY	FALSE
fINSJiéQehwyUrRcqaRva	FALSE
gfXěǔùXaPFunmpaóXRMdO	FALSE
ióFrbaDnùFěaSéiǎěFDhà	FALSE
jfhzxMéóEYPZWaǒoXǒèar	FALSE
lòHaokzQuaIMAPIsvZIRX	FALSE
mUEáeaàéǎjFGasiùéěiRù	FALSE
njmuèfyaàBàwaFǔAájXWV	FALSE
pǔIárMqbWHèaǒaaWònqXU	FALSE
qUXwEAaCUMéuikakòRxMj	FALSE
rpǔXǎLòUuQjaTǎmTaqCùL	FALSE
těUAqeFUaAZatBáfjéLdG	FALSE
udFòCDhjtxJeááPlaaǔFn	FALSE
vsǔéLTmkBgOlagaxEhGGD	FALSE
xǎúwèQaLǎǎǔmgFAvhtoLa	FALSE
yUYJaáxmnrKOuǒafèjWLǔ	FALSE
ùùéOwHnBsòèISkVeYHaèeq	TRUE
ǔRDFbjOzrEQùPUBcpnDgoA	TRUE
áYRmAmagSùjóYQEpzofSyU	TRUE
àhxRèAHXùmeěBǔpUXúbFRO	TRUE
ǎnIYxCVdTXcNZaéRyFMKJH	TRUE
éxIǒzoXaMWNTǒbpKDGCjff	TRUE
ěEVnMtěnPiwnǒèbjKróVUT	TRUE
ójFqRhhGTPòRFKAPqqWfàK	TRUE
òvǎIvYVcqCKǒtòǔrcATYCù	TRUE
úǎmKHdAFZVxPmVǔPBúzòxp	TRUE
AKNPrKEkIDnlJbpyNěQPLw	TRUE
BgmJǒǔswnlFdaXMsééhBgh	TRUE
CuPdoTǒHVuǔRwhzeWimJéb	TRUE
ECcAxáǒPòǔWsbcKǔfaIRrà	TRUE
FWàáyyGoúiDpBǒpFetwGVY	TRUE
GdEZZLyoáPzyGMBàGtqlèZ	TRUE
HzòEOIOǒxàǔWǎéhrNLhúHe	TRUE
JLkMmàEVymvGóFGWěRǔqàH	TRUE
KtúcBgrsFooptOClSǒHckà	TRUE
MDMzédóCsérrCFErcJHBVC	TRUE
NQsEǎkiaùyxVsǎZEéVZkpJ	TRUE
OmvReFqtTznLwbmòZDiáBó	TRUE
QàQRǎpǎòèsègKJCGxéàpvm	TRUE
RFYhEJalXwnJtnùBttóCXv	TRUE
ScbéWùáàcpòTcátIXóùkhq	TRUE
TvEXúqWqOBBeòUjXFFkoVI	TRUE
VEàviJrzwjYiuEPFdwFeJI	TRUE
WTjmùǔGALjiWúnbGZUpgòB	TRUE
XgostǔǒMtPaxfLwcěùJpJh	TRUE
YyBnNPgèǒdtrǎnòQnnngàF	TRUE
aOěfoTúGIèOFjáěGèVavVx	TRUE
bpmOánIùiXBloTSQùáXǔQN	TRUE
dAbDkMǔVějCběPlOyZPyoJ	TRUE
ePnADFjtDàzrUPULGráònV	TRUE
fhoiubESCZǎVRdjáwxàUWI	TRUE
hàòsyEnùmnrOVYJMùYàèóQ	TRUE
iNmnFBDǎòedNbúXyvQAHMC	TRUE
jpqRWàvVchZúAǎwǒxMùéèr	TRUE
lèyTUúmGaQèwqěCxVèsrBL	TRUE
mHheLUYǔnDEBoúTgFěJǔnǔ	TRUE
nZgkùlSILPuJdaquBZCyOv	TRUE
oePópǔmtGUǎěèùfdǒGpLrǔ	TRUE
qéaóKUǔAòkRzUbSdCeùéyS	TRUE
rEacyJvěPDzYHwEUnǎǒJBJ	TRUE
sKtLFinQòyúàXmwBOǔLmUZ	TRUE
tjèágpBǒHmǎFHIwoǎazzJv	TRUE
uvtLQǒaZiokmZVRǒbǔHVmf	TRUE
wCúukWaDpàuQěcájAoWjko	TRUE
xNhgaBfptIQgóJǔàGOpAlě	TRUE
yhHquIàòQytqcjfHeRpeUé	TRUE
ùùAgIeAùlKGURoaINBǒGaO	FALSE
ǔJyrIàedhombaòpxRawWBs	FALSE
ájǒoéfèǔóaFáèTwaqUkVxG	FALSE
ǎAtQfloXXalfcyaVhGFaáy	FALSE
érěRMRaláAhgWlaéZOQXóZ	FALSE
ěéSVóatàFěEWkěáaeHDfúW	FALSE
óYaKJáNòyFSNZKoKiMjwaě	FALSE
òsguzOòTuPúěaaOgIGZIrO	FALSE
úEYTrèaFabwùBóKéTIZàoT	FALSE
ATJKRoxviúaBúèapBhDwěǎ	FALSE
CéJǒJzaèùPiaànNTdddtYW	FALSE
DUazAkèùRnJǒsaUùqdèrqg	FALSE
EbcoSonpgUayùgàBqaZaǔw	FALSE
FrPCcaZaNIieIHǎùSFjEgC	FALSE
HBOrFàDWnéibesaPtaOòWǔ	FALSE
IhaléxIVclNnzaDEǎFHNaè	FALSE
KCoaAmsdhaUaWyqaAiRlpf	FALSE
LgmpoaápTPCUVaěǎUWòdGv	FALSE
NóVjrJlgvrzrGalǔwkaWnǎ	FALSE
OYviirQúXPPèNaratTqóàI	FALSE
QǔeěGMvaáaàMúǒOJuùóláT	FALSE
RPLPUREwkOòooqXNTCaasZ	FALSE
SaPzéǒtVSònáòZuBaǔrYJx	FALSE
TjqanJPIkDéòiuafmCMvsp	FALSE
VLòeESGVvpINoiNiaDXèac	FALSE
WaNQxCNààmPRHVókaDUAdú	FALSE
YúzúZZóaǒDztYuwZǎaǒǔJF	FALSE
ZQFhǒcKoIayHvPòaXmAYJǎ	FALSE
aòiyLlFXèaeSàfámmúòigm	FALSE
aOamuEAFqdèaRLmcèMvoUL	FALSE
aaVréWdTYeXxaYJxODèDój	FALSE
asymyRǔCzaàXkvFUJFuSěá	FALSE
céaoTpUZsǎzěaeùqGeǒWYS	FALSE
dJěǔeapEéaIàPVrBsiwjuY	FALSE
ewZéólaOCùóEGaMxǎACAEr	FALSE
gGutaCCUacOuDzwRǒxSCǔv	FALSE
haYaXWAmifgcauuJǔùéJYv	FALSE
isKatNǎrsiWmQSpMOaisdǎ	FALSE
kùMáNYlNHZOylMòaěwaAùN	FALSE
lFlégJáUGuéògaZQǎToJab	FALSE
mWgǒCjúùMBaZǒWaEArKǔit	FALSE
nmIàaaoFhAnQAěYEoArCrC	FALSE
púLaaeèHSLpWJBkiyàBeiN	FALSE
qaDóúáqJDOagáukowRjóǔE	FALSE
rhjúùiUpaylvQEáMEaZSrv	FALSE
srPknOMùokKwòNahYPasCl	FALSE
uJùóEsauǒHmǒSNQatgPZúǔ	FALSE
vzNàajògsYaObHaahtOLGC	FALSE
xUFaaúǒCěliǔECwAjEjUtD	FALSE
yláegFèeRRcrABuqǔNaùxa	FALSE
ùǔmúèeZǒUyuBeéqPòlNKMjà	TRUE
ǔSDQfRéěJimWPǒgrZsùVùOq	TRUE
ápuèJUUihǒZnPdTáàǔsAMvl	TRUE
ǎDWasòBuJòásVǎfUDAZsěvk	TRUE
éMrRRUMcúòLBanhJTmIrAkP	TRUE
èTSJuMxreIUaěǎèdhRUKKXh	TRUE
ěkvYCyohQěLJyfkPmaǔzééǎ	TRUE
òCNnǔxOAazdblzrRtsXMaTy	TRUE
ǒFnǔngwKsCxětyKgbǎmILéy	TRUE
úGǔúDrOXMRSEpfWòKVNúěoR	TRUE
AdWHvhFfLMǒZfèoSivBéQpC	TRUE
BzǒZěUNqSǎtáòBjioVKáApf	TRUE
DǎCdèàkLqRPIǔOBOdóvkNTI	TRUE
EJǔtsXHkèFOòUòbdfiàlKòN	TRUE
FaUtHdSidófEjZxxyscQANC	TRUE
HàZSròráGfpxaCSěCěUufqV	TRUE
IUEScJCòlEbYKXyéqnnbOOò	TRUE
JdioxhnbKTJóǔǔsǒqKàHmPu	TRUE
LáǔvAfteicHyVxaàIédCtpe	TRUE
MizlpWGWjOZèjdNbCnVBALǔ	TRUE
OùxLSyTmRXǔtIywpLLǒéCEL	TRUE
PJǒsóuuěCXJoxdpMhYgJèǔm	TRUE
QZéjHEHIrwoǎéMAuwJlhEPl	TRUE
RprMdáFdeòvORnPwUVVPPIǒ	TRUE
TúqqTLXWymDHzmkaSèAFoDù	TRUE
UGrěNùǎhmJvApcdFoxQǔJym	TRUE
VZNdVWFèwFJfbApBréWxEdǒ	TRUE
WlFWtjAVPáoùxáciLYòUáqw	TRUE
XofTJaàcaXúyIMpNxNCNěIl	TRUE
ZòYcafoJOaDYxIQǎpiMlGuu	TRUE
aHXwǎvJMórPSTeAaěPúqRró	TRUE
bUùájùǎwúTKPBHyGòNdhfCX	TRUE
coUúOZRBWmAyetrSPKNxráp	TRUE
dváHhXDbDcKJaOvtòKtHgeW	TRUE
fNúFbcCǒbqógúàiBǎvHòáRs	TRUE
gROàfFmájXmfZTòOEòbùiPW	TRUE
hWqoCXóNeiǒVwQSjòZwpdeg	TRUE
iinBAIdSdrjqvVnLhowvtey	TRUE
kǔfuàqwCteVbXǔiYǎHètsvh	TRUE
lMyIYiǔvXǒéMùgOiSǔóhùǎS	TRUE
mjXgéèDásuBBǔmróiǒPǔiKG	TRUE
oǔóaèfoJrhBpCjKJDDOLyZH	TRUE
pázKaduFléǔKRoczZUbXMMi	TRUE
qMáXAǔCfJXlXtZfrQáDPKkN	TRUE
rwTMǎObsKwPJQèkxJehWnǎL	TRUE
tMQpPBLbylNMRHDvWěaLLee	TRUE
udPiIesrIFLǎyǎjZDqDIAHk	TRUE
wàdWZCYfJrdWáwozdxqěAKK	TRUE
xAayněITNòDyODxBivPgVág	TRUE
yQàlDzjcvedYAkZyAHùQmwé	TRUE
ùùfqYaaùihUHPhfaaNOIoHa	FALSE
ǔPàkOIaóhnxaDHMTèPJJMgG	FALSE
áròPǎiGXJugèaNOatFTòéNv	FALSE
ǎKPGěmàáBftiDPQCauacuèl	FALSE
édyzaaòǔHxKjSXhkIáeLhTi	FALSE
èwòRROúHǎéPXzotáélaafFó	FALSE
óKaDǎvpodzyaǒLszAptIEaC	FALSE
òcaRwaěcAàòáEàModjGòbèH	FALSE
úùlpǔQfaaKěSboèCAnàrxIm	FALSE
AǒhraQEWaTLIKQèWhGgvNSP	FALSE
BaǒóTKSaúMrUjMywdUATáěǔ	FALSE
DǔvoaaMúéfǔPleúBlZYldhj	FALSE
EVKEhaJsǎǎDJsòuaVQǔoaée	FALSE
FgSLamhYRIWuǔguáabǔqxùf	FALSE
HǒGAOnsJóaalgúIREsQǎUlz	FALSE
IUwàLkeIPDzpaiSIaRúyióǔ	FALSE
JiùmQERahaAueWiDJuHGAzf	FALSE
LóHèCUajèsaVOYèkMJLogHi	FALSE
MOkkMccOěàXaWsjBraúhItj	FALSE
NwGùdaDǒZxkǔLqeGaaxMèsI	FALSE
PJaùNávmqaòiéWxyéIukQft	FALSE
QfMùyéWTàúVTnMoaMYaRioO	FALSE
RwǒhTVaPzèOYCpaéuMXáPfr	FALSE
TKěsmaYmǒpQhóMlaErzòHol	FALSE
VàeHùaòaVUǎYojjěsNQduAJ	FALSE
WHQTáaoRanQTtBBmrrBeywC	FALSE
XamZaOqgJfHJeKMqěGXěQjc	FALSE
YimgǔwiqNIáfrrxaDDLmǎak	FALSE
aùItǔSPùANHóavXJLqàjSsJ	FALSE
aItancFáodVWnvIúMjxyMxK	FALSE
aaFKkèòèvWěJGléECRapàHé	FALSE
atěCBFkmZJHKǒělHVaDòwVH	FALSE
bgNaǒlBVléaHCqPkudwóXEq	FALSE
dùiòxBnKúxaQVRVDSaSuáOH	FALSE
eǒMFqGUdmPéaXEàIBSsHalè	FALSE
fYoùazXPSTltùGkCHaSlèTa	FALSE
gvtfHaáqBLiDkIhYǔaEYtèǎ	FALSE
iDMHFgùònKBHIYEaLnǔaKYp	FALSE
jUyáùUjUQáFaáuHiCéSJóCa	FALSE
kbOLaCajMvSDoltgOtnbǔms	FALSE
lwniqùcOaVZáoPtkvUùiKaL	FALSE
núdàsjIaZswùónvRhavlsěY	FALSE
omLKonMAqtJQGlgaaǒTgěCx	FALSE
qDéaJáNùnRrvajJRJdCEoǒQ	FALSE
rhjǔJqRkǒUiàmceZajkPtsa	FALSE
tFCxsòóědDYGaUaXRlěMDgg	FALSE
unzJJIYpLEòǔMdrmXaCxaLu	FALSE
wúuBaCQùǎjHsgiNǔxXǒgBǎa	FALSE
xMbuJyVMèTBNOqaaNkvCMtT	FALSE
yYědqXaMjHǎTwaGSTivZcVM	FALSE
ùùVitpúéFtlcówPúSàUckSOD	TRUE
ǔǎhaěPjǒueǒixIQalGoàHáóB	TRUE
áLBRYrgAXómtědcqlàyqfGqk	TRUE
àjozyVéHùKyNXEúěòsáQKdJu	TRUE
ǎsiáBodúfheIúJFPwWphgoYp	TRUE
èóNpTěNWBkSCGlTLóRǎAǎàǒL	TRUE
ěTeiDhrǒQcbWèPYgVncaLuxk	TRUE
óoRjXJàGóUeDǒnLáuzsZYpCS	TRUE
ǒJVGTǎBOPKéUAwǔIòCJLLnEU	TRUE
úmvpoQáCVKZuglgaywQTARBC	TRUE
BDǒDébHCNèZòDZédBéùNgemJ	TRUE
CmTUvpxaBqtrUǒóǎJXfnVXue	TRUE
DzROYóéBHMètvycEJsonòwbn	TRUE
FZeáóvqóQLéNǒFaàAtJǎXWMR	TRUE
GybNémVYMkAǒMàcfcANSQwwU	TRUE
IòbntéZsvópwXqǎiaYqiIcpé	TRUE
JTZXatDUMKǔQeDyVágóGaYuQ	TRUE
KYqqùHyKoOXòeiYósqlSkFsM	TRUE
LoúfUurògWdrDZxwcXDCyDkD	TRUE
MyMóoágùfmEpěòàLBGNMGPèN	TRUE
ONQlHCXLǎtIYVirXǒglGàFyó	TRUE
PsqXòHCéTzNáàuOCUǒǒZsQKǎ	TRUE
RAlMNtQěǎévzEfLUQYòPǎYUL	TRUE
SDcwěbzóuVgIwSǎójrnmbasǔ	TRUE
TGTdNtúAYPěòmkcIYWǔààBWz	TRUE
UQbMtUvqzgáǒǎXKéAwsěkPuN	TRUE
VYseKugáEOxěWDEǔXùOAaXRx	TRUE
XùRaEPúààjDJIAokicǒNCcKg	TRUE
YCPKvXtAuùPWlWùéhzCcwNaB	TRUE
ZLoRgZhǒhyóǒeBuLRǔIqaAor	TRUE
ahqwssVRàXBEtJQJkrpRvPǔc	TRUE
cBSHSkùTilqaAZxYRXKpknNt	TRUE
dMeIRxùWYmVWffDúpPmJbFHw	TRUE
eUnúèlUóBzNhtnwIòrntàUba	TRUE
fsHyyJǔqkClDhùhUybFdttVO	TRUE
hěpPéUèuǔeòWvarVJBPniJNá	TRUE
iTTTRǎICéràILièrWdhMòǎWa	TRUE
jYakUèZXàtHrHKGUlMéTběvW	TRUE
lǎJèiwèQQRálézfǎHǒfVmhnp	TRUE
mCSáZgDTGICǎUǒoLóKxRéqeè	TRUE
nJriacbkùSWtvjmitUbdodǒq	TRUE
onSzùrěULCMgbféeVAYKFxXb	TRUE
qǒlàcaóifcYěKRòààVUJeěóè	TRUE
rUFYJKPxéMcjeJImTKNèDfPP	TRUE
siúǔVUǎGNJěéidDǒByLFVDHn	TRUE
tscAYsVkpmlǒBòǎaMLnJBpfi	TRUE
vúěSgdYèCZJYYimBMdPNTvùó	TRUE
wLéVRóPZWKxRúPhǎDěBúnEGq	TRUE
xWOUEJYCmEéFEWLoěTgFBbAz	TRUE
ylQǔikdakǒNIRRALǔPqvEǔóO	TRUE
ùǔYǎYWcGPájDobKanpòvqDxa	FALSE
ǔCcaCFBBtUSèhǔaUvMoxsqlm	FALSE
áawóMUùWNFaBnTtaóǒoTZPǎj	FALSE
àrOaDjPǔOZóqooájUHǎajxoú	FALSE
éSGaauěPrkděebóěáǒqBeZaG	FALSE
èezeUacPEaòOGStoaHefáwbC	FALSE
óIYRcyEauKEHWBnWNxhélayY	FALSE
òavfrùrxǒrǔkULCbaHaLUayú	FALSE
ǒzzhǎKTěaXLsawwuiqICDZéo	FALSE
AIèúQRlAǎCGtWRXùgèYaqmxa	FALSE
BmécvnfdskDmRhhKXpYxawaq	FALSE
DàyEpAaVoáXàAlěaWTóFJǎLW	FALSE
EBEmqBDwrQcukaKaIǒèáLvHd	FALSE
FYQuaFUnrlxCáXrECaSMtrPM	FALSE
GxàLNIaPkaǔdOFLiBRLfějgw	FALSE
IQHAùEaTUPIxxJDkkaǎZjònu	FALSE
JuNeKoaúwWippvúFYYWaùbeQ	FALSE
LKarùVCaùJQVěaQàEǎelàéǎQ	FALSE
MhàbXWxFJQdaǔúlùZqúaóUBV	FALSE
OěeBpǒVbóyaéGAyáKaàWFǒlq	FALSE
PVgaaUsByòbXhtPwTudgkRNx	FALSE
QcDòújéěfsǒdǔěXàDBClaraE	FALSE
RvzèVHQYrzhsaaqObmáǔgyDà	FALSE
TGaúQCMoLǔJgkaZmxzcwJkéB	FALSE
UaúbMaIlYxvaWóàLdvnXLfnT	FALSE
WáscGmǒajNILBǔyANKIOxaVG	FALSE
XVCjnVngxcnǎETraaEYoChLA	FALSE
ZǔǎemJaZoXjlYJDělùIPěaLB	FALSE
aǎDanZMcuéHǔYqIUjánǒVwee	FALSE
aLLIQaEDplasiFhMyǔAmúěbk	FALSE
aamùYLHfxǎHpéáWSCFhLběrF	FALSE
atújryzaqòUSigGáEúNlbqkg	FALSE
bweQáQZioqMáǒQMuvǔazaWYD	FALSE
dRHwiVviaùXàGupTWanKRcuo	FALSE
emWěQELeviCaEiaOZcKǎqjNà	FALSE
fyòlPBvAxXYǔGóǒuWHsIUaaj	FALSE
hOnPrecnWFàěuntoUravCacz	FALSE
ibáJsMtaiZqipaóùaXJqAbEO	FALSE
jpxqáúxhayǔCúúúSRAǒyZǔha	FALSE
lúNóDVfugǔUaèTYaàFSùwújé	FALSE
mLZěfYótaAgàYaěXrovjJfǔb	FALSE
nlYǒwharaùfnùgvWZctSeèXr	FALSE
pèQSnVǒǎavRGpMWWèùhqyqza	FALSE
qHàbaaRgLRǒOLCpWvLpbmQtv	FALSE
raNaóDdKBrXGVelèXǔùFTuWJ	FALSE
tàǔǒatněǒYXiáyXaZZoQjtùù	FALSE
uMtVzafsébólnWzǎsifOVHaa	FALSE
vlWfaùaRVfrVYhKǎUHèLGYTI	FALSE
xILIèweJtàjǒaǒhǎaGtWXmSI	FALSE
yaPjvǔMùéuaoáHEópHèZQòkN	FALSE
ùùwfmCwQJbpóàVVKrúúCrUFDk	TRUE
ǔǒZVzZTLtěmPàRèúvLSZeawKg	TRUE
áMWNZhiYqIpIMQWměZReOIjàp	TRUE
àWZJHSmECTátásávWPzàbmarl	TRUE
ǎpBkUbKWǒòGVvfkGOliRúZAùr	TRUE
ézmókpǎiLYjCyKXxǒSBòeàQUR	TRUE
ěGggézdpxézpéèXABgiYcRTàf	TRUE
óceBLeqotJiVXmóǔvqNělPFPé	TRUE
ǒàWXxRaoGNntZTwQuùSyAgòDY	TRUE
úWAMXcóiZèRéXdpBhCOatpvuU	TRUE
AivfAhsTyPzǎevFIvwVǔéTQòh	TRUE
CǎYlqàNTkOJnǔùRIIUWDbòYél	TRUE
DCOèIaWXéǒòEEěFùjvǎwEúRWk	TRUE
EhMxwúykhóvbLNqUofúVUTǔFZ	TRUE
FtIǒosViWúwodmKHIEGYCgómc	TRUE
HòMéCèóVgQclUVEioàMZbpròg	TRUE
IOnPUnBbVBuóǎhAHYZAKNRKHè	TRUE
JeJHǎánEHaorQbEEIgqàtsKùú	TRUE
LàJEěOkTyùpYJwxVměúdRpEER	TRUE
MEXǔmvǎǒúWyǎjpxMaLMùYěrgè	TRUE
NLIkwaqMúǔLXǒAfxWPjKNéTLá	TRUE
OrHáǒtqeHwcWlVHiaàVOèfjhò	TRUE
QDuzqYbYkcVKkJóBMDùUóqnIN	TRUE
RPǎWICOrFQyJRSǒlXceeyóyAw	TRUE
SkvriMJǒTóòpjKKàòpùjBcGRT	TRUE
UéYMáZǎOèóenáulOvSVFxcèpR	TRUE
VLfDjrNzIòǒWBHYaxQWzcWhPC	TRUE
WbxgheòuùùkòhENqZèsXǔfjHW	TRUE
XrQiAsǒbqǔyFsèNybMsFmeyèZ	TRUE
ZǔVéqJspǎtDksbIdBVqJUPhób	TRUE
aDEèOáXRhvUétbZòHómxàpDqD	TRUE
biěúYUmyAtPUDQKqIkTJgvěxM	TRUE
cwFvkDKGòTèFBWdgWMLuǒcJwl	TRUE
eójQGZhréxùPYJEqcOkCjBPeC	TRUE
fQZHaZlǎfguWssLegxkòMòXAO	TRUE
gjfchèrSJaJmùkòTfGǎwXqUoH	TRUE
ièeRěXSihLjǒdaiXOMVmXlYóZ	TRUE
jMǎùYvRàUháHFúúbFIaǎSURPb	TRUE
kebCJúBbEBZǒqNéVbDoúZRHbJ	TRUE
mǎiáùVùǎcYóZKpLYFXeéooaèN	TRUE
nǒhmHmèVǔQuètMRéàjéjimkaZ	TRUE
oObaWúunnGAPeHMEbtNlěIQIK	TRUE
pfKǎifThwWTèúhOněFUúZqilǒ	TRUE
qsJaupsQnxqéáiòfnàyHYùPVù	TRUE
súnWtBNóHnTrělSáRzějoIFnà	TRUE
tSxlRayeěIAMXQGáMWBkràHII	TRUE
uYUOJqJLyvLJcLXyKdhàeVAvl	TRUE
voiSmSDsǔwDeǎljǒYFòCMesóA	TRUE
xAvhoóUóhVWTeOPbwCLGNiBRT	TRUE
yVǎUMCGXúOMǔdYpRnzdoéQfcw	TRUE
ùùQoIEòSúòdaěèSOIosaYdEmF	FALSE
ǔIráGlaHóUwWFózxzSadWHskT	FALSE
áoBEèLúěNqwMfMXJHáLaaCoGu	FALSE
ǎULtUHǎkáiUZqoaǎzRèDngaVó	FALSE
éoLdábùǒYkoaEDaUdKrSdBvSB	FALSE
ěHPlaǔOǎpJǔvèsáòvaIoBDoBy	FALSE
óRHRnlFpMǔóqǒàdCbIcamuaIO	FALSE
òzsKKéIsBǔUEèàKúàáaúyanpY	FALSE
úPSàáIéLaSagéWhépjNGKóQpw	FALSE
AxtaOěSúYùqaDetqiFǒEjEJóA	FALSE
COXgWàDWDQIaPrhOaòélkRuqǒ	FALSE
DkáǔkuHTQèIǒUfajRakǒóppSw	FALSE
FǒqxnǔLàezUaLUmaiCjyěaúiǒ	FALSE
GWDKRnpóKaǒGjvaVxPjGJVNiW	FALSE
HròǒúSújpfaùFFmmRXhóaVěJD	FALSE
JBbGyáoTGJúFéaJAarSràEzTa	FALSE
KhASvpLNzPMóaNzááqgqrEwòa	FALSE
MèjkDgóUNvNBKIVSWFpYeUaBa	FALSE
NNèIahJimZorigǒaáoàSWIkoK	FALSE
OkùmPMKaLuqgXOaudonBZZJYá	FALSE
QáóòmbQáapBbcyWZfaomwOaRǎ	FALSE
RXiIgùThóWúMmZGfaTiCjěaǔQ	FALSE
TǔxòsdxOHGoóQgRǎwXwdaVhaV	FALSE
UCvABTúatàazKFBfjcúSXuòRu	FALSE
VXUovúoaaXúfáZgRZcDiZIúWE	FALSE
WoKRxSgyJúwJddalgavTAèfuY	FALSE
YDTuǔrsqYaòaVMǔútàoFxMVǎP	FALSE
ZcaèbhKajOǒěpHnaNaHYLoxMǎ	FALSE
aòUkǒCjJWòZúzqúiGúèDlaYsd	FALSE
aOǔěHǎmlXǔRGaTǔsTDEayTáXW	FALSE
abIàvǒVEéavUiréYTFXUoéLja	FALSE
awIéwNRwSwIUYmyZéluǔaFRgn	FALSE
cèjàweǎTLxQlVkZuhòaxaFADu	FALSE
dNměeaCNoWacèCUeXncWPAUCE	FALSE
eiéxjSǔWùZsǎiquGǒataǔWùkz	FALSE
gǔFxjàUlYǔUèaVKKPaMsRzéxó	FALSE
hJQNwYjxRNahóMuTQCoHaacns	FALSE
iZhahrǔmqběaaUSiiǒǒvCAoeé	FALSE
jngpurPaǔWCabVgJèǒrUvúàéZ	FALSE
lǒrHMZAKuǒrVSUraiPHHaòVóǎ	FALSE
mLCpuaaèRiTLcùJJushOèvrGa	FALSE
nZhDekfXnǒAFúfRvESaTaéGěà	FALSE
pájNjVNRaVPvǒaDdexǔKècLqB	FALSE
qSXèbaPǒEkakEùQPfFlQǔòrmP	FALSE
rmUNùlKǔGaěJǎptBóNrgaHàòM	FALSE
tógRAYǎDAzòKLàTǒPVaaWjigu	FALSE
uMěeJTAOayǎaAjOjǒAutlHbhǎ	FALSE
vUypqiBvZvpvTbùKUǔqlrIaaZ	FALSE
wtCǒtOUtxpBòùFrhpáKuaavRD	FALSE
yNjéPòiǒùzfLVǔaTzqgaRRMUǒ	FALSE
ùùrOzgOohLBaéYxfRkDaGèACEw	TRUE
ǔOyLoLzqzZEDOcYQVXǒRztoòXh	TRUE
áhrèCGTshhěSHMiBOmUàmpǔéhC	TRUE
àugùsmǔGǎěrOpZARQDzqúéLHMm	TRUE
éAuěUrkOAòQbnmKzmpDsrèIǔnr	TRUE
èLǎuvzHǔjAEmWgǎfWsùArGMLǔm	TRUE
ěmòùIcvdlKEeOoBHjǒuòSvóqéX	TRUE
òǔvóqcHQKcEbMAVèvěòàùNHDxò	TRUE
ǒDhKPèmJmoàjGaàCbScBóKKDYu	TRUE
úUqvǎàUEIHòúbBdVúúzLNoTěvL	TRUE
AvYqJmvZǎQnYqKFWavǎZgEoMóH	TRUE
CFQrǔàgpéùjAùèWimPtAVàMJěr	TRUE
DXéHSCIFQjNefóéùMeúsOkáěHm	TRUE
EqtvSWěxPKcèúxcàùLUǎCsNlóm	TRUE
FwqEgOúHvbEwqkNHYáVfAIútIN	TRUE
HǒMyncényèDǒběWbOèǎELrDXRZ	TRUE
IUcWAèZKTwùsqězùòlmqwFórCN	TRUE
JrwrFmfzYzhHvnǎùYEJNeibjjǎ	TRUE
LéǒRcYYxpMBUùbèeNrfèùGólOá	TRUE
MLláMOxvCùwgfeeJnVùsnJzFeh	TRUE
NWGcàXtEuXAIZTJAZDěDyDgiOT	TRUE
OysàcDJMRouWàlǎjǒCDUAQèúSj	TRUE
QBtgHZěúyruFúGZkrsBěJějLPm	TRUE
RRFZVjTRǔcEnaúděUáZaGTòZǎK	TRUE
SppkZSadPRDlBSkvrPǎrsmZfdǎ	TRUE
UǒtùRlefǒqáflDhlòtwèRhěhBO	TRUE
VRgyáUfcDóZKWSjuSúenRúhBWk	TRUE
WhNMwQàiRǔpblpkvAxzEèlNTlo	TRUE
XyLCnǎMIFQgzòxFYIéEùáESouI	TRUE
ZHMJntDBzOUZáóalPvǒSqzSBpD	TRUE
aSjNoběuéèsbQvàDLoòǔmTdIǒT	TRUE
brNpTbiǎfBKfùZngHLFùwoyRQE	TRUE
dǒeBIobFòybCàUHRYnAcRKSQFi	TRUE
ecMyhnràànegěrěpyYzǒbtujfO	TRUE
fqErXwNmMxxěVùdamIààYidàWA	TRUE
hǎaòcǎwrnngKlPINNèQOóivLLǔ	TRUE
iPPlQQJcvzFmUuWxrZDfMCCóói	TRUE
jiqrcvTZěrllSSúQcKJěazdúoo	TRUE
kqDǎErXěCáséYfHTògMBMxWVPT	TRUE
mFxOgpǒUrCiZGUètKòúàlhKgòǔ	TRUE
nPàmèLDképàáIclMzBpcXQLùrW	TRUE
ohwxhqdXJDWóoEYukAhJǎyǒCDe	TRUE
qGgóěrfàjGUdxoyEèONHǔGBógD	TRUE
rMIwàVéǒQUcéóěétwúaZsuCcJv	TRUE
siXCubJztJXqwQjestFaYewgùè	TRUE
twhqPGuCAWrósFòGGqáùrZùXhk	TRUE
vàùBǎnfòCgytógZèLymqekTBód	TRUE
wJFécJNéZbThIfAǒJǒQGEjVXXv	TRUE
xZeltcèuLǔoysLsrlUUfIHFAfě	TRUE
ykǎépKtpsTaxLéDhgWnnqFpǔKg	TRUE
ùǔckQYúlùěǔǔFǒAUPaNIOáaAAD	FALSE
ǔCaQúUvnWREǔgOKènaiBxúkùùk	FALSE
áSuǔHtaadǎxCǔAeNéúbzwVáǎaá	FALSE
àpNrJǒǔTsSHaàPOzkGIEFHkyHa	FALSE
éHtoxáRcócaxkuyEmnGyUaojoy	FALSE
èsjrlTPKIóFǎFavqhDDǔrqTFxa	FALSE
óFèóvufoIJwxaachSsEtáěèBEY	FALSE
òdnàùaajǔQbKsRISǎLrzEǎjvwX	FALSE
úáNBòSkjbDàvIdIvOoYěóaoBaD	FALSE
AJlsZěSwmmOqVumEhěMRócaǒàa	FALSE
BgyhlLCRCTlnvnbhLeTzlǔHaat	FALSE
DáluoéKEBwóNRAjakPESkóaRùx	FALSE
EWmaǎǔùEǔaJónSljRǎBùVyQCKs	FALSE
FvTgGZVUaLùukLBhrWhGnaǒTKh	FALSE
HLlavaRzcxǎCTtZgúZlfmùVbǔJ	FALSE
IrnaXsóIGDlěanNrhWVTJgyAèa	FALSE
KIèfHdqǔRYàQaCUUyTAaUǔRUěó	FALSE
LbFmprXàEEàHjavóaTJùóEAmvW	FALSE
NǔCàDòVaSaJòcézNVTHtnkLPuk	FALSE
OCǔCttpiaajyyèDhUebsoYHCpO	FALSE
PoqAjanòDwGòěkJamSdǒsáhoNE	FALSE
RòJqPaMZnCqHWnnòQhoaǎGZùer	FALSE
SQǎàuòGjnZFspXaJqiaezàpéèd	FALSE
TdSòdúèaamǔIǒRRZFFwDDXFXJV	FALSE
UifuùLwhvZcYkvJéazWúaWHofI	FALSE
VwmǔéRFVòéáǔèpxFRjjJLNaDǎa	FALSE
XPvàuojyKyHǔóvsOáǒcSKmamka	FALSE
YrùùósaGZanóxgxYGCzěǒúXNPZ	FALSE
aàěwsaZbgBàebWgfǒfzóyOFVsB	FALSE
aPOCLóPqaNDǔWDRsYéOiǒǎzbFú	FALSE
agèhQqBxpkRXáFHIhtaucpWgAt	FALSE
axYAgHHNxrèqHPERawtwZTvěmJ	FALSE
cúxwóqaégěsHZòXòVXEaéBaiùO	FALSE
dEpLǒbKnXuaNxaubiùoěpYSdàV	FALSE
eavTapàqZàjrIlěZójczàixBlě	FALSE
foNWwéUàaKdèaaAdVAùqISǒCkp	FALSE
hOuJNhxdábalTaqSJUzpaEWgAF	FALSE
iXQMaHRqǎAèèQTYEzàaRZbsMǎó	FALSE
kéfUǒQxáǎjòǒǒoáùèqèqaámòOa	FALSE
lVTvoailTiiTkvapUówZAAUlbè	FALSE
mgkEvgahGúrLUsltùPvalIágUZ	FALSE
oCVHéXxCKLúsdAavPaànSUCVsó	FALSE
paKQmTaIAuwóOpòQrèZQZCùewx	FALSE
qqaéwKyzprèaǔǎGpTuxavhQHDè	FALSE
sFOáEkyREylTjYQgqvàaWUgGaK	FALSE
tXTGKěTmrVavDJGFéAmEéǎahSt	FALSE
ufVǒaRyaThúeOèKéWvwkZSěUOP	FALSE
vzúúǔdǔDrXúQLáqaěJéIòaUJRQ	FALSE
xHěYcCoYàfKcaVLujaFnjlpBJx	FALSE
yiNaKgoǒactqjIKǒaVPGǎErpùX	FALSE
ùùgLMkbkròxTùWqáWmwnlúfVidr	TRUE
ǔBpPbúRnZqVěújYhbKúnIpBkèEu	TRUE
áYgCoFèyEoHKDěRQzAáEoPESSwB	TRUE
àYǒoVdpzùjfBTYhóùHUgLoèéeDi	TRUE
ǎiWGvYDhuóVvTaYVoLGtèHécúle	TRUE
èǎúsItúrJIXPAàoIesjYcùOúijù	TRUE
ěQáchQxěidwlséeùǎàvDmffèpúv	TRUE
óSǒbǎdOěAJǔDǒErófsxsLWwědeM	TRUE
òdhaǎOslǎdPIúOQèFèVIpokCnAr	TRUE
ǒrǎkHàGEéVqUESIBUsOVǎnǔLRqě	TRUE
úněCeiěǒTsYHofanGZěkINrgéKZ	TRUE
BǒKjWwnARYsBLBéàAǎJsvAWpNmǔ	TRUE
CWLBSUFóǔcúPùěVRnóceAlsavPw	TRUE
DosSnPěpòVJàéCMZǎllKNǒRfcxg	TRUE
FòPóěfkOeUǎpWaIKBózAǒDVóVPF	TRUE
GQóIYqUINfogNòBònzZdqkgXBGe	TRUE
HSiěnLoVúQknrknFxuvQKlMiLuě	TRUE
IfléDJěZsyxTIweéěárvypUdrDF	TRUE
KèPaGMcPwtóiLMmxfěféjRdKlcc	TRUE
LPáGLlVwkPvVlrXàfrYkǒódJlqD	TRUE
MaGrCsióHXóWFKlcDhiTXnVhiXz	TRUE
NoóhwxVLMwùfbeVdwbdAbGóěKpò	TRUE
PǔuOHǎòmhiFKǎǎiowMǒàzvzEgRp	TRUE
QóoǎylAlrPeDgbVǎěDǒIvhézuǔy	TRUE
RZábBRkhbIagXrxKómEtiMunèòè	TRUE
TàáMǔxcQgEàájúEtrnHRykóZgMl	TRUE
ULFlVncórGEFZèKkúJNòhqùǎJáE	TRUE
VkSǒSvnépvOGóBóáWKDMóEKrKèU	TRUE
XǔèúCǎLCVMVaAIhelpásRQZQSRY	TRUE
YFóEèsxálsoúHoODmzhkTIěTSYB	TRUE
ZRbtChNóVTXuhehèrlVjóxvWPěU	TRUE
arMǒRomtǒtùzIhCAeZZǒǎrPhxMZ	TRUE
còéaàDCaOMdmqdàbzxMǒIRàNbSV	TRUE
daTYwOógZynlikFúbdJAnùHYjSX	TRUE
fǎWěUBxéxójyǎbéHěYSúǎàHfhGa	TRUE
gQtxfèhiEèàRznTEPIvaoNVvwPǔ	TRUE
hVNfoěXlóUudMdǒhAagWlhKHFǔA	TRUE
jùAeImRZǔTarQeYIJFùUòtúvfáN	TRUE
kCúVvNVlcDfùdhuUpzLApgbòěsu	TRUE
llsZoxZbEoulKGǔlxHoemqsiWvC	TRUE
náěòúieMCmqRcgOFJDSssXáòwro	TRUE
oKpcomǔAJNàsDMbySyxǒftOùFxU	TRUE
pmnfTlreqòtIuAěǎSCFǔzǒOeTzm	TRUE
rénefWhZntcfǎTnpNMVěCdZcero	TRUE
sMOǒbàgRáXTbǎúISmYòMVibǔilI	TRUE
tdèeUVúyYPFGJeǒuBsJdTRSGICx	TRUE
uxIXtWxNrěWDXQouKlùyVzjrcgH	TRUE
wǒúynTkvKrXWIZQKKDǔiǒZùoMdj	TRUE
xQQhlJxkiyIèmtPcFtIfkóàǒRvE	TRUE
ybáUkǒFujgMkèLZUxNúàOnhǔǒeg	TRUE
ùùIaOaZVǒdHLGAIdUàZFlòkOLPS	FALSE
ǔGóaGQBǎDahMqiReáJDSPPélNIN	FALSE
ágaCPUalpabcjtXKrěgGGhdVlJO	FALSE
ǎǔhVVbAaiáIááKUgPHYaoǒZehGj	FALSE
éLòNwówǔgělzǒaěààaTDToèQqàG	FALSE
èkònjsQgocǎGǒpròǒLMSMWwIOaa	FALSE
óárěóéaBèagaCQUwYlpúměědDbO	FALSE
òPǒXěDèWDzwqěXóquqàmgyFaěaQ	FALSE
ǒhrwOmEwsaIkxDArzFǎòaQǒBIFX	FALSE
úrJaqNjmMYyanǎkqpVpcětùVyYF	FALSE
BQòaǎpVwéXacǎNfzKFmGRLèlMin	FALSE
DùMFJcByéWBUviDzEWaèqǎSaǔáB	FALSE
EAèáèèǔrOcCoCjcQCYòTaaeZBǎJ	FALSE
FJLqTgVúOéroljèùǒfKaUaXRBǒD	FALSE
GaOwùKSkFlaùbgxxWYwxoFèzUMZ	FALSE
HsSAèBùělaaJXtwuAbxXtjéwiEB	FALSE
JEboZavaǔRKfBùPrliRjdPQuiǎp	FALSE
KjAsYěBPéXanhvmxǒEéaRcceiǎH	FALSE
MàFǒèrObFoKǎcIPFèYpaùClgXMa	FALSE
NAWóMbsIùGxfaùaRzIawVVsrsDV	FALSE
OYIaBuWTEóhhCKáiHzFjappsnós	FALSE
PqLWJKYIXǎDFBéeecuHaZSiaěPò	FALSE
RNrKáizhòmBwBǒODIrvǎtòáaIaV	FALSE
SaaKwjALGEZUpSOGOHEZTZcMrCO	FALSE
TzBéZdpmvJòùkaaogxěéèNgúéLj	FALSE
VYybzǎFrǒoòfkgwjóalaoeORSAG	FALSE
WtPuybKpǒkIOPèpwkSWNQaaQòCx	FALSE
YǒaPPKjgwkóqéLKaXZILOjLYewA	FALSE
ZaǒmHXVaǎuLSUmwófùNAàUauěml	FALSE
aǒahCPTuFǒàIèTrniYmcOpzmUDe	FALSE
aOwomUVCyúáuwiUújxkpǔnGHaǎú	FALSE
amMMùFáIvnoǒaLGvǒtvUfzAvxLo	FALSE
bHMirěǎhGSuAaXàwWèFxèaUěPXF	FALSE
cbYMWRqMiYXfiIFpuǒRǔgaaóDYr	FALSE
dlcùKjpcVMGsfaPWxagYúnǔùfFU	FALSE
fFààRRJpvPMplgrMaoèèHyPagIQ	FALSE
gméYéHpQKLYzǒěuàkaéawRàMVVL	FALSE
ièèAGǎQAemǎqéLKalypǎǒSaQZáú	FALSE
jUǔtkVDJRdǔaMkòCYslbaauEPjg	FALSE
knsYBAahCWàIHaWDoNPGxàǒeWwp	FALSE
mIrnYhǒǒGǎMtnnaNZLzmamnIzNǒ	FALSE
nhezhUGoIJaaEuxàgaorYQQzùéN	FALSE
pòNéIqhǎaaazjMaZǎqpWùCǔǎwBp	FALSE
qAzáWùNbeNayWaésNASsFIàBTyp	FALSE
rTenrDǎaoǎǒhaqOmtigJOjMgelQ	FALSE
sfnFǒlEèǒdaaRokLGPwWuPxinSM	FALSE
uDfNClDJgmúèFòVùaXéiauubtON	FALSE
vrNaNBaYbWéMóKǎótRCwyRèFeCǔ	FALSE
xKBLVjBFmmKsdSLnaaǒFǎoéhHǔp	FALSE
yaiàRnCCUfqaaGcbLèMǎjAéHLcà	FALSE
ùǔěVjISOùtòàDbkGTrdqZjNplBQO	TRUE
ǔRrFiàdésvunNùyubRAYXòMOBgwǒ	TRUE
ácBkJMbpPKPVykEqHǔósúqzAǔǔUm	TRUE
àuUkǎLgQcrMBǒwJIBùyúBEEjéBWc	TRUE
éǒSeqúQxSCYNvóGyǎǒyGbéòWzwòa	TRUE
èOPmcvnXefFaJéubBóxjKJAòdDgM	TRUE
ěcgSGBùKOphhAxmLdhmHOméMcRNé	TRUE
óvúòeBCJwxQàcbémmkùkzSyhoǎVM	TRUE
ǒěHbSbKJběrfLDàMòvbvIrězOěPf	TRUE
úSQRemJǔyXkDLRCgléúáuLǎmòNil	TRUE
AwéùSLMocòBWdGsXǔSéyùnànyTbp	TRUE
CFǒèéFRMYZSnMófDbQSǒǔrYVSúúù	TRUE
DTqlTXúúAGUwCJTojQWǎàwwPqxhǒ	TRUE
EesrUoSHMctOHiKSwdhBwjoigJDo	TRUE
FkJfArxsJziXgmSiúzdǒOKWbemxt	TRUE
HǒPOzvtVòéLávrPlrzhqCxULAóeo	TRUE
IcBénWèHvZrwǔZRVTIAùfBóbPǒqW	TRUE
KáiLǔkléaBNCPmXZgxmpPǎVfǔjPl	TRUE
LòVJiIáPUlRoxèěǒǔMcAlCndéjbf	TRUE
MQmJVRUKdSnnlVFumPOyhWbùnèjK	TRUE
NuRtZòúNfgUybjYOǎwkHaJVdzóuP	TRUE
PKùgzúgvBNaKuVtǔpàqJYLCXnzjx	TRUE
QRWQùjókJQVNrècOXIěPMJDfwsVo	TRUE
RfáenpwhFóAFEXJRPxeQjxeRPiod	TRUE
TǔHoCyócmADLxknWnJWJsxZGHnéF	TRUE
UAahOlyǒsAHǎvèTRCùRoxNèeLozú	TRUE
VUXRgóOmTZzEwdwmIkLHnibjoétǔ	TRUE
WiRrPLJnáNxbáéTLJámWUǒlibzǔP	TRUE
YGrjlělqiméSfMIùIrmlrwqǒúSló	TRUE
ZUnpfDfuGiWùGbUbàOdwùéyOéRde	TRUE
anùxNàFXUPESǎéwQyilunóQLAZKK	TRUE
byKrTJVeàSguLàjèyóMyTIhxǎsEC	TRUE
dQcTaeXVZMaHOuVkTvEbQAǎIIiJt	TRUE
ekDvNSkěcOaedYqgcáxěMjěukXCa	TRUE
fséwDmPVkáQRJbUpcYCDPSGZtsCm	TRUE
hǎgRemtáRTIáSBlJytSUòHjwsGBò	TRUE
iIAExUǒkLeAYvckTùNórdzPǎaǒhZ	TRUE
jiZOobAǎaǎNUǒVLxrkěYuNWáòPWN	TRUE
lězySFfvLlPEěWutVMSǎCHJmGfXǎ	TRUE
mKviSkGvVdKyyfAhbSomLVdQHjàJ	TRUE
ngaúZTAYpydmEǔǔǔzRPBědvèVHéK	TRUE
ohRófsVókfWmèvluǎoYpùOzféRXj	TRUE
ppěaddèLaiNàHXTcAaLTsúǔsòKQR	TRUE
rJxzudóQEGǔMVZxúgjQébmèAhCúC	TRUE
sZlZqdVúQMYqèniáWcdeěNfvqFln	TRUE
tmeijthóZPěóTúxKAIGYRRvòcaes	TRUE
uzIEáèvwqtDùNúáPwEmEuxěqAHeJ	TRUE
wúQUMAálNAGcUfFàKbǔùCKheWoǔb	TRUE
xKhqmtfOvIYébǔHeWiYBóEPXióáS	TRUE
ybPhnlmRWzoOYěMfòòPlByróhMII	TRUE
ùùáLweZùQrRqSwgvPQjeosaPaedp	FALSE
ǔBrApUxkqǒqryAOǒǔǔXénayazGab	FALSE
áUWTXqàxOwqVwjNYnQLJFěaéaAle	FALSE
àiǒZoxtxtàVàordyDgǎKSéHaapdo	FALSE
éàéSrǒQCaaQhqUǒèqOazEuúFKtSx	FALSE
èFihIwàphLnùOMSdpiqtwdEdaVǔa	FALSE
ěkNReǔUYCLóziTdaxEBavxǎasLBo	FALSE
òúqLzǎvQmWdǎNYyVǔǔchwaaójUiz	FALSE
ǒDoULkDkMHRMòtaDVaEQǎShZtxaf	FALSE
úWDxAetffgEQVCVkèGYǎWFaTgnaW	FALSE
AqiLhaajdfòzvMWYrDùjiYfniǎAP	FALSE
CDwwGVYnZDqyDéwkSEaWsDXjùrěa	FALSE
DdEaSLRDHEaOemZeJpLaeJZWTpRo	FALSE
FLVElWMaSIywùMlqxSòaCBTmnàwC	FALSE
GfFLyTordoSSkwǎFGcáhBbaajlxw	FALSE
IáenǎFróYixěATǎIkkCIaaYZMmYl	FALSE
JGzXqUyHTEjxzàèxahoIKòSkxnav	FALSE
KbBUJaUhxBXòuGFIúqGGaèKGXOlD	FALSE
LpWkcRSóPAoxNOómnAWaBiQyUzaK	FALSE
NǒZaaQǔWúNoOFBèòZéuróFeòOǎhx	FALSE
OJdvaacUàaidúGMúXQHgiLěánkJg	FALSE
PhaWěDavǎiǎpǎzbggòLSóIFuJQpú	FALSE
QwwlTàaùǒGwǒówùHaàmòulJyCuIè	FALSE
STAVKéBatNsaeNNáyiqéVjǒjùzQá	FALSE
TvWHXǎèùZHaVzhSJuaWmqyTLYnVI	FALSE
VGmEYòYJǎXFQrzàYUYúvpLokDaZa	FALSE
WapósfaàTYRxOéQèhèoqaóWtFJGú	FALSE
YàCdvbgjYJRróahsNnQpǎoaFúZIG	FALSE
ZFaBaWYfǒǎVdZayNrjRánJSpúSFǔ	FALSE
aòoQLoǔaofXpUzDjwMQqTnvAuKTZ	FALSE
aSXvRUúxtǎpFEéDVéěXaèjpòàxLS	FALSE
akiKrlvkèwhacéyòOFéOòúVWǎjǒq	FALSE
bGCPQFAsVeZUGrWàTUsaaQrwqúld	FALSE
coXMvaIàěùGIOótaéZOBvàSTVùws	FALSE
dxoQSKwaǎNòbkPetpdisICNaRLSa	FALSE
fOaLDYDaQsrhhemQǔuFGFáwIósHP	FALSE
giTáFEhRSFtǎǒDWaòWáWagxUphwǔ	FALSE
iLzwàuàCàYmuáaéYaOppzAFǎKpIU	FALSE
jZèwqgmǒaMúǎóusRmxvFugùWQaud	FALSE
ksBáǒréCAPnRNáEsKbutèaoWqvxa	FALSE
mLZjOgJiyDTǒDegxEaMùSaOǎKgOL	FALSE
nlsuǒImTLkúSRbaaFtzcupOkoiKp	FALSE
péPwgàǒQrXLanoaaoWvsèOBLúynB	FALSE
qZYorùaóaǔzěéCǎúěFadiXQǒjtáǎ	FALSE
rzzrvryPWfiNZZQtanOmNasngqMC	FALSE
tSbVLmNzUgFTzaaúdjǔBlcáuHLUt	FALSE
uqGQuFǎEGamǔtaiCZtYàAǎoxBmxz	FALSE
wòéwCYIǔZFLaGáNWNTHBnJèusaXh	FALSE
xPDLówféǎǎFLaHLyaaiatábdPCNV	FALSE
yiXzcMjàóǔaǎaBEfFwójqzdGWFud	FALSE
ùùKrZfnóLXVjcóSGrǔǒBJXECsnPkf	TRUE
ǔLóYbzéOlǒmlqmǔoVlMdDucoKéàZz	TRUE
áUllhběJGAǒbRNwxPDǎzBrMEáótuW	TRUE
àuLUnhEUBǎHMgǔpIDsJqiěsijsDmd	TRUE
éóIúniùxvgOurJMmRJllhfqéBcòFá	TRUE
èJuězMJKLklǔǒkòzRfnVCrěexěFfI	TRUE
ěmsúWTjòdORèEyiTXDEhgMSTTǔèóm	TRUE
ónlxǒeoéǎaKZQòPéiEZHPxjǔoYFeU	TRUE
ǒáhkùbSljyLázǎpKWoǎAABùòáéwhó	TRUE
úSMAPnfěYfBSmQùdEWmxǔFógwjFòK	TRUE
AWùmFyRaǎQTbpIèhùěWpDǎrQkyHxě	TRUE
BolòǎUpfWJQWxSSǔYǔLBǒuǒóéèviJ	TRUE
DBJfuSMadvRJPihfmKwPGdmóděvaB	TRUE
EEmoùBsTPgBǔnéěqyQgéAěácCdqvù	TRUE
FYhwúCiYbSwPtáXqKnCěiKuúuEvóq	TRUE
GkAqòúVjǎlLTxZèIéSlNárWjEAPCj	TRUE
HltcUDBZwAPDèkLXUYLNrTZTPqniE	TRUE
JěNEvKàAuèXUàwàqIKTmrtéòeKOUH	TRUE
KLKFěměèiFǎaiCyǎwHvówGFLòfùzé	TRUE
LwfCáKsVjOZnVoCDmIóPwRúǒZBfèǎ	TRUE
NIPcǒliJWqBáNwxcSKZPvtZEymEáó	TRUE
OXEáKHLECuRChǔhqXuCSVBwTEnyle	TRUE
PxùwYáéyECeOùaFQKóBjěwxěSùèuc	TRUE
RJǎèsèfVúPUùIyIéBecbEǎcWZrùdG	TRUE
ScǎfcdNXǒǎjYúIIHzksYǒtaDsǎǔZn	TRUE
TrAuWúojhScKYcsIǒuèPvEPLǒFwhc	TRUE
VǒòǎQQNèDFIEùxYBXNyNulrONOWhX	TRUE
WRòPEwIHACuDQLoCBSiǎGXFǒgfDQI	TRUE
XfèààmyRwùDǎkQReUoySzdrpowTmo	TRUE
ZùtPotěaDggdoTFTOnLyiIuxòSèWL	TRUE
aZznOXLláuQJswéwNláSJGPXǎùpcò	TRUE
cáIělháùùUóKljCGlLEYTsmkNVMdl	TRUE
dBVPRWHnxGCqhRuáàbzJcSVBèRQYù	TRUE
efJoxabzXIòdvyǔeLbátMáMYǔxblC	TRUE
fkzsEbNFgGéNamsUDhWèigxóKFDRI	TRUE
hèIPbipúnWNXbqSIùǒéáSòGUZOWèy	TRUE
iLesfDyVssXMAHgqFwaegzBdumEvz	TRUE
jTGkKNIfnNdTpèNQLbQgwǒGáaselè	TRUE
lěérJnòyrSdèNpDGyàtChQMxǎrxòj	TRUE
mFnJFǔiArtMuMhVJùcúaIèǔJQFmBR	TRUE
nautOIúuHVqygGRápqPoDOyOMóVso	TRUE
otjfdùhbtbIxtisǒKeSěéócVfPKéb	TRUE
qúúypóHúéǎváLbUWGmYbzMvFPAàZá	TRUE
rQdèǔTǒěAòRroKsFPèHmrùqCzqàZG	TRUE
sdiIlGěuDépYQqwIFYkoilóhbAuJx	TRUE
tpXuWztrOcgDěkkuBúrYxpSEFóóǎE	TRUE
uyseStOZúèIPtéLNIeWěkbRLVFOèǒ	TRUE
wOftúTGZtCùùvyǒrZuYèénjTTyJlv	TRUE
xióBànutéoxsSlSGIrTPáěgypéFóè	TRUE
ypdfVIKCRxáuFayCRéHRisjéIquqx	TRUE
ùùVkOvTèjDaXòsailwfédFkǒFNeóV	FALSE
ǔaFùgLúiBéaFudNQNEOMěXvWRúEqP	FALSE
àěphoaMkaqnErqabkěXNkTàgKEgpJ	FALSE
ǎMPGLZGaalqóFsrùLiJQtzàPQǎpǔz	FALSE
éhwòaAPgHKoadHnéCDsNAMvmsgdtá	FALSE
èntèLaFrPěxiyǔOjátauYǎiiuIkjú	FALSE
óBQANbamayǒQDZhlCLtlejVlàsJóA	FALSE
òYèdKWǔóNyGgaǒaTBàOxrCXnUawtp	FALSE
ǒsmaxynSyVaBIòòSbáQaèùèèZPlCv	FALSE
AUòqhiGoágzlwKxaalPsKèAZefADr	FALSE
BfdGcviésETjIhZGRqTalTaKPPfmQ	FALSE
CrYJQFDRyVnǎaoLAEZhPaiFJYLcQK	FALSE
EOǎéniaXuOJlUWRùMaǒèZyJRCmqJe	FALSE
FaJhqǔrzDúqYOtAGhěTEǒCaǒEUéig	FALSE
GxffDyNQUáaPHaáAjrraTbFwěǔqpL	FALSE
IFElljòùouyebáatUKVCZQúXKrZRa	FALSE
JOQwcHééséMxaàaGmcèQměMOuFJET	FALSE
KmCGHZVPgaMxIǒLaBàaHBǔROYaoYz	FALSE
MEGòěWuúamhaFjáǒtǎóBUQYnvsóWK	FALSE
NfoPUQTàCNaZQakuoSvQǒùǔrJùyjt	FALSE
PǒóKàbLyuXǔcèjwCaKaǔmXpMTTUbé	FALSE
QPazRhGǎòAiiMlPIuOIaǎdZZdlFOě	FALSE
RoTavwtHmJòiSXaàvHYtIAyWSyzUR	FALSE
THQòAóòAsaXúroiKMzTtwMxoàYǔac	FALSE
UbpQNòvaòànúvěiRZCWègYGnZùaòǎ	FALSE
VqrtxtnrQSaoùsaCǒfjUGRjpnǎWNl	FALSE
XAjwWAhYYáoWùHaoěBSòALDúPamrù	FALSE
YVǒBAlOGúXWxvWvaNǒMhaěàasNEOh	FALSE
ZaVóAkQwóuGùxòmmTWǔěOVEaYávvv	FALSE
aAiHùòayUgXgJXDAtàxIIsbCòlRDg	FALSE
aXNxaKmkRNCkyPtZmaEràIEqkmqBs	FALSE
aqaSdNàúakǎòzNBùGǎVqriùVěOeLó	FALSE
btaóáEVNaòRHácrpǔYPPoǎXújvwhs	FALSE
dFǔápǎrEHNèSoiQaTèaǒFàIHnyòoF	FALSE
eeDfěoěoymnkaWaǎsulNǔaQZAbòzy	FALSE
gàTapàhěgzèlRhaxěpGvIqLIcaěCd	FALSE
hWèSěYlRTMǒnQWyGùsaVjxDXnèBwa	FALSE
iqBvbeROSeaWMǒEEwXaǒgFǎhTEsRp	FALSE
kNeaajneIsOnesUPRěRwjLKywuojU	FALSE
lbeJkgRKVwNnmcmFOUǎAPxKOzjLaa	FALSE
mvLNóEJoěXTtúwVLkNAcTyaXtEàma	FALSE
oHaOxNlzxotaeJsFNqúHYpbGzOzNě	FALSE
pfIGCauJaWhxpXgwHpUuáǔǎIhGyFP	FALSE
qtěxBSRzúXCjjoaPwéáàáaldAvXòV	FALSE
sólúWádqèPIVagóByInaKOxahsBZo	FALSE
taónhoZkaZáNǔOèuGqkFBsYMcqòAP	FALSE
utCéeèHSǎǒqQùTHagJvaaJǎrrzuMg	FALSE
wěsbkcàděfágebfaVúùatRwlbCTJn	FALSE
xIǔVhXSǎvqHéǒHJKuAPOWanǒaaAhO	FALSE
yaSúaXjpgotǒyXTěHrzHDQhecjuAT	FALSE
