ùùDhhtZGqHǔrhùHdàLhN	FALSE
ǔúèktOdrMKYOxěówFDWN	FALSE
áGFeVKtciaKzpcFǎfǎJH	FALSE
àdAsgúNwgěéFaBBBZěǔh	FALSE
ǎuóbNààóaéqOJEHùLWku	FALSE
èGvdcRIFzZcOOAMùOgáv	FALSE
ěgNRiSnXUàKDENKsMKoú	FALSE
ónXMqODùUcǎuVCNzaCbr	FALSE
ǒúàzSwtIzóàEpThOVYnK	FALSE
úWdzoùàrBuKǎInyktvúǎ	FALSE
AfóEIǔCNUQNMEyDIeYLu	FALSE
BrTMUòmMXXyXGshtdBNZ	FALSE
CzkkPgDéiFXáèdRZDéCm	FALSE
EdnRydàxQagIGKùwEHRZ	FALSE
GùqiOuPneěTrYmmWjvPx	FALSE
HNàzIozqǎnIdsIhEOKàó	FALSE
IqUOUOJǒàgKHHQCsNtUU	FALSE
KBTǎóóDoWǎCAmkSǔrZmo	FALSE
LOxxUEumnòùMvyXIZSáO	FALSE
MoSǒYùWTtèǒGFVFTVèkD	FALSE
OAKgùuHdYHnyǔQQǎNaJn	FALSE
PTtyoLdàIQbldǎjGàEVK	FALSE
QhddNWROpjVàIGgxIcjy	FALSE
SFLǎHOEflòěRóáUUvOPú	FALSE
TZqgPDóMaáOjQGfěxkNz	FALSE
UphUYhpdèjMniBIpǔáMé	FALSE
VvcwPZzUkfSóMFdfwtlx	FALSE
XFDkXidBeǒvfùùfǒOMrr	FALSE
YbnZsEVoAaèábzmgaáWè	FALSE
ZvxAǔěfàpǒkSEPǒDǔBpU	FALSE
bJeZkSBmOjUmwàyáǎfrS	FALSE
cVhxYzGyǔhhgvHHbpnob	FALSE
dvOJjMKrYydYGBkTvGZz	FALSE
ezaEóyVaRjNúǔhěTèǎBp	FALSE
gǎpsbkOJITbowKEáwCug	FALSE
hImOlMdZěXǒéXcZZbHée	FALSE
icráwZJvUnRězúpSSOBf	FALSE
kǔǒVùUKOMcmcqpWsóuǎQ	FALSE
lécNSnYǒBKǎúLXNQǎGnm	FALSE
měmWAiurEǒùStPzzFYlL	FALSE
nRIzeǎVocAVJggciAlZT	FALSE
oinXwǔěBNFgTǒqǎmZttM	FALSE
poerDwdkzùfDěPúpchfò	FALSE
rǔKFàCYHVALsttQěráoé	FALSE
sóriéècúóHRùubdnRěDQ	FALSE
tMwtThnjmpcviRMJDXWA	FALSE
ugWgSmJNòUEwbAJéFǎqǎ	FALSE
vpgǎjMJFtVUóǒKFndUrh	FALSE
xǒMgGIǎqfOqTlrthUàLx	FALSE
yXFóegVfazCLvvFěexèl	FALSE
ùáùaHwáAěbyaùèsbaNbM	TRUE
ǔbaNNwbaAéIFBqIpbaIz	TRUE
àòaRQLáboNNaébaFbDrL	TRUE
ǎtCwbroYoULabQabawnT	TRUE
èLQbùěauEbabotSàaEuǔ	TRUE
óěóNPbaVXTlKbaNYébRa	TRUE
òabaFǔbuaWǒbmvqtàǔhx	TRUE
ǒtěbmaRǔXbyJabNCWǒaP	TRUE
AUabuqaubaóVěbùEiwǎM	TRUE
BbBwabǎtaGěRòbawnjIá	TRUE
DaMYtsbaIbyLnabòRkrT	TRUE
FIabaóóoXbaùmSèúCunb	TRUE
GkLbkUúáqnBZbababaFg	TRUE
ICELnLùábéabDaEAZbas	TRUE
JambmwxaPHsbǒWoaYbaR	TRUE
LàpaSbZabéààǒǔabDvyY	TRUE
MSSUoábaYbaǔǒRbacHúN	TRUE
OFúLaDnbIaulébaQbBPm	TRUE
PqRaOěbzUxpQaCbaáQby	TRUE
RhtxXBbqbHaBbAaSubay	TRUE
TWjfaxlFbSablaBèMbág	TRUE
VécKwgǎaǎbYQabYmraàb	TRUE
WhèbEVyabDCǔarbpvFaq	TRUE
YRgbaMNbaěPààbàǔaczy	TRUE
aǔJbaXZIèbEaEévbCNSě	TRUE
aDnbawùǔJbaHbRXLghFé	TRUE
aRRAbMMabUHZalbZFeOg	TRUE
abAawQvvrWěbsěRamXòb	TRUE
ablaboQFQáèKaPbáSǎgO	TRUE
asaEbbaJZsbaùǔbAxěéa	TRUE
béabaKbqlMFsaKMbállU	TRUE
bInBasbpaIbCxaǒLáAYc	TRUE
bVanIwQǒTRbInabQqGay	TRUE
baSbPFRUabRnPsaBtrDt	TRUE
blQyTPabaěwVqbéààòIa	TRUE
bwpuUQbaúRàbNaábòALa	TRUE
dAsbarFObaxDZyWbasjě	TRUE
eogYúNǔabúEaFbawbHVM	TRUE
gTàbabmCaWbATClaeǔlw	TRUE
iěamUbabaěǔùSXóbGRjb	TRUE
kéǒxwbtabòaNbJMQPaqz	TRUE
lbjykKiObaǎábaObnaJù	TRUE
nWRbaNbaGbMpzulomaéQ	TRUE
ozFCcbMaGRHǎbabHaǎjf	TRUE
qKbǎGamrXQrobBuaobaǎ	TRUE
ruPSóNPbnéNabáaFpbBa	TRUE
tTdDfvBáěboabaZbCCCa	TRUE
vòGaQábaFábKQFxěDóab	TRUE
wkbaBsbèMraXěAbtúaòY	TRUE
yRXSTóaébaCbsmàaHObZ	TRUE
ùùáTVòXjPmrNXáAbQEQQě	FALSE
ǔúKOǔGpǒvgEyUMPLGUdwc	FALSE
áVUvnèErWveùRHfǔHhǎEj	FALSE
àndBeeduVcOúwǔoSXrXll	FALSE
éáxpygZKqgBeúKtfdSǔiF	FALSE
èMòuQmǔyóGóIoqEMIéáir	FALSE
ěhwòHcrJbJèǒéZmNFZiKp	FALSE
òǔbáoHBVdoAǔclCévàPmt	FALSE
ǒGǔfUBDIǎǎkCfcaTrGdsa	FALSE
úVxPTáǒaràúèórájBotRv	FALSE
AjOxěòvuǒnoèiJwrRoàvD	FALSE
CázěiqéKeiOHSvITnKèvK	FALSE
DPhéédFMpLúúdǒSrúPBVù	FALSE
EoQwSfHnocSyzfmaeùkfE	FALSE
GǒEoAcùZPiwǔnjNRlèpku	FALSE
HSmcWULurheKSóNbèaXNJ	FALSE
IeleǔOQwOaEiuUOgWjúfR	FALSE
KǎáHSXvJsFGfiǒyFlDdmN	FALSE
LGTDVóàWDdfúIWUAZhěFě	FALSE
MKkǔLBjKěulOTbónkieéj	FALSE
NZěFówvKqrIěHDZVbàOEù	FALSE
OinǎqáaoAǒBeEcjpàswAd	FALSE
PxdmOfěJRǒQásàxMBSHko	FALSE
RǔáǎóxrLxKuóhhjFkǎědf	FALSE
SPrzJPègàQTdTPRnèòing	FALSE
TwiTsTělGMSnotqkRǎètJ	FALSE
UrbRsJěnptLWkóUaUTvMǎ	FALSE
WAXDTǒGǎkTJWqhALCòhvě	FALSE
XPsmiXSèLNxPuòBjpǒtRL	FALSE
YcUhLlsXaAStàKpmiwPHR	FALSE
ZxùlYpKbdóéyHrKóěbjHk	FALSE
bBǔqknxOWPóWvlgWǎCTàc	FALSE
cKNPRcúpmBXcYBDmmcúúq	FALSE
dYdoKHHgWPWèBjdúNofXǔ	FALSE
ekbPrrUAěyhboZqbIspGd	FALSE
géPǎRVǒiQQIgcxVUáàǔmá	FALSE
hVfcrLpyhmòoMhòHùKatq	FALSE
ityFpNLěWhDHjGqUQthek	FALSE
kàtsvMTjuóYótsMNTNWúá	FALSE
lNhyiLěcWYnǎmúlWiPǎzJ	FALSE
mbúǔJPZhSRxbVNXddoXGL	FALSE
oàSòhkhRSuocEosǎEtèVL	FALSE
pJOmzrpxjěvqěueVmHzyò	FALSE
qOQbKǔYcaàdRoDJelsMfW	FALSE
riEBNěotCxsqBCǎHàsáǒó	FALSE
tóDùWǔèKbáùhmnOARúIùJ	FALSE
uTNyJxpXugdpOAéécédpò	FALSE
vabYWHxǎHoYoxvgpǎùùPI	FALSE
wyMóVQaJRVǎnWuSòKsqJk	FALSE
yMVSǎNáùéeCrnhLBùxYPá	FALSE
ùàsàaébIaPěèJvòbatbéá	TRUE
ǔPaxbzanKéYWtHbǔRabJK	TRUE
áqdkbClabaGbHaimkCXch	TRUE
ǎXSapFDbaěbBèablnǔsùé	TRUE
ésabCǔUYaFXZnbaxYYùbj	TRUE
ěaDbZyèèaébvyàabpǒIJE	TRUE
òǔbaóbáQHwZVyaPAoobaú	TRUE
ǒabéWěRXIatbǒaZǒbRLVp	TRUE
AHHbabmaàbaVoWydLPmǒo	TRUE
BbaúDǎKAbaRbxǎaHOǒwpc	TRUE
CpbabaPKbòUCKnlKKNNza	TRUE
ENVwlbazbDàamSàmCSbwa	TRUE
FvQùDabLaYábEZGHaBàbl	TRUE
HababFxAaèVCbecwOàPóF	TRUE
JUaWǒZbaěpǎybRsPFaHvb	TRUE
KuotbabIpaCbHyzpaHoef	TRUE
MbPxaoINRGbaàǒlbtzasY	TRUE
OIébJQaGObabajHòhèKRó	TRUE
PbaAbaVnbahZJoàVvědjL	TRUE
RNépuKeazbaSbaúuIVbRC	TRUE
TǒaCbPMpKàHrIababSXer	TRUE
UbabaoHuǔDHGvèbaoBpǔJ	TRUE
VyXnòzsnólabaNYbaKbpO	TRUE
XcybpQalǎbDZvaxéQHbaè	TRUE
ZaéMmbaWbaPtVnǎVǎbhCf	TRUE
aòmElpbnaTbaWGbJGàáww	TRUE
aLMkKHabBGawbabpùuàTù	TRUE
aabalbnFùxǒnvabòFZàkS	TRUE
abaCéLbsoaJCzPblyCYsW	TRUE
aoDóbabOLaěèpswLVNHLb	TRUE
bǔQaàCObBDMFDaAéANbóa	TRUE
bBzrTPalòbDalrbèEnlaW	TRUE
bNmMJrùyabùaRVóóbINaH	TRUE
baúyXAbǎwFaǒoUNǎbzaGb	TRUE
babtQWVabéawpQRǔHèvRV	TRUE
bplaZàbaCbǎxPMajqfRhQ	TRUE
cZYbabIWaJXKwbFxafDsC	TRUE
eětncvfbabBabònaEQxWa	TRUE
fjkbmHmDDtaùbWabéqady	TRUE
hbóaRPHZbaxǔtzbFzuaiò	TRUE
jTOaSzbxQabNDNTmKaAbǔ	TRUE
lEbaùbLAQabnéMaéàJTbS	TRUE
nAalbnTǔúéqúzWùabambs	TRUE
orárXZaFbUoaGsUtZǎbab	TRUE
qKěgubMabààǒalObaDàDp	TRUE
roúJiàbaBDTbaKlbèalqV	TRUE
tabǎwéZaobaUoCMbpzhSr	TRUE
vèCòeBEWǎunabwNnaǎbab	TRUE
wgbaóxbtaYHxDMMxobYma	TRUE
yTsǎEúEvxvbQababpUúaf	TRUE
ùùUxGaǎhRiúmSRPPLòMdVT	FALSE
ǔGSǔMFWsPJetbgléCzéQIN	FALSE
álóówàjBSSEěLsvùabjǎqG	FALSE
ǎúàlOQqfMYlCPzkǒLllmrǎ	FALSE
éePéTúAGkòXsdtWzùZnGzG	FALSE
ètRnHójQáǔlPLemJIhEngS	FALSE
óFRSoàUNdkBǒvòèLdàGáàn	FALSE
òWGWFnRópúoóiywKuxǎnuq	FALSE
ǒlOǒhgáOWófXrNǔUèXáNtz	FALSE
úrtLOsoWktUsKopfcEdPsM	FALSE
BArWOentHexǔotXFMeHMǎV	FALSE
CRaeAaǔyVQsimGRLeGUùLS	FALSE
DffFàáZFóiBVGJKǎSHmRǒO	FALSE
FǎěyMBSWuLaǔHKrCUAbZòx	FALSE
GFOdWfLAcyùQwXYáùEPVpm	FALSE
HjdYtGaBbAàaEKkYDZvSfb	FALSE
JóAXHáLèGQbNaàHúJaèCéZ	FALSE
KDéRjěKàGféojkHrOFàMay	FALSE
LJgúyZHbfIbǔIQYyéJBláò	FALSE
McièbnbTMúukLPjkàaowòy	FALSE
NzsLZjRǔqiJYòdǔPEfvnVé	FALSE
PéCWBZuzBěàDSTgTFǔgòòN	FALSE
QCWyùúbSWCèWBaZkvkěèié	FALSE
RPpòùeǔVZdmqNAoavwOúKI	FALSE
SZzhàZvHbYCFjdqtBedCmx	FALSE
TlùSsbVJioYUOwěVyHcpAú	FALSE
UvUALOèeHTOCxǒéfmòyuèR	FALSE
WTwYbTěUToGoùèUúElZHMu	FALSE
XqOYRǎtQlirOIvmxJMoEnL	FALSE
ZBNǒFeèJtwbCvVOǎúSHègn	FALSE
aDfvZJCDMlmEèǒcIEJqzag	FALSE
bSkxpkǔxMKětéSùTeqjaZD	FALSE
cjkòGpbWwbyáJEǔpLeQuII	FALSE
eMUMCwdfPcMiéyiwqWQxEX	FALSE
fgòGFVGPCeùGUSěǒBaHxuV	FALSE
hùSFIǒhKqEmóajYlKèKAds	FALSE
iKókhpmYCDáúGmqxMlWeév	FALSE
joqàǎèHDKRǔuKbmlmóPZrH	FALSE
lùroTUěnxboQMnqRǔdgsěs	FALSE
mVyèqEGBóǒWPSàpdYtǎyBě	FALSE
nYLomXSeésqHXdáHěuéóùǔ	FALSE
osǒWlChMsBtlakswgVǎKGq	FALSE
qLWuBGzGbsGLǎuRtFMorKh	FALSE
rQJèPAQbjEdǎShfkSZOgBS	FALSE
seOICejhKdBXáěQùQBRkYS	FALSE
uèeKǔùcǎěBWǒpbRqBSkmaà	FALSE
vAXǒǔéyoYLóyjEkzbáúaxI	FALSE
wJCuPinEWRIbtekaebSMer	FALSE
xfwKMIfQQEFEoòuěomǔvzO	FALSE
ygtzqbzxsǎaruYǔùápàyBj	FALSE
ùǔěgbaDbaéTèbPQaYhZQZX	TRUE
ǔbzuǒèasobtavGbnxaWhJà	TRUE
àEbGabKZaǔFVbaIiGTLǔnI	TRUE
ǎgSóSbvLuTpnababoaúUUK	TRUE
èUbEòaAMěbabúěúaknEGǒè	TRUE
óǔèCabaswIMbòusCKOSAab	TRUE
òbNUlùNlaánbqabaáUibzh	TRUE
úaàTYTFQDAAábawObvqabv	TRUE
BúWbaòRJTbEqaéúboxwaóo	TRUE
CaDbTOaqběqàvaǒoGbǎyCR	TRUE
EàWéqwcIabèYVúabaPOnbó	TRUE
FbGHabnaòMECbTtǎaàpHur	TRUE
HǎJPáebòababYaczUèékCǎ	TRUE
IbabòRTáCǎTTaUbaZortTc	TRUE
KEabsaLAInbòNMaběaScrg	TRUE
LfbaYNvbaGllxbCaLDKqUW	TRUE
NáriǎiZaébRlaVǎbabSOtY	TRUE
ObuxaúVXWbUYMáaNUbNEaě	TRUE
QLǔAmǒéMkbéaNMFbabavsv	TRUE
RldWjféMěSprbaFbǔlBaba	TRUE
TIiǔEMYcYwaSDbDabmaěbà	TRUE
VùJǔblspmsoabWèRPYabaw	TRUE
WYòbTaXvbvaObèFOaMwQaH	TRUE
XwoaòvbaXGBCǎbLlaIàTbR	TRUE
ZaOMwbabáQaxbwxQstRRLi	TRUE
aètEǒmbltmóèaWxUěbXatb	TRUE
aKeWaJbMěmóXRabCùaèHFb	TRUE
aZKYbGǒabGLQayWǔóbMùáy	TRUE
abazóxèEvsébaQQǔmbǒvwO	TRUE
aubmLPFabaoúéóòbgàfDUs	TRUE
bóóaEwCSèTlwqǎYbqabaòI	TRUE
bKBTaKrbamèRòXxVqbWaǎě	TRUE
bWǔèaYPqbaUTZLPèbvaxpx	TRUE
baTBóWZbAaEàúJzbǒoMAWa	TRUE
bnaǎUbanSZKǎǒSVCbCaDYA	TRUE
cùDUabCrzarTNúbXaóZǎnb	TRUE
daqtWbaTDbawbYGsrPáTfu	TRUE
fBVzHbFvmvLaIǒKtbVabóa	TRUE
ghbaéLuGbónaBsSàèbapHJ	TRUE
iaEbXàMǒaǎobuabCehysjV	TRUE
kNatMBpOǎtsHbPaúbabXpR	TRUE
lnaKZbLmaèzCCDábabZUFD	TRUE
nYUgWófYPIGVcababaOǒEb	TRUE
pěgJaAěHàAbSabaBébvJám	TRUE
qjbaFQbùsǔpaǎrèKWbMxai	TRUE
sHKMawboúaAbyxabcdcRPr	TRUE
teHeSBbaIJCbaQáHNběacS	TRUE
vàKgaBtmjSòbǒltabJabWa	TRUE
wbabsBabáCXaLvjǔǔeyǎòB	TRUE
yKóOǎbaYuDblùawbUXAaóh	TRUE
ùùzsǒéYgZNECedWǒKjIBHIH	FALSE
ǔCGǔsAGhMǔǔRPyyUTLjòPTk	FALSE
áQǔHtVNVPYNAǔóbǎZRNZbpf	FALSE
àZèhóhIYGǎmcvUcBGPPXNNu	FALSE
éóJSJlEHJvqqUxǒAqoGòUPZ	FALSE
èIuòtóLéIǎhXiòkAASvuuFú	FALSE
ěSdàKsIAdǒHVMIHjùvplòǔǒ	FALSE
ófóxefJYòkLjoéUljARdrWn	FALSE
ǒàGEJuúOiCTǎIRPMàiPEòOL	FALSE
úWxWèazCzqgHCólIIDBLuDf	FALSE
AtXarfhnxùúàuByxéePVvtt	FALSE
CàUTRTbúFqKòMEúujMlDélI	FALSE
DFREVrGTMkEvjGTWKMEFwqà	FALSE
EVvrfHpuAetezGáQvoWZǎBd	FALSE
FksiúUáóúzABxowoMHAǎbyJ	FALSE
GxZèwúEBcéBYpáXěSObmAax	FALSE
IǒOáLěAvbMóáWsOùBWSDhsE	FALSE
JWǔVúfqpPQTUfǔnXNwyEtll	FALSE
KpEuBnivQCAonCnóǔěǒFhYz	FALSE
MěpsZPLZùéopsvqdEBmǒUgX	FALSE
NXùiǎcógTjNlXGFùàofóèGj	FALSE
OdógHUEágBVLDǎWYvmTěYěV	FALSE
PkZMùXBúmúcQeúJEqNdLSSz	FALSE
RóPqrnZnièémòrBESlTUnqm	FALSE
SJhYOBJcǎLqkěavXvzpxǎte	FALSE
TeTJPlrqRGHiLOYmGdwFjkù	FALSE
VǔùnbWúBLjngèfVWRcscmDú	FALSE
WJmZmúǒIZcWáyRWupJùáùǔe	FALSE
XarnsěYòNMòBsòstkKméFVE	FALSE
ZàNóKòmMzlwòlkGEzànxeBx	FALSE
aOémaxVgXěsOwǒSèóCytaur	FALSE
bZsxXupDuBjfoQBCuRAEuNb	FALSE
cgHqiWCFùeJǒwVKdxWǔObǔd	FALSE
dlqdDáhIUjyǎmxGóWáǔúIǔá	FALSE
fǔbuAPFǒZqwGDkOijGXInVB	FALSE
gErNǒMaáǔkTǒDáhAòJxZaùx	FALSE
hQgàozwyPvètKNbnRpyxBFè	FALSE
iawuEiIVCáAtBEAGmhjmLYL	FALSE
jqWNVóúkAPEMOǔuhòVAEóàe	FALSE
lòùepGagúYuXéZGKWfǒwZRZ	FALSE
mMPWaZúǔTtLyǔeKàaRǎǔDgr	FALSE
nbǒGVdáLAfRFeAvxùHǒPnPI	FALSE
oohFúkUǔàAVǔYfNMkǒWùoWě	FALSE
qáClJǎǔdéXtxxGǎoǎjsǎááH	FALSE
rbùOAPllKǔJráGódPúuSěCI	FALSE
tóCoTaZXivLDèmUVogbùrHa	FALSE
uWuHqdlvhUzAmHJuwmobANf	FALSE
vhǎdáZhCéVsNòěTaòùqéOěz	FALSE
xGrěhUqUBcvhaWYáajcTsyb	FALSE
yjANFAHEhIkPcPRLósZpFeD	FALSE
ùùZPbabGmpPpLAáLaUSbéZa	TRUE
ǔaùBbOGnaJNYHbKymuaDbYN	TRUE
ázbéKaEébaCQvuHOrYbaOrn	TRUE
ǎWUfhIUǒoabanǔsTùKbabdJ	TRUE
èàaXLbvǎaAtbZabàxCdáIpa	TRUE
ělGbbQqzaòòǎébUJEpDabZa	TRUE
òLoDhektQAEècǒbababsWaò	TRUE
úǔǎóhbǔùmabBrGǎNVIYaTba	TRUE
AaSApbJyFáaVwIbǔabHmcTD	TRUE
CěcbxwaǒmNbǔPsòaHàbaueN	TRUE
DXapbǎwaráèTbRoaQsbǎcòB	TRUE
EeYJbOJIaWFSGpUbaóbaifh	TRUE
GòznGgYmHFaSyabaHbaNARb	TRUE
HbxháfyúSQavbCGayIbNabk	TRUE
JBhCabaFtbaoSbPPZOJǒrkD	TRUE
KaCXbuaGnèJuPEbabuxzHǎN	TRUE
LuPXxjsfátaùLbabtPaMbòL	TRUE
NPjbèSabayNóDbauEtùèext	TRUE
OfbǒrǎAgapbàBùWaQYbabQD	TRUE
QEzXHDgfvbaybaWQNFàEvba	TRUE
RnnàbASoNáyaárbxabsagǒw	TRUE
TaSbaáObtMTSúPmǎVIpHaǔb	TRUE
VóOlaARgMcèùǒběababòaAL	TRUE
WdaǒbèpéěqězPQavbDxRayb	TRUE
YòPAeaaRJHaVHzěbaBLZbab	TRUE
ZiěbFǔaNFsbtJèalbóvaSjS	TRUE
aúmpóbalbaǎAbrYEéQTCHND	TRUE
aOoUtSbauBAèlNTTbSaIúbM	TRUE
abùóQAnEabóEaàǒyZbCtXěI	TRUE
abvěXabaǎGbtYGǒòaiǒKWòè	TRUE
axtúxZSbévLJambxZTaRnbk	TRUE
búatùQGǔbǎFqǔBabyrQSaAU	TRUE
bRaQUbáabypvTSnrsDssaUj	TRUE
baRpLCQbwYabúFHrHaGscóN	TRUE
boMTovabCxTxaNWxzwbZSǔa	TRUE
cLMaYòwǒOpbùtIaèAǒblaWb	TRUE
doXéGgbwěaWbYJlambaqQEg	TRUE
fQiqNElybaóVbasJbxSaǔeé	TRUE
grǎrCùaòrmbJSIaběasTJRb	TRUE
iWùCaùlIzbBFsabnaXbOòkq	TRUE
kúaiaJsnbIóAèIabQKKabHF	TRUE
llExxnJaábéqIpGTabDuaLb	TRUE
nabaImRbZxabJmněémXLYUq	TRUE
osèfAIabKsaWFbaCHbjěááé	TRUE
qXkàtasòbVabAKXXAabXzBR	TRUE
sófouypaRRvFlpèXqbabaOb	TRUE
taubmaHuXUbaòTHǔxbzǒǔěc	TRUE
vèLabaǔàlLbZCBǎaùTzXvbT	TRUE
wbfyàjdabuaUPWběNHaùébZ	TRUE
yKoFaZvbaYòbéLABAlUáabd	TRUE
ùáBTòSFqjuMsTǎEKRMvQùOOǒ	FALSE
ǔhQKáèNàaCxXcádáòVXlGTCó	FALSE
áxzuAěcáhhàgxEěùòaQěòrGe	FALSE
ǎǒoCYKwkóNpKYěgQmúoGwSjc	FALSE
éeòOSdUSkOéGsǔyxjhFyqcOè	FALSE
èspěyVPTGòNndFúǒǎECsmMǔǎ	FALSE
óócbúVVsXǔLWsTifEaveheSa	FALSE
òUCtKMPúNMEǔVTqwOngBKzúd	FALSE
úǔáCùSBDBLxBtsáfqKkDaǒHC	FALSE
AHóJZdSCRWúOuUFéTlDRlCMh	FALSE
BQúfFPcRǔyRòLěKLPRhZLLiù	FALSE
CfupázBWùfNeZYAuixUuYTùj	FALSE
EGejCaGExvuMEWèjWkuGOokě	FALSE
FVCQHpWfPqzóUHhaUbuEGVhM	FALSE
GlsǎtUuAsqSoǒǔrujTVqǎudó	FALSE
HyQBǒPyGqXNPbAktòhCcXRDv	FALSE
IwsCúcóóaMòIQzgwúoHamcLǔ	FALSE
KàvnIYUròSRhIjMGoósùijoq	FALSE
LPèEúRGpOtzémwAcTIkǔNYět	FALSE
MqùRáXdmgQZoOjxXáejMVXpd	FALSE
OúǎòvAhlMáhxǔèZHóhdeáJON	FALSE
PKǔábzèěrzeézbvQaéIIáUZV	FALSE
QazóápujàbOBufèhèBdPZóvJ	FALSE
SùxeIzLtdztbǔkpàgdttVknD	FALSE
TENMHUmNǔúplàDnnnFòUǔqǔM	FALSE
UeàbaZújmcRqajúòNEwXmyfC	FALSE
VzbowHùòdpùágnzàYqúgDjik	FALSE
XAPqLAofRHknJSvMoUqOhéòǔ	FALSE
YGVWxHBéáGóEvùPóQDsimuNl	FALSE
ZTPGǒCWeaigFodHnxDrKEǒwR	FALSE
aXrYǎóJYjuxEuPUqynBěaPjB	FALSE
bpnPàzfǔjlFèLvzqDefǒFSlK	FALSE
dàPpylMssayPvphǎbWcǒtjǎú	FALSE
eDgbFóóUMWVWSnKMǔùěǒUoeY	FALSE
fPòáeWlttGǒpVlǔQùdbówiRS	FALSE
gRxàqéǒlQBQEóNItODJuěéEr	FALSE
hvǒrrEzǎTéNrtfùOIfùtdsUX	FALSE
jKGCěhssBPXeSFéhNcáděkgZ	FALSE
kQASTtYJztXmpcFúsytfXzOU	FALSE
ljvuLǎHgmtNYwLnVveeVEgYm	FALSE
nérWzZPclcgyǎuXWUqúnUSqz	FALSE
oRWBwMrZǔfkVrBVpVEqcSMbv	FALSE
potCUBAzXqǒJwYFyVCǒdiIvò	FALSE
quSALcrNěQZPǎǔéXIkvgTJòù	FALSE
sEùkdnqǒluuFabfMjDděYuOT	FALSE
thaeiúnZTrcJmcHOLNxFEoaX	FALSE
uyKHdùuéhkMǔZùfxVúěYXXBY	FALSE
wòfbhóànèdhRylCǒzóLGXTiB	FALSE
xSAuéǒkVGaPjéoúLxWpzQQió	FALSE
yjáGLDèPEeORcKáhffǒxFUpK	FALSE
ùǔfmGbJsxalMǒbabaDféhkèq	TRUE
ǔmgabaURXCwmLbrMqaYDRbǔy	TRUE
àJCùuCtZduǒalèyUbTnaběab	TRUE
ǎmdaKbDuCWaJùbaPbààbyTqN	TRUE
èǎǒAbGSESAqYaóbNatAxQSba	TRUE
ěWdzúéaǒEbamIOATpuùGIbab	TRUE
òAkòDúEAxbabQTnMEaběIáat	TRUE
ǒjXoWàaǔùZEǔbroaAbaKéUbH	TRUE
AǒódaILbaǔxéSbyJlPxaKóbǎ	TRUE
BaHbYambCsIHKaYbJǔǔdwQNE	TRUE
CmúWbKabMěúàaěpVbHèTWJaJ	TRUE
EJaúbCpaMlRoUbùaFbTOMyǒK	TRUE
FeASJGbaJObKáStaUwbǒRaǎJ	TRUE
HNZǒEKOYǒbMèxabMrCavbǒXa	TRUE
IvaábabJCKTayùébvQgǒIGéi	TRUE
KbNǎaRTbalqVábmòRaéqdnJp	TRUE
MIOtòNbUEúUaFLbEapbaVqàw	TRUE
NzaZbtSáFPQalqMbCaAxǔblp	TRUE
PToQtXfiabNúúaobéabHPéóO	TRUE
RǎJnmRQODaàEbYYèuéabEabt	TRUE
SarbKtaEàZNxxmáǎLbaRbOěA	TRUE
UǔaFbabFarJtxvGrzzǒFWbUt	TRUE
VmèabùwaEUSbMaKbhxBAùDsU	TRUE
XQubéaWXǒXbnaCòúPSrQbvAa	TRUE
YrǒlqnóápbabnWúaubáOaMsr	TRUE
aáblUMaMzbMaTSǒrAbFvShóN	TRUE
aHbDaxTOéyQbBrérGaVIZAǔb	TRUE
aWDǔěUbàaàbaAáxovHJbUáAr	TRUE
abaXVtlxéKZóKébaPàbUYABe	TRUE
atbǎxOqaXVMNpRObSTaèrVby	TRUE
bóǒabLZòěnvAaǒCOǔGrRqbaA	TRUE
bOAOaVIbaUBQWMbGaDùfNuěZ	TRUE
baEFǎVáblaNbCaCNprsBWóvi	TRUE
bbJaDpvKbLúBaybaèrUgéBfj	TRUE
cǎHrdJbǎyèVKGaDbQaùFbahp	TRUE
daYmátROTbTmJěanbPaóóbùù	TRUE
fDRǒbNéZòaàbǔaRǎCbagIèQe	TRUE
gaèbQaTbaǒuDlápIJèlwbpTú	TRUE
iGsyúwaboBKabqEVwGvxawAb	TRUE
jbqTzZaùbaàóMVbMAuaùPcBy	TRUE
kyXaXbFYaGbNaTZsbvgaJúVr	TRUE
mjqbaǔuabawbKLǎaǎbèwcXOt	TRUE
nxtúRpóVǒWKabMTaEùSltbab	TRUE
pEqbpDǔMatboQSFúYXǒabAai	TRUE
qjEsLtèNvLablǎémaqbabVTt	TRUE
sǎkbwVǔòaùàwáuAbTaQbǒVya	TRUE
tabFòozPmǔaòDrHbǔSěUàǎab	TRUE
vAbwJzdWHobaNbaxbǎKZETWa	TRUE
wgYatJsbsUnèaUǒuèbtauNbD	TRUE
yNVHǎZAaBbTòsGWpabUawbZò	TRUE
ùálSDNSIUyMFRXElVjaHKELCV	FALSE
ǔáěmFiAóUBeSnAriùxPSrIxHǔ	FALSE
áIwaaFpQiòmǎAnJǒdUcésdiyY	FALSE
àWpXěTzwBqNDzmPkHhHǎmùuBP	FALSE
ǎhnáHnIwDiyédeZDFsHjgùiLg	FALSE
éróúǔliXFǎzSxAùózlkǔfvGbó	FALSE
ěNPàázPvTuUSCéòǒwpúcùOJPb	FALSE
ófyDNAOZnHòěujYaInGRàuBQZ	FALSE
ǒěRfjEIùOjRjǔztěPAZǎZvmǔw	FALSE
úOBUhrXǒCKRwptóTJmPOWfQqE	FALSE
AXuzǎmjBLAoCwhmuHLáMzovgY	FALSE
BhmIEYXùóZrGRròǒVdǒèCáòVI	FALSE
DúBQéOkOiSeVlZqéABVxlKBCn	FALSE
EQùaSfswMiKhwsseCqlettMLD	FALSE
FkmNBWlùMweàgFàuaRéèFayct	FALSE
HéRzpZXsfcDSùpǔYIfaéfZúeQ	FALSE
IǒxCPXòEwúùybVkpDǔFzxúxùO	FALSE
JPxTrkDHLPRuHcnKfwZàdzOèq	FALSE
KrějKǎKxefhQZAguqUjIěDHiu	FALSE
MúkwugòoPOlYosáIǎXAmoxPie	FALSE
NGěbpùApOvseeXWǔZfmǒjGúqp	FALSE
ObHXwǔěqùcTKbsóIéTdJěbbqè	FALSE
PjnTjlbMnmVADqlǔOExKMaiKN	FALSE
QwTètMEǎjakèadmSBDǎnfIsúd	FALSE
RxòYUhXWLseGmxTuòòEyVgsdz	FALSE
TàcGSZóDOuGysyacnQJaLyhúf	FALSE
UTCZǒCGǔlòXjòFtlcǎVóVkohò	FALSE
VmltHNóKkvSUèsimXMJXmUKGb	FALSE
WvhDSMZgEǔeVmCFRYRrYǎRaEw	FALSE
YJBfPJtEYrjWCPFSZOàTòéJux	FALSE
ZfzCbqXàXTsLWDúSUǒèEèHJòM	FALSE
azrStjwvcNLwáTùǎZòwǒPéjTa	FALSE
cóQYCáfSVCǎěoEFKVúYtDpuoù	FALSE
dQeteKxYvéCmkZúóboVhwunbc	FALSE
eqhMòǒJuPzèniNFMDtépAmháe	FALSE
gùmàkbXRTOěSqèHUzCeTXCTuE	FALSE
hEaykzvúEvTEZbdVIFqáGǎcHA	FALSE
icxxěPàujfLDNzTBFNlDipáěM	FALSE
kéeghòGèZùHFErRèzUHèjUxBt	FALSE
lRLǎYLávkrgOLúRBqsjZǔExǔT	FALSE
mzbUSéUPNáDòmagáEppRérvvj	FALSE
oDuRnóDánSNùYǔOéǎcnGǔNqca	FALSE
paKwáysjrtihDVNgVùCzGQtfà	FALSE
qvbVlzchlfyUgRzeKJáfǔtkpi	FALSE
sKuTTTréELèéfBCVeUHUGNiYa	FALSE
tlOfeUàogSzCUYáqNcUrfMLAO	FALSE
vàsufHuàevzWQmTnCOFDHáMqq	FALSE
wbLUlsKsABoaVuVBiFàjyyeàJ	FALSE
xhJQǒXNhoMBFtmǔJrtòicǎmUd	FALSE
yxSzUfhǒkcWWcjeùRTCBmftXl	FALSE
ùùPtCǔeǎFzaJQbàaEbaQEbyRs	TRUE
ǔRSyaPKbabnOaǔKPMDǎbqǔLǔk	TRUE
áuósóusYblabaPbqúEǎazzKǎb	TRUE
ǎMHSúéòEBCbaqPbaàSsbWZaVa	TRUE
épúPvEbpǔPUZaXTbaAVǒnAbJa	TRUE
ěaěpboabpDàOrXVMRrlàaWYlb	TRUE
ózaémGMzbaqxFDQrQbóatYWlb	TRUE
ǒUZHqùKbaRlLKùUGǔbabRxIaě	TRUE
úvpTvbòǎWJaúxyAbTIaJPbèPa	TRUE
BbJyxébatzbaáHbòQloRHǒEóa	TRUE
DBNiUFawsTbabRJaběOPeBaNù	TRUE
EnaZClGQbaòbaàáJNnbcmLiúd	TRUE
GòWPèZiytYabFtabmQǔntabzS	TRUE
HbTěaYmbóaǒbéDaUfMzOLkEyR	TRUE
JKbUNǎéaPBpWbJayRybpaphpV	TRUE
KcOPaabaLRòéObzaàǒDǔsboáw	TRUE
MNěyLYrmabVàBóvvquavběǎab	TRUE
NtalZWnǔSSSbYazbarzbJgeYR	TRUE
PSǔFáLbVRPrKaxSběapYbYSaR	TRUE
RHaybRVGUaàYrbàazuLááoZrb	TRUE
SpmFbáIyVMaAbapWVloVXtyba	TRUE
UNnUeDMAbwaébaqPbèxXaiKpa	TRUE
VbOabDaǔbatBgmLLáébXZáYEǒ	TRUE
WvkzNUbqaDbYǔǒùxNWǔabIaAA	TRUE
YTmclòdWaawtbIzababùùayIs	TRUE
ZofKIGEubouababYZoúǔúapRò	TRUE
aGǎbOsuuyaqbBqMaFbycQidEh	TRUE
aVIbwěQabaKběKIZCCyròtApq	TRUE
ababǎlqrnHabvKǎèéyrùkcyùó	TRUE
awLbNnsaVóPoùHbǎGabVTFbMj	TRUE
búRQamòVuAnwsúbJabaqvnuTd	TRUE
bPlaNbXaCbEroaLúqxmTcfOOg	TRUE
baEFbónaǔbóEwúoAzadHJááfǒ	TRUE
bcKSWcabOaLòbJQSvaúbgUoóg	TRUE
cCjěDUJdàqòèabNHSaLQbabNJ	TRUE
dYnaMsbáóaGbttARaZùBlǒybm	TRUE
eoXeaCDǎbǔàabèéaUZNPSyJyb	TRUE
gRhóSěQaDFEvcaIbaqEbaòotb	TRUE
hjMaǒbabwrnAabjcòFéRmézwm	TRUE
jMWabSwǔRFuabFrězqXRIxaMb	TRUE
ksSgywaǒPbaMóztmbǔRabiKbX	TRUE
mWCbaTpwBFmébJCGmBZěabAMa	TRUE
oóItabaòKTNNùbabéAfHohjoC	TRUE
pQvQuáaFèbsMwDGaúúbXEaěbd	TRUE
rùhCPabqFaǒFYHNbraǒbDHóNf	TRUE
sWFaSmnzUǎVbrODAvaDbaběvf	TRUE
ttUWwbPlǎǔOSáabSHabQaEóPó	TRUE
vNPqbrzvaùXtbabVOYèKZPyat	TRUE
wroCIMXǎǒobaàFUbsZùaOZbaI	TRUE
yabáaJǒBXqòRNVbzláHlZabUb	TRUE
ùùPéStKDYMPChDděqmXùkxlWuu	FALSE
ǔóapULùDHpAOkwWaéJHItǔUTNu	FALSE
áHTUYZávRLYSKoZPCkqbTXéNěL	FALSE
àkQáSǔòGEpLwsbǎSseQUóWBéTE	FALSE
éǔCǔlozRLYǔlRoDLdmTTIyShTN	FALSE
èHtòwFoiěJojIyzlRpseCsUégI	FALSE
ěcivAQèǔhǔèǎXOEMiǒGbeǒULNS	FALSE
òàǎpLnLrOwxgUǒLRǒRrGHciVcf	FALSE
ǒNrBTWěxwfjKUGòYfèEqèlYLkě	FALSE
úhTòMMóǔwPfUNoltòBnZlFeàǎd	FALSE
BBDtvmgòeéRSuNǒěuhěTufNSPó	FALSE
CNejhZébRGCòRgJAvlGCRnúHTù	FALSE
DZRWiAéaIùxWHdQYzzpiSěpXCs	FALSE
EoáUMnlwABTPJTǎSIfeSèfóArH	FALSE
GǎYCoǎzRWTKQzIIěgIisóǎkhàC	FALSE
HCOVMEDMǒgtfHMDxóazùaEǎQJf	FALSE
IbèǎběróaEmYǒǎièFoHǔdQEǎěk	FALSE
JddnúImbugmPGIgLúYDDFAúVNN	FALSE
KnHSCJóPjXúěxeGpZtèAúRvXKM	FALSE
MHéNábhQnLOhBswPPTOuváèvùo	FALSE
NQǒRacRYPàǒéjóGFavXHèiúTCK	FALSE
OvMAkNTVqqěXSOǒéHXrCzeCCQò	FALSE
QézqrwTáqRArjRhRGvHlěHtpUB	FALSE
RNYBLLHMsWYéFYoMxgùlSJvKuE	FALSE
SbyùáǎaXwMzUfGrěCFpfiqGKBg	FALSE
TyQǎóxByjZUyVvPXásùOdqxOFX	FALSE
VNbDiuKgJyfwbdòmBeábIWpvUM	FALSE
WhmWKCXKǔkRyXuCkǒMheYváqnú	FALSE
XyéXtqàákevèèPqGInaEEQòZBZ	FALSE
YzútHqoYnóódWYayDKúpyJóCll	FALSE
aQycarJnuZNvLFájewURGjlGfU	FALSE
bkènRóVQasfeGGgbwLMéòCLǔuu	FALSE
dèòSbúmujHwOJitKTCGbLFcQPj	FALSE
eJCLOYEěXvRióyoUzFcPáèéDGr	FALSE
fméándPóQucyEúheGsAǎEzxoóJ	FALSE
gxcMWPDsǔàQYjdPVéyjěJqóóuQ	FALSE
iHYànfNxKvEGrZKáéIqVSATZpe	FALSE
jJcNiáXUoěTpCénrgvHEocjǒOM	FALSE
kPHjEHRwNoúuEUONnùbáěRěyǔy	FALSE
mùcvWòúvWlgǎVLKGNIgRZtDSxà	FALSE
nFáòAjtLǎèěWǒULJlqVIWvMWáb	FALSE
oUQWVǎèévJàesàNWsXvVòGUBwj	FALSE
piwSKnchHVmJaRSǎKOVJǒTJLùK	FALSE
rùYǒàómCaQOèǔWsAEMZKújLèǎS	FALSE
sLllHcBkOAMnvMaIóLCòáilGěC	FALSE
tVIncácùoZěqRrdGGMěCúEmUFQ	FALSE
vùnTIǒhúúvflDhlEǔkxkjnzcmǎ	FALSE
wúaftyáHǒNoQrAǔMcqùyHèmgǎq	FALSE
xJbBjǎNJulTbTxùAùǒIòémCqGO	FALSE
ylhGedpyIzAGxXǎZóFǔShSeOfe	FALSE
ùábǎúàwaubBàoaoboùqRaZúòCh	TRUE
ǔUǒvLUvóàaKMADúǔbBababMYHU	TRUE
àòjoaxUJǔMébaóCǒbalbGrǎATO	TRUE
ǎwuklNěbǎBablCaFWLVbaěTJFF	TRUE
èISáVlójabnRabǒWIuoéaHKbNǒ	TRUE
ěelóNěbnEavxúbaYbaJLoPWTXǔ	TRUE
òěCcaCLèanbóanIáyFbyEKxabs	TRUE
ǒbUUZúǎabMpPsQJaáNvPbHaòKǒ	TRUE
AǒPAFPFFYqòozaǒTbabyèabIRx	TRUE
BaaèBbEòèSaóLòRéQqbZNaOàbǔ	TRUE
CxSòvběQáVèpNabǒapbpamGěMn	TRUE
EbxeHaOIaásMbsabKnKaBbJyYm	TRUE
FiVbòGPMaéùrJbòMxabnEEtěab	TRUE
HaXbXUuKlxCZaèěUSbabsHZlYú	TRUE
JǔYCbyaOZbaCbTǔémuLtSROaaě	TRUE
KWèzKGTZbGNsaǒbaNxbaZòSWFT	TRUE
LvOběěLambDCxaxJPqZPZǒEbwa	TRUE
NXHuSaXYBQpbaàSJqyrybǎaRbb	TRUE
OzaòwbFCrabaééEQsěǎbBPjòMW	TRUE
QNkAwmbBaMxPsbaèbxOMKěXaùQ	TRUE
RlaBbazynrǔbabzMuěTUáUHogB	TRUE
TVlGědbKYBnóJSabYaúKObaoPm	TRUE
VǒcnPùpXPMabaNbHaJǔEMTǎbmF	TRUE
WQEfKXPwVauxbaǔzèàpqbPaVob	TRUE
XlYLhPRabJGěatèAxZuWbQaàbo	TRUE
ZáOǒbalbaHRbùǒxaFdOTkRSbhX	TRUE
aǎbǒěaàbxXWǒBQabmRcENRdáXZ	TRUE
aIǎwbmKaùbàǎFDamLrqNǎXbAàq	TRUE
aYwbabvMNJáPHaRbRQSěeTWCVe	TRUE
abxyaWRGǔvbréEVaQábqgDFgli	TRUE
azmFbxaǒHbúǒRěpCoqRěmaGZbG	TRUE
bFYrJaWTbtaàAIúǎbavǔúfEFBS	TRUE
bYKabRJabaògqAVojnTǒAbLMěù	TRUE
baxzǎblwaoZsbùZaXrIJEéAHiè	TRUE
bzòdubKòaZěwbáIEAúatòblaXD	TRUE
dHZFǎztnIxPRùbáabUabPSqMéa	TRUE
eaoJèabWywqwaGbSpabFxoouQR	TRUE
gMbJSIwKarDbDaboóóǔpNFUCam	TRUE
hqRzfkOIaltàbYOabamCbòMàAb	TRUE
jabJéLZaJWěysUHBLùbaTQZbvú	TRUE
láéXókAfwqùdbǔwabazDLSpěba	TRUE
matwbaNèlòvépbaǔbOǔIDiFógH	TRUE
nznkfrZáaBǔobúyúèǔúarbabDJ	TRUE
pXmCQáóNXbabóanèGPbnaPqeéǒ	TRUE
qyrBaNIlánxbabSauólòxwmwèb	TRUE
saaVǒtǒbxJéyaàzMsTbaDqbRJé	TRUE
uEzvalnǎbTapVYubnláqtMabaq	TRUE
vldHbYFZalbaQOZSèbBaTqbTqá	TRUE
wvMQǒeuǔéubZAatbàaDbRèxaùP	TRUE
yaAMzOuuqbOKavbmFasàKNbóǒx	TRUE
ùùièpxàLJěVxáEhInaJmzHTpoLf	FALSE
ǔKRiàWúkmJBtRTPmVòùWrdUúfug	FALSE
áaJMrcehTǒdtGAqYěVIúaLúTRPà	FALSE
ànhòaQnvKhhùHxNbAJeDAdòhúvc	FALSE
éòqtIYGEAběGQGXǔǎKésBěyhTbS	FALSE
ègfJùúoJveZBěwZHNFyBOQecqSs	FALSE
ěoQUsKIúYSGfszIvkcThDgnhuǒu	FALSE
òGcapZCǒfWjkTyMtpèpSVCmoǔVb	FALSE
ǒmkZSnǎXcnúPSǔòěMxFfqáákúXw	FALSE
AàbáòFbaroúǔWgpoERvKěòMHCmD	FALSE
BòAqESssIaXbUEKydbfIǒRatJéG	FALSE
CLSLBCxgxaloLǒencGkDtEzOGPg	FALSE
DWzEòekYlvuamVHHmèǎdDDǔgěIl	FALSE
EqRSèKQUoJóuIDcYNcǒàBěòtuVB	FALSE
FzQrbgZáWhPVRaáǎJxjpǔVKMdSd	FALSE
HFKMXùèOàOwawqǎkúcǎzúwNLHóó	FALSE
IRuùYOaKèèsqIZàJCQùWDYzmǎáX	FALSE
JbdóǔcéFjbnLúHDBzwcocUKNǔZk	FALSE
KyQǎbEcbèúheHZIPdJAeěóuSZzé	FALSE
MBgBDVCèDǒNDTówYaásxIQAAàǒY	FALSE
NVòhǔjǒYVEuJǒaIwXǒqsIùóLdúj	FALSE
OrcybbáKasùúvIVwxBAyùUfTZéZ	FALSE
QLWFxVZAmAjcèvéocùIǔǎmwCOHx	FALSE
RiúRxǒòabwZàSèTòaGpzKfZDmWZ	FALSE
StRhOúlóHhhàoBEKjhwCpYòèǒqb	FALSE
UútIQwèèXXsMxáGJTyJùDúRéPáj	FALSE
VXIKrrEPǔTnáMǔkZJZúiSkXěvLq	FALSE
WoǔǔEògugnyjkntHoéěyǎzmXQáF	FALSE
XxǒLòmzXADQCeDùójHvLwòiihPT	FALSE
ZGójháélJPIqpsǎeVTHHgkNYJGR	FALSE
aNHNQuQfèglóppǎfcmkcpCàjàKJ	FALSE
bdqjnaSǔǎvcIionOCINLsHúGwuE	FALSE
dǔMMUjcKxQěqdsUcmvJgHNTǒsèP	FALSE
eGOHYxVVOxǎoùnMXDRTnOxKMAcu	FALSE
fJqeǒmHrkKQITaGCùǔtwJqòKqOà	FALSE
gXIRyObèqcǎhlvMUzpfRMqrcNcN	FALSE
hròiiǒǔlprCeEZoWNbZbrJDǎrPg	FALSE
jéZGòKtVvwéKpFTǒkQulǒLQxjǔT	FALSE
kTVvùqèòaǒWbVrǒCaNnVvVǒHhàS	FALSE
ltIAúudMRCCniqHǔzjpAyěmórcO	FALSE
nòxWEùeǎǒFáéLMJTòIǒmuqèqǒyu	FALSE
oOǔǒthyzkSgXyVWóEwixRnAvNIn	FALSE
pUaGmKneawEBJGBYXWjěboFQVòE	FALSE
qpJCggǒgCHOxóRěhspDDwziqufé	FALSE
sBúyBdrkùòǒFaóZeǔǎNIQRóeèDs	FALSE
tIǔWoXqZoǎqBEǎLHmRTvWAzElDj	FALSE
udPáqdPscSJqátwOǔgXZùFbǎPGi	FALSE
wàxSOeváqJqVbtxVWYFtkfHèRéq	FALSE
xQsezěbǎAàúdPòDBqAzdFRhtinc	FALSE
yiaǎKRXDCéNZHhúáoGDGYKPWpvQ	FALSE
ùùbabèAéHFsaRrOAbNJamdNhIIb	TRUE
ǔbIaUNKàKunIYSǎbarybVOWZakP	TRUE
ámERòudPODGabNZaEùbTabedAěx	TRUE
àvIàCedKIǒaUqěGbYabaǎěàuúbJ	TRUE
éòkmàéSsarbRaSbabèùUBrmggqK	TRUE
èoHbXěEHaFbtKNavéǎNubBMawoH	TRUE
óaFbGqasSTbsatrDàxGuAAbQǎBN	TRUE
ǒóIuěcNUWcEJádYgPFfbpDababa	TRUE
úaSFnbáaúbYaàbuhógmSTgSyjǒě	TRUE
ArzúwdCBáHcèyvNDbaǒtObanWba	TRUE
CFyVmBbabèFaqTbsàslyMéauGOf	TRUE
DcBaěbRáVBOababXLGrDLǒYgcAf	TRUE
FěnZǎQYGCǒabsoaběXQVTHzVaba	TRUE
GbaEbaKbEGvTmNaeYtzEtntkjAj	TRUE
IǎòǔaǎèàbaGCbaQWnmùFóbúSPRv	TRUE
JSHAAkkdùxPkóbabaěvúllbéOaI	TRUE
KiqXasbaXMbtRaEàozbvBjCcmcb	TRUE
MHfǔmVòVGboěaxqóbJTBEsUabǒa	TRUE
NrISáPbmxJabEIGLZAěaFbJaQée	TRUE
PYkOjkVǒuǒqǒabaSlvXǒAbabAvi	TRUE
QrKkClcRbRNMGDvěabqwNaNbuKa	TRUE
SEUobaǔYmǒbaAòqXRHmTtbaEǎqW	TRUE
TaàbNabaNbNMVzǒxMxóòèSSpJNǔ	TRUE
VěGbGnsèAabaǎRoòBUòbXJaglzá	TRUE
WbzACaYèBAPybaIyJbvaóFrVaRY	TRUE
YUnMbNBDnaǔàbazObVEaèpóóZbD	TRUE
ZllcvgQQlNazbaěTCtPIbYabWlr	TRUE
aIhǔòùacabaxWlIWblDJáFaěESb	TRUE
abáaAsCòVLbXùabSbgBpùKaoLPè	TRUE
aouannZvbaZEbNKDBaòòbUoHGCJ	TRUE
bǎVaXǒblàěyEXùUabEèěZXaQòòt	TRUE
bJUaóébFabaVwbYúfCpNsWSSXSh	TRUE
bZaoMzboLvyYqYoèzanIPètGbNa	TRUE
bmOxòaRbFsGNèapbaJisyóucèél	TRUE
cbGàaàKCVwHPWbapbILaDǔúétBb	TRUE
eèBjDpjsbCaóZǎSbabaááǒEěZBX	TRUE
fZCèLùaosZxbuaWèbFóFaHbNàRL	TRUE
goQmJcbVaZqnRbaXblaEiaxueói	TRUE
iaLábuěaòbSSYáNtEuTambáVPRC	TRUE
jtvFàibZGaZxbaYRèbPyaOǎjokk	TRUE
laJǎCàvLǎIbXaPqVěyáqbqMAuab	TRUE
nGRAbEPéaèXèASòGzblraábávla	TRUE
oczabGǒGasCUbaùbTvènbLlèuhm	TRUE
qěNǎbaPoBbXǒWassbaSiiMnrùfZ	TRUE
rFbRJoUaqbǔPsBWòvEaQǒLbaeLx	TRUE
sbTúabHsssaRZùóEbLVRaXólòús	TRUE
uàapTpLóxǔEpèǔbabMDzOTTabqJ	TRUE
vWdJéaěNébèzòplabmqLabydúEh	TRUE
wiambqTúmJyabvaSábHuèmǎùUYM	TRUE
yLàYǎEbaGOYbèqaSZbxaPúgOéHà	TRUE
ùùfUFRQbyGSBKèHlEIúàPAVVScsH	FALSE
ǔGWǒBghziOmòVYgAúSrěàfxuácúR	FALSE
áTTNvjAáKoWOwàgqigóECFěGúGéQ	FALSE
àsKMVùKtAúLwóOdleólěptRPJPKi	FALSE
éǒTOóYáxfPrZqòiwNnfyKwdtyUvp	FALSE
èUGóRefàǒVBoATwaújuBòfǔèAlSà	FALSE
ěgOOzsXPNJfóGxNsYrbqòJXòhósM	FALSE
óvvgèRòioúǔùtòZèhhàDDaódrNeF	FALSE
ǒóǔWPmKǒfQLqǔáiXQiMEpKwzmQAa	FALSE
úQùDXVIFavóǔreOdKiàFLOnWǎàSW	FALSE
AcBAXQbésEbSXFóvàeeiEvajckàǔ	FALSE
BqdYǎNUalpMFdMWúwYIQyFQúvóKo	FALSE
DǎáúyhfcoàzǒcxvFGtaóGTdUEtǔe	FALSE
EǔjéYiwhnuqHjyBwqěutOǔTxGouW	FALSE
FépFHskGòzxstauaXóùFRdjqgyYy	FALSE
GQTYFatgéùNsqWRmòǒtMXURueuqd	FALSE
HmBenǎjagUmóAJécǎsanqhéómULh	FALSE
JàmbfǎNzvULJòzBVpvnEfNàPQùPC	FALSE
KJZèáOXkQKoèòǒpRǔLǎLzFmKLxat	FALSE
LUfUòèWogOùxLúJRlMCQQmúTóCTU	FALSE
NèKAiGPèDZSǒDcUááIaUyYsqVnyx	FALSE
OMégBxblmuJcvoIkZFúǔSbZùmfUY	FALSE
PWVxǎKóCfYYIMiUhIrázRffLéQúj	FALSE
QkǔǒKPhězèèjubRdJtRsfNaèHSJh	FALSE
SáqgFkBZòiPvfùsMlyYIQXiFàǔóh	FALSE
TOUáBǔCMóWspZRRoolsúohùAfKpG	FALSE
UfHXwǒǔOǎJoúxIHàewwHoZYJDLoá	FALSE
VkzqRBoǎqHwyNmǎkětjAèYztyMaf	FALSE
XúFOoRMùWflHètjPFSVewImMwéùF	FALSE
YAkRGqtoTMWSǔXKEùéòGòPqpeJuk	FALSE
ZPvJZUtmspèvEeòEnǎarPkggYRFE	FALSE
aqáDàaObòFlǔexYssrGúNBoQtrvh	FALSE
cTmtQxPMicVauBcIQbRtrfEWUVzC	FALSE
dyěObQMòMècHybǎqAZBFICǒzjIǔj	FALSE
fàTEIEVrùFnTwQOhPAATRYGQFuMX	FALSE
gMXMeèMqjgkPóàěPXnfúcJzóègAN	FALSE
hVǎgMJòòxrLoNaSXwqěfWETnRdaá	FALSE
irQmpooUDRdMGùaòBaáògwiPrFùV	FALSE
kEYpcxěSTbtfmVqaJáàRBáóRNpǒj	FALSE
lPFùǎHrlctàNǒBEéóeyMolVItRMs	FALSE
megǔrpJNcTAOkpóèBVevùCmpcSIn	FALSE
nhóJǎdsSZbhChǔcSBMXySpLKXǒòz	FALSE
pòvYwyJUèmFvXXoGcwúDbuKzFQFà	FALSE
qaGOKFHómjxfěǔéǒěZvryMǒtxXáz	FALSE
sDZěǔEOIràhNRóbbajoSxfUGELKs	FALSE
tahxqeTOvǔUvDEkVeaOgaGFQEǔWw	FALSE
usMcpmKèxWbSlSsWùàbkCdIhqCbM	FALSE
wòCzorYaQdVHgTǎióMǒgsaiécwCè	FALSE
xREKZGgZVnDòǎOděèǔJùgǎsNxéTQ	FALSE
yZtiHFuhtǎCYSlòěLVCKRtAoTnǎo	FALSE
ùùǎàgaxHǔàbnCrXanbabxYvvhuba	TRUE
ǔbzVtaAbBRǒmsabuèadWyPftKrzn	TRUE
àUéIpLTaDéNbǎPEabaMbǎXèFǒoyp	TRUE
ǎsquǒGbwǔǎxatbQsaúbRxagIpsir	TRUE
èLMewbQCabAséMBǔavbHFàoZNVKa	TRUE
ěUBbabHabazUgúLdbWtbgGrajUVz	TRUE
óqhǔnrPMáaBáasbsHabaàbzNúPNP	TRUE
ǒNròXgYòàfTADIǔaábabOalnòIób	TRUE
úhóeòxvAgsbIwaKǎObDDaàbWYMèa	TRUE
BEbUéaAtETbabTVaáEqZǎéáóGTxm	TRUE
CaSTWUXWbǒGaxuATáoYHúNùúbaTb	TRUE
EàùfcbsbàIaúDAbaǔZsànNVNbnCa	TRUE
FiTBqaDbMIEGXnYPHabxWěSuaISb	TRUE
GzbzXptGawbTaLéOtbyěùzFuǒLap	TRUE
IbJJzHPǎTuDyWaDbazIobYaATXIa	TRUE
JtbzlCaJYKàPbBZáXǒaVbmYRqDMa	TRUE
LaWQbàxSǎxJsaǒbIlLCazXvZěbJT	TRUE
NòdcdaZGGXǒòéěUbabHsGRaOEǔyb	TRUE
ObMPVtsKèEytababaMOakQYxúEOe	TRUE
QàWrKfbǒHUWsPaùbvaxUItbwaóvK	TRUE
RTóǎAocàYaTYMTGVKěbnaéxIvbab	TRUE
SsphTYDbITuúǎaEbaYbmaYvǎlpDz	TRUE
UGNaQVǒxpběóLTvSQapbZèaKQbKj	TRUE
VkóabNKOCaBbAaHáyHébvIépNMJr	TRUE
XSkbqLǎJóAaHmXUbQDaoCyébalAn	TRUE
YjwYIBubzUàJzaPKLnBbyqamébaT	TRUE
aáàBMHbaRLKoXbaZoǒǔáLxbKMzGx	TRUE
aFbúGBGQaYJèMHObCLGtzpaèobEo	TRUE
aXILDbúJVzTAqYoaNěubáMúVnxab	TRUE
alKMQbaáéOǎèRběHAGǒQSFtabdZy	TRUE
bǎBapsObnoayxyNVvXJòUóbZoaeS	TRUE
bKHQóxOabyxuTFabFltèXtaFnjLw	TRUE
baúBbòùTǔabmJaógyRúupyOMlcáG	TRUE
brNVaDXbJáKaáèàbèDěyAzwMYRaè	TRUE
ckùyGaevoamUzXbǔaóbMmaTbKROó	TRUE
eLPkLuabaURmùbYOaǎUbJRGpBákě	TRUE
fjùPnxDRPnYéùaSbRǔabǒaZbòkHC	TRUE
hIYFzjfdpAúabRRanCnbVaKKǎNbN	TRUE
ibaMébXaObaAlKUùSXocOpNcKzKq	TRUE
kArdOqBPRYKLazǎWǒbSǎauJběaǒb	TRUE
lYèRkzéZábòaázbaZóqùPbaKWáyv	TRUE
nàaLSRqbaómvbǒaQùàoàZmbnnJoú	TRUE
oOBǔbawvBLbaùMNsbaórIkEjYFWe	TRUE
ppbCtúbMQNèzPUYpzSsXabFáabas	TRUE
rAèNèbaěGFbúǒMAaPsnYuqbaéǎǔN	TRUE
sdéKGaébLaúUoEǎuáòRzPVbabeYT	TRUE
twOIbxawtbǎazměTbuPwVǔZaLyjè	TRUE
vJLdkqabValsEWbàapvWbóFbxàjQ	TRUE
wlLmAJsGaBatbHaUbopXsIabWxtR	TRUE
ybùTaǔbXěLLOlòqXPaYúbpuaXwNO	TRUE
ùùAreDaKdkyáMjWéHBMněPéǒòvòYC	FALSE
ǔFtnVèsázBoùáKZmKǔcVóǎdLDvaLj	FALSE
áeàúúTGěǎPóhǔBQnLiMòXàtWUrprT	FALSE
àordNòuúMYlmgázpyúqQjtAěǎVùru	FALSE
éáYbXěùqJJbxbwfobwulgBYeùZsóJ	FALSE
èEtlvuzBǒQDIuóYòeTǎguuSJRòJJY	FALSE
ěXjórBiUúwádUgPwuAEAlNèOkXpAN	FALSE
ówùàèJHQFaàbTèlTCpOEpVKállxWE	FALSE
ǒEòfdDxzrMǔòIQBFHPkSǎqXléDhjO	FALSE
úmCácVěQLkǒòFOYahrnrtDòAùPLaA	FALSE
AvòVoǒNQbGTiáXeǔLaJRàgPvIExTM	FALSE
CàNQdfPrpdcǒWIQbhsěFTrfNNDoSR	FALSE
DEXQcWSaeIáTxéoeGkǒyOóDwXesCX	FALSE
EZǒfTjBraGǒpBǎóhoWHtǔOvZMoPxG	FALSE
FoUcsòEmèQpókeYOlmERlwàbBEDxf	FALSE
HùsvùdnXUàkiqòpebáQXóěMjdsMiP	FALSE
IKdoEVVNhZáèRTEIǒVlòmGVoBRvIG	FALSE
JYTpělpNYwLCéègbxùépbxexlBamN	FALSE
KmiQòMZBǒBMUvòùqòhatBqlǎyZZwP	FALSE
MóyàrhRakruUQFwCěscóUwtWBGNjY	FALSE
NYEáùTHZèàojUǒFéLrubúUKiSORqD	FALSE
OpEPèzVòǔúVXeǔfàZoOHǎskKtOTéI	FALSE
QèFWWHOqIHAǔyǒTDáàSInsDfǔgYGF	FALSE
RLějvéééVvǒLlMéǒrùCbXHvévTIUc	FALSE
SdǒsáwokubrǒPwǎKlAùPPFhOLáOBw	FALSE
TquxúěmYXFnBHsObIkHYCTáipOZaè	FALSE
VǎWWgnHXhxtèQhCòUClQCZlQǎRǒxM	FALSE
WúvfòERyFVcfIèòèIójéǔpqrdmFOl	FALSE
XQTóVPàMàǎfHděQùèonBReaSQaěkǎ	FALSE
YoèérRuhpUiyǔAZgYBTgáUěOáJJàA	FALSE
aAeútmRWěàGssǔIéHjáóeUdǎgsqKt	FALSE
bCCDLmzgwXVSKuJěnbMZNSqáZRxFh	FALSE
cYáSaGlrhpújNgfbǒóJQóúaGQlpRo	FALSE
duEMvwzèMPjOBRyFxèwXEáREgCKUe	FALSE
fIXxkoáUwTDKáSwCcTOKǎPuòJsGue	FALSE
gmwMWLIDJvBǎKSEèxdǔóùysòKkGpe	FALSE
iúLtqFMZGRèjBMIódBTFUQmvUKOǒě	FALSE
jOèYòǔqYmèNgěgEǎhóAZǎtHSièúLX	FALSE
kYèsObQgèùKwuùèCǎYálKZpcóJCóh	FALSE
lrěOLXSàcMùTejóvczDdǒnlxQáDúé	FALSE
nǒMzSugéFlpèfifǔhmFOugcDOAHkX	FALSE
ocQòZàyéoDKUeByvXyMKbiǒǒKnqQr	FALSE
puKLSǎkVsVúěáyùFnKgqLwqFsdwúl	FALSE
qylUwJWmQQhWéUpzDHmevfǎLoMUXv	FALSE
sJnbRpNvpgOǒJáIQmqGFàhǒNOěAzú	FALSE
tZpuqZèNwJěxmfRBUBèFRcgOúHRfQ	FALSE
unLWzBGYxèEǒbwàUBeSeJèxCéjzBé	FALSE
wúCqEèsLTóòdMRùRyebóznYSHAtxp	FALSE
xXúseǎnèVGdèànxǎuiómCBwvjùgàk	FALSE
yihDpèKJeúSbiálajBOrnIwěWgǔAI	FALSE
ùùbsFětaoàúKHQbabaàMFOfkMuvFR	TRUE
ǔQaqbaěbaTbùǔaEEADfqQǔFGTOaai	TRUE
áwaARUZbaMWolbǎwJúOKlvaTbhàuD	TRUE
ǎYarqbQěnmtněMYBaAbaRbTEnPxJU	TRUE
émnBRGbǔúèMVKaIúCqbWVKmLabǎan	TRUE
ěǒoǔòOWabDRaYKbXéSXYaúéRbéQǒW	TRUE
ófbòmllBwéEùicabaQnbèGaéOJbYǔ	TRUE
ǒDáAúàIuebabáZayèCNèZIRUobaPR	TRUE
úWbaqpbKTápóùVǔDyaulǒzoAbúéLa	TRUE
BCZnáXnJbOaqàbOaRbǎJRmósvéaòv	TRUE
CWkXaAHovèBnbDaTTJRtbuWúárabQ	TRUE
EèEúubOaMxzGboǎaymǎWoǒbuDaoem	TRUE
FUwěvhUYrSsbaRbòXaúěǎzúsLbasZ	TRUE
HǒCabMabZlGabdàdHxqznzsǔòIAtv	TRUE
IaffUSWvWòXzvGbwUaubAHMpMabEa	TRUE
KùbFHaGHbvrYDXaébyTǎlHràMuTaJ	TRUE
LTPuUaTéèòEbaDboabàtMOfNmUJJk	TRUE
NùabpyQDáanbòxHaGbéaAoveoDaCz	TRUE
OTbNMoRqúútàPvabéaIubmQǎèaVak	TRUE
PhjàJǒzhfCNbTSqasonélHbaéǎbYa	TRUE
QzwàbUyaqSbCFòaèzbOXabBquOZEu	TRUE
SUJvvdZXVùedvXwHSaàbǔJvaèbabc	TRUE
TládòuLTvbabSaAbèaGLfWòCxDvyè	TRUE
VGHébQPwvFQaóIqěvymbaObadfaIB	TRUE
WbaFXbaáKbDZBaéciHGGDpJpSDéPK	TRUE
YǎOèWǔaǒboěSǎnsòabaVrbkZDxòxF	TRUE
ZbZbLaPèběémèèJaNEFbJazQWrBuV	TRUE
aCpbAarztwbECLAQǒaKTbJbzvǔgtǔ	TRUE
aXàNbéOqóqaBbwNMòyxvDabOòUNYf	TRUE
alEDóbxaTòbxúWóaCbQZXBSZpPfSé	TRUE
bǎPèIùzVnqEabaIObCrúJakrLiJML	TRUE
bMsabaoǔrbzHNmúrQaǒòfàcIBǔZDi	TRUE
baXSbéqzYèqàaNvblaFKlNaáErAèC	TRUE
bxGTéDCáèaXúèwbzOabuúèazswvOg	TRUE
dOèbaFèNéZbIuúHXzaBwNJbùaùáQq	TRUE
euDEbnowtHuCPtyBǒbaǔqNVbǔabGa	TRUE
gǎNóPfCMbNabǒIaJUoJbòaHvELuvK	TRUE
hbLNsaCběúBFabxwLòZzóoGakgèèV	TRUE
jǒgYcQaVHGGǎbNsxZtpIaběZpaybU	TRUE
kUababWCaàWzYěúéXmTùvEbáEěhqL	TRUE
lhabmJANàUPIěHaébǔabZadCtqlFb	TRUE
nàaZbabqNOJpuHHaPbpTBugxqǎnkM	TRUE
obtalDbabTFaEeoAQevzvUATZxIWK	TRUE
pzěJeujazZpGbvHyòOaLbaTbuikLZ	TRUE
rOvHùbaVAoybVúáabRwWaRPpeMwpS	TRUE
tùNAWXTVgwQǒHVDebLòaǔǒrbaTbaF	TRUE
uYkwaRnAbawUTbEaobQMǎalUòàzèl	TRUE
vnIZáJsayEbDòRYDQDǒUaRnbabEóD	TRUE
xèàIOùVdjbHtaàFEèmrbmJzaMbyxa	TRUE
yaXJébabFUyuISDYGTzRabǔimTlyo	TRUE
