ùùùRuylyKFcKéóEwòqpc	TRUE
ǔLSxmábuQfàtákItDqAU	TRUE
àákzhiǔsOùóDVúXCǒòùV	TRUE
ǎGgséSzfbwprǒZveXtPx	TRUE
éXSbCBěNěCWyNWàbetǎf	TRUE
ěàjziTEKEdbiRqvfXOlé	TRUE
óòbeegxòBeipLsizdlJj	TRUE
òGkǒunByùGHZmKéJvzVb	TRUE
ǒOVyMgNBPvnzdPJzGTjù	TRUE
úgùEqúǒUDhGéáoWézAéW	TRUE
AvzHshsDRuKUZFOHěKéó	TRUE
CòVARpǎvjqóTyDkpGAvú	TRUE
DNrXcékNcBiEgzáIpòJj	TRUE
EljXWéyáTòpvaòǎǒXFǔN	TRUE
GǔLǎZTYúnemòOXXEènòS	TRUE
HTbǎáIxlxfcóoéBàinhH	TRUE
IYVsóHmaóEOJjèhBhhDC	TRUE
KùFénRéwaKoǔsnxVàkfw	TRUE
LòLdXFúISIzAěědmúKmB	TRUE
MUcyǎvùDCHYAǎxQàpHéz	TRUE
NphHAznTXBjTAjESWZPH	TRUE
PàùRaBvGpsCoSèScnZKK	TRUE
QYúxbkuLaEàBDMnbONòL	TRUE
RktFMUbchhQMVàòIǔoHA	TRUE
TDúUcDcAàbèmxòOnúdiN	TRUE
UZWàǒEAóóWIcgUOǎHFGz	TRUE
VrFmYjfwòoykhyfMNkIM	TRUE
XEdISZáLǎTòScXErEQAX	TRUE
YcéQDLaIseVHbéQgEOéN	TRUE
ZjbUngYhYáiJIOFvJKmg	TRUE
aváRlbzoKciOúDěèúrxP	TRUE
cǎǎlvGhEdVDomgòsèyrK	TRUE
dMzfDtDiRGTgvtIWordk	TRUE
ecvzLifFpǎPAuàVLGuéM	TRUE
fgRMědDalmRǒJOHrvWwY	TRUE
hàmwkqwmuKǒááàlqHGNT	TRUE
iQúcWDZeOgltYHrtIǔnY	TRUE
jVUdnǒnùREPHORMdpǒǒM	TRUE
kvswTvsEáahmgùùXPèóT	TRUE
mèCgZCoxeTlcJátvBZBI	TRUE
nUfófàbVwǎRdbcàvǔuyǒ	TRUE
ojLgNùLHóqnUóóLàmoJu	TRUE
qáAbWcWǎuxóPùédKUcèY	TRUE
rIédgewǎáQfàkSTǎPxbY	TRUE
sXòòlEúAásgǎJDǔLAáéV	TRUE
toYyúqEsmJMMDfZCZOěW	TRUE
vòfFCTcyLrùCSChgNàxh	TRUE
wHcQLKtdeUzHhVGZtjep	TRUE
xOjSnPhpHYjnevCárKYP	TRUE
yonbéeJYbXyjbLiLwAgN	TRUE
ùùSaaHZaaqgcHTqqcèMQ	FALSE
ǔaaIèòraèGPAaóVjǒMUK	FALSE
áumihaúaLaóEOxùYLPYa	FALSE
ǎPaaZQBupùxKàYǔMrUaa	FALSE
émtkEUhuZtavúaǒaaòrj	FALSE
ěPMMDiàanaHaǎěrajQèu	FALSE
óvyTFRwavaqNJGJaaMnw	FALSE
ǒKHóSPUǒèCaaraaqùUKé	FALSE
únWBayWWwzaOaǎXěolWa	FALSE
BEóMTèhaDaéCúamaěyWE	FALSE
CWRaèsaalEPaLKBApZmm	FALSE
EǔdòàoaNrǔaóCItaDǔaU	FALSE
FKagPdaQaǎIaQLIaoXLp	FALSE
GmtqRVKaaaùaǔxhoIhZo	FALSE
ICEFyuaNKHǔaYaaúuTat	FALSE
JYǎKaaǎǒaSEaROlǔvPxa	FALSE
KvQEfijáaaǔSDvaymaFe	FALSE
MKHeaySaOèaABóaHéwyL	FALSE
NcbǎkaǔmóZUoQaòCJana	FALSE
PGHaòúUtaéaKPaZsoBfz	FALSE
QsgucaaamzaàiHcEyZqM	FALSE
SHhùaBǒsaaLzpMòSazéá	FALSE
ToáaěanaDvrajpDlzàVz	FALSE
VanYayàXCuNaQSaoěZLX	FALSE
XèRYHEǒFóKaaNWayúNóa	FALSE
YaTaěpòaBYraUzPcvaěZ	FALSE
aùaFBqDésDaraxluZbvě	FALSE
aǒúmTawùsǔòéaagèIYTH	FALSE
aHBMaKaULalǒjǔáBjFǔU	FALSE
aPVòazMDZěWyVyamaEhE	FALSE
aYaáUJVàSoMmaaHúgolt	FALSE
aaWsqsHQROZUCQazěarZ	FALSE
aloJaòtaaLPeTnNdXIyA	FALSE
avraaèUGOLTavzOsJànà	FALSE
cBBwójaaazGGGCóvCòBa	FALSE
dTMYjmPvnaamIparwaǎǒ	FALSE
eqemaaaéamjbbákKiǎCh	FALSE
gCǒVavUaèztYǎYyaaxIó	FALSE
hTazéqaaFètGwazcwjBL	FALSE
ioaěazstSUBzěoWazajǔ	FALSE
kFèKúkúaaEaàQplvraWK	FALSE
lipzXǔgkcLxaěpQLaDaa	FALSE
nHFěùDJpòozaaaAExàaD	FALSE
pCSdjraUaAaadéNKKCux	FALSE
qoovlǔAvùataIEaaaTyě	FALSE
sEihtaOaMLǎLaJJTaǎOu	FALSE
tayFaqazaKziStGzKbeq	FALSE
vaCxaǒILaLxDóaókJoúu	FALSE
wsaSǎOvaZaXaQXǒSoKTú	FALSE
yRDOnNGuRgaǎgaIaSaaD	FALSE
ùùcAmEDDgéhTIOSAZùMrW	TRUE
ǔàòàXCiVKRSBRzGWjáMOW	TRUE
áFoěǒǒVjúTTrcOdáǔáwdl	TRUE
àVǔRTOjgòVDběkgDfkǔqA	TRUE
ǎrbǎYnèWjthojǒùNEuJěw	TRUE
èòAtZlyLKáOTòoǒxcùZPě	TRUE
ěDWPfvcepPùOnUòeseXQD	TRUE
óWLFúùvHCáCtáOFRBèCfx	TRUE
ògǒyúyDěQàvRlWHéGúNǔu	TRUE
ǒuCYpKòniMqNáxgùUǔOGa	TRUE
AAHéktoVvvǔEwNRěxúIpc	TRUE
BOeKVdsMùcMOQěXFOósZK	TRUE
CcqǔǎtTèùoSNéPRoGpzuě	TRUE
DodhdkVTkóvPHNUFCFbùo	TRUE
FDYóěǔEǎBkoFNhIùFQpmL	TRUE
GYiǔqpCOhOèWtfsùMRxKè	TRUE
HfddtdJVKIIkKááiRxRAA	TRUE
IqzòěnYééévùNáArniMJS	TRUE
KúrTZcOsyTèXuZfbWǔnAn	TRUE
LKádvJdBfhbDAMaIeoTGP	TRUE
MeXTǒXYJaǎTydFkǎUlsQs	TRUE
NeeZdkcPFàǎYIIWKCRxrf	TRUE
PùHzSéCyòixIKVěyBFeàq	TRUE
QZIǒgáfOoKěxESlPUǔTcé	TRUE
RiBoNhUjDěxáPnJXDJQnI	TRUE
SyIúFXYMTBxǒOQǔkIHzyT	TRUE
UKJYùYàCèSiIùnújuuPǎB	TRUE
VdetUgàǒhǎàYtFèUmǔbòf	TRUE
XàdmQSZěMLLDgúMiBǎDdù	TRUE
YWónUuvZUàotéyAèxVnqg	TRUE
ZkgsIǔpàěupMòéXvxJěuM	TRUE
bHOHáǔLnPkQBFaǔMADèég	TRUE
caUjTCeèJTǎvOYraiòlXE	TRUE
eùàévápxOnPkCnUAblSàe	TRUE
fOòfùSRHHCxuRHSeuErNù	TRUE
gsòpgózwpeǎǎcDhUSZBén	TRUE
iòrUCPlJaSléPwJǔǒgotG	TRUE
jútOvKoDGYùZáZCeòxUCH	TRUE
kbHNòOkKpYqmǎFQZblúWv	TRUE
ltpxSjCgPEySXFlwBekJG	TRUE
nIǎcKFáxvèCèOigKǎLSpà	TRUE
ogHfQǔǔHqzJóbhsaǎhVàb	TRUE
psáGumXsufioaVjzLVpHa	TRUE
róéZufbUPZITrADGdàCQA	TRUE
sWwSnvzztCXTkrjAOIOyf	TRUE
tptxAAplrAJkkNnNobgVó	TRUE
věPrGshBǎLLéXxgLXTGpl	TRUE
wPyábCSpCgGǒVkYOǔǎCaJ	TRUE
xPFáòèROMsbynzzúéKTBB	TRUE
yhjaPqtoóBedOOMYRjZEv	TRUE
ùùjaPaaQYáaBJpsJpwòGB	FALSE
ǔGgyQdVdxěpaaZèòwaacT	FALSE
áaalùaaPiWèwéBYàqiaXè	FALSE
ǎàyúmhqamaálǎèNaaèǒhl	FALSE
éZBwnHJaLéaTarěPùTaco	FALSE
ěáwydENysaaamàpXǔèUaě	FALSE
óYsaNoZOYaRaIJRQóauǒx	FALSE
ǒBóbàaOǎaNNIGóaVùLaǒP	FALSE
úarGOVàMMsGaUzWoBAOaa	FALSE
BǎJtcGjaINpaaPoOǔFaKa	FALSE
Cděǎapmàréoǎvsǎraǎaǎa	FALSE
EBqaKNoéaanaHbtèBowJB	FALSE
FaTùTPmrsIgicJIGaaaaF	FALSE
GuaqaaéóDězàwGxaHKojv	FALSE
IaàaNCpCóaLHJIKxǎaLZǎ	FALSE
KùgQgǒóarSaqaGaCéègǔJ	FALSE
LQúpùNaNaENǒaSLǔòqaèp	FALSE
MkHlaaunpYssDVruCavag	FALSE
OéefjKaQumNamaWaXròmn	FALSE
PSórFUmóóaPàSwúXMùaaa	FALSE
QxlaàLotqLaqMGHHaLsDa	FALSE
SaaaxAHpástRaxCzbMècD	FALSE
UóXéayǔQPlZmvǒaaafYdn	FALSE
VawkaaúJZEaalSNùàUgaA	FALSE
XCOkvgNBQrxǔaaXrrTaao	FALSE
YayOGúaùWUrGaKackCEoZ	FALSE
ZsaaZpAóaPǒyKraèCayúv	FALSE
aúXkmWcaòPlaataBòCǒWj	FALSE
aJarraaEvFǔwězIswdàQà	FALSE
aUùOaaYakxhfqáhbNtafE	FALSE
aaJáQwoRtǒaPmaáǒvNnǔk	FALSE
agaJAaarǔòXUěéAPúèlar	FALSE
atpzKMěnaOàPaFFxZahùP	FALSE
baavàěuZnLaǎsmynúDaěD	FALSE
dèSayQǎGóaCrtáCaAéapě	FALSE
eiYsaMrPàxaměarKEròJa	FALSE
géznamaOúappzYrDàAaěH	FALSE
hXoàmpǒaKSPpàwKèxapaa	FALSE
iyDOumKaWaPǎryaajFczá	FALSE
kaóMBaaaèRYáDLqùiYqSM	FALSE
lzmujaaSLWómúsxóCaèra	FALSE
naúzaYaOòǔxGMaBáojnwA	FALSE
pǎtXǒnQBaUaaóarggǎEJò	FALSE
qOàǔBaǒǎaaěoWEaHLDupS	FALSE
rWuówbasrKaèaqaòǎèafa	FALSE
sxaEèXOamLyǎYuuaǎEaGG	FALSE
uaGraIwzZǒaaalIòyéZRC	FALSE
vrHǒoPfFVaaóYOóaajRjo	FALSE
xCwtEcatòazúCǔBaZaSèT	FALSE
ybaKMaǒGúéaFaèWYvkNoZ	FALSE
ùùàùPsITèěǒáeMqYGMbroá	TRUE
ǔTèpBXjaùWùqJYúrwaGnzá	TRUE
ádéVGtmWesvǔDóyIpCObzj	TRUE
àsǔYdSǒdǒúWDSECYZbébǎk	TRUE
éMásTzyWúZùsědKlRWiYJK	TRUE
èaóǔoSnyozPùáòéprǔLdyS	TRUE
ěrèllrěiejlòyJabyfwCěè	TRUE
òBciógéúmpxHhásxóqyHji	TRUE
ǒSYùGyùnòúUěǔkǔtióùWRǎ	TRUE
úgùcVWwmvùJVTNKwěSdSlp	TRUE
AwblYVoPFBǔjoaAvèǒGBrt	TRUE
CDàgJDqòXbGXJtxHINvokz	TRUE
DXCzAcěqiRThdǒKǔJrǔknU	TRUE
EmǔǒnNdèhlxmRigMgzàYxf	TRUE
FoCMcDkGxfxgkxLùjfǒwiǒ	TRUE
HèyEibXòéuupmuùHáDwLQi	TRUE
IhpDhMsgmDbPONèLòmwPZó	TRUE
KèúJCiNtiùhxèXèètětǒOv	TRUE
LSrRMKzuàòwCSPkYGVMàEP	TRUE
McMuXQpGóèjSRfHMǔúBOcj	TRUE
NtaFNvQPaàrGǎúugGBTàse	TRUE
PóyEDóBgOQFRQúmóYáàvJp	TRUE
QIOieéWòjfTTèfzKbàtEèS	TRUE
ROXtQjAvgzKyOFǔiuZcMLk	TRUE
SdMGZsrFBEbIuIǔJgQBPVW	TRUE
UǔjLtOlXKKóMàpsògàáLRw	TRUE
VHCZwlqwHóHAóBWégCOnóz	TRUE
WSPOXTóSfVbEIzdYòòuVcD	TRUE
XnxdǒxUpNjSNNOěUTJdmpè	TRUE
ZǒGáTùmxmyGWeQóéCAPJzú	TRUE
aMXPxZùmFgaxéějeáQàxǎǎ	TRUE
bnLERsyǔgBQàOfIIǔEVógB	TRUE
dàhpfèNIeòttBúpQúAbCwT	TRUE
eMáFVyruTBgùzynuKwMbǔb	TRUE
ffUDGùfVdhfRàJUzHPNLpN	TRUE
gyáNBěǔEùJVèKGeSúUzeyU	TRUE
iòéNsaáDMèvǒěbWòhKióoU	TRUE
jFàqWzécuLUDóHxfCBLrQc	TRUE
kbowXǒaagúMboaǒZrMWwUr	TRUE
lpjQǎnùcúQxJMSMjGhfBDf	TRUE
muKkjhUpaKmàiVcgYLXěěX	TRUE
oěBHeTFiMRmdnkCóéeAèás	TRUE
pKqmTGyWbeqDvúfGPcxXsB	TRUE
qkǎBqZxsOéGILàNhezjCsC	TRUE
rzfòqpNbrlTKcúOahǎpryb	TRUE
tEHèexǔFBoQNMbmghòPszn	TRUE
uTCbYhJhLzvsmàXRúcwAUg	TRUE
vqèǔEBBXIèntqùHZsqFfKj	TRUE
xěkVlkYrkuQkcklHbHàVěU	TRUE
yRSDgJZSiCdǔXKEvěCopuè	TRUE
ùùawWaùmǎaaPPǔèkóKdGBw	FALSE
ǔQCóáaaaǎéahǒOùYwyWTTD	FALSE
ánfWSóRsěaJEDJaYaCawUù	FALSE
ǎěaIǎaLGqLěóBaZuésHMMa	FALSE
éhtùaróaLEaBzéIèyaǒWpC	FALSE
èzoúcIǔNehfhévbaaaéaKp	FALSE
óMaaOaóasOZtděàIxóUTFG	FALSE
òsceVxkvGǒZrIBbaauaaRq	FALSE
úFxBTaJqàèaǎaKèVaKSSjb	FALSE
AvayrúěQHǔòaǎpAraautWu	FALSE
CJtPǎAfTlaWVaNaxuapSnp	FALSE
DvHbvQaǎYSaFzqaTZxòPan	FALSE
FWavTVaPZnǒaEaáóáabǔSW	FALSE
GuurXkaXKaKtaSJǔTRaváú	FALSE
IaéAaAHaayJCWnCàqDxIfQ	FALSE
JwyǒáěWaQmXaAaWaàySéPě	FALSE
LaPOàINNéaMXèlaFaOùéfM	FALSE
NAmóaauXwaPDnBLGòùaMmv	FALSE
OaaPmòǎúǔpTLlzaaáDqúKs	FALSE
PyREmaaaapǒSHuVBwóUonp	FALSE
RGǒYLgrGAQRdBWaaaEaOQX	FALSE
SaTsQanXaGàěCMóXESópVa	FALSE
UádKaaatCntYpuaóéhòCes	FALSE
VaAǔDěuaaIsàǔTwxaiRoqo	FALSE
XǎKUèVaaWowwéVěazOAzěa	FALSE
YaARèVwEuMaHHǔXaafbòǎd	FALSE
ZuljaWsXIaVǒaJGTaáTvèP	FALSE
aǒRaaapUeótiOIóruOHxoE	FALSE
aJaHóYDazaaúeLwuxWBóQj	FALSE
aSZaaISaXIùPANǔsJqpùJx	FALSE
aaEsRararuMóPgùnocǒàaP	FALSE
aaytyaImaKQùBUAzCbàKhF	FALSE
auAuéQCzsyVtàléqVaaqap	FALSE
bcòoúdszgYalaǎtPauKOaQ	FALSE
déòNoavtLtǔtnRaaTǔaǎYT	FALSE
eaòKLzaaNéwunaNaXimuRA	FALSE
fdNázRǔSrUXpaènaaagǒLb	FALSE
hówEórxtàGiaéENùWòaata	FALSE
iiwTaaJYuMáQǔaAzUoYaǒó	FALSE
kóitSZeòEǒSaaUaEaFseRi	FALSE
lLUCyvhǒèbaaFsésXaǔTěa	FALSE
maaanpEQaVlQkawjǎMóWdi	FALSE
oúHǔfófǔUEeǒzDàMaaoaaN	FALSE
paàUZěGMnaaIDakǔHMndòT	FALSE
rùAàlufayJaSúWaNPqEaǎU	FALSE
sauIHFpXqaPnaaùczWfǒLN	FALSE
uEAZQwYysfoAKhatòaGaàa	FALSE
vaZaJsaKawDhANrZǎByǒàǔ	FALSE
xǔivchXúaoměXapaaHAiúk	FALSE
yarèyNHWéCéaqUNǎXQaòaú	FALSE
ùùONKMtWHJsǎNctNqyPUCjè	TRUE
ǔCBHànQǎuUEckǔmoQFRnfEL	TRUE
áVpZMNCJYwZgPEriahfmájǎ	TRUE
àYeXǔSUòVmZSiméòYXátWǒe	TRUE
ǎpAgěZbnFoùZéNèǎirKNUGd	TRUE
èěciǔDǎkKhxZLplGòdécdoE	TRUE
ěNEAǎKǔLgǎeùKǎSjcedrUeP	TRUE
ólMòQákkZaTwàHUWcQNRDǔó	TRUE
ǒàFnúDfǔùRfKózjILiàNlèV	TRUE
úFQfBQácRwYCHéWcKYHLǔhN	TRUE
AIBleMXDEJIóébaUiùòCdlz	TRUE
BnZXAPèaosxFadlzHtǎuhOS	TRUE
CuàDHNàOǒWtvǔTYùětZkZxT	TRUE
EúFiòsVkmtECHèocDàDbnhz	TRUE
FHqueUtófzocIDuǔAókUxGm	TRUE
GeHIFsHkóàVgJděTZPpIvxw	TRUE
HiItpDILmjntsiSòPxtPcVě	TRUE
JùXrUZěmeóqCPJzRlVWIàiB	TRUE
KǎòTMxosamiéppwócRLkTuC	TRUE
LRàèKeEǔUèmàCAùǒtIEgHCs	TRUE
MpQTYǒfětKEYmKUàNěPádbO	TRUE
NwqZtNjPMCvaMkùqQwgsǎhD	TRUE
PQTVLáàcZSǔJǎeNNnǔXlbyN	TRUE
QhHéVqBvFhHoLáǒwvFdGódC	TRUE
SǒěǒuǔcjòébRěxalZvzqGWi	TRUE
TjwVbDqěSaUǔlǒdZSwdyRèF	TRUE
UoGEeExěDòyětckWsfXvjlR	TRUE
WèLsvDtrgNtáOgYěVUkǎUòá	TRUE
XLGRooHivRGxWèQáǒóxkswW	TRUE
YqTZsEYUtPHMfEZkrDaoqYv	TRUE
aépKǒbxèxuzPGHPUúǎsOǔXs	TRUE
bCuMupeLéPFJXEsAPǒǒrxRM	TRUE
cRCHRàiTòoǔkdrGXIdqKZSb	TRUE
dsRLlWRaOhǔFvlpWXóèKRzx	TRUE
fBǔfFzzóNàmǔPcHúNgLwUUY	TRUE
gWLsòqbàYòKhpèJUèsmèPMv	TRUE
hsǔiáurXxwDKǒAWrJNclRgt	TRUE
jòBLgkRéǒbZKfAQlmZFǎWiú	TRUE
kYGMyplqYàěRWPVuzXSàkZt	TRUE
lweAyRvCúTWXǎQzǎpEdèYWc	TRUE
nǒzQHoDNvEJIgMaxeGctvML	TRUE
oTEnUzJvpxZyDUoHSJwbHéz	TRUE
pgxTWAvěHRDybiPRlògCéeZ	TRUE
rěYǔèTzXPàHIqcTěKvDYGst	TRUE
sLmqAmJafEepeúPqRxZVoKt	TRUE
tRimǒúryáRǒVQúMAúDéEBAx	TRUE
uhIǒMgWiqwWqMkaWIǎǔNWWi	TRUE
vsBaAEaFJǔòcjáúpItSbmAG	TRUE
xàKnǒBùvKLǔgúwOqěfkEHóO	TRUE
yXùjráTBòRrgrǎHpwxJYyòo	TRUE
ùǔqhǒaaaúAaiǒàBqBNaGPǎT	FALSE
ǔEGYiazZuQaUóaaǎpENlbon	FALSE
áhZUǒUaòaEtaótKúajCIǒRǎ	FALSE
àywQǒaéNTNqDáraǒCETaǒóa	FALSE
éQMSNCútGaRéXaèóGAaPaLg	FALSE
èpaòPaQaMxsaMwrjXWvjàYX	FALSE
óaIǔRrNUàrnUPwúauaoǒǒaO	FALSE
ǒǎújayLaOvxlwEaZéaJYWBi	FALSE
úbAyaJDJatPvaOaQXYiǔqěk	FALSE
BóEeaaILHFaaVyUúgIfnjKǔ	FALSE
CuXRCúDaFPèaMIzaázèFaLp	FALSE
ELZYfaaóBaYaiùéméǔTQzóY	FALSE
FyǒVpEaaáHzIVaMalVfeKmc	FALSE
HCǎRQaùGYYCnMTaòèPaFǔaS	FALSE
IYjVfxcbQBvdocaalNaCaJZ	FALSE
KàOEoCváúěùaanapabCùPsn	FALSE
LFsxdIQóNasúaaaDJCssIsG	FALSE
MVauéFòaapaEVětnhEetǒWs	FALSE
NzEBpVmFàLdjaasnIMatúar	FALSE
PQFaaIHéǎaèYaZNVeuMózIK	FALSE
QdOóRTXaNaǎaaLǔǎvEáǎǔék	FALSE
SKfaUpěWrpraataikKtkǎAd	FALSE
TaFùnùòóaYlrétǔNaOaběLO	FALSE
UwNqPhcǎlǎalaOúoǒRaBabg	FALSE
WByPlaaaOHQùBaRkOQpXǒFX	FALSE
XmBhSDqsKeaLóRèaaYxaǎhù	FALSE
ZWEcCTXgùPRaNMaIaWaNegp	FALSE
aěPBKaǔYaaOlHǎwWeDjeRǒD	FALSE
aIQuěqCmRvEàaópóatacǎtL	FALSE
aVXoaǎaAESUansòPypWděúě	FALSE
aaYǒaAynHWXanóòàxPoSóùt	FALSE
aqaJaóIagxǔjYèóUDVObàIF	FALSE
bKvZXizdOaauIěDaFaòjQWq	FALSE
caaaaǎcúbTěSyrxIRZèQóèl	FALSE
doAVǎarèZvlOwawéayéakDj	FALSE
fùǎGZGaaǔaBCaǎhufvánQGo	FALSE
gPúiUVZolalaOxaǒsaèáPIB	FALSE
iàIúKaHàaóNsYRLqGaTmUaf	FALSE
jIVáMmdDCWavLIòzPaIaaMp	FALSE
knoèaúIǔáùaaùUIWrNLaBòp	FALSE
mIJaǔWxéZZaFaOagqMdbvǔx	FALSE
naùPòSWorQěǎaúYaatOKUéǎ	FALSE
okCanèòélPaaòazlIMwNaha	FALSE
qǒrZjpgàaavǔaUvahfULěSX	FALSE
rTRaaHDéNóMóZwZlTaUumYa	FALSE
sxsoyBrùJaaSJúOáázaaalj	FALSE
uaxLwNmǔáaǔoúaKoalgXrNT	FALSE
vzùaBOaVòaróaòDpBáiJHéD	FALSE
xRódǎmPmCauaBGtwBMaúaCq	FALSE
yaVaàaqBILXTaINXqdiDZeX	FALSE
ùǔǎsGwjQQVVtziEZSghqiDKj	TRUE
ǔócefǔǒoeAHJwteGwxsSQiqV	TRUE
áOJzZxtèwéFbhXVGupàRhǔFv	TRUE
àWkKWNOóKaoMEjUbùQoqáuOC	TRUE
ǎuVlPgFYZJǎXǎúitcTtgZdbb	TRUE
èǒǎnPRDpWDsSSzRhfDfPKgùQ	TRUE
ěLTAtFZxlrzpséhlpsgHwoqj	TRUE
óecDqcVkKVǎávSUmurtTàDKè	TRUE
òqzMOJTéOSyCFtTǔroeJòDèM	TRUE
úIóUVléLHEljLzYǔsAnlTZgá	TRUE
AYhxWHbHáMBCeBmVXàtiCúZL	TRUE
CǒIóUDěǔJEeyXǒAVlgbZYVRc	TRUE
DUTgOBabǎffáKùEJXùQPùeěn	TRUE
EtGwOKǎZèlèAQVbVxJmtWyJC	TRUE
GèòaEvxJYéIPùzTáéFGBGQùú	TRUE
HYOXòVáóTfDNSùGdBsJOWBúU	TRUE
IqǒMDUSMYNeWmBuáàIZeNjóO	TRUE
KèTxCgvPèPlCoXRLAAmgyjmf	TRUE
LMáUmáJòěkNóhrhgVhùOAtKp	TRUE
MXRkǒCrěajfIIKEǎsVǔùNǔjW	TRUE
NpùjNhmXólVJòSpInCeREuéB	TRUE
PámYhPqAlTèorǒWǒLGàJějtm	TRUE
QRàFSdshDáǒWXZàMóéWaúáJF	TRUE
RqxgErpMYǒdDSQiknǔHdyQxf	TRUE
TǒpMFBǒhǔdcsrKeTtwǒsHVBU	TRUE
ULdtùPohósálBvmLVxHyxǔsP	TRUE
VTǎběúrNETazùlSObSWmòRbh	TRUE
WlǎCeYpPTgprénmPéVyǎàDLo	TRUE
YáRfROwQrBoFBbgóoZEsGLIN	TRUE
ZKcnzYxbicòCpeOaFBKmQcúK	TRUE
afMVvòXOeOXAǎiHEǎomSWfjs	TRUE
bròZékvWoCZèàJògYKěrtNjY	TRUE
dòúdoZkoeòKtypmpeeXòbqHl	TRUE
ecpgaYlPǔxheèwGDRRzsEhPi	TRUE
fptxPigtoqKAWSEOzplBNhUè	TRUE
hMèREyClTHAǒtOykǒupwolól	TRUE
icyzPVWfòúGCgRbWWDUPǎZAY	TRUE
jtCtTDdniRXhrQKpEkokòèzT	TRUE
lǒrWvTULluUǎùNsháNaIVdAU	TRUE
mJěBzNLǔZxgghKIǔiFtwFIyE	TRUE
nSYfáPàJGqmlOúBZvEKnNJǔc	TRUE
obiòRwQxǔgOùǔNkuPRBAgqFK	TRUE
pisDqéjLAóevèZaMùqzmǔvác	TRUE
rúfǎKkTCrKàJPULrUEiǔjCbj	TRUE
sRLKAUwsUVórvRbvnYPkǒAéè	TRUE
tfJkrJYLOóǎjUHǔVWFIurNmǔ	TRUE
uwòlXwaiòaoòlǒòMùdǔBcùWA	TRUE
wMJKYúpwěáwGèZFnmEjǒAcaN	TRUE
xoHiùWCcOZáǒOWSKZIzèyhEH	TRUE
yuHQVPFYEHBZAHJHScGmǒòèò	TRUE
ùáKhRvCLiaǎèaWaaLéoPWqsA	FALSE
ǔWwáHěúXNaAaúaFaGxMaZIIM	FALSE
átaaNyxCúxvǔUXùWzpaMaePě	FALSE
ǎaFLPasaaMqùkNHùGtoUKmQw	FALSE
érUaaTáaaǎùyHhRUiàZYgLbé	FALSE
ěONfhdUFaúóaPPLaDáDXòqaǎ	FALSE
ólòmoròǎèùnMlòPanGAaaSUa	FALSE
ǒZúkHAaaSUnXZIPHNáaawùOé	FALSE
úkaRqaTwaoaTzdRZEcHIrxzx	FALSE
BǒkbKLiéPqFlaaOTJaQDOzWa	FALSE
CYbYaaaaZNúBvGXCédpLWJàO	FALSE
DwEUgQpóriRkaDaéROKWatla	FALSE
FUqeóaGaOǔyúUaTnóZacLsěa	FALSE
GtawaněYnwamIéaǎkPQTkups	FALSE
IJUDaalZKúOtLàHaYaCWzBdl	FALSE
JqCzmarMMaAǎYxǒsàaTTRayM	FALSE
LHKiNaaoataáLlPDybLáǎHúǎ	FALSE
MnJúASǒàFaǒUXDèWrxapaaYO	FALSE
ONushRFBaaHyoQXèaEáIIQOa	FALSE
PeIpoěfYbaaDLWmvEúZaaqYò	FALSE
RèèdGxTaPáùAtaAJaòtaètVb	FALSE
SKraBKaòTMaqvǎNppahǒMZEé	FALSE
TmFěsgǔuaaàaGacPěKWTNYFV	FALSE
VǎsùfxjpZwúaNBQaLDaàMpNa	FALSE
WRWǒúápqaTuyrMaaxVaijàùá	FALSE
XlkaLyWaěmǎQaGaCòpQYXZLj	FALSE
ZHApǒrpaaRLǔéQlawmMaYbTǒ	FALSE
aǎRaaZVùěaMTóDCaRUóTùàjR	FALSE
aDmǔynWǒDHVpaWǎBOyNaGaIT	FALSE
aQXraaavKgIIěHǔUéVROvbóO	FALSE
aaFáasRwUMòùnòéSHFǔyKùaé	FALSE
amEéaEaYèvxGDabùYǔIAZéjg	FALSE
axaBZRsaNsrTraqǒyRlMYèaó	FALSE
bzaaEpDKaGSzaiágrsTJXúuF	FALSE
dPUxsàaèIlQlaaǔaSwěmpqje	FALSE
enaàUZǔBKèGxaZGǎapéBIaǒQ	FALSE
gǒhvJdǔWxǒaOwGNaHòaèIMza	FALSE
hWùnBàǒqpUPaaaLuǎBaHzGjp	FALSE
inrhMècvGaúáJǔoaóaaFSùǔY	FALSE
kóVaawNùZaxséaówKZuAKzúù	FALSE
lUyaaaahówùúxWèlcùaàúhSz	FALSE
nàkMOGaaaayEjooǒAzwxlgPS	FALSE
oaaxHèGwaLMèHNoùùǎaùfXMc	FALSE
qàAéynHEaùlaúaFaCDáyXPěe	FALSE
raòánxYXaPaHpaxNRQYKoxpg	FALSE
sqTbPXDějoKaNHaúaoaéiudv	FALSE
uěaYZúnKLryxaZPaFǔHzaafè	FALSE
vqaEaèáCǒGǒWaUxYaWhJmPóG	FALSE
xóRòǎóèyamanMlǒǔlnvnaara	FALSE
yVVyaaAútaxFUqúaCrǎGyCNl	FALSE
ùǔpajnUTjǎnějCTǔówsZjúzAN	TRUE
ǔTzquOEGLLvzMAcMYzóNobOdC	TRUE
áfkVRQúpǎwNmǎqAueuYqLxPGW	TRUE
àymúuZIHěúdaàAEòSGVIovqTE	TRUE
éAYLwqLǔkégYjNǎPQydRbóaEL	TRUE
èPfmóZòwnWrxPdjlZDùJgJxěo	TRUE
ěrhNwpCntBsyyYzgBMiRPBtig	TRUE
òǎbǎòBQfYvhofTùiěDIBAAORn	TRUE
ǒúTkùDǔyòDaZIquóétTrbjǔOv	TRUE
úTqNEǒqhuxqpeJQGǎǒrtCcLfh	TRUE
AXsxpòósDWEnzóKrěMIǔdǎgiq	TRUE
BtǔOxgěozsSpWEDkNúGxGiatx	TRUE
CyàZjdkmPòúbCtTǎSaCttjjZB	TRUE
EǒBppùarYǒlyGéáǎWMFwBupjr	TRUE
FCQPmSICoVlécNZwlksùMMZáW	TRUE
GeILtàcwZukQJùrXIRèUehNàN	TRUE
IàVàJrfátcǔZuèUàBáZLùwtQo	TRUE
JKěǒTakJQyHOBlòsVpùKoǔǔlù	TRUE
KiciGWbelBiqeVopiRsfpEkMc	TRUE
LxáàEèàfúNkBdǒiahmáHèàPEò	TRUE
NóiòèJcMvhOiyWywTZjtHWǔǒm	TRUE
OYwOTùCGILIMiCeHGVǎáuuRHA	TRUE
PryqjRěvVkkaǎZeVJhǔjcNǔXf	TRUE
QoPKéOáWERsTHpRDreLdBSHrB	TRUE
SúkěQXSYDTNPúoewhuMXSHmYm	TRUE
TXhvFǔcpǒRaaXcèssěOZHDièB	TRUE
UecòdPwNIǔRcǒyACnRDUèYáòO	TRUE
VtózgsějNIáOòOREXOYKMAhDh	TRUE
XEtùVùòoWGěmVNOLéRJFxAěwE	TRUE
YUmJjmzQqěUAHPhMcóuiùQdǎX	TRUE
ZdaWTtMèXxVBJéBCvzelèFPKT	TRUE
axGPǔòcGěxǔùsgpmhǔvLIòlHv	TRUE
cJysFvwDCEZdlbèozúqfZKDHH	TRUE
daQZéWtěViHIkISHEhRNFtKùb	TRUE
etmDHǔrIqmWěQHMGZmqákGixs	TRUE
géoKBǔHYbǎěoyHZmzRgǎùzWYé	TRUE
hRweOtkǔcPAUuWùCfuoPèxZEY	TRUE
ipWUlǒNWELtOqóPHvòuèPuiZò	TRUE
kòDqhYGǎOòǔgóiogsCPzNMaqp	TRUE
lPnùluAfúPvWSyoěNkCqTxciF	TRUE
mgnqIvǎEòwIClùFvóMLǎǒùMGZ	TRUE
oělMòAYByCXxqOrtxiRòBykLE	TRUE
pbápIRSyěEOAHùoOSǒogXǔbIà	TRUE
qpóDjWYJzBéǔaùfUruNZauóTǒ	TRUE
rvcPWkQukQUwdnRLBměXIXeéa	TRUE
tTEUǔààyGqElòóEuAhBRyYLXt	TRUE
umCIwXFKESTàKcnbèNPWOǔAsi	TRUE
wóǎǔQAvVwDzfdLayòréTùMaǒò	TRUE
xOzioKQCòUlǎCmWsScusmPFPǒ	TRUE
yXfěòwRixcNwJeIMsqNfBneeà	TRUE
ùǔRBméPRFaMPéaNtáQèNaQùay	FALSE
ǔaKcyMaáaèazaIMWǒyǒzVǎmbV	FALSE
ásaaNTvaacBpěCkpOǔputRǒxC	FALSE
ǎSVunUwLaNmàǔKaEavAaFàùuò	FALSE
éaóHǒRaàosmKKvarUxCJafWZk	FALSE
ènXSHaGrHLaxFěaQósǒICaúoh	FALSE
óJseoEaèPuaHǎòKEaǎuòauEkj	FALSE
òlaǒdfkGaòawláwùzJéHarpIa	FALSE
úóúphaaaqaòmsútàěǎlJIBZjI	FALSE
AaoINwǒáDuaéaRnZàmáGazéqú	FALSE
BgykeRauUsELaatYyvéIèǔanò	FALSE
DNkóXEgMéaAEKEaayyXuwCQua	FALSE
ErWfGmaWVaKYàǒqwaoMZtúGLa	FALSE
GFauamVRSǒlaǒaDmLǎòHbògrF	FALSE
HnqupòéscfèèaǔtRBVaaaàNQè	FALSE
JóaómnqavrǔyaěazràzMIjPtu	FALSE
KLikFnaùvǒpùyèóBaQwaqWsaá	FALSE
LfYIǎMóruyamJBanTaYuMZaRò	FALSE
NǒlxdpQaONFnYmaDaOàJUǔěay	FALSE
OZdaaOnaèàEvFasZèagGàmdmi	FALSE
QéZfaOǎlèQǒEgaqBlnPaaVJTa	FALSE
RTXnljCavWlypSOMaBraqWwva	FALSE
SivtAěeauaóěéCàIHéUTpaaYá	FALSE
UJktfysEDMnaGaVěaabatéǔtk	FALSE
VaPǒoSYěBQaXHùyxXaAaYgnjX	FALSE
WqaFǔóERaSaBarúVUjefoèáps	FALSE
YaaIáLWǎLlaNaSAmncáGéVQUà	FALSE
ZowFxtaxWZYPOaaxzpzaPězNL	FALSE
aúnWWRwoaZLHINrBPqaùǔáPae	FALSE
aKytaòaàǒJòKNaSGqBúcéNWYn	FALSE
aZYoaqáDaxàǎéPàaNOqVNItCe	FALSE
alMpaLaǒaNqLéjOoVǒuYàkkDL	FALSE
axxIaaCráEaVjpFrZérusvscZ	FALSE
cúREpǒzjnaWKaǔMěaaXiHPnsU	FALSE
darPaFHàǔrúxyóaCppwǔòěaki	FALSE
fDOFùMaaéOVmPazèyapBijbpq	FALSE
gkǒgqDuaKAwaáasDúQǎEOanùJ	FALSE
icòqaWNqaavyoBéVoaùIjhǎǔd	FALSE
kùxtADúTvǎǔéùyDayaaaUseDà	FALSE
lIHáylaXCoAaaoaJHáúFCcémt	FALSE
maaavTVKzItHóZsajcHǎIvhěF	FALSE
nyspězaJNéaZròDaHyadLblCǒ	FALSE
pRbúúǒTzwVazólaaǔCyaCkLWD	FALSE
qdeBaLaàzYUMrKraEvaǒOǔǒgw	FALSE
rwZFlDùQóúhaaYWWóPKaaùsOb	FALSE
tIPaFaaaǎúBlfqUZmàùqtocLè	FALSE
uaaaǔAVéDúRawQúkgVDǎUSTěǒ	FALSE
vsUDXMúaaMóGZèLaXaúKKLfòà	FALSE
xLBaemAvěTǒàaǒuXaAòJéěaaW	FALSE
ylmkǒHaaaQzlULmCaoRPyùNWN	FALSE
ùùKFTkvjnùYEXdèfěúvwARYóhe	TRUE
ǔFxYprúLdǔEovǒCyKDBlLhyuMu	TRUE
áRlTǔělyQvěTmDùrbǔáJXǔgWòK	TRUE
ànPOKWbǒPYVsQlxóChbuxQWCxT	TRUE
ǎxsHnéBBAěvùmBAibhXàVKsbPé	TRUE
èDLSCǒlOobaSèMwFYouzzètèaN	TRUE
ěIèkǔòQEZiNDuniKěSDimCmiyě	TRUE
óZFWoiGIsVxsoúsbcàbjipmKrV	TRUE
òmTNsLèoGWFǒQPeYSFOqxqqómT	TRUE
úěVCǔpZdèàóyUoótsáǔvésNUIH	TRUE
AQǎdTxFxevùèásDuqàZlKlǒhhw	TRUE
BiZqǔaàùfKmyHóWúiUSáDbxǎtW	TRUE
CvToEUǔàùLMǒOJǒGpiRXsǎTsóc	TRUE
EòáójDuwazzADàzMEDzgxeYúǒU	TRUE
FPIwBòCàiBIóeǒOOnjzúyVLLWé	TRUE
GXdùáBFSdZwJXFpiNeHfCCWMEǔ	TRUE
HoSèEáùWBYcRRyMBlKDbPojAfD	TRUE
JGěàěTfVzjSoBKeLSAxuCPpCeǎ	TRUE
KRoEdTITFOtuócòoGxmJbNMEùj	TRUE
LnohoQFIxxpLmlàKVUnDǎpCZyj	TRUE
NúrouájdoCZFcǎaǒAxǒYéFCDqg	TRUE
OOCIzumòRYcAzaǎiXBJPfǒJxiV	TRUE
PfyuHucRPúEóXRoAùMubyizaěg	TRUE
QvniOFxUjáVLéOwZrFdgUǎóòvC	TRUE
SòqrRSǎqgJǔǎdUrZPNidyYfoáa	TRUE
TQǎùFrKfpǒCBéNWéúàgDTAěnRd	TRUE
UXtVayxrWxjgqPGùgsPjIIXàBǔ	TRUE
VměuQwaQFJǒuGBěùMUzpàsYyXV	TRUE
WwiDèFgjéEòhAcùwqrǔYwèZpnw	TRUE
YójTTmFivǔKwAWKVdXWFArFònj	TRUE
ZLyENpáuduyTUgfioscymDxWùI	TRUE
antSèljxaqrhèYpNáFIFǒaCBRx	TRUE
cǔlNnDsMǒèfaGroveóoKanǒJXm	TRUE
dBywHèkglyvzájěChmYEhùMGéd	TRUE
ekǒjKDmhǔǎhěqFǎqAésRnnhVhX	TRUE
gǎHDǒeIAǒjeDàǔZTzbaársòmjà	TRUE
hIZbhpcúrZoàfYOKouǒSvúǒJOo	TRUE
idVoJeqówkVWFVJùefoPewBnJz	TRUE
juwRQGgùLXVuPǔzdSéewmtúwéD	TRUE
lEMYAǒgǎuzJPWóúLZixIKDDisg	TRUE
mWáRébABIXFóAMǔAúeWNadòtoE	TRUE
nbóǒǔcǔkǒBéiǎitIZVsájqpUaY	TRUE
péhvyipoJRaroSpZǒDOEèBnjEf	TRUE
qJyItYWYěZpjiwDUfoRqmEbcǒL	TRUE
rkZJYmxáúHBLKeShUmywNJěéts	TRUE
tèEǔkǎBúpeqsPdyceKzWǎNemDh	TRUE
umáAMǎkWKfMiNAqXTLjéDucǔUz	TRUE
wǔKèǒEMhGióPAějKRBjěSofSjD	TRUE
xQsǔWpQǒTOQQTvsHYtèCaúQtaò	TRUE
ylfpěBSXQlPzejéQǒebOREbPCN	TRUE
ùǔaRXtǒVaéIétXaèaXQyARàgjv	FALSE
ǔTěhJFQRéOEAWPóPásaTaGaaee	FALSE
ádòNRUaatUQotTaaQYchFOhXdǔ	FALSE
ǎòǔPaYSDoaIqaànràxaáUNúkSC	FALSE
éaaVaSèqFmaXJxxNLfAnDIěòyy	FALSE
èlhAaoWaCVnáǔWGèOaóúEèCQaC	FALSE
óúUnGaCvQaBaDěRóǎaRjééIFRw	FALSE
òXboaěěàHaǎauěéawlǒZfdEyKR	FALSE
ǒwxgGaCùJaaáaàúǒdmNfPdphoV	FALSE
AYswIàhKaZaaTnEaypóqinpREr	FALSE
BsVKǒàrVaaGKǎmaKKóXaxYéòRz	FALSE
DDǎhVrBxJRNǔsàèuaaěAaěúaáz	FALSE
EaqsUuèPGQLaIúamKxDakVRděi	FALSE
FrááBmbaaTqròCzòaNyèGZaBjQ	FALSE
HLaqaxtáùIrHaTTóaaJisSjzàY	FALSE
IaǔlCLXǎaaóCxMwLYvrsFyXFad	FALSE
KǎHzVaàèaxmKapKatàěRvyBQup	FALSE
LXaéSèJyNaaHúáaeGvMJGLurWn	FALSE
NǒjyfnFúěrqSfaHFaúǎaJNaJwX	FALSE
OVtmBúeawGsaIlaxèxèóPRòaHl	FALSE
PhmúaavěaFDExlaslěvOpztOGò	FALSE
RǎNǒVmRxòhIùàtOVJzaǎaaǒěIa	FALSE
SaaFzSoWèqGBlaMEPaRhùbVeuW	FALSE
TwnNǒóádBKpURaBYYaaaAòXNVW	FALSE
VLAòàzéFaasxPIWBaǒèMTvuaxs	FALSE
WjZaXaVQaàǔayJIPáYTybǒTqeN	FALSE
YúavúVàqKjWuKKRaòaàaáraǔǎé	FALSE
ZbKMzjLYFatWYWYzSaúuCaaSYl	FALSE
aòěyBAAoaQǒxaqáùamyYátǔAVI	FALSE
aKrúaHaàamGéúǔWGjjlNùitǎTw	FALSE
aXPlEJǎZtqaaLlDǒwvEOQéaPCy	FALSE
aayaSnpamóiseVLULVVRZQMisV	FALSE
awyěàaarIKDvaZǒXHMWTExTjVi	FALSE
blógLFqpeèúqZaFaaaǒbJxIArà	FALSE
dHSLQaVáaaCúaVYYUàMHěxKDzC	FALSE
eaPoraaǎaZEǔQHsVrMéúǒSYFǔò	FALSE
géúFBǎQvczqPaBOaLaajfóSeǎá	FALSE
hMfaǒOXYpUaSàXlǒaaMtaǎOKWG	FALSE
iláAtBMwèaòSHǔYaéaamEáZǎǎK	FALSE
kHCuhPRppTéùuIaaaaéTHMNèPǒ	FALSE
lbwPkTZvawaVáparAsEtBIxmCa	FALSE
núOIXGaYCCDRLaaIzPaNqlǒáéE	FALSE
ohNayqVaZEaTALqUauILhdwAaq	FALSE
qAZaBJOMMaǎaǎmQéaúxDEBǎqWo	FALSE
rTnlaùGanNóèuúaQABlaXxasúx	FALSE
stxVaúKěLMBlayXEpaYmpvpaaO	FALSE
uSLaCùaaéJMTMěóvxyClTěHNqa	FALSE
voàQsijnUGaèTuByFaOěaadmoN	FALSE
xBUhsOQiotWPaaRùFaNlǒTFaFy	FALSE
ygkuDfBolxaAlaaBoáZMxpRaKK	FALSE
ùùoúúDtOópHAuiCdBZqqXAádFZs	TRUE
ǔHǒEréIGAjúsQwwZKsAoéMéGXòǒ	TRUE
ádrBlaUpgXwPSqYuRúfIKlyDDDs	TRUE
àqHHcGEtNǎMyélǔEjězDǎSCǒrJE	TRUE
éBxWěvfdBóóxǎqkyùTyxéWCázce	TRUE
èUjXǔǒkàMDsZSznsSoYeUVùkIXǒ	TRUE
ěeECltǔHRéEIOhjmjUxsésólaZw	TRUE
ófbèbfQěaoAuèRQhoPěxkOùflRA	TRUE
ònNWGZAneBrěǎorVhaZiDTovQYj	TRUE
úAvOǒXZàěkIeéěHliIéegvóǎfsm	TRUE
ATǒQgálynMěyǒTqǔaújKièThěvf	TRUE
BwrFeKmèTGOeàCuàeqipOóJbHbé	TRUE
DMiquDRyKbXPrMSsúIaryDsěxáC	TRUE
EfwVǎsǒdVwhbsǎjQQpcsMEXOáyl	TRUE
FwCàHègvúlǒqórdnLPxjkeRTRuC	TRUE
HúlyQJéXRTZnGhBCměSuǒqphyǎO	TRUE
ImkPgbeEVEImttǒdKdiPUTOyoOb	TRUE
KěErtXàAOǔèúSùspLPMZVITZPǔY	TRUE
LUkFCóyKNùUlYpSèKěDfòCXhnJO	TRUE
MsEoǒUsCffqtIvqmHhHǒFLTPBòK	TRUE
OèilJVHéZCTVdtóuùVJFQThlóho	TRUE
PVjYPTnTfPéumóKRHàDǒabjěLéA	TRUE
QiǒbHěLLlRQǔTelcDòBFfqéGHPD	TRUE
SFuKovEjDHǒWěUKjVteZǎMǒTRRy	TRUE
TatXEMùLògzǒCáWóaBMFmGQXTKD	TRUE
UjoOAǔGdHQjoOMnawpbFàZymZCé	TRUE
VxeweVciPúWVsúrbzcjFěiMùzGá	TRUE
XKNcWdáwnQvlLnvqKiIQǎmYqhuH	TRUE
YaiòùgOoXfXjboITéǒRPLOFpmAz	TRUE
ZpnVhuRGQzséveSwgZLzoMgǒXWp	TRUE
búUǒǔojtjfnxXtEwpaJOùQgkuól	TRUE
cJóhaǎqòěZQèOYgAwDPúlénmóǔC	TRUE
dVetYJtàBòZDVZVkJèàsLeRàJrR	TRUE
ezXBiǔEAùojFóFiQwQYLYwijmVb	TRUE
gǎTSREkldNJvèǎDCaBJbBEúymBl	TRUE
hINDCCeZhQAchǒǔFWUuyItQIIAS	TRUE
ibkhǔuUfCPsxfgòXrVòvénXZSBn	TRUE
kǎúlebiNZDGRtYLvqknvòYèHONg	TRUE
lǎuEcBbEpTYbNSdHAòKgUeurTkP	TRUE
mMYoiVòaùOMQajuWKoèócúMgyLW	TRUE
nZòxvúsNlQVbèbGYNXWyPHwHROk	TRUE
orátlIArlELebTSǔdtXáGXàDúPH	TRUE
qHqLxXéXRTdùuiǔBfHgóéuRěmou	TRUE
rKGXèYFréCibèmHpvàbmzhFTCbr	TRUE
sMěKòBhtTExkxmòDOUPǎifVfytR	TRUE
teAzYRóIyFòǎnéFWigtPpatdSfi	TRUE
váǔHXTTJIaàDMUnòtJòàJLUWmHO	TRUE
wFAdmnzáYnOUéóhGUaytKWùoNrě	TRUE
xYIEWhDǒBJOzòoòoXǎYipjzálVb	TRUE
ywBMauvlǎǎcjěInjTǔNZUqfèXpa	TRUE
ùùQǒLwllmnúFtUQuaaaWúXaqiúx	FALSE
ǔXfBòORhjikPmhKmaXBaYmaIóaa	FALSE
áeOaTzzzWaNàEaaVMǎSuéLTéwNn	FALSE
àqvǒaaùmNKTqaayhSADàCudtPuá	FALSE
éúpaàJáQrTPaaBBFRoySakfZOZn	FALSE
èPéiaIxrKxOaSùáóMIpaLCaYGǔl	FALSE
ěaTfǒèeCsxaaàqamznVsaPGYuSt	FALSE
òDWPèóPLěsZéraDaUaRnlǒtàaLǒ	FALSE
ǒbrMàaarpéCaCzCaAgTòpxeǒdNm	FALSE
úmdalSaLaSéNQaJwTǔbtàǒnGǒnM	FALSE
BéInZboyHmUdhaaCmmaMPaSùgiG	FALSE
CKBětyKVbfNvyawvKEaxvòEaèaF	FALSE
DXébpIrNǎezthaaYlwáCnúOáaua	FALSE
EtVdOaAJomOóaLuCaaoǔèhWjfHw	FALSE
GDLUaàWaǎYwèǔSamèaèjfnnkmpr	FALSE
HqěqBěaaáaYǒaFoùeYrsúóúgwQW	FALSE
JQlJWLǎǎdàMiaaVzǒaJEàsxKěAa	FALSE
KoccùOGWaóunLěLxLaaItaiBǎhc	FALSE
MUògěYDqoHNAZkQMDUJTaaBLasa	FALSE
OóLLeWǎRHaOmxaǎvaInvGóawQIs	FALSE
PcGùéaXaèHVnaartXòjǔjrcěKùC	FALSE
RěQtaavatàyzIDàaWǒoYǒǎqěFzǒ	FALSE
SMlDNtXznKpXéofuaGlaHCúaaoc	FALSE
TeúYqpcsòúdyàZrUaIatalwaqNI	FALSE
VěúxikayatsUQùaFIwaZspvyxIh	FALSE
WaDúǎcaEròjGáBpúYaValBznaYa	FALSE
XrlaaOGpuóTéaaTBeiǎuQlgJBEs	FALSE
ZMEXaaaZotèPlTZayáěgàxnlUóǔ	FALSE
aòOPayosUVpaYxqanLxiFlùóRǎX	FALSE
aMaNòEaFtnHmprLùUPazLFTpxts	FALSE
aZQMOtGǔBStLpnvaBaánabyszǒw	FALSE
afLéFKIrpsraUawLSaPGoAnxòag	FALSE
axvpXKaèzzaaòGdYúOfWQúyyKPá	FALSE
cCLaPaHaXIóUVlsúAYVMévGaǔHd	FALSE
diDaaaEIUXMGNmqaGDSáǎMwAELv	FALSE
fMXoúJszHmqaRàHQDùééaslěaaU	FALSE
glǒěrvaKaàauǔúoFabànOLùDQqP	FALSE
ièhùBALúaRǎwàǎaVJuéaǎahHFsx	FALSE
jZbMVtdǔoaKVmrNéiAlaaFùaCma	FALSE
kpbdSDúWbNayaáántLLARZVQaóa	FALSE
mCuDlcgGIhAzRuěCqMaéóǔaxaIa	FALSE
nhauLyuèǔJACKzOaqtaHUuMaúxò	FALSE
pèKSOhaKútADkaǎNasaóGàMMvaà	FALSE
qZRuaàMnóPúǔwQFaYaDCaFoǎUQé	FALSE
rqapDBYaúanNzvFèawFǒyFJXhHV	FALSE
těvbUDqmGYteLraaUGPaěpǎHmaè	FALSE
uVvYGkòapaCxZYYSnIWIVaaǔtkX	FALSE
vwùhZNGWcfcdTXtIdsNuNaaxaaJ	FALSE
xGXGpběVMvWrtvaClaùaǔaòPDbU	FALSE
yfqmǎiòBiàalěàaòpzaaANtNTóa	FALSE
ùǔLóScéCjèoIeWKǎyóhIbùqeeAmG	TRUE
ǔIGOvbáTfDaVRjeDǒBeúJEěfymOG	TRUE
áRùméTCcRóILBxmóúwúqqJhzBVpi	TRUE
àwǔǎgpyOiùwùbúZSùuhQNwàeilǒZ	TRUE
éěbPlRiRbpgQobMovòStONKOnèmJ	TRUE
èFgBEOBJlèNǎǒMAKoJBoKfnǔùIěǎ	TRUE
ějéjGBKNZEBéǒHTcqJQOùàYzZoYd	TRUE
ómiSLáIáHiZlKmphSkykKéDUòióz	TRUE
ǒǔBNMnóaDěYzòHDndcNbwiòWiMbG	TRUE
úAATHleùǔàAQGoCyQMǎkwVxcLZòd	TRUE
AWQXQDwǔLJBàvxVUQOmdǎkvVAaCW	TRUE
BuótwyqifCIwytLGySbEǔllMhobh	TRUE
DBYGCtkiesùnCDbxjNHwybyJBúfò	TRUE
ETéjNIeǔzBěvYSùpěWǒǒmbCViKòB	TRUE
FrózUǔGMùAFoòuAaRáqzRěAonàAó	TRUE
HǎlǔNeWmYdRNwUèiqNXWWUBtvSfb	TRUE
ILgEùcǔKdèKeèùóPèjrjGyhPkhzW	TRUE
JZhvákjtǎaMbMNZvOUǔlXSǔHwGEw	TRUE
KolwflǎqZéuqáaYèPAǒǎcXGJòhvé	TRUE
MOǒAnZvCéFBkHéGLAaEIbDvGEMQb	TRUE
NgtQwmCdobrJěáDyǔǒdtGcCzěcRT	TRUE
PùsCwYvUùizjieeàgIBvǎXùáTjdó	TRUE
QNùMfyQEéBqkyMvhhuéizRrHANOZ	TRUE
RnápuZwgSjSǎtXMQtjóúIyUmUNgM	TRUE
TǔrxCrInrxuJYǒySgmmPzCúvQVěě	TRUE
UCJEJúovFhvhúcXYeKtáWeTVTPMS	TRUE
VDoDkNycmPYóUpyèihAàtMjbgàTJ	TRUE
WQxúWhUOàórqUǎǒóYlkǎXàǒnAByk	TRUE
XgBóSSEWǒaWeákOPèXhiokxJóaYK	TRUE
ZáiàávkasjZKqaPǎyOyzzEDhOCRb	TRUE
aòMyAùkAǎRVSDújqEUXlRgǒrvoNB	TRUE
bJAyfǎjGenóbmǔzFTJWTPéóòcmBP	TRUE
cUrmXJEyáěéǒǒMěkTwósKAVéhgDC	TRUE
dyèUúùJVáQiZoyFèpfgBéEpòzúùJ	TRUE
fEǎVVPjuqtQzKSMdZunXǎGstRǒbZ	TRUE
gWGxéuěúoǒéiZTpǎvVgSMKNpbOSǒ	TRUE
hhfbKoXSBwinjuóróTJjAěBòPHSk	TRUE
ixwgrxfKSRqàyáwOlrKYfxkTpsEě	TRUE
kLAAmYMYdVkjNRNdWoCxnǒKQXǎùò	TRUE
lfaLzFjZfáKQMèCpJpneǔWgLuzqǎ	TRUE
muWOhIGJiUsnéUwuqyvHYlptLXBè	TRUE
oVfòYóBWòtQkulleAèZfyDgáwPgU	TRUE
pwJHcnRfbáMXKEǒSwBWóyRyVEODh	TRUE
rCjkGgǒàmMcCcYeQlbqcNbUkRoGC	TRUE
sdTZǒZrhwRúYIòRKDèRHuYZògQùa	TRUE
timwgLYHóàupsómgwYWòzvwújngN	TRUE
vèqQytxiòMúWcppudDKlùYvcwEBà	TRUE
wMYuèjùbědǔvaUzFRòJàòáUǒměMF	TRUE
xbtpǔVnxPyéJLuigyǔCǒJSpǔwDPl	TRUE
ygfHKSNòáeyékmWnEóbqnkhùVMéa	TRUE
ùáFzNiXStaTéEězaònaPahùùCjmZ	FALSE
ǔPqùAúDéZKAPxaqúmDtoaàaPsaNx	FALSE
áWDUaZaúpaaZHrJǎZééáárKùNfJj	FALSE
ǎéJèǔùanavěHGrTBúlaaZDcTTùyà	FALSE
éTJYTaFDǎmyDaWELFaàUaǔWUFLká	FALSE
èiòFxOGYeúwaYavaDùZwDauhǔěsH	FALSE
óùmUnaQióàVTǔaòISarwèàVDaáaq	FALSE
òWNAoTBOǎYxHaúaqaXúmaZwlàOyé	FALSE
ǒniutěJúOmouěaGWúBxùaapmOQam	FALSE
AGǎrYJysLaLSaOSěavMTaSmmPkUR	FALSE
BoósNgaèyZmUsaIéIBCtzaaYùVxF	FALSE
DRuùjùùěǒQàǒFaaRùZTXóěOaajEm	FALSE
EeuONnwfPTfteaaèRaaòfPzpǎFsS	FALSE
GJdùòayLJuaǔZanlamEhUVèAgmAT	FALSE
HiVbaaWaěagSRvǔOùuejuàUwóǎáU	FALSE
JóIGxgnGavXPKaHwVRuvQOGlalVa	FALSE
KMiaYYaǒaGǒOMHNqǒǒQSóHanǎUwá	FALSE
LgétZbǒLIlQHQWWaQpAǔaaaùùUQO	FALSE
MrQáoZVauYaJYmuòZaázlèùabyxW	FALSE
OOrloPSǒǒéaZavǔRaaJbLLwVizvb	FALSE
PfùwáJwtuoaVèBJaUnaPáuWJadàc	FALSE
RéùztǎdonaarAaaJTcjǒGncéXNiV	FALSE
SIIzóanaaaeKXǎoóQùeJtfMúnqLH	FALSE
TazòGNdqDVHéhFMaNaYaVaICǎjOz	FALSE
VǎlǎDPVBJlǎZéòayúaaVáaDqeoSk	FALSE
WFisaWQPěǒQaDaaTòppZELrZuSúd	FALSE
XnRsaRǎaǎúsQPlaJúaLwéNsòXěeT	FALSE
ZPTEgDbOamAMaSxSKóraJaAwKdkě	FALSE
aòLzFmtQaslèKaúyFLaNpùdcUBVh	FALSE
aKěApOUaaPMpáxHadGóèSghùmvHV	FALSE
aXaWTyaUKaEGgUTàdXzWERHOǔhèR	FALSE
alèEuzBGnmQalIòPléFěxGòaaCtS	FALSE
azaRaqHMUEoèaùǔTòóxhdusXCIqg	FALSE
cQsCBtvwwzTáúYappéaMrBaqaèGa	FALSE
dgúǎcwaFaǎpóGEUaOVazJogědljE	FALSE
fǒvqJaUaanLúHJmxYagmxXZǔYtVP	FALSE
gcnsJLhaTCEvòJatèRSJaCJRaZxm	FALSE
homàdaCùaaSArúqzSxmóQěsaPaLj	FALSE
júGpXgròaóEbaaranAaQkUúòewóZ	FALSE
kZdkBatOVHNrwQWaCóaRúěKǒaMMX	FALSE
lwzèdèOGSobsdWJaDXaIáIaǔMaOi	FALSE
nPayàWùOtòOaóaapnfǔujjYTbòFY	FALSE
ozcraéùùaFàUZóaBaoèSSCpmpBxl	FALSE
qSèǒreRaàIJJYwlaáězaaPaNJwBr	FALSE
rpcQVeJbnèTaǔamCròaaCcFéFJvú	FALSE
tLQàSsUěwúrGaaslalJmFaeqJtLǎ	FALSE
uhCTasQssaKZTUataFfOUCDqdswà	FALSE
wBHOBSWnfLOùIPQEǒěGGaazaèKaǎ	FALSE
xaaLDaaIBMnwáJHUǎfLǎUUsúfsnù	FALSE
yaXoaaaRlFRPNtCszslóùMNBcUyz	FALSE
ùùfHOYGXnPkèàPnùSREWQvlGǔěYiz	TRUE
ǔGyCbAPtoěhZjádNùduNéèkkSáyvJ	TRUE
áfUSqexǎyàtltDuéSuOZjòWǒúWwak	TRUE
àxFgóCBVóAieTóqkúOhYWRǔnLYSvú	TRUE
éJqmzGqhèFǒiJTVXKcUGYTǎqcuEIS	TRUE
èNPxuSějèRBQTaqtPaTOàédmòèMqa	TRUE
ěXzrhYèttLIGǒáYfMùHMszoóyXWCQ	TRUE
ódJFYDZùhBumMkávòDHyNmIXVlǔTg	TRUE
òqLWKTàklPlwHkjLrDvLjLVOkOZgò	TRUE
ǒvlINiěfGàozSsEUpeòNbZotZúJSW	TRUE
AMPhCAMéylQRsDSEàdCúKLèSéáLyM	TRUE
BNSjntRUǒzmCálJNóEúòbtNwJAsxU	TRUE
CfIYyèVeHKOxSoàdJfjVèúLhyQjúu	TRUE
DrgrbEyGLómvgyFTkvCchszbFUogt	TRUE
FǔùTcWdGùeUéiyfKbYǔtHYZzZIǒdù	TRUE
GDuSPFxEZElrqFáloIáGeǒǔJùǔeòq	TRUE
HPmcIZYXárùXNwòèXHSKTFwNqAmIǎ	TRUE
IcjòóYPeéiGzOULmùeUkymcjJfzǔp	TRUE
JknRǎmAVèésrBàQxTEěYǔèGOùlXAè	TRUE
LHǒubeùèeúhémORěJBELlMqBsáUNh	TRUE
MNUvmùQOsgGǎinúěPORvUqKǒuqeJu	TRUE
NmècmSLTmxbBNǔlQyVAǔXOBMǒqfou	TRUE
PBkHwmOtVòAeWBùsàvyoVòQBaYáFt	TRUE
QakháàMJěàaMlAGGòVVTeJXCàěyóx	TRUE
RsIòèLǔbúLCúfèadYADTuqhǎXZEěb	TRUE
SzUizznSLUMRúNDWbUéSVcesùěNyt	TRUE
UMfNlzWKěákYáùyyxeófjcPJǔwcEV	TRUE
VkúbàQauaúǔávkRòmJiyQgiizúAfG	TRUE
WwohRègZJaòCItpBLHCuiKLprGùOò	TRUE
XzèěisaOàKnpVHRizmèUGUtaUzYóè	TRUE
ZbroAsvèzfYcZáWrvBnFCóEúBàTuq	TRUE
bàvSNWàJYdKPèDsǎUǔmòvnnǎoJXuj	TRUE
cúSóecòFàRdBJBóWuhCFRXzbpNLWu	TRUE
diérDmrǎiLRpKPzKdsIFzvàJùjJoi	TRUE
féVzèZòYdSClJZLjcsIvǎFibéoCNo	TRUE
gKOdKJdlwyEPOLMàkéúWeDvGóeSRú	TRUE
hwYdzDIZgbKTNnzzaIrLáFUjlVJèI	TRUE
júWácjgeápaCLhNeGkǒKDjéniZdéG	TRUE
kTědRxiJqáǎibfyXYXǔdTMDUàyBUN	TRUE
lbQjQRroSǔúGOújsèwQfrúYDjDoNV	TRUE
muHoóuòEqdLaúHlauBuiéuXzQsjèG	TRUE
oòBmJUQàGoOiqQHvóSptTLCNàánZJ	TRUE
pFFhèéXjrBCpUSbtftwúXxMnRKdxf	TRUE
qbsérWXibXgfTQfóǎACGxhODóéLOF	TRUE
rnseNHùxǎóéKcpAGRtYàuxmPJCRtó	TRUE
tùXVFkBNltPodUèAWǒSAAǒeCdgzaW	TRUE
uOjǎàEiAeéǔéIBaczBqXqSYTIYMYM	TRUE
vjWzWrúvgltKeZIǎxegǔgèZúveMpM	TRUE
xAAWDaUAieǒdJǔFDRXfZgOQLUtbWú	TRUE
yVàMjwpvsògNXnQqLyXàONǎǎgvXAE	TRUE
ùǔSvanQvJoéJáaSCǔMawǒaCyZEbVQ	FALSE
ǔOCaBarlGMRaéěapfáLqeiTjǎJAUf	FALSE
ánaùnMèwayZuSaóNXSsFYaèSNKhsq	FALSE
ǎúqaamMzaErNǎéaqmhdaFùqaTKgfe	FALSE
éXlEjEJaǔaIěòlaèaLsǔcèUssVútp	FALSE
èyUGpyRfǎTKIFWKùvLQaaMPOmaxwa	FALSE
óYCFOjUEanaWTalaKǔtZWDwPjBùèj	FALSE
òtèTgmTòduaaraLòraDlǔEooúǔPoè	FALSE
úNaújLaMDBayJaaWcmváJèqUtuxJV	FALSE
AkúúǔsqErIzIéEwOaaóDSVaLúagKH	FALSE
CěxqMHJVxOMaEoaaplěWoúDNMaòTw	FALSE
DVzbMHkóǔaaǎaóAùGVVàùFèúaéúwi	FALSE
EkPǒaéaaraaěnEoǎuILuOtǔBOovsw	FALSE
GǒvqFúRòězRaKòǒTaéFWzàYAaOaqv	FALSE
HRSjfǎAiAscaGnUVaòùaTIZùaSǎpl	FALSE
IaoǔNQéaátaHaGLmúCNáNFǒNOlǎGé	FALSE
JhqILFWdaVTaqpùaaEqoTRuYǒEFEQ	FALSE
LMTSaěHaAMalAqWòaHZAUxhPoLDNp	FALSE
MkTàHěaOaGTraúǒajjusdNecvTgUV	FALSE
OǒrubaèaXZaéǎèóaónRaspVGMàBvm	FALSE
PazeaǔKlòxázaFRHTqKUPěyxaOaBx	FALSE
QmǎeúCNkǎěàllsRIOlùaaUaaHiyUT	FALSE
SàBèaúOSaSEaǔaRojǎmGěgDnoǔǒYa	FALSE
TVyáTEVrrYYotmJxǎéyPapaluNwaa	FALSE
VěEqlAaGsěNaqaEVarOidWTLNyAmó	FALSE
WatXyaJGaHàaUdwmZqRKwéUGaǒèzè	FALSE
YěUFvVdóiXémEMduYaaáaaZuóaOxr	FALSE
ZXxǔawqIUsaWUúYaDěKaPPPYúHmpú	FALSE
aòwvazNKOaEsóaZvyěsjbèKIEPDzg	FALSE
aOóDaaǔáǎVanèOmáfIǎtuHnàdDZGǒ	FALSE
aaKàxJoǔqaNúIPAFaGfhuBAFiuBjn	FALSE
arǔaaaálQréBBEGSreDHsàTǔysòUg	FALSE
bUZacNfalanKǔaamYUèeZaEkTmoKZ	FALSE
csTJKFZmùiIiaùQáaSzraáSAoXaLc	FALSE
eQbaTěaèùèUWaaHCwWWǔgmuwgQYIǎ	FALSE
fpaaaYóaǔOiEVúzěmEEGUouǒMǎVég	FALSE
hǎièGapmSròSVJxaXxZaéZYměsarF	FALSE
iYúSvǔqlǎvQeINkaLTJoalNǎaarTǒ	FALSE
kHERHUúIZynpalTHXmIXaXMaòEaòd	FALSE
lazàqaawFSaHyówǒéQDLǒstàǒtnyǎ	FALSE
myxIvpVYǎONhDlvsaNNKěaòKaNarJ	FALSE
oHBrANraSùamǔéNEVáaaaǎHmHcùUq	FALSE
pflalaǔaXǔasǔúszHǔbǎECNuèqlúǔ	FALSE
qtaZòaHQlXǔwOsěraDaGéáàémcǎDg	FALSE
sSIPaxMHaaaxTxiòqéhUFMZomǒúsj	FALSE
tcsqfKFpJfEBèaèoOaaozJGǒǔaRwò	FALSE
uroWtDRèóaslCavtaQxèèVaGàcěyd	FALSE
wJdtuIDBFiYfúáaamaaHeézǔZàXée	FALSE
xaxéùèMLnaaEZPǒNwèGNxAùamXsmǒ	FALSE
ymAxUJǒaǔtJNWoaéSEaóvZJèoHuaá	FALSE
