ùáaczéěicOacOLJǒOFDL	FALSE
ǔXqSQaèóFyOpLUvyàKqs	FALSE
átvxJMDùwKMyqèsaNRyV	FALSE
ǎLFóávzZaUiKéfgODFòz	FALSE
éaéjOǎlcóleJnělXZzFZ	FALSE
èlQúGNPxJGHaoTttQAdY	FALSE
óáDUsUpSòvUàEZAqRòya	FALSE
òóǒpEùRúzpèǔAZxaTMLm	FALSE
ǒQséoqMTagEóǔjclACóè	FALSE
úakXMxrYihgTòòRjzJǔi	FALSE
BùDNmèaPLzVTkǔjàcádS	FALSE
CAavòàóThtjEldèxvUgT	FALSE
DWoěPaNryszLVǒYEfMéz	FALSE
EmDMòRáqLzaLEqRsóǒDF	FALSE
FwóléaqghNRXJFRZhWrY	FALSE
HòǒFMEWYaBóRjDǎCOYWp	FALSE
IQIHǎǔZLxanWoùDiIrZj	FALSE
JasITSIBXGslUóciCPIQ	FALSE
KxSINxIEzQRJTuHuaBfc	FALSE
MLaRNǔdfNRǒZzgèpèǎpx	FALSE
NNaAFOKjOqwǎzhRFYzGǒ	FALSE
OWqXMuTauDeLXIwWFKiú	FALSE
PqaépZXèXaxDqkxáRsBG	FALSE
QtEVQawKàOnNYǔHVkOuv	FALSE
SúaǎMknǔmjàùwàDóùMzà	FALSE
TSvraxùdukPHxóMPSWpp	FALSE
UnPSrlNOacYPiVáYJdǔT	FALSE
WúNǔúěvùXtqradGqkójn	FALSE
XQoTNMGlvNAǎRnIahAbY	FALSE
YyHàmoCènqwóFaLFGGPE	FALSE
aùVéegMqúúùǔiAJzMǒéj	FALSE
aèTèlRYLfUFPzUsqAóRP	FALSE
aClinINDDIjǎrTtQWDXf	FALSE
aKFpxXurCUigùwvuúLSǔ	FALSE
aRhZRuoivóRǒTRhcvbGò	FALSE
aaRǒiBPábzWhájfWóuóa	FALSE
aiUIdZtàmgFiTkKěóLUN	FALSE
aqǎZǒóéEJTlléyòWuMRL	FALSE
aynSttyiVJǒaJàmIZQSH	FALSE
mJaThǔovBMMNHgcUQTěH	FALSE
naIICùDSvIwàǎyniSeAw	FALSE
otXZsVòwaicojqéHgGNf	FALSE
pzòZǔóaHèǒròycǔǔtrKn	FALSE
rMKàSQruBqèOAYHVBnaS	FALSE
sVCaPǎIWúMmYSzjqryls	FALSE
uǎnLRaJusZgzsshEKcBs	FALSE
vLaùOèNDXǎZeJXNEǒApW	FALSE
wVòakéǎUVèRwUNDǎpTuò	FALSE
xaYMǔfqWkéBizknZTEèv	FALSE
ymùaqNFIáraǔNShyyUàù	FALSE
ùáLúXJBDòáfvWDOiVIWJ	TRUE
ǔúǔEéDkùCQrOVéfgáKjè	TRUE
ábRPnqthvTEuoorLKNvc	TRUE
àykguzapsgAělnqLSfáB	TRUE
éLwóstTrRǎèOáiyǒDWfg	TRUE
èjQVRlcwdèDbmDgEVòXI	TRUE
óǎWǔěúlQrúXùQvioiúDa	TRUE
òFugssdcSàbjflFzwviU	TRUE
ǒIèACùYjAǔáUTèRùeSfF	TRUE
újTjKhǒDfǎǎupPrAàtcá	TRUE
AtuèǎZzxAlùéFkǔdZdòe	TRUE
ByUǎTqYtóówlglòXeMěó	TRUE
DRàréájYSdǒeùwIǔxǎUM	TRUE
EkQIVBDIaóoùAsMsnèpS	TRUE
GǎcáámLuǒsQjopCdywbf	TRUE
HLkWhimǒàéPgxěWCXYTj	TRUE
IfSBmIGQKEGAéicùkCEN	TRUE
JsúKráǒdBDBpocòFǒòòá	TRUE
LěZěDnenckòEMLfRnSVa	TRUE
MOFWRCǒErFPigCbxǎwPF	TRUE
NSkěòWukyMOyuVJgQjGě	TRUE
OhQDGofIvFUNBRBOoéGN	TRUE
PzúěIgRiùBIZMBIrNqZt	TRUE
RJěNpPjWszZBvMwyNYdG	TRUE
SgùXRjXsNqTòMpǎàkVqǒ	TRUE
TuFOCInMGoPLiùLMpTCV	TRUE
VěXMyHǒoZcejTLAueHgI	TRUE
WIPzDàLtàáFdJYBhdaTG	TRUE
XjtBeěIZWLewgXáàUDwH	TRUE
ZǎEKCLNáIMòwHeltGiàt	TRUE
bàlCěuLBoóǎXǔUAdqDvQ	TRUE
cBKqHqACVUmMVkmwYJwl	TRUE
dMVIBoàǎUYuqèèrcgèMt	TRUE
ecgVUàFJzaUKóPfuLXbZ	TRUE
fzJwrKUǎTùZOueàREyQy	TRUE
hèFúgZòPwǎtuoIBcEXud	TRUE
iFcCNVbléqèozáYaàgàá	TRUE
jOyMiuCRsǔKǎzànQpwvl	TRUE
kWnfrbLNyàcGBYàwmWwU	TRUE
lmàéòfrYNHvycHGqOoáě	TRUE
nòHSyvDVripèpRuéYEVJ	TRUE
oWmJRèAnVpfAaúrHgjwX	TRUE
phanSkkZTáKlbBáLnCCB	TRUE
qzQVGyvèDúTOIXZLdGci	TRUE
sGyEvǔUkqBrFkBàFkDYV	TRUE
taqRótbUòTOBYmsAùIGx	TRUE
uwIǔdfrèoàIYùgCRPhvV	TRUE
wègNprvxrBgBpqèpóCFè	TRUE
xHsYZàYFMFcsZcRkxáMn	TRUE
yiFáRiǔzxéCèiCéXFkén	TRUE
ùùDMXyéPmváaèàGZHǒáuL	FALSE
ǔǒxzBKDaclovǎBmBòsThv	FALSE
áMùLǔKsèzoGagóLàYgMwX	FALSE
àalTvAáqtróǒolsumFXǒC	FALSE
ǎsCzJvàRacáùǔUHXJBàLá	FALSE
èóáarJsnhTPRwǒfBvZBpF	FALSE
ěQEGsaòuKlTKǒéJxóBCéf	FALSE
óahEeqhYòdKATtgHàxèYd	FALSE
òpQOwPaRvǎupáhhjQgScv	FALSE
úǎXyYasLàZACěǒoyzSgOZ	FALSE
AGrHVzTaFohǎRfBjǎèkúQ	FALSE
BKCoǔzRxoǒEoúvqoèxzua	FALSE
ClIaXuGCQIhvoáXXvYBlE	FALSE
EéSVéahwbUpòmocjqǎkxè	FALSE
FQBQqBYaFNCgyLlQNyékó	FALSE
GanoyOGsMOIcnUemRjCIN	FALSE
HwaXTǎùzCTǒgReYPZshěL	FALSE
JLXúEaMLCUTúFùèyftFvè	FALSE
KpóWùFMùJZazHòkDáGHWs	FALSE
LuóúrzSoyáLDJYyFàǔaTt	FALSE
NLaZzjywCKZhzwRSǔùzml	FALSE
OWáaeàaueápJěrHPvDjyǔ	FALSE
PzJJatiaKKùwFHauLQnDa	FALSE
RAǒCGórBXaGóLWtùIHUóc	FALSE
SIwxqYPaaAruQqQVJWěLl	FALSE
TOòaqyEDPCgUǔWYFòJUPF	FALSE
UaGsHzCXQútéefCGIéYyZ	FALSE
VzaúcNnPOBalúWtsusǔDF	FALSE
XIMIWySérJVěEVvǎOLDaà	FALSE
YaòùgLJOMsòOúaGUYVFcd	FALSE
ZsǒxraFirSdsèǎlbLàyYO	FALSE
aěděGérjgmJǒTùhhXiBCQ	FALSE
aDgKAkBTMèěCǔnáěqjVQj	FALSE
aKGLjòiqáMnǎZéVbsnjǔe	FALSE
aQtEZvùHzWqǎcaǔxlvcsǒ	FALSE
aXMsXeVzpúòDnMXRájDòg	FALSE
afDShVkGwOydJfAtMémél	FALSE
amZǎSNuóEJEwWǎTJryéúi	FALSE
auDfgImàoèǒZhXcApqjàS	FALSE
lKóǔaqfěBBSZRǒVicmóDǒ	FALSE
maTǒEFǔáěPEmúóOkáòdǒJ	FALSE
naqUBroQttxgCLsUyěqUg	FALSE
púQLòópxaòdkeABaRcAwH	FALSE
qUyùxGuajCcdbwbAXUXàc	FALSE
raroxmoxaLCérMPǒtnórv	FALSE
téXDyYuǔáqqluVakhqNòG	FALSE
uPOqDSZCoaFěDséUdóúàh	FALSE
vaIXOLiySOòsSYObUèCCl	FALSE
xǎakCiKlZmKwéoMqYiiPM	FALSE
yaWmzqtlCOuáǒYhhGèòNH	FALSE
ùùúXáóHFOèpRVQYNrMnoF	TRUE
ǔEvàbkǒYfqNZQdOvGtùòX	TRUE
ángigéxHwRúiátPEáegOC	TRUE
àxètuuICóYWTbJYlaiVQY	TRUE
éǒXApKVàWFOqRHóKWbéhq	TRUE
èTjWòǒPJxMtàxYuJúLóǎó	TRUE
ěUpCDnxHCinǎeBNAcqSfi	TRUE
ófNbNEAesYòòugxnǎǔuyO	TRUE
ǒéfdbHèèrGjKMsǔhGPByv	TRUE
úJTwòhXyFùYvWsavwrGbá	TRUE
ANJOLuNXIèifYDàzúHèxC	TRUE
BgEKyfQéHǎǒfwlhLcRéVa	TRUE
CxDNrUvbdécVkuPoUapPB	TRUE
EDèfVzòúyfuWlmpdDsrdL	TRUE
FNǔGòMCoérhLBkKgsěbYc	TRUE
GUwVùqxKùziPèyúNFxǔUè	TRUE
HpMúxEyóǎtjqqUAagMPùk	TRUE
JàOVUéHdwLcsngtGmVhwA	TRUE
KMěǎXiáùǎǎápěaóGNRDèF	TRUE
LhùCqncJmYTǔyRHJFxbúv	TRUE
MvBIǎZrJvuGǎbCCAMhtBa	TRUE
OEUWJtWkZǒéXByUuzfMPV	TRUE
PeouSXhǔtrǎzOzcùánrSs	TRUE
RCèbámMDGLpyCaXxfFAPt	TRUE
SWóteTYOcòeDbFvFezúoà	TRUE
TqáhúǔQRájUgXpVIMVuěù	TRUE
VéǒKtbbpzMSCHRIUpfcGy	TRUE
WQcǎXěUUSaNkIhYěXSgaP	TRUE
XduaúZǎduǔxEvLǔnáRnoá	TRUE
ZùéóúToèftáèióDLàLylU	TRUE
bèopptasiKdVOFèfokǒBf	TRUE
cQWóWGSKděMèGWǎwAsqLI	TRUE
drSxLuZuoSTYWúttòuéqz	TRUE
eytTCàWCBGXnawutlěEwz	TRUE
gòúWVHEUùzdECyZYHwLóP	TRUE
hDptfWfZQǔIéCAáBòxaǎt	TRUE
iHqXébXqGǒécdNeěùòtèD	TRUE
jMBdGtKSRUXawkěówFěCQ	TRUE
kbǒKrQǒókTKáRvùùǎòùDb	TRUE
lsOFIGKWbygúàIáISJzée	TRUE
něgPóéùdEZhOáCtfkDLèa	TRUE
oRfsúJHEKUgDuPúoPpXDǎ	TRUE
pléděóeqùunidélFǒbpǎi	TRUE
róCHtsǔxVwKgǔǎDaANNáp	TRUE
sòWěàòWtjNnpXUxKEwINo	TRUE
tMIéfěkTVreBnréawHQWO	TRUE
uléùPèpdǒXapùájóAèVAc	TRUE
wàfUDiǔQóMǎátEIǒorTàS	TRUE
xEOUMNzekaHnSkcNYóFzy	TRUE
yceRěùǔTóáxAjfkFKYéPC	TRUE
ùùaǎCòGlǒGlcNCxjTǔfYIe	FALSE
ǔúuOYQoXwǒáǔaWdǔGBSxSb	FALSE
áPIlèMRaUdCZěRHsIOVSlǔ	FALSE
àTéLaoZDUèXóDvLZhknèEA	FALSE
ǎaXǔlnrGxyòǒnBùoyQMOóǔ	FALSE
évélahEesǎlOWUJbihAwOc	FALSE
ěIěQVaflooXUcBnóùWǒǎmú	FALSE
óXFaVpQǒRǒdZbLúYOónALI	FALSE
òausyéfsHAKǔDLdùúLTJWv	FALSE
ǒzakTǒǒárXáxtǔGlpyAváo	FALSE
AǒRmmwaUVCFKéLLwèWxONà	FALSE
BKZaOéWSCIsLòBqEhiJdsx	FALSE
ClPǒaBJágyApTxPZLóyYuZ	FALSE
EèQSsaòMZcSAHYUàZóuwbr	FALSE
FOpSzKsTWvàEǒUOaxǎRátt	FALSE
GoaYlaézqǎǎpzBlTHaKDáj	FALSE
HsakNbzVeTpitDnMMUúHWě	FALSE
IyKaZzOHùPJeZmòytUnkYE	FALSE
KBaǎckQěǔttèkiféAEbuéy	FALSE
LHpaǎctébJoeskfgfvdlOǒ	FALSE
MakěUCááLǒWThFXURYnQúd	FALSE
OóaMǎPLfZùàhěxzhGQKCěW	FALSE
PQàYJaaAǒlOCYǔògEOyǒPl	FALSE
QaKunYVEfgdOSbFYǎhzCLC	FALSE
RqBBBxěaAElhHqKzièCuǔp	FALSE
TàvqCTuEOéakPBèkzvéDQu	FALSE
UQqazàGtAmpgZWZEkDàwvá	FALSE
VvaCFQXpcqkngMCWDaEàrj	FALSE
XCaèDOEqGVGFélnPmQtnHè	FALSE
YqajdyòbwcGesicDǎSǔIZF	FALSE
aǔLYkàGHǒiPsùbggúùpdǔr	FALSE
aòújěpYǒùáǒQMUěWuGXTAw	FALSE
aGSǎàzvfOCělqměXndlǎlp	FALSE
aOóQHjrCvkFAkAFSSJùáek	FALSE
aUWcsòwlRóevQWUTZhěJVc	FALSE
adJámDdǔáRKájGApyRóAki	FALSE
akOòWúyědCKKEnSgùàyrEò	FALSE
arRglKòHǎXZQrCséOwbxěn	FALSE
ayyHdKDǎtuLeObPlPEuybt	FALSE
mǎAraXóPyMKTKuOzUǒxěòE	FALSE
nPaàMPòTóiáigNKǔèCcRǔá	FALSE
oayreókVfnwCTVYsdòùiòF	FALSE
qàFoyéóùwùaVGOMvVǒDmgm	FALSE
ròOIráxúèǔCOàyUùaFNéKC	FALSE
sMòQVQráGMáàQFaHǔZQxZB	FALSE
taTlJDLFGáàrRvkvNFnCAB	FALSE
unòaǒǎmlǒnùNOqylBmòriA	FALSE
wúKsAàAyBCIWDadótéCecě	FALSE
xVXuaJPtiqèUQejQAuQecá	FALSE
ynxùzVaeVeXnVxFofNUlZV	FALSE
ùùZhamLPTDkCvnRèsOKWST	TRUE
ǔDrTtKNàYàlSiWqIXQYOWd	TRUE
áKMORàLRYIǔVnAHěZǒMEMr	TRUE
àhEGWSéptzHTRxIQacQòGI	TRUE
ǎrhqKYeKmBhYEMomDbáècf	TRUE
èǒwMoUépòHBàvóDmnnHeAm	TRUE
ěUdǎáPAdyàqwlNAYbQěEXo	TRUE
óhHHNácZFAAwkòùXGYpVǎf	TRUE
ǒǎgNvzYtguXǒceFcAvmèDo	TRUE
úIkáòǎcvbgVixIeEMZèSNW	TRUE
APěhGVjèfsIǒàeǎKPRLjlm	TRUE
BcXěIINgLqLcùTǒPAQónBǒ	TRUE
CidNrǔròhJIjMPdnRkeàPq	TRUE
DwǎmǒJOiQoCaADPtùrhǒnR	TRUE
FKGWHVlBěmOiinévXOzAǒà	TRUE
GgqnSfSGaBeatSthxwYToo	TRUE
HswéàdRǒpùMDùVYùwDúZěǎ	TRUE
JBǎběhùEcuóDzxCtvvekBc	TRUE
KRPùLkHtjRàcxrVDěgàǒAb	TRUE
LmgěGubòúǎdsIBCNnyUděh	TRUE
NDWòpBWgZfnPǒtrXrNáKgi	TRUE
OcèòXuieBYvfǎYéHRkEncO	TRUE
PdWuvGaàjpGUBFpvéUěěgA	TRUE
RǎSIIWěgVJAHFDnVcBělVQ	TRUE
SXùAyòZàfěpTtsnAWbúoèY	TRUE
ThóIrYéZgRbVúPATuPRDip	TRUE
VàhghǒcGmúoúQǔtǒhWhocó	TRUE
WEQscBIáchuzZxbGúelaaS	TRUE
XeCHdTwkèFvièAcmrtèDkP	TRUE
YfdpùVdDKazhAeGǔóGVBóy	TRUE
ZzwlbHbǔxùRQGcyxáOwǎùj	TRUE
còTNNKǎwSoYUCZgaHHaOǔp	TRUE
dUIǒvpgǔjXWaPpEVóIWPtP	TRUE
ehJiSDDvMvǎèǒàCzlǔAǎIZ	TRUE
fwǎaYJOqrùhTbSErNuúàMZ	TRUE
hGvByáNbfElEóCTYèTTsKS	TRUE
iUpòRhGyfbjLVǒáǎMfXlAt	TRUE
jftgFyǒKUjESxAúkeǒéZEO	TRUE
kdrlDJVRkhYKGIbVicěJPK	TRUE
lxoSiǎjmeHǔùvNtHuAhQǎW	TRUE
núùòqcèSPKCnmóhàPèZEzh	TRUE
oNùcfYHbEsAàGSCFJWómRé	TRUE
qáSZrTùYMdtZEéHCilRtWR	TRUE
rJdFEudǔcgWYToOǎdQaávk	TRUE
sbVúdtkGZEYMUIKvwcIǒZI	TRUE
touXZzfZvgNoéhkWǎhwYOù	TRUE
vámiIZEAǔpuúPàáYnuǔGmě	TRUE
wHeLáǔTTFxzihúXhEOlàrs	TRUE
xSǒPàESbTrdIjgQókwLGRE	TRUE
ycGDRrDhOqZQKǔySXgápXú	TRUE
ùùaPòSáǒǒgibPNéObQsóěkm	FALSE
ǔBMaǔFaPEiKMTNáBéZPIzFL	FALSE
áSsaRǎRèejBQDXNjhùzátxQ	FALSE
àralVYDóBdǔQuspFwXdóBts	FALSE
éHMpYqaGsǒLtdRMQěǎàiókF	FALSE
èNapQcmTǒzxxAwmǔmsàJMTN	FALSE
ěaBBěrOLóSáWèINhmmIpPám	FALSE
ópxIYmvGBǎSTavvǔjǎHiVDS	FALSE
òxJǔaNokRYúKkXsuMLYPznV	FALSE
úǒIòòǔróLněyKúLznóLaǎNz	FALSE
AaKFǔKèdAiACXnnqLpsùxaS	FALSE
BxIvlqOHpvEoàaKfYkPǔáEV	FALSE
DJaGmQcdǎxZIEéHqWGrcThA	FALSE
EafqMmOělJǒóBtgWǒaqtUòk	FALSE
GèaktzbgwjǒQCSqóǔàxerYB	FALSE
HBaoérgjèxHrqdòrxePGVWá	FALSE
ITJuàzaèYSErrSwddéèEAcy	FALSE
JuBahkUGBòoǒHéhMJTuSDAM	FALSE
LěaùWùaáwvMǔfshěMNùùXDǎ	FALSE
MIxúaMěpǔCgǎjAóQCPhkjěA	FALSE
NPàaQòJúóhfaúCvPěkiPRáè	FALSE
OXNWAyCauzóóEptúKdóhtUX	FALSE
PqRIaěěpZUgbpLYóuBTqpèy	FALSE
RúàaTǒKrJtLzGhdQǎKqLFéf	FALSE
SQzpSZaYqkgRòebEPHbmPǎu	FALSE
TaAgrBkDAeNwUchHoXprEàB	FALSE
UzUzsatqcTcOdJYEFfOKrúi	FALSE
WAoáHaQCeéAFáfeVnqZyVma	FALSE
XPIòQsúèQxpIaàICvOsùYKG	FALSE
YOacoxwGiOóǔIPPAzGnrvpp	FALSE
ZaeNsBXNjYèúsZmHUEòHéCh	FALSE
aèJjjǔSágKRyzIGQcěZKVxè	FALSE
aCAǔǒmOhǒSAEIwJzmyIzwIw	FALSE
aLiYTSepTǔfUCoXXoJéMvOx	FALSE
aRvfjYkrJSǔyLUjxjèdyětl	FALSE
aaGkracPùNmwRuCpùrěwjèZ	FALSE
ajeVQGeGgnJcKěYFiǎmoǎPr	FALSE
apUZvxtLXHKERYǒCǒzGCyǔy	FALSE
awtiǒDaàPnUWWNcNXéěhYUL	FALSE
mǎHoKAEyùAWxZaBúQPvǔEzA	FALSE
nJFaMòòvòdSvWěYQélBúrSf	FALSE
oaZKwKùùirbWlNvJFqǎoùùY	FALSE
pqUrWakadNAVěqúiUáfFEóc	FALSE
rùxoacrúIàCUWFtexjéòMyq	FALSE
sǒNlYsmTaZlMDiǒEwóTINpP	FALSE
tKtUvàsSǎyBaWPěJWěùKàOa	FALSE
uaéǒIyRXóXsNBztóàvmKUjF	FALSE
wěúRMxKAAZSFaOòèVòqicvT	FALSE
xVàsQPmlPaóUzHCvZǒGFpBN	FALSE
yXahJAaSǒjǎǒHqHmYPOUqpm	FALSE
ùùlSMóKseùCCIèMSMRjzǎmD	TRUE
ǔGóhùùcaknJRsozmkvkgrQt	TRUE
áXYugxxewMIàěsTěFárcbdP	TRUE
àhèGtXQoATáttkYxáIoLlěI	TRUE
éGFXcáMVàLtsJXòtTTijrEL	TRUE
èPǎdcsdzYGfTWKdJECAbkóz	TRUE
ěháIkxBEJǎsǔfRǒGDYBlGjǔ	TRUE
òèWǔbèvócǎgqpuYdGzòóúéè	TRUE
ǒOóTWkpùáSEPanziqPXhhlm	TRUE
úaméssWmbFPgkuKaǒǒKRǔSn	TRUE
AjcHhbóiBDlKWlOMvZQoǎjó	TRUE
CàeyZdlcóhGrGkfiùZYbǎvn	TRUE
DFiTúJòuZfámtaJPáázAIJj	TRUE
EWěbWYùNéesMiIjmMSxBGsB	TRUE
FpéOlǎěEPiNpmjNlEzàǔYAk	TRUE
GwùtFěcItANGuǔWàCLQsàbǎ	TRUE
IDTWZmVùúvWWuSJfpnmaIRǔ	TRUE
JeTnaBCInYWxóùPǎúyòjǎYǎ	TRUE
LǎJZskjeGKvmbòHJlplZkRX	TRUE
MBYOjǔúSHǒáhaJèuVAUmrpé	TRUE
NRnTWtBùqzòyfcaEcěàEjdV	TRUE
OkrmKfBútOMFBpYáQGèRxaó	TRUE
QúáǔopúDǒiqAǒQcèùfnǒRmù	TRUE
RUmJZMoérEǒúFJwùNóúvAyn	TRUE
ShNjrriéBVběqJOlONTMZNǔ	TRUE
UóLoòvàgèXNLLVvpnùnGǔtW	TRUE
VSisbDVxgqPIOtDayJxěbrC	TRUE
WxLJólcioiéàqiSHCnRktch	TRUE
YàFúiFPPnSsSZúbsoMQZwok	TRUE
ZJóIcqLWcnHFALfáèPZPiqC	TRUE
bNKóyOǒNnqéOmPpQFNfaTúW	TRUE
cdtaLJDkitěxdqHgságccéf	TRUE
dsUǎlsbPljùèaIXAkVdǒAUQ	TRUE
ewGlvCQOúltnhqRhNbeěWVj	TRUE
gǎVFyhòjrfEyaGVěUáduRti	TRUE
hFvzCzǎFTBTòTRQIWtdaòRé	TRUE
iGjCGTvVTCIIJNBxYWKJnvá	TRUE
jVCléebrDEOCUdtuWDpgXvú	TRUE
kqòJEǎPLhHGfLiZlHtorTvx	TRUE
lzòěoFsjvUCTegǔVArKjǎiL	TRUE
nCálǔTcgdixSfǎXoùEkAPrt	TRUE
oXěYIkGlvirjLRkxsOmóxvb	TRUE
poǒlfrIluNógúǎJljRkEQcǒ	TRUE
rPbCWòmsWhbbXvHbzěvCWIǎ	TRUE
scQǔlTóǎéHfjǒyòQDVǔikSv	TRUE
tqZhǒZUJbTVpSMXlKúNurUm	TRUE
vDDéGsrkòEèCnbàpòBjxWCE	TRUE
wMzlǔhěWkihcMjHqGQzjovó	TRUE
xbzéhhJdǎuèoèvàcéWDaěcU	TRUE
ylIfFOLOzDBǎJBSgòtaiùUó	TRUE
ùùětYZyQTKǔxaJFtEkBysVrY	FALSE
ǔXnùaseùiákSwLAgPdáóUeVó	FALSE
áaqQvKgYQmuNlFELeiNHTSzm	FALSE
ǎǎKTUóEùǒqězaWOvKiahwSǎé	FALSE
éYNatùOOkúěàénáLtttPfcjG	FALSE
èZJSaLěcARuGSězaBnyxMǎuǒ	FALSE
ěawPièúESjIAúhNDèFuúZǔcP	FALSE
òáaHgúFxrLúCáèèànYKǎhNGù	FALSE
ǒèsaYNSèvǎOáeBwIwwxBecEA	FALSE
úYaZúùNhMDJZěRaYXyNùǒpěV	FALSE
ArDRsWPaóWzDJVjhjùRvNQlm	FALSE
CAVIXmDaáNzúLèSùHCáUgRMQ	FALSE
DDUvòTWaJkmILvvàHqnEDuXǎ	FALSE
EUSOawsJJòóàlyLNIfpmqbàě	FALSE
FaiùsuUéHěKpphrxAHCàWzIs	FALSE
HèaxIGpFwǔJHosóyfZvYMSèz	FALSE
IGMaiMaTAúaǒRNfáygzYJóáu	FALSE
JSVxaCGéuáAúOVměHàzsXRǎj	FALSE
LǎayIhVjAóZYěǔyZòěUPDòyt	FALSE
MQWùópǔaEvOeúUOáZiWfúEbE	FALSE
NavEqLCjpWgthQipáqoOiwsǒ	FALSE
PěTLSpèTRLEaxePmQKBNvJBd	FALSE
QCTPǔaBjDéPLRòKòjbvQKPCn	FALSE
RIlyOqàDaSxdàcxVDVppLWBm	FALSE
SVKQaUJrJrSQofDDNUǔBDygn	FALSE
TlVavYMéeáFYdlrěLKùinLWo	FALSE
VǎOCYXKWARawéiwwdaUǎéTjL	FALSE
WLSaOmWmkBBNdRBMǒiBSúpVh	FALSE
XVWYMIqaǒcEàNECrEwtUZNBǎ	FALSE
YvVǎTaéxúQBáLwncNBJáǒKiX	FALSE
aǔBdǒvtrDKsǔkUǔpmUédTKEn	FALSE
aòòlNxVtNwkZǔáǒǎúěeèàJGC	FALSE
aDqNFUáyvKǒKClóGXuzòZpgò	FALSE
aKkrwUUUjTáóéòBZùZóFězóU	FALSE
aRǒkNúUbDùǒǔQsěcùsYDeakd	FALSE
aZkDòNKwqOuzhJùDLCoJlvBO	FALSE
ahmXàgvzyiǒuHGTYUFàHěFKi	FALSE
apHALMǔrácèèàsfzucDWKmnK	FALSE
awzlDèàǎOMmòguyLHQPCéGxh	FALSE
lxAvpěùaáDiiixAgtzATlgTǒ	FALSE
nQéRxIaeèMǔFǒùAàgióèPtǎa	FALSE
oaMDFxiáUejoExCCWopdphbk	FALSE
plaKcywprbNúzbVFTKYCwRst	FALSE
qzàsùPǒmtJIZaJwIáMùjKdRT	FALSE
sNNuzHéaǒèLiǔBBEYqónLsòd	FALSE
tafqceéLqonMdiéAéúZcnoúù	FALSE
vǔEvXRúCúlzwúǒCUuèFaFyPB	FALSE
wǒnaAlltúczObPNcòprllPpe	FALSE
xRrArxvBaseHohMkdnvzjTáH	FALSE
yaqǒXégIfVkcJJAqǎopúúzgǎ	FALSE
ùùǒIúDǔòùQcxrOSeOwFDHAfZ	TRUE
ǔbClUEaCěIwIkJúUaáOkLzěo	TRUE
ákofǒrěuObPànRǔGmIMátaǎg	TRUE
ǎùǒúùDCòqdbPSWxTJèYfyJcǎ	TRUE
éSmnizòBHcXrùaǔsVjWoVvFR	TRUE
èvěYOfGùHsyZUáǎóVIOCyùùm	TRUE
óDrSdWHěNvJqlùóóóTPojqqF	TRUE
òFáAFcHNócJbIPòixùEMwZuE	TRUE
ǒNGcòhbgàfmqBáTǔmjYPedoV	TRUE
únúCKIwèSzmyssciLúnVétGě	TRUE
AuDVeAbáGèSPMiWSvNáTisDY	TRUE
CòéTvòmeáZQpuoFIpisQWktw	TRUE
DRJoJkEtTNpIkquFwRaIGStó	TRUE
EvKKǎBfúxtReBSYXsYéUBrMé	TRUE
GFUoúRZěAǎcrZěELgpòBǔwbQ	TRUE
HQipNnQUǎHuaPEBQdnuyImUǒ	TRUE
IglwáàpXèKxNTWFzKSáZèrùO	TRUE
JknqbPFFbOóPWěOWEYTDFZrZ	TRUE
KquǎcAyqTTUbzqúwtáfRwésq	TRUE
LxàiIPRZlmQmǎnlsgGUnVWAz	TRUE
NGuKYIáznuuèkqEOBOAWnCǎU	TRUE
OiwhqiTèBoeQéZAYfèJSHNvs	TRUE
PyLóAǔcwEóPUDUNSaAHFkoPv	TRUE
RěoóèExdlAvXzZlUbJfNHemx	TRUE
SCJewzwlzDùbHMvlěgtǔMǒQC	TRUE
TRAIàHleHrèwkoGeXXlnpǔtG	TRUE
UqZǎbuwDpYhkCxBséúJáMiUN	TRUE
VujXHYqMjdfUvxDOCUózJWDZ	TRUE
XúziiéáCFfRBěsMzPùYHWCéY	TRUE
YEIUǎXWBǎrCGàfHfZqoYgsYE	TRUE
ZZépèKDDlFjòEwCWQǎsMgěQp	TRUE
bUMnaKKDnPjBiGěeHmlrveLp	TRUE
csdozALPOCNlǒèQYéòmXBǒDn	TRUE
eBhbuěUKéWqàéZctòeǔCLSJW	TRUE
fYSTǔPaěABJLmtSfDVIkQQóU	TRUE
gwAchznIeǎúbJPǒBěsVsǎFHe	TRUE
ièLHLMSNúIjXfuAMHFfSWtPN	TRUE
jOěwUSóJoihùkXUzǎtivǒZúó	TRUE
kjkHPděfNOǒgdúKybpúFNENL	TRUE
móZRǎsTKhzIacàǎXXnowAlYT	TRUE
nCáZeDǔutFECàYújZlCěèMCe	TRUE
oXóùTtoOOásWFèkàVàěWfAeM	TRUE
podEqtdFlrLtqIacGFTiFmiě	TRUE
rDWtùrrPGMZbBěéààRsóVJyo	TRUE
scǒlDncsiOTEvKlěrAFjRDàp	TRUE
tlJěcòGhǒjwRlLpówTVèghpè	TRUE
vǎòNěvHǒLEysùTdBuOǔjqóbb	TRUE
wSklLVxgFXhbLóGǎúěQVJWèv	TRUE
xTeetǔOóKtrócUfVOǒúmùǔpR	TRUE
ymbTRPgoònTsǔǔwafeHuWKúo	TRUE
ùùaàxvMCtNuófdOpzfWggzAòD	FALSE
ǔGàǎúFwuajǎǒMmAǔOYSvTDUBn	FALSE
ààaèqǔjzěWǎKzzhYusJjaéǎeJ	FALSE
ǎVWCaebǒpPàcknqpnJfenúXwǎ	FALSE
èùSHGèuaáuWèǒrliúwEfěTpjC	FALSE
ěDptABzǔamXDèlKàúBjEúvkǎv	FALSE
óaláMqeǎǔSbUBǒQwMSùùétyrS	FALSE
òzlCaIájfóNpòieóemxéFoMOH	FALSE
úúayOeWQùmàùòaflaěiPmydǔn	FALSE
ANàsuTRLěXaéheóIbgndǎBZWP	FALSE
BaZUoowǎúsuèTěYgwóOVùpzQE	FALSE
CvlóRtrùMaǔHlNHVLGǎdùWDQS	FALSE
EFaWoòFKJaZdRVOqwmlEkVOǎB	FALSE
FUnIOaqòAleúěoDWPJfHazTxK	FALSE
GmòaOKUeKJPdrloRxUFGsytòb	FALSE
IǎúuXTSypZQBTPaóZhǔúHNMIá	FALSE
JEoGPaiòEuJóprHLIUGnTclUè	FALSE
KVFyèaiǔtèWAqǒyoYyXgǔněyb	FALSE
MùlxyKCOadOoRbRkShULFǔěAR	FALSE
NAQayǎZóDWrJhǎzàQjFaUaEáJ	FALSE
OMYaǎHPùRoRBhKjUKfóRǎòQWQ	FALSE
PaHEZBNlImáSèèòTjmNPspEvJ	FALSE
QtpatoiqwoEòOnùIuédqùàTée	FALSE
SNlnǎZèEaǎóBDánfTKjuzQnbk	FALSE
TYGuGàVQQàaVitqjjYeVǎRàpy	FALSE
UaEùgúKxUWsuOXArùVùáCAjYz	FALSE
VqǎPIùBéǔIvxqxǎzCHqvaKqru	FALSE
XěǒCǔFPCùKyJǎaGěFEjhIzùqI	FALSE
YTtXDIáùappReègyEèédsǎúZt	FALSE
ZXXCTèIéésYWXauqsgCàNpOGx	FALSE
aǎhpvùrESfASDLkQhǎbpCǒyúò	FALSE
aúqǎsHvfsdYtIDikenhjjoàèò	FALSE
aIKiZěkqGěRrǒálBǔasǒryèZo	FALSE
aPézCtMKZQǎgSxùófCvRúPFkU	FALSE
aVUUIěxHdǎXJáùoEIirVauKnB	FALSE
aeKDmJGsnMMàMkxsǔvFúLmrCǒ	FALSE
akxùhoYQJZsyTòxDKNùnLznsW	FALSE
areùxhàXcGYekxZàǒJodBzLvQ	FALSE
azǎIYCǎVTsHhUgòjpfǒqRBUmF	FALSE
lyxFYéJKadKzSǒpDLIgKòVzùG	FALSE
nLúZsnmóqmazWàjXpmàULrMàc	FALSE
oltoaqévtéZúDKYùSjqOnkBàR	FALSE
qàòWvFWUIsLpèuóLaGléxǒQLM	FALSE
rEaIfIfiatQcNTJLxIěewháiL	FALSE
sUUajxcKqFQWxVeeyUYéyFòLX	FALSE
tnGXNAǒQZòǒFòàQIzpartakéO	FALSE
váPàùWyaěfèPZgdjvnSúcBòHn	FALSE
wAJěYAaIxYXTzuqXrHwTYSQùS	FALSE
xJNaěùùeRsUetHàwAFFQKANKa	FALSE
yaèYGoúLfhAxyeTGhhSǎFSásw	FALSE
ùùTóHFUqúBLnkWfVbetEHéiMT	TRUE
ǔARAQOFfnClVàmQwxǒpVawtóB	TRUE
áJǔxxrǔòYOòǔpIóDghǒUMùCǎQ	TRUE
àLecEVúPǔEqhPeééuDAějyǒTy	TRUE
ǎgoáùYANbaléiHEMnjvBDRGZD	TRUE
èóFéIeǎEcvqUéHǔJQPwIdfnWQ	TRUE
ěSòLgóNQběRèubsdòǎòvǒZjOM	TRUE
ótěěRSMéHZdclBVHwHhHNRycá	TRUE
ǒCfGsQBEwfCánmrpepúKfKáhs	TRUE
úbEzúvxǎPdéfxTmuájnGHhúDo	TRUE
AqYbcoWHòLeówtXOjúqviCěpP	TRUE
CǎYPjLohcéoQǔKPjùòdpGEOyq	TRUE
DKxLczDcràxRèǔEùknLKQATxM	TRUE
EQNbVěhjaWdóǎHIáòSYwXnvmD	TRUE
FcQLusfwnXYOBeqscéǒlUàúqX	TRUE
GkYzbtHèLOwópAvǒIkQnTKQGà	TRUE
IǎddBoǔaxéZjùwvúQhrbáOAáA	TRUE
JQeàvlǎVkúQsdzótvLeòDhùcE	TRUE
KdsQnCRKqǎuxiJlSgéóboRGvz	TRUE
LrbmYǒáQèIěQxBazǒǎEiDiJfú	TRUE
NGwKóoRXVVòSjTJVYFezǒWhWm	TRUE
OWOmkpEwdèùiUfQkLphvNáeLL	TRUE
PfHSHFqtoúRàěSùSDiRDúéǔSp	TRUE
QyCIlEúkGUCwvěěǔyWùuLàIGd	TRUE
SǎpSTPCElKùZráAHpócfiELzM	TRUE
TYJKHvqBFTPZEeóǒoPJEkuLin	TRUE
UokUIoeTCUrgkPhbQELPfdfWx	TRUE
WEóMKCUhZzOIAAOHpbucWYǎyL	TRUE
XbZèZúáwBgèCNFúǔSCoPàFwuv	TRUE
YtdIhZsRQETPFǔawVPWnCMGkb	TRUE
bùAPHnUFeQJCXǒoYoevǎmnScú	TRUE
còàUSǎàèdiAúQetAVèzRPéǔpú	TRUE
dùdXXTLǒǒlheUNsghCQFfzNsm	TRUE
eMáhàpowpCéYàPIzénZkNgYòU	TRUE
feVòUblflámlggDàSéLIdkQjf	TRUE
hépFǒJHPJkASòfebolAEzIbóD	TRUE
iěópVhaidWgoZhǔAǒOAeǎLJǎP	TRUE
jézSRaúPhXvTkIGòNàIMQùePy	TRUE
kIúúDaKtMhCáIyagDqAsYFùso	TRUE
lgWhHCMǒMKMFJékHěmtáleyqT	TRUE
nǔCèǒèiOpQwMXáQNufFěGSHww	TRUE
oQàjǔSuxgeéwjéEIGUiWDwrjw	TRUE
pURxQúHJúMiùòogCrSTǔSyéáx	TRUE
qlóURáqgGéOùYvbpeImzkcTwE	TRUE
rwWmxUpeUxzAtNPOFOùGkHRLǔ	TRUE
tóUhsAsRSkPchxózcjLrPeZHX	TRUE
uXfVnfdNEpKhLGáKJnxFOcyǒY	TRUE
vokhZljhTaomdálqWvosJkTjY	TRUE
xEHùgǎNéFbǔóOYazYWpurRdvH	TRUE
ybNdójubàěézhBBPACuLòàspP	TRUE
ùùINùwXxDèxJaǒXoNtBhèlPhti	FALSE
ǔLXXaQáOklóàeGVfCNDDǎèDtkm	FALSE
áaofHtehécEyáIVXbgèLcICRàj	FALSE
ǎóXEaVòiǔǔzHUělmcMKnsNvBAC	FALSE
éPaKówtàEhàlOIKZèejYGWiàoz	FALSE
èpWayǔDjǒYǒCtóNOHsAxSByBno	FALSE
óùúèOúQMlvGwvaswZqImkEPMpJ	FALSE
òòGaùSiKirjlòWèǒVFTeWemáaj	FALSE
ǒOCCóaEóODVsJlsǎfZPWdknZǎT	FALSE
úVBǎOpwVuraXzZVCgéùVbuòohK	FALSE
AmlppXwYzówúaoiyeOJGǒjyWáC	FALSE
CErǒakBUùECiTǎHùZóAòmvjutl	FALSE
DUIwvFQaúèxXAaTùucCkǎaBdNi	FALSE
EZLIMYaHcZXfLúerJlVBffpMoa	FALSE
GǔxagKuWáéHmiùvóǒùěTàeESBm	FALSE
HCzaYrǒdAtǒfRmáKkUDèGyKQWá	FALSE
IaóBéJngFocRmEdizituTVAMRè	FALSE
JwèyèSaIOZVvàKSyróqdTHùcbs	FALSE
LNěèNakYqniuxuǒPJIxNháMUkó	FALSE
MaRCǔOòrrICVvnPmàáEzgjHóWX	FALSE
NxBGSBtaòMtvxBUDèANgCcKnOK	FALSE
PJMùaFpQqwnJétEtiBrQCNZfHá	FALSE
QmóJRùUéQnawUICEEǎuaWqHIlI	FALSE
RyUròèaaúòYLJUkHjyHEZPRRRs	FALSE
TMověsspaVkkMYmlzVLroXkGiK	FALSE
UQléyrtKnJZNLaǎoAúdúMNoùàU	FALSE
VUaMeVKSfalJcwRǔzYvLKueTAS	FALSE
WuyrKnBAuyxùWwVtRYawLocQxà	FALSE
YóMòVQQǔSUBaRGBljuèàuxdgJO	FALSE
ZGVaYoOTsèéOòàáogésgZòtKhM	FALSE
aàGpMúePCimlúuaXFGczNùòéqJ	FALSE
aòoàECrtEuGpòygGuOǔáNsòKKà	FALSE
aFǎoǒhLeXNuzveodùAJjAsZéǒQ	FALSE
aLtzBxDjóiYuBapOPSyyXòúCDa	FALSE
aTCèRǒzxxkADIěqXdèǒoQvafùT	FALSE
aaKZanNPǔgèèěupsCgGaPUyXáo	FALSE
aièCbAtsbKóNDxyTióòiwZsemD	FALSE
aoróWzóVppQèwmfKgpèPoFǎQQL	FALSE
axNOWqàOjedYOQIIouòfTWǒǒǒY	FALSE
lsaQOXàgwnOǎItaeJàèkpZZKKp	FALSE
nóRaWǔáznoqèyNuòHsVaeojólM	FALSE
oPBnRǒmùWoCBúaMnàèǔRéúCkzo	FALSE
pmLVRoPaqvBdIyHDàibLǔrfZxI	FALSE
qrsǎaqyJNsamtEIòèrjéǒJvJoW	FALSE
séPaCkǔeFchPNRuCzIǎftChoLz	FALSE
tUaKGnVkEnZmYrrJRCjěEHVHpD	FALSE
váagTaLVMIKLypFkfXějUóWVòó	FALSE
wHXGqZUlNBIǎvalEYTèESeSZǎD	FALSE
xUBRXJJèVauóNáaúvnEVFIeQbO	FALSE
yaRULǒtUFBeJLkúòRutpsDèNsO	FALSE
ùáYádVucgWGFéhAkniǎkDúXáUJ	TRUE
ǔóǒFeUvcòǎulPùěvAdNyoNszWY	TRUE
áYUrVhGǒGkeékǔFTgEcàzQOYcR	TRUE
àoVgSlàotèJGEǒsOIEQǔxjUéNM	TRUE
éóòusudòByQeoónǎWrqByuóúmó	TRUE
èGkAǒsEááXzHǒyúIvěMtLckěIe	TRUE
ědxZSEHǎàZcǒpǎiTtQoùooòMKv	TRUE
ólzXIeYWZǔIOtosgxIWfVKécAr	TRUE
òmVǒEtTyJpxNVcrHkádBzPǎBuù	TRUE
úEMàoásXàǔàKLUTgEwwtJtQèjL	TRUE
AbǎaVdófzTnùǎěehúǔùjSqkóLR	TRUE
BoDàQùnkWuoAaBVúáàǒáqSKǒNé	TRUE
DGRèJázdǎEPgyVǔbYbrùóZéuVt	TRUE
EhkRyzàuuxzáǔeSùyètběúbǒmK	TRUE
GáǎFvTTEHsctǎǎàHNaJzPFzILF	TRUE
HNwcLOhuJJRtCcnúpáXnUffKUs	TRUE
IeǎZPYOtWyrzUNIVVtKqZLchwl	TRUE
JsQUNFèòWǎHgwAfzgZZEǔSKGQè	TRUE
LòGéRNVtáryǔùDoEgJMrNpěéGL	TRUE
MEDHvOǒiKDGZOQYXhmJVxzqxèH	TRUE
NIiMhòUǒòAOXéPCióAzWéfUěbO	TRUE
OUǎùPjQNWMhIeYnmDcMàKDǎctD	TRUE
PqRPgbǔěúXacrZyKPoòzxméPQs	TRUE
REòYYvoYWNáqólèHǒrPGàǒIslú	TRUE
SecoàkXFBeyRPZZbSwxxpWJxjk	TRUE
TnáYbICoLèVENvcFjDCHéVGunb	TRUE
UyBATǒXmbmqbòSMRTvSǔhuǔOPI	TRUE
WKXèNáPPIgyùTWGqódbfěldòéǒ	TRUE
XchJOOlRAAǒLYzwOMǎYAlsGnzN	TRUE
YtubNǒedàǔúUZwcLlQánváMǒiě	TRUE
bǎTHRUǒTXáCVRǔóOùyúFOeTqXl	TRUE
cPjáfmFuYlésùEdxFòLxYxgTGc	TRUE
ddYvePmóhǒAertéMěVyùYDDaáf	TRUE
ehNuETQJZsBmxwwǔYúzWǒpOPóW	TRUE
góódeHCùPDCJxCǒsgèiáUZRtpá	TRUE
hAWLVóèòcyxXBaxWáǔBixIsYVv	TRUE
iNbrdtlBOTBVXCǒúHBsèWzxkzs	TRUE
jQláetǔKhcàWljGQYlVhEqKqPU	TRUE
kSuqiqwfCDZqPZdhTiBùjuvxús	TRUE
lpDuGCCHSáCiriyVwèHoDTǔùyA	TRUE
nKveeàUyLdpsěWolpUdSǎEuéAó	TRUE
ocMòúèGlCCNǎxROlelěaCitStb	TRUE
pkoyjJmVěuwwiCàNVImnHsiJAH	TRUE
qxOòQWGudkevPuBaOppOGZúbIU	TRUE
sěIxzrckgWěǒeVUwHSRFèMjwEè	TRUE
tDèjsttVnwULwòYkjeRRYTgLWQ	TRUE
uPAtCàPNuOgAlEùǒeámNvzUHmE	TRUE
vsfYNTssZPóKOIEdhImOtlMCxC	TRUE
xóèUzCUdètIěSrmèTVgǔVòHǔOH	TRUE
yWQgOnúétXcùǎlǎXRBnRòrqApà	TRUE
ùǔètZlTCaAQèvwùóVwXǔhùjúáKj	FALSE
ǔùaYUHDsBpcbàTéǔhPYbjKǔXfèù	FALSE
áǔZěùtwXlùREèùJVTEXnUQCǎaxH	FALSE
àDUúMǔnARaovXytcěNRUwǔkXSon	FALSE
ǎaLYTùdwéóeIbJjGBpúzkqRǎGZo	FALSE
éyUǔqNoOaEIǒiRUFAbJIPYxUBOK	FALSE
ěǒèaIdǒuOwFGáChgRwjcbeeuoCJ	FALSE
óOalreqCéUORFTqnǔàFCáBbyúFN	FALSE
òaěLBKVUéoǎTeVPafhRǎfqèIúSò	FALSE
ǒyHqoJaěxSHpSPjyùVIUQApgaPà	FALSE
AMpGùRHaiJcǔQcàAfhyOhlhePxú	FALSE
BaRArRCSXǔkTTéQùRLàRNuTYǔlX	FALSE
CxatynSwkOǔBsogyQùclzpùúmòF	FALSE
EBxǎqaDcSOòúUvKECIklTǎubiéx	FALSE
FTUNXJyvaYvEcsǒzJBQùèzxSejX	FALSE
GmITylYLNlOaRNǎjZiàGEwREJdx	FALSE
HynSòHxaQáNKYzKGYcbùCsKIuPL	FALSE
JQmpNXsaàvCwHoaxqSwQEfhCCtQ	FALSE
KaYVráèrlNmxEVxQGSěǔòQKoFDz	FALSE
LaLyAxjEXězZDàeHPSFhèqgiZNV	FALSE
NèǔxǒBěaióJváǔDiótxVqZvKecb	FALSE
OUlúáQZaRcUrZóZèsvBWUfijHwu	FALSE
PaDǒLóùRZNùhXQbAUttozlWiùnO	FALSE
QoXaBdYypoYinóFkzEtoDTCfVkL	FALSE
SǔrèaAěqgscykyOrHyBjGWrteQb	FALSE
TèNKIúaCVwtqǔRèLraoràdzQlNz	FALSE
UQYxacXǔvIDnptWFDABzéajzAwC	FALSE
VswBroaJSeccYUwKréDZJBǔúòrG	FALSE
XěUatKòtBècqLpEDzEDǔvPcyLTk	FALSE
YIqavvHBrúIjeUéqǔIhCTòùùeII	FALSE
ZGBahCqsOJDóaInJQIóoǔAVlePw	FALSE
aánSMáFmXěáruòǒwkMVGFkRKBvL	FALSE
aúlQczAPGToěmcLICáXàwVQRYjR	FALSE
aHVliXwdùGKNEMcZvǎUtvRbvZgd	FALSE
aPVCqzXBtNlòFMsZsAiQowMjMRi	FALSE
aYGèAAàSfjOTFgnémybOFFydòvz	FALSE
ahiEXKkóZsLkrrIàgQyJDvOúoCá	FALSE
aoBéZhFZEykVàXáoIXrúKéǎrFio	FALSE
avBFéeGNJǔǎjdKpVSǒèáěIǎxáúà	FALSE
laàUKZJHhziDoLDOIàZázwùěYBǔ	FALSE
mamuvwtAfèkUǔàǔPqzúAgDMhFCh	FALSE
oGòpáóacwrvzSORàGaKTFYMEhWF	FALSE
paúIYúǒOlhseWóòéJWUEryLǒkzz	FALSE
qaoǔrùenDéoamfúSznyCQEsIcfA	FALSE
sòaDgrèsilRcǒLàáaFLBàJQkEGù	FALSE
tUQǔIaEòOaIdHjPzǔùěysOYZbFc	FALSE
uZIyaNuQǒàDKEZBDLsuIóYàjqtj	FALSE
wBPaPpRèNUpRfFEèbúHOlXphYjL	FALSE
xarKFZXIYNOsTrámAoYAWdMZYén	FALSE
yqǒěOyxzaúòvWFmHcùpVxLGVoéG	FALSE
ùùedFǔóBǎtùJMUéSYblǒWSiCxep	TRUE
ǔCwkJMprBRòIrqQGAzxǔEBcNerK	TRUE
áHfyěwFvSXnyTUhkNuOpodlBBUá	TRUE
àOùàUUǔègèiPyqoěiGiXapskWsk	TRUE
ǎdIrǒcúéTóJyòXIsWbLTuzMRnlQ	TRUE
éwcǒxXezLqRóxxǔCpaBózLMWvǒT	TRUE
ěGmNKQfACGúàuHǒǔgéúěXSIBúaH	TRUE
óbyXrNóoěuěòěFǒlúLóiimsmvxi	TRUE
ǒéSdTZKrXuOǔxWBPrTSEpfLGCds	TRUE
úHndEVlǎazǔhgbTaǔVùdZùhDnvo	TRUE
AWcqúécúòiiZhoPèáWQWNvnIkPá	TRUE
BihINǔóeǔNQIwǔPGURèěrVsRdMm	TRUE
CzǒbLkHHWYbqAQcHvEVmoXúOǎmn	TRUE
EèxXǎZOwZmúckBEUryWfCěhrBNT	TRUE
FXqWukódhxǒRlhHynyyConGXgéq	TRUE
GnjUwRǒěZQxONGúěèeGFFjlJAzl	TRUE
HtNYLMBǔUfǎWúJǔlfuKIVanrzǔo	TRUE
JDytWnàgzKBuDàNIúxOúYlyirúP	TRUE
KXVrkǔSHvòUyNrdvAATvdgtkàGa	TRUE
LsAoRjHYMàDHqùéARFlqFùkgèHW	TRUE
MyylPpCWtkiVRyHQYyrTzRULěfq	TRUE
OCIfZQǎvnEsYHfdidpkáPmbEéLD	TRUE
PhyGKGXLáèIòWWcèáTǔMhFMeèqǎ	TRUE
QytSGIǎYzHǎgykVMOběUQSUòòàg	TRUE
SAmlQdjZówárMzYlǔgoMHYfòcXr	TRUE
TUoGudcfiAPgTIqsLymsUizxPHp	TRUE
UxiùáZělmòUgqcTónDHdPGRdHvF	TRUE
WAùBNkJDWyvjTbèèEéjúmSvImOj	TRUE
XcCDgcòHzZtFGNdPLGěVpssYEEK	TRUE
YqDòfzElòmTgěclèFàěVxǔféèou	TRUE
aXTDSxbèùoóSaJpHǒRptǎeMFJrl	TRUE
còzoeǔtǔzxQBqǔKDSlNbrMáBósn	TRUE
dSlúxIBKAlùPbfYJSehpfhúvLEO	TRUE
eWnJǒQSMalXAàǎwomZTHFVdcjWc	TRUE
fsàiuBCqvwoDòvluùMDěkZVǔSCt	TRUE
hBdépǎeMZúqJoówpaùcgqXNoèhg	TRUE
iHIONGywdHlomCóxéWeimrmrJew	TRUE
jUnáUàGácwúIuèQxělmhHiúDdgx	TRUE
kmaSqvWprZǒefWúsáǔYGměFuNgA	TRUE
mǒfzqFbEQaàOZPcòpBFXǎOIeDdi	TRUE
nQWKBpiàDBèbǔCWCùoAáaKLHhnG	TRUE
oeGǎrrVlyUBXWùRgdHàGBMofikI	TRUE
pzVNGkNdùZQjWèRàANSORWjwuéǎ	TRUE
rBàAPeoDqtQUHjbvPuhějXZjbně	TRUE
sKecjoègCKWèsMǎFnKgǔqkyIBbǔ	TRUE
tVěèbRXsRLvéXmdKZWKPEmǎBEáO	TRUE
ufoTNUOiXTzRUQJYEoùXNmNYèsT	TRUE
vnXBésnúDǔUpsùlXeZgYDByyuFF	TRUE
xěBdPoPMNpSCǒNDqěHmnsYgaAmg	TRUE
yZZcGubhqèfcrSDNqǒhèwhNfaAN	TRUE
ùǔamàfloàHaCAufeoflOODáKoTkQ	FALSE
ǔJEvJsyVoéDEIazóǒcvǔTnuUǎEZǔ	FALSE
áXSGEaGédetfiboTqywXpkqDUlùD	FALSE
àvǎSěaUkZfxIòXABbǔǔUOKánúuPX	FALSE
éěAuQoVTPǔsavNfDòuǎYjVVIcqTl	FALSE
èEuBWaHǔègúoCmúckiHóZòówWaxi	FALSE
ěTáSáwvèDqYtùáùYmvxDǒWěasQcé	FALSE
ópaWCPztvgǎSáèteIòtYyMbgGàUA	FALSE
ǒǒáGUéyaqBPlòJàávNFiwVòpǒUmu	FALSE
úVDaékLYfǒKsRBxhhFǎmǒyDèóxuf	FALSE
AaOYcOJGHNtTTúnǒYPJgyoiApOúǔ	FALSE
CùòqaòiKImFàUTQBaTDpzǒHdUlmZ	FALSE
DGOǔOacudIQsBwǒkǒàIòruhPOPRè	FALSE
EXaSyxdlbTtffséEróIQgúěnmZYK	FALSE
FaMArHùRhóOKJěcWMGǔxCzHYzSTL	FALSE
HéJEMmatJRsGWróòaéLHCvzèáǎUF	FALSE
IKaxGMuDQózLFcBiKaYRESVúPuXP	FALSE
JacáèWDbDǔFyUdpěǒúáVátcypěǎG	FALSE
KqoTaNGplěhJZáGyLYwythpcSèyo	FALSE
MáRVaiBòTóFIúápòCrVPZCWJggEt	FALSE
NKTóaqwqykZHàpvièNácehwEOmǔA	FALSE
OaqjkbEǎDXMlURJóbiclRrHnóvJè	FALSE
QGYxèrǔááéaJóvWNDOMúkòwmHqIZ	FALSE
RNVvsNLàGǔěalhǒoNgqYXBSèvYYJ	FALSE
SaUpvhLnNvkZTMYǔPzòMUjácANdU	FALSE
TpCSwsIqDǒLaxNXFmtaDrDrMjRNW	FALSE
VǎosadDKRMdgBǒHmoisRLkoqtuǔY	FALSE
WDSyàóòPaemuhuèAmqrfǔkZEiáMb	FALSE
XRRBzroHakFǎvyTóěwHkisvVùGii	FALSE
YXéaxyiJTSCùrǒzMTBBǒeUómGwrn	FALSE
ZuònuRLUFoYǒGùagFxfyORZǔóékL	FALSE
aěsǔiajòoTǒYwtècKRLmbfǔáTvTě	FALSE
aDTQvUdiúGSsáqyLTMAuDuikyJéE	FALSE
aLEkMbhzEěmtQFzòqòNǔOVmKgrWV	FALSE
aSeyàTomùamPdtNKhóeǎyhǔmhnzB	FALSE
aYDlihVcéèfzmghpuVOlùúTUtàot	FALSE
aflRlmbDiYWsdCYuxgBrMAnóyOst	FALSE
anzmětGóLéóvUjǔmbnéóUwǒNáBKJ	FALSE
avmSkóàeFPxeZúPBSpOOàùIjEPNe	FALSE
lavèwwaěUsHèKVèKYyAkvLTaèXWk	FALSE
mxéYBéYWmtCAòNaztǒmNlonéWRWw	FALSE
oHBòKpJIXpPNarDryXJGǔHsSNHEc	FALSE
paoVdZeHesUQEevLàMZARǎubcTlk	FALSE
qvANǔvěalHcUdXKbBèIRgtóHfZKà	FALSE
sùMèHajjàGtZěSQqsJSVuTNHblMu	FALSE
tBáqǒIuacàvfóMxxdUxipgIgXKrG	FALSE
uSYězQǎaJBTzWBkFNǔSvofèáúIsV	FALSE
vtaèjOulGzèCpuǔDEntgUǒwFWmXg	FALSE
xJlyOwMwaJOěghèWfVLUvCEówwMQ	FALSE
yněMòówCúèaúázaAyLUkǒqJáYècE	FALSE
ùùbnúDéǔnáJdànNJSZjasRěJJAAt	TRUE
ǔèXNwzsjZPmvvLájhUQRáKpàYeoS	TRUE
áNeVóóRGEOGwYIUkóFBJjZIUTLǎX	TRUE
àbúuedóbuXQqbáFúěoPVJúvrǔǎir	TRUE
ǎetOéEǒvENTZIWCJgWHKèzwvxlXu	TRUE
éqeNrwhIFBévóéYàHKuaAǒGfóEEM	TRUE
ěéǎlPSYbudTéPúóCkpwvWHhSrCNj	TRUE
óǒSuIHuNSiDzxcěgEùPòmwZeěmtè	TRUE
òKFúpxidsPoNgvùózApRDNuSwVfF	TRUE
ǒdBùlùòuVcògXylgzEyáǒEěxkrnz	TRUE
úvqpwèetkDYèfsGNánNbòdCkXWcv	TRUE
BAiCLéaúVWWsǒǔTǎTLyrcúYBtjDf	TRUE
CQDVqsQUhbiUXQDsHCfvjcCBPǔmq	TRUE
DsJLhàxFVxcHLEttpàgfuMEgPCgi	TRUE
FGfcGvVhYnXúXòLwlebAXgnHqúLx	TRUE
GmQúEVjSIIDAlIǎaYHǎXǔOkpDavc	TRUE
IěiMnEQǔVZZJTzsQhUDěMiOiPHCm	TRUE
JSkoǎǒqujúimOnUmaNóTkdlǔTSúD	TRUE
KosIeLrcàvòBkwmKdTccPIgXOgXB	TRUE
MáhNDiàjjfuYVjjyGmúlBWOWAMlL	TRUE
NLczKNKiOoùooSWaKYésJMVGvsXq	TRUE
OpFxNhIòKeLieúěWYdednkpfbúrg	TRUE
QééfùWCryLzòùàPBkXDliǎEPmátM	TRUE
RAVhXOxZAIoaWàLoXPkYóIRgézJò	TRUE
SeQuoxrǒNǒQVóDaJuFybZWiRzgùL	TRUE
TqBHVCDJENGEoFǒVècNódjGòáBAT	TRUE
VěvuvznáFNàěfTNtǔGaeùúótawfU	TRUE
WJKNěSnndéàkKóúsnóèjRPzzépèh	TRUE
XWNqDuWtBfòOòcuèyNMCmměKúUMz	TRUE
YuFZjàǎFóǎQěKfNOVVLTLpoNipbp	TRUE
aéTbbósqXqlDFCwKCèùfzisRhàAè	TRUE
cǒóihàfXPJùAKDkElqoJaQáeFKRX	TRUE
dDDknjdSVjRzciRpgYtVLgzNHFcú	TRUE
eQǒfIKiDJjyfaǎèAtòTàrhěYáLùO	TRUE
fSáqUJZUHaRdOdqGvsimánáBěèoc	TRUE
gYCúBqhgfówranyéàVFUNgGéFQqY	TRUE
hnYhuESoOábNQcǎbqǎHyLfGOxdpa	TRUE
jǎèWwXDòEKBǔErxHlgǎyWJéseMpN	TRUE
kGTmljMZJQxzésxllaKǒPkvtRkVò	TRUE
lWǒvYxXEieaVmZkxàzvFǎZuktTxJ	TRUE
myòJDrzebANrBǔǔgkèBǎúFITGqth	TRUE
oúùKXsCgHZòójèZQlSwRYBQcàgfM	TRUE
pdǎǎYtèóVèkiàmésLDllRèseCàBú	TRUE
rǔsùENdNvgFvEPkxàaAPOáEpàěǎX	TRUE
sòpFyVéqhjyGtéósiSNWǒKiynápH	TRUE
tcRmlhàuèjgOtHYaplHTnlěGjXPu	TRUE
uuábcSqcpúpwNFáóeǔǔǒJùAyvHáv	TRUE
wàixOQUáVDDǒèǎHqòCèQJFwècwnó	TRUE
xLdéQAòlZWvOrhQǎéěwěazAkUàeó	TRUE
yilHǎFEúhDsUtIiSNTKBbqzuYUjě	TRUE
ùùSCVlZFVlWyGóTHèETWLFStHWarw	FALSE
ǔúaUCOQuxyjqBgkdVèǎnWAqátWtfT	FALSE
áXǔavCyXWàpyGóóITsFovvqEXVxBR	FALSE
àlMězMHvpáanxSEsiǎfùèwOkehxǎo	FALSE
ǎvǎaTpKIciuEFGZoiJTfAIiFiYXTm	FALSE
èCSòLóMlapǒxnOúuěnǒAGNóúúmGfq	FALSE
ěWWIúAyyzròóKaJZǒXCyYDCIèHetH	FALSE
óxpaEcYZXxIùNjIyùqWvaETnKdxTa	FALSE
ǒópCǒúmaǒnXSqBZǔVQaBaBkdCDyaA	FALSE
úúXPXǎóWùalUàěGxKdIzGFóhXmEcǒ	FALSE
AYXDXaFxálSXdvbANeMxOBCWgJAPò	FALSE
CúézsUrxKMǔówHǎawggXwPxaTáùRt	FALSE
DJTǒZagAKiXèohgNQciǒvaWSyiǒok	FALSE
EUòCMakrDkěiXJsdPouPuárNXolCJ	FALSE
FwéxaàCeZwZTVěóUáIàuséúpDpGgX	FALSE
HòéNáuěOuFHǎacfgempèNwúaùQǒSá	FALSE
IPsǎúyxóasXùItGùLOtfWǒòdcbútú	FALSE
JoaǎQLsvèeMVAeǒEDzKnaICIqanòq	FALSE
LěaOvuKfgjXLǎqAwTLSSúQAAMiòrI	FALSE
MNsGòTáIIUAGaǒjutásQJùAòWLzZx	FALSE
NsavHKWBlpùǔBèBzúoCénúétcyVúk	FALSE
PǒNǒQyBqQaagEXEqwvInqvOHóMJùr	FALSE
QFúaIgUěKiaVdQbLxQQwǎlvViEǒbN	FALSE
RXNFnBBèpEXoéaKwàhJljWRrNSBwI	FALSE
SmluHxǎuzQahòvBdǔóxqOǎyiàwmCY	FALSE
TxNDxXnBTǔaèárNFJòěVtLDáyiQkb	FALSE
VQàaVQwěóYLjèùěǒBhdNurYòPjYhR	FALSE
WaeǎQCdUjTěóéuDfwPòeVnEcbTyGj	FALSE
YǎINavréFheBsJHHVéBAQùnróǔSBX	FALSE
ZBoLxaMXxúcgèPvoFěǒkvUTǔWjúNa	FALSE
aáLǒRscERZJoYogwYééWǒcMmpvuBW	FALSE
aòzhyátvnNǒDǒdyEecAGOxwòěJZQd	FALSE
aGWaJoZkNvycáVNsěqUqdmRsytKXR	FALSE
aNgDUXeuHvVmlhUyEJHRjELRBěZam	FALSE
aWigùjùLgnwNFQcHyXqRPǔǔNnICjǔ	FALSE
adZFóTEcTTújSOfLBAROKhǔjwDFàY	FALSE
akǒǎcósxsdHóSòLCIyCySZDèùsEǒǔ	FALSE
areNhhgàPsGsLǒXAzrrèǔěěSohXùá	FALSE
ayyWgCYfIdJFOVEWIUàdoAmxqǎIXI	FALSE
mǔAǎMǒmuxalěáwàzKjKòwEcvQLSMO	FALSE
nACawdAjjBGIxqěuúJǒukTUbxěèoA	FALSE
oaàómfǒyMZQKCLvvóQǎzqNZúgCáàu	FALSE
prSLNPaúáěrHòWDeàáùBcKBGOwòxà	FALSE
réDpuěIqJawéNBiUfěDCCRcQpááóa	FALSE
sOóaqolovZEtcoHoAeDàrFBsOHǎǎú	FALSE
taǔóHOClggxDPBnjKwJanprxSDUèo	FALSE
uxǔCǔVDtnòHaóCMEUikibòǒúKàhSǒ	FALSE
wèCBayùIUYuyǒáBúJǔraScàMFXGtH	FALSE
xGavXzAGǎQLòmiRpemèlXxdhxSCxa	FALSE
yaJLtéOYòTNaCxejgǔbdqiAQuLfjb	FALSE
ùùoérDviTcláqVoFXtgùǎGgCùépml	TRUE
ǔěWVAxVvfèeówqfFPybtěTmMáHwwě	TRUE
áfGUqBècNzZGnwvHcZxětrdgvfJzV	TRUE
àrQLMHOIeBOúDPFXǔMMséBèPENQdM	TRUE
éěllpOtZTAlTZbjàégBtúsEvBabCI	TRUE
èOúgòdYóhFAOYphAaèzMǔZxBzqúPǎ	TRUE
ěZJnTRáIVEDxAéyThUHúVòàXdǎSgW	TRUE
ózLùIèzXkMXBRwJNtKQsěnWàMyhGg	TRUE
ǒLBáFvéyùzqvivǔQTrvjXCElzpǎùè	TRUE
úljèèópxQYaóBEFcWtóoúYǎMyùTQd	TRUE
BòòpLoàǒDWBfùQWeBiDIéěǒSnOBùk	TRUE
CYúRoǔxàrúèVòbdBěyèJcùwrcKSjz	TRUE
DvòLégvdeNUwSwèqWGUUTómqRMCWZ	TRUE
FǒGwPIeBlTkZcéěfPǔGǔSHdkhyZxK	TRUE
GGBcǔtǔSdgùèQuòRwjOěeéIHpǎtgS	TRUE
HRùJNFHHCSQCMbWǎysdPáisXivZwQ	TRUE
IhqTàGIUPiISùqLàěùMqèlWòòWlWw	TRUE
JwběTáùOWEebQEMIwanVGDFEuááwe	TRUE
LàǎTsDpLUbAscfkYrèWěǔRqtamyNR	TRUE
MóylcxscowNOXTlGpFvhlfQtsóòme	TRUE
NNsPqylfYzúvgáXCAZVèèExTracWó	TRUE
OoǒuSlóWkepCUQhfpajJtdBGohFRj	TRUE
QèwhoTěEglzEFSǒàúvBBfQfyffehè	TRUE
RWlDlSMBfgRjqtdnbxlMHtNbceysù	TRUE
StwBPlfhKTLjTúIefLùjkáDvoOzéó	TRUE
UòwDEhJCFèFboQěCNNoDlcenùYǒkj	TRUE
VFAvǎWAéPòtǎkèUdaliCǎbJlóNOùh	TRUE
WPWBkMtSIèNZhVRFèWáSiókQRBèDN	TRUE
XZNdXěSakúòqKvGURVaIwNwIpúxyh	TRUE
YhhǒàtháZcúòxKBYRKAJróOIJújpG	TRUE
afǒsJátSyòFaéCXOnpRětATEGbrrj	TRUE
cFsSéúFMqEááugqkdYGsBbpUCIjùT	TRUE
dTdPdpWkaZěKǎoěèòóYGwFàFbHúBl	TRUE
eXDTIiXEXexěnTSYwZbàrqfǔEQrcN	TRUE
ftEvNúAhxjDFZxxUvBWfsIxhèònop	TRUE
hòòsZmwDCThěXěWàJngbèWFQǒEZKA	TRUE
iKALzfmǔóaUolsǔlǒzuùIùǎáKǒùòǔ	TRUE
jegaeLúaToAàPǔTvBxxèLJhòLAnXc	TRUE
kródásiRUVDRaázehǔkàtwubIMQyò	TRUE
mEjwOcoóZáfBcúeuéěQNéNdèIVvgr	TRUE
ngBVqdUWqyMqGJsEòEóFEOXbMǔgSO	TRUE
pǔóPNybòěojCopUbjhèénOefwLIUà	TRUE
qàLpXRòsèDKjkduéRvFGXVWPFtyáf	TRUE
rJktòvKfmfúzpuLHRVtbHIOZhBYDǔ	TRUE
sYkYWǔKúaúFOtfǒgwYIlHENSǎjhQe	TRUE
tpáYùACXSUǔJeèǔwrpvDVCiáoěááD	TRUE
věkkAUěPrJyhtpáHpIdwANkGKóegX	TRUE
wDDsáYonJDvǎdmQZhěDkcDSròZiPy	TRUE
xTéOǔCáoZAZKpèOááveYKùZZQMYǔv	TRUE
ydVPoGnMqúpFpqàúósOZùúTàFBùSX	TRUE
