ùǔaagfaauáaHoVóaanok	TRUE
ǔaZmPalHUSáeècaYaaaa	TRUE
àITaaaRěùaURayaYSólG	TRUE
ǎpBKaaWaaCaàGadmúWOV	TRUE
èaLaaapóInKómAsaYaùQ	TRUE
óǒaaXùzuXxQóùaKaǒaàa	TRUE
òaaoPaEOaPNropSEaaCO	TRUE
úCaMúaamaùEPDEaaRèrW	TRUE
AaaTaGiaaKoǔHyyxéaNa	TRUE
CMaaǎaaàǔxúPYUaěEmOa	TRUE
DyaaěaSaǒYóVaQoalxTU	TRUE
FYèaJaaóDaapwǒakǔòǎO	TRUE
HPaQaaUaaaeTéuEhzJGZ	TRUE
JózaúaaaoovvwLASHaaq	TRUE
KWFótEpaaaCFJBaéuJaa	TRUE
LqaaaǔtuAaaúoUNměaqN	TRUE
NaACaPpqDaamEpDHSaǔa	TRUE
PáKáaAaWaaUalaYèǎǒhE	TRUE
QVaamǎSyapazANAaagvl	TRUE
SèaaěOaaǎzyaqaijǒEYX	TRUE
TVLQaNxaWCuoyaaUaAwa	TRUE
UrauaaaòaJYaXRTpMgKN	TRUE
WaaQaaKYNórxǒpyvaaéD	TRUE
YòalZaEaEDHaflaaǔakI	TRUE
ZaRaTàuGVMlaTaáaQaEg	TRUE
aàOmaVtaDPaWzaUaǎǔfè	TRUE
aěqLrxaǒMpQaaakǎaXVa	TRUE
aAaEayFQawaUmaAPxAld	TRUE
aEaaèaQáWGaUanúCNifF	TRUE
aIaaaBěaawrSzGùqéèJl	TRUE
aNaataITazUcNaAùaahD	TRUE
aSaaEJaKǔùNǒúósaGAaP	TRUE
aXDyaGQùyayòDnaaaBgy	TRUE
aaěùaòYètóaxtaòXajBó	TRUE
aaJOǎtWaaVqaPpmwtatC	TRUE
aaWpùòOpTRRpaaDyaaéz	TRUE
aaaaJmIamaéúTQHKTTyM	TRUE
aaqXǎDaaaóoanGYkaUkP	TRUE
amaééawaaNUaúkWBLIQá	TRUE
araěǔQaaémaTagmoZtDm	TRUE
avaLmBGaaàaaJNHAnlSě	TRUE
lǔzIoaaaHxazǎaamKHpó	TRUE
maàysaéXaǔFzQarGAama	TRUE
oùǔZaExaRaWNvGSaaxaj	TRUE
paaXòTDaéaUaóéIǔaTbO	TRUE
rKaTWRayYTtòRaaazaQu	TRUE
ssaaaaIGéraaláMULMvt	TRUE
uaJaèataaWJtaùHúálGè	TRUE
wHGaéWmawǎaSRQaaahúB	TRUE
yEnaaaazáúaaàǔSiéyEG	TRUE
ùùáBelqehúpǒúTùtdltZ	FALSE
ǔAáxěàBJǎǒUHpfTùávEb	FALSE
áUpLVùLúRGGaècolNǎXN	FALSE
àwwcfxYFèXNqYKrvBhNz	FALSE
éáHzzUéKLTèěyqbAoSIv	FALSE
èXfULDIXkQalnBmHfXZa	FALSE
óàBWPsBLtBRdSWhTǒáqq	FALSE
òCMǒéXàvIeaCRěWFóVow	FALSE
ǒbntéoàIlofIkZNèCkDp	FALSE
úsBVnWsRóaPlGiEǔuǔgV	FALSE
BAzǒTwUMZRiZIntóyudg	FALSE
CQàdGiYeZkFèNLVZVyTk	FALSE
DzZuVàAXdòzéLWcOpàěú	FALSE
FBPJXúSnrSTOǔUtUǔNfK	FALSE
GWǎOSuyóTBYeǎKùòdpǒd	FALSE
HkKùKcúzjPàCǒohxSyǎz	FALSE
IwYJúPCMjGéHSjGzwNǔy	FALSE
KúeǒùPvkYYNèyKWhRàǎw	FALSE
LJWěWQGKóJàaúuFěOóAs	FALSE
MdXTGJAPoDWeBUzrJMLc	FALSE
OǔBDěFPOmKcxhWTghexO	FALSE
PHKéUXtcaVqGcwQúqwèV	FALSE
QMuǔjóbyǎQVèwVSvAudZ	FALSE
RWJmSNèógrSzaKJoHRAG	FALSE
SiZMNqòUUdbUeAJAazùě	FALSE
TpnségYdSòMǎgJMbqáql	FALSE
VájnLBGNChHěvTDdUàvI	FALSE
WGóNTbcIWèǔUrRVRùEDO	FALSE
XdèIjdáJGújBgCGyxpUl	FALSE
YvMnúǔVvMdxjnsmelVIs	FALSE
aBvseSFdlYǎogéèěOoSr	FALSE
bMPqZrxUlǒProǒHFhǎNA	FALSE
cmqqáGèJuDuàtdrDamUǒ	FALSE
eBàSwzVquPTtktlxWúRS	FALSE
fcGànAFèmvreTdOFǒmZg	FALSE
hLOktàXqtNMNàZǔAArKù	FALSE
iiáCNěRèrIdúmùQsIMCj	FALSE
jzfIHSiàIARJyǎùPvNtC	FALSE
lHbKTzDtBtpúVAfQúHyc	FALSE
mZàTvFKiNMǎlXǒIjLyaù	FALSE
ndFùiuyNdAyJàdWLwsǒL	FALSE
osggAehnMòKóvyójQVǎE	FALSE
pwXlBùáDùFúqRENNóaDI	FALSE
róalIvPàfRòZYRǒIyYAB	FALSE
sWGFHhItwXbZàHuyàFvl	FALSE
tfápXUXNgYWǒMktǎcOyx	FALSE
uvssOǔBtKLǎjSnZVXHKb	FALSE
wBàwúTiTofKAvjEAmqlC	FALSE
xPxsáNrCXwnQǒOóàǒǎáx	FALSE
yoRuwùòiHKjùěLedineǒ	FALSE
ùǔXGRlaaaKzaEusTaěafN	TRUE
ǔaǎaǔaasTaáaDúgQYSFkw	TRUE
àDéaróěAaRlùYaaaáLYGa	TRUE
ǎaaYúaaǔwVCayAaSFNpYǎ	TRUE
èFRMEaaaaáuoFMQaùyùaZ	TRUE
ěaoMaǒqatKFLvtDKaaaǔè	TRUE
òXPwwaaaúaéaúBaàuzǒQH	TRUE
ǒlaaaUàaVaGaǔǒpújfRcl	TRUE
ARyyLanUaawXavrNaNYac	TRUE
BsOUaAVTzaraanaáaEoqa	TRUE
DaóNótuaaLraMOXAAGaam	TRUE
FAoaǔógnaúaBaIVUaaIaǎ	TRUE
GzaayWaaaaběYǎǒYbGYós	TRUE
ISaqataloqiaqǔqYWaaaC	TRUE
JwěòqCyHǒoùtaaaaaMaBx	TRUE
LaaúlaSùzapmaNazoNtFà	TRUE
NěuCavQnZTVaWDJaGaaFa	TRUE
OanamULǔmaIùzòyQaěaOa	TRUE
QBOMaElóaBaMQqèaatQaP	TRUE
RwUaaaáaavǎpéxJsacFhS	TRUE
TWpvúaNYBqaéǔǎaHaaáaA	TRUE
UaaaasKaòamoùgxBczRpǎ	TRUE
WaupDooóaaFDaěDéamGra	TRUE
YQàEAFaaèaDaǔIQaaXnuI	TRUE
ZaaGlJaapwàQmqWsamDua	TRUE
aàǎslǎaRaSPyaBnaagúlA	TRUE
aóHLéoXǎJaóWaaZmaaèTo	TRUE
aBIùǔoaFàUóoaRlaǒQaaè	TRUE
aFaHaǔǔlCMIùětěaaaOlù	TRUE
aJaUaàúQrHaaaSěEoàLfE	TRUE
aOIyaqQùalaKèúěTaǎaǔL	TRUE
aTYáNqaIzHěayǔaaalrém	TRUE
aYIaaǎsLaděbaHXaahèpò	TRUE
aaómNěMttaaǒarqAaǎufN	TRUE
aaNǎaJaWaópéRaZǎEvnoN	TRUE
aaaéVTaèqaUmatLXLmAls	TRUE
aaapaaGxealSQWVúaWkèè	TRUE
aavqaèaóùòBXasamtzpmw	TRUE
antxataáraǔUalQqaBudz	TRUE
atááaHaaMvnBXaPWTOEúa	TRUE
axaóǎmDoǔaRyWaùaaklrV	TRUE
laaǔvasOaaxzmkaomaǔyL	TRUE
naOMVZaaaMayǔáqaóYOnq	TRUE
púPVXSaaòLaZrGGaarKaI	TRUE
qaxVǔUSaPrPaAoatZTaaH	TRUE
sJàaaaTaHwWatèagbàGuě	TRUE
tqIaMázwaaYauGpnèùěaa	TRUE
vTDBaaGLqaaaIaqùjiLQǎ	TRUE
wzmaQamúaóónJEnaQXaar	TRUE
yaLuaDLAHalawaJRIàahó	TRUE
ùùvjLdDhBeIvHKfuomPéJ	FALSE
ǔKFOXCTMFMóHXQAcǔSMpQ	FALSE
áeeWZiBèHfXgLBùYqúúUB	FALSE
àtBǎxúòlCQqCyqǎVbTRCu	FALSE
ǎyhOkSkHyfhmqqǒzKNxkw	FALSE
èPeVótyQmcESJndzAeoNi	FALSE
ěwIXézYHkPUukJuBkèhaV	FALSE
òIOùOóSúVáUZAlBAoqúfo	FALSE
ǒTpIQyLěyiǒwǒdùfUyISQ	FALSE
úkEyùhRDjòsxábFěaiáMd	FALSE
BǔEdINěàKzOjLVMurěBRp	FALSE
CSùJFéLpèVrǔOAúrDsTrP	FALSE
DlFiǎtúsAàhQxùeIóyQJw	FALSE
EtzaǒwùiǔuLWéAúnwCwpv	FALSE
GCqǎZěZúMPpHójQǎáwVIM	FALSE
HKòNGǒJLTlFjKQAfrèISw	FALSE
IbMatSsHúPHláyMyRiLǔú	FALSE
JovǒcADǔpXǔlVKòòyWadC	FALSE
LòLmxLòKdǎǎǎZSQóFààós	FALSE
MHzaRPǒjbrGlCDhAèěNUK	FALSE
NgLTéeZZXfIPGdoGjXxXM	FALSE
OxrmtèXqBuěLSlFècCdSà	FALSE
QOǒCóDfJVúdLfdCVpGvSS	FALSE
RaUWBLncsItMPXyekǎhXp	FALSE
SwkNTdhěpjCbdOKisàěuS	FALSE
UéTdREròYmOéXMhéTycTú	FALSE
VIMBNrKSUùngòvMǔHnǎoS	FALSE
WkúaEáùútANEpěJVfFjIr	FALSE
XymàMFkyslrfCtěGusgMo	FALSE
ZGFěFǎělRzbddTPYòLjàv	FALSE
aPěúáBùhpryájěaQtAtùH	FALSE
bnzMeelBaeEqaWTRzpATU	FALSE
dDtstOHdKRzoVEXdZgXěC	FALSE
eIzǔěRxǎKeWIòHOWèdǎlò	FALSE
fXHúàCrúNgékbuěpCWBIp	FALSE
giYdJyùCWQjJNoePǔFǒLò	FALSE
iǎgxIèmYNxkǔèPiscuUHY	FALSE
jNQEàéVàúvyvQgRaúGMXn	FALSE
kjnúlRfòSobyagyZaùHGo	FALSE
lvaóuAcòXkhUBHQNMomǔa	FALSE
nFúbsTZtROGlVFDZfYlkE	FALSE
oZùCQvěfnóFáMSMPYěoqe	FALSE
pitfěpcXmUpfueRóqBclE	FALSE
ròǎwZMRMdUanDRXǔaǎúzB	FALSE
sMCtdLtějIéèuuYAóeTnR	FALSE
tgCǒEěeLóALdóFfIibgoa	FALSE
uxqoiuEoǔwbcqcǎliTiXF	FALSE
wEòqkYLMKwàzCYYuwUhDZ	FALSE
xQésvBPéVSsWdmréěnojK	FALSE
yonǒuǎfǔWJouxqExèfoRr	FALSE
ùùaDóèBǔOQúaatèaKyAaBa	TRUE
ǔXálùéauàaaawaaCàpCǔVT	TRUE
àKǔsLaaaáNvFLaovòaUKaZ	TRUE
ǎoIsáSaaaaaaèèéxèěJsEu	TRUE
èǒWarLZaaSaFEsaaOvtMvò	TRUE
ěTGKéúúEaazaǔaSaǔaáEǎb	TRUE
òěaaavSZùnXNQǔǎaaZmmaa	TRUE
ǒPalaaaEaaǒwRbògLbǎIǒL	TRUE
úoEaEǔèaNalaGaàRùǒAaSè	TRUE
BúJataaJrEsàaaǔLTaóEèl	TRUE
CaXQaDHǔJèMqaZaaáaUvás	TRUE
EèTòRaQaMLaHRLVFaKaèay	TRUE
FaLymúpXaAaDPaaxYDuPJa	TRUE
HNUáaaULSyàyaáoaaaúèvZ	TRUE
ItúázZaaPauSaavBaZHnZD	TRUE
KaǎúaaAaCYtMǒaJoàlaFKM	TRUE
MòalJaaaaamóIǔqpúCpTNN	TRUE
NaaaaNaJrILasmApsIzdUP	TRUE
PIaVaBCBzVuaKùWBYòapaa	TRUE
QoPùaZaFnaǎWGWIǒaEIaBa	TRUE
STaNgCBrvaBaèXaaxaaMIB	TRUE
UàPaazzampaaLVLAzoaěòy	TRUE
VaapRUaFzóǒaùnyǔIRLaaǎ	TRUE
XàvNaǒBSWazaélyúaAaóaS	TRUE
YTǔěZaòaaǎoǎaIQalaabóó	TRUE
aùùàaOaHDGJxéaaěSawIbl	TRUE
aéaFtaóaQMfLòAYcWaavMa	TRUE
aòaQNpIPaAqxauTwaaùeěV	TRUE
aCwEùprvHaaGaVFwavUàéa	TRUE
aHRplVaaaáaéEQaQHXSqgG	TRUE
aMKFayuMaxIaaaOQQRhàqz	TRUE
aRètWRaǒXVaKǒaZaaQǔGIl	TRUE
aWěRaawúVuùYaáXGltaúBa	TRUE
aaáXaVèqaqaasNXTéxnǔúG	TRUE
aaGcLaaMaapwsRQèaQvèWC	TRUE
aaZaTJasaVEaúoùuepEafE	TRUE
aaawBSaPaMèuRaYOlókNéX	TRUE
aawnvayazMénxPavaJOwQU	TRUE
aoFnǎyaaHlawaNóaJtBěXr	TRUE
asZstaROǒtaRraaéaViZPD	TRUE
axNrPaamùBQYaàwaaéájHá	TRUE
lvaapsaBIRaNuúVJěaabpè	TRUE
nYaBaxaxJYsIVPóěaaaùYM	TRUE
pIaěEàaFWlEwóHaaNDaado	TRUE
qrúzaàaǒaòTpatnaLSRayE	TRUE
saǒCIFèWYawěàWarWaaRaY	TRUE
tuaaXtěaàsaǎaLǒvXaVǒgǎ	TRUE
vAéaéaQaǎèwèJaGaaOyvLQ	TRUE
wmHazqDasèaAatoaùaNPlM	TRUE
yaNJépaoahgazVMaOaémaT	TRUE
ùùsPveDVpcokCdgIJdDgTs	FALSE
ǔRfufXǎducETMàqàkZCAPú	FALSE
áhvLúOAEwNdNxùneziQǎss	FALSE
àxwRèwǒpUsblOTIoǎǎRdFr	FALSE
éáUmldXLUěicVǒúKejSXPa	FALSE
èPUgáróUurqQVǔNyHUgáls	FALSE
ěeǒssKSùǔituYvyéoTOùOi	FALSE
ówBTZRJCWScKQXSbxaòLrD	FALSE
ǒDYFěBhiMǔXeósbònwPLQè	FALSE
úmvùrNnùSILuYDeqEneéqD	FALSE
BéáMYVDòivcaouHPtóúzhH	FALSE
CúváéèǎywGEDXMifUǒQNQR	FALSE
DLqtúgodgwǔmsWpPjjVLóz	FALSE
ERIZnqòǔDTòbuyáQGlǎqǎK	FALSE
FnSúPDQjànàǔbpúǒMukYDO	FALSE
HùlǒáDTRúéùRRhǒPàyJGXc	FALSE
ILúetBSǎrPTWàkObtNNKbv	FALSE
JtwúByZXoUpspsHǔkAJJaH	FALSE
LáTúùqtkqMGpwMIóbèPvqà	FALSE
MIGrRJèJrǒfryFhgeòěòqy	FALSE
NlroaFéwtgIuǔstúJtěAAǔ	FALSE
PèTROkkBYlǒNlVYùpYěǒǎo	FALSE
QNsuàǔWCFTóúFIbeǒluElX	FALSE
RgGUWMVTnáLVpǒXzáivNRg	FALSE
SgxǒJótǎIěLCmràqbejqcS	FALSE
UéaiWrCcxFjjnJEWIPOVvT	FALSE
VXIùóOdWLSòávhUlùoáhQJ	FALSE
WqtMéǔPqùHoěǎSmUbǔzIYS	FALSE
YòqCtzdUúrPúfKWxzospct	FALSE
ZYàcNdRPónUMGùěvYAěmDV	FALSE
arHHáDlJXKldYúgCdwyJǎà	FALSE
cǒZèLǎjxfUkNIHJjVtcOgk	FALSE
ddYteIeúDkgVOlOIUǔAtmv	FALSE
eqFMnOETóMXSàITěVBánDu	FALSE
géJsgytOěqjAQaLóvHòiNM	FALSE
hFǎdPXpShTàNéezvMsǎhǔA	FALSE
iUoHwHǔFǔěAéěppxètsVrN	FALSE
jmòěUhoiNVàUúmWOVcIǔòó	FALSE
lèhgCwUlXJKOúAcYSPgkyi	FALSE
mFǒuHgFHgQFMAixzkSáGǎm	FALSE
nSuclbjLqbcrWqdkOzEiéE	FALSE
ojiggsttiFǒégHeAksSAZp	FALSE
qùóVaèYdxquPoZiUZùYzJi	FALSE
rLmyPóLcqsúcuòwaWytaoJ	FALSE
sajYnOóUSKhCéZMFkylùsC	FALSE
tgzKxlKUgZgǔIBhROTWswy	FALSE
uxùkUCVRrQXXùóTSswKǒéě	FALSE
vzGVTeLKBóǒpóxhYtPjCcl	FALSE
xFázjIFWQHCDHjHòQàǔQcw	FALSE
yQpTèùbDwZaùBóZCwYfRKs	FALSE
ùàùaoàEaUsYCóaaACNsvana	TRUE
ǔPaǒéùǒròvamvaIaFèùJwaa	TRUE
áuVTOMaPaoaaòYajǒMNnaax	TRUE
ǎaúasóaPBaàwEQOpOmatWpa	TRUE
èADalvVTaYRǎaaXLDaaUDHu	TRUE
óùTakQǒPaqaaaaHKaGéóYRó	TRUE
òaǎáUanraYHHuaǎPàaHIaZé	TRUE
úàǒMáaNézSEaXáaaaáFRCaY	TRUE
AaùàRIaaIUGamapaòSǎAúYA	TRUE
BxaǎáaPáxMRQòaaǎAaěBazè	TRUE
DUǔaRTNCqaǎQCWaPKasèaao	TRUE
EmuPaZaóDQaaaaJǒQèXéYEz	TRUE
GaLraxaFarnAxXmOYVRaxaé	TRUE
HpaèavSQPsaBaaHUaZsFXFá	TRUE
JVqSJPxWaaòaQeqaaaǔòalo	TRUE
LEZVaaúáoazaNDpmnùvaaěf	TRUE
MoallaaǒOvéKwaaapuRókFT	TRUE
OQHXloQamFaaNaaCmagNOmz	TRUE
QClBaaZazKRaBURCamóaqNé	TRUE
RaFóóaèazramTMaaknaéimX	TRUE
TGaZnJxmǔzHaxúpéaaaòaEa	TRUE
UaaavKtyaZOlsuaěacGnifà	TRUE
WSaǒRZaLaWúaxOUMoSNúaaG	TRUE
XachòXAzóeCpaaaZrUaaaaU	TRUE
ZQaaaǒPèaRHVWEaEaZEátzé	TRUE
aàaǎèOaóaWCKLaYEXuNamqò	TRUE
aěaZaOwUowURuarNmaDmaSó	TRUE
aAaúpúaasGTuaVǔěTǒDuVxa	TRUE
aEPNBùnaAǎaěanmYǒTaOaěr	TRUE
aJèXoNmQaLaanmQBDJaaoǔo	TRUE
aNaǔsěWaMaSIaWaeùGúFéEh	TRUE
aSZǔDRYCVǒavùǔaEaaMVaFS	TRUE
aWvAaǒaRaaàJukDasaòFXcI	TRUE
aaèYaaLDGfaaanVLaeòrLWN	TRUE
aaIaǒQóauaaéNmLbUppKaeé	TRUE
aaWahaUAàlzěaCOaòCaGGwF	TRUE
aaaaaěTQGsAòSǒǒjQDaaXěú	TRUE
aawUaaXlúěaaafHDMxonzss	TRUE
apěGǒaGVaaéVaIptpBěaèLǔ	TRUE
astaWaèpapanNyàPaWTxOòt	TRUE
ayXaUEYNáàDWauBvCMZaaaú	TRUE
mENRoUMaZEaAaXCaaVvaJgA	TRUE
nnèaoavaAaàmrǔxllěòSsaa	TRUE
pLaWarTExmaaAaaaeNóǎéúG	TRUE
qulaLaǎGGòTaaaIBaUTùbop	TRUE
sOaWEqunfzèIèiDaaraaaUa	TRUE
uùasaǎODAaPalNXùéaRwaóS	TRUE
vUaaaMoutaaSaóTúùwěeTVQ	TRUE
xǎaaSNaFYsuaéyězCRaIXNa	TRUE
yXaaDaQaNóapvóDCBOUapDD	TRUE
ùùěbXKWKhǔaEGcZhěbppkwR	FALSE
ǔDózòvxhòSyRǒánàóUèóReN	FALSE
áNhpxYEásZsěHáZoFstCXyú	FALSE
àhWJěqHěJBàSfKLXàsèsUQY	FALSE
éǎdqǔWWcXGEzTWYmvSGFNhZ	FALSE
èRFZjzLYHyěAiJkNrǒpěFAz	FALSE
ěimZǒǎcùZEòCǔqUáTyKuǎRé	FALSE
òǒěbSiUFIěwrxèěégRWfàUL	FALSE
ǒGOfOǎǎJGggàFfxǎUxúVsOE	FALSE
úfWàYeGUrwkǎyhGELbvOsjf	FALSE
BázPǒJnmUbJóDJTuúDfxjùq	FALSE
CCAzcnOJeáueQùóKNjuuuLé	FALSE
DQtǒUHKàéùVǔMXESaYwDLKù	FALSE
EglMwafeNsFǒóǎTSwRdǎmǔh	FALSE
FwYòUOQbǎKRADùHvtbtUXoD	FALSE
HúdWJOHǔVADòtrpKviPKèEò	FALSE
ImZèytULSYgǔlyEUMVFQaSQ	FALSE
KGiGgFzXwoAbWUOHùSCWdǒé	FALSE
LlóLxónrVGlbiǎdHrXVǎècu	FALSE
NáúLGéwJjKzFUyIqTǒójàor	FALSE
OHcóTmsòcFqjwufNěWWGWèU	FALSE
PVGCzijjanObxóěZNòukNig	FALSE
RùBNieSGhrQBlJěgděkùmkb	FALSE
SCǔqJBrqQIqgeBMǔòvUNàlD	FALSE
TTkdúAYDRcsWúsTàěùǔjxǎC	FALSE
UmQǔwgxRKáCtNHlbWDYPQYA	FALSE
WòyálTVscRnBgOGagXGKUMF	FALSE
XCHfWCPvběZóvfǎptsǔhpLP	FALSE
YPIEqmSùóasrSouUCMějEKy	FALSE
ZXORhǒSuPwiwDeáPvǎwUgaL	FALSE
aoQǒaOèDXnlDWTfUNHVSxAJ	FALSE
cCIBvOUàKpúóùGBwQqKǒàCǔ	FALSE
dbadTsLtqòNwGJmATRfMdRN	FALSE
euWsoXèszmFuIbIRULFJHLD	FALSE
gIùIěvUègoGgVLěOWosáUyw	FALSE
hLúzTAZZxeǔonXhEcNàioGO	FALSE
iiGIZǒBBSgáHnCqTzHsMBGR	FALSE
káUGYAPoùèJdYbǒdKZekàáR	FALSE
lókxóTMYǎEHMzfjsǒHJBUvè	FALSE
mévákGJSBJjYǒDgqIZFùGFC	FALSE
nWsòkyJBdOwàNIYpéOJǎPPy	FALSE
oijènwTjAlNnybjPCrmtTau	FALSE
qěYWwPxOnDQNHXèzLOtfkdJ	FALSE
rKǎgljǒPhgHéǒUAáǎvVxàNé	FALSE
sjNDǒUdEfHXCAùCXRxùBJsi	FALSE
uAbKUXZsǔEúszdufDTmEègS	FALSE
vJMǎáòóCěRxcUéPvCFAúǎyK	FALSE
waMQéeLáórtáJhbcEZéIDBǒ	FALSE
xmHVgcátJPQaEálPojoàXdú	FALSE
ynfHxUtxzwIòqùéǒAOòOeFs	FALSE
ùáaóNECWaaataBmKGyPXBtǔa	TRUE
ǔYaàwINYàapàuaaBatěaJcwj	TRUE
àLTéXòoMǎaùsxaaèaaLaWprF	TRUE
ǎlaDzaLàǒáawKaaQùOHěǔaAè	TRUE
èOǎanaaǎWSBazauarWòheGJó	TRUE
óùáBmMaavoAaIHèaQWamaTBN	TRUE
òMaǒwámzaaLravaXùaUmoLBá	TRUE
ǒqòVQaUVaNtolSnIěKaaaBaL	TRUE
AGuaEèTaPáasaKaaiMkéPklH	TRUE
BaaǒǒònXoKPnaaylAaUfAaae	TRUE
DAuJwèAnaaBJSaúGaEQanaǒv	TRUE
EaaàaaBuSǔHaayjóYEěCeXǒF	TRUE
GJFaaèéaaVaaITJCnEtRDbqX	TRUE
HaaaUǎoyrBaǒFYaMqǔaBxěPv	TRUE
JYaóuaORǔLdaSznaaNaǒUMna	TRUE
LáPaaàòQaSsaaaáKTEàúWVǔú	TRUE
MaaèamNLaAéKIaalCkpJněbQ	TRUE
OáaKSVWLěóaCaaèaVaělǎdhà	TRUE
QùaaFaaaúWéPrwwMVJaprKZO	TRUE
RaRòsGaěraRAVuKaEZaǎYLCa	TRUE
TEyǒUTVaaXQaFSaǎaDXCtaBM	TRUE
UawBaúpIǔOǒeaaJyaaKàagáu	TRUE
WDGàVaaEUaaOaùLZpélSàlaB	TRUE
XaaaEatUpaNèasEDXǔDxéagw	TRUE
ZBwxXěyàaaGóxGMKaaSaafQd	TRUE
aàéuawaauǎVIapyayrHdRPHF	TRUE
aěaqaǔtaHPàWǎYLVMèXpaxao	TRUE
aúbVaFFwzaaawaKHpWuPRRTa	TRUE
aEaNZmNaaǔwràWLSǎOaúapVn	TRUE
aJaaáǒXyMLxaPDalúMcyaaEc	TRUE
aOǔBuBagcóǒaZpaxKaGayaYr	TRUE
aSappLaǒvúUàpQazWKOaóaǒě	TRUE
aWvSǒSaǔEaZEhúwgaaaQaCpc	TRUE
aaèaǎTěPyzOnwaòKpHJBaáaj	TRUE
aaNzrPTaaarKéaGCoCSǔlEeò	TRUE
aaaHamFKouDGlEaaAbòixAoS	TRUE
aaovEsaaEOòCǎaǒáSQěTàDPa	TRUE
amEaGaOzawxMàKntaDaRfFSé	TRUE
araMzPaasKBEWsFǔRòòaaDkě	TRUE
awLBěéaàlúBaRqòqaxùIaPpa	TRUE
lKòaGMBaXQDúvOazKaXaùǎxa	TRUE
maaaWǎúpZaOPCaKnEVaRǔBèT	TRUE
oAaMǔǔaòǒúaXaraòFOMGVaGo	TRUE
paDaxǒZmaxaúRJaLKWalsveH	TRUE
rEóGanǒǒoTéaǔPauXpaaJWaA	TRUE
saNúxléxCaamlHTatsqMùǎaa	TRUE
uéaPWáwaaBèaLrBawǎtáavYN	TRUE
vaúùDUaòSésaaaFajVsrEVQF	TRUE
wqIaKamLaApNsóaWUaOaárBa	TRUE
yaúIatNGvsQaVnNWaauHsvaP	TRUE
ùùéIgǎJòwTfuXvbéWRAZǔǎEP	FALSE
ǔJANwIàQGzKzxMǒLcǒévSOjf	FALSE
áVèéTpoòVáQáELvhzLyHáwéI	FALSE
àYHEExlrkgPZhgVvAeàYUsǎx	FALSE
ǎpRrjpùmpkJeRqedmCWuěBZà	FALSE
èBExEFeǒàZfMèǔmmvZèGGDěq	FALSE
ěMLRiDúGzDCkDvTòùěbGěpHd	FALSE
óVnSǔXvúfNyKomgKsùYSfTéG	FALSE
ǒěǔRǒDSùxQǔfòxuOBǒéěóóvU	FALSE
úWòCáhùeùǒKlGMoKNQdXhògě	FALSE
AuǒRwAdmbúAǔqpihlNdMfèqX	FALSE
CEnkhmvtèPSlVyCopcNCzzZT	FALSE
DjsKZkSòèugBWqOhDǎFǔfPqò	FALSE
EwWUPFaEMǎLqèsoHJǒěHjùrL	FALSE
GǔJóhiFoqMuuàkěeZzKKàpRm	FALSE
HDzclQáwDlbsKòèáàsnWǎeAt	FALSE
ITxáPWEǔYYaPiNNKKYaèrAóx	FALSE
JjeesúcpqpòfiugCéeArZORN	FALSE
KtsWlènkQwùgNzHROùóǒQdóf	FALSE
LzxWuEnJsOeòLFlEdftZùkdè	FALSE
NJBCáéáfAUaXlGjmTGeJàBǎé	FALSE
OVQQZěmáDbLmeǔLádòmòVùXd	FALSE
QèǎSaFONAkèBěWzVqZDUWpfj	FALSE
RUPàLqIdHOXxùkAógǔvèkjǔD	FALSE
SkbǒmieplgHocAKUEkHǒbWcm	FALSE
UěBovrúysKxZUoBtCIrFDDTJ	FALSE
VhYdamùLàeCLdfNěPPDéàGNZ	FALSE
WzDtLJJzábòTBYùuKjIbSJǒY	FALSE
YPòHSKRrjQAwàwjzbhDicjHe	FALSE
aǔDMlOMZoGdAbeqDyQiSVptW	FALSE
bLSssfòjFMàMOEùMáóGylǒJL	FALSE
caznǎtZbapdaLkqiaiMUydej	FALSE
dwSěJRVǔUklEWùéésěIJàQkb	FALSE
fCyoezHVoflkwFyHxdsKèéVè	FALSE
gVyWèPdxEQNVǒRqàEABvwqNI	FALSE
hcvBUbqRòMwqxjúMLéCuiYèC	FALSE
isiFNZwLMyYQwmHǔětgTNkěK	FALSE
kécgZUěbLdpbzIMtqkYSVnǎh	FALSE
lEsGNǔěóSitcckútlPrYdmAx	FALSE
mOkEKOuògIGrǒwǔǎěcbǎQrFe	FALSE
nWOsPéJlòLTzcnXeyrúgysrǒ	FALSE
okIVěUFǔúcwClLQyhZSXóRqè	FALSE
qǎuQbGbónǒéSxvBUljRNváIù	FALSE
rFwbzsǒáěnUqWrBANIóQhDéX	FALSE
sUizHHúUKGIFEmuqvCJuvàWv	FALSE
tsVxtèeAǔvrláNWwvlèXWDgH	FALSE
vAtèPòuTlófoǎvChXVBHseHk	FALSE
wFCqYGjNWIxaYooXòXuúwhUf	FALSE
xYgòèUweeqbNrSgqinpakàbD	FALSE
yjPǎfROZaKITkfǒfDǎpzúLNX	FALSE
ùǔMaaayKFuBGaùnaxamSWQukD	TRUE
ǔQAaIaaaaYzRSàElRacxxěBvE	TRUE
áaaayèaaǎLrEèxaZútTHyCQěa	TRUE
ǎǎaayWyaLoGDaǒNRazNvvàADa	TRUE
éCáǔADazaaLaREyZZPyáaSavM	TRUE
èaKxDvuǒPnKaWVayTaXúYzaaj	TRUE
óǒCZùPXaMvBàLyYlǒaaǒCaXaa	TRUE
òaamRěXěèLpFtrsqQaaayaxuǔ	TRUE
úěaSèaǎavoaDGPaáùmSJaúJAe	TRUE
ATwavXmacqYUějaamaOUzayai	TRUE
CǒKaóòòéraáaoaBHóéaàaDccě	TRUE
DaaataBaapTVrwIBéǎqGaóěeò	TRUE
FJaTǎnxaaàUaùaòaZǎwXláKEú	TRUE
HúaaRúěúǔǎPaaaRaGhvYepMóN	TRUE
IaaUXQzéUǎWPaaǒéuxèIzaaQX	TRUE
KLBaLaBúDúTuaǎaqBLWaúèZRa	TRUE
LmSXsatQayWUaWèěaaNafpbYg	TRUE
NEPóaaayóaǔlaròXLHAuRěafE	TRUE
OaùKèvnnTaqěqwlaòWaWuQYaa	TRUE
PaaoXsàRSIRaáèazzaxmCOaFQ	TRUE
RòaAXaaCFIóátAsaSUBsaaKǎò	TRUE
SaaaaFFKèGaXQHǔULVaipxjnS	TRUE
UDRaaRasoRszlzBéERKMZaaai	TRUE
VamFEalwaEaaHLqJùBEzóxaDd	TRUE
XJóaaVPrUévóaxauěVaoaNǎǔz	TRUE
YtpaJVvaauaMNaDéKJVatXTúé	TRUE
aǔaòaòaáaJlHDoaǎeZhCmógkY	TRUE
aěǔúaBraPùaTèSaNDFqakoLZǔ	TRUE
aúOaaqBzaWapanóXěUèslbPQC	TRUE
aEèqaPaZaqTPpLmzxMèAaěaDl	TRUE
aImXuKaaàaIalJàrmAaúpùHqg	TRUE
aOXaOWrSaGahrqaFPyIBúaEqa	TRUE
aTaxastmaàaVáaQzàGèázimfu	TRUE
aYěyopaaWvěAaatNoKQGKZóaF	TRUE
aaòóyaanlnnamlnaAOdQnVZoi	TRUE
aaRVùRaYwiOBioaqNNaUnoFaa	TRUE
aaaaCwVYvStarqSǎKaLRfXUuH	TRUE
aazzXBCxnaaaWqWVOZtùlyapG	TRUE
apaèVRCZmóBawùxMaWwǔaanzD	TRUE
auvlaaXHxpǔaOZaòVlrRCTaRN	TRUE
lòasnmGkuaaaEJHCaxVazYaqq	TRUE
mSHySXUóRǒrWSaaaòNaanVxra	TRUE
oǔOarmòDpaaǎaUaòUakǔtmAcú	TRUE
paòěLgGYAaéSèYaHsSZaSaaAa	TRUE
qvLaPwzèHVamǒZawaxěaěraBZ	TRUE
sSUuarwAFVnaénaxDxnaqPéaa	TRUE
tqaúaUMǒyXaǒtúuHnamGawUáa	TRUE
vaǒaaBJOKXòvUWǎaèaaQěAǎYq	TRUE
wsnqaDRaSfaVaLòUSSaWayXan	TRUE
yPùltGparQaarsxIaqqazVaVl	TRUE
ùǔAǔwwvvQZXpyBèYǒheLpàeúK	FALSE
ǔEzskJHěWBAWIGrijNvlZútaX	FALSE
ádesJZyxOLàZòtnkpǔǒàrsòIP	FALSE
àtgPPwVjvftZOPǒAHNǒNDǒCyj	FALSE
éóKQIUucjLEjFpébVMfdFXbKh	FALSE
èJhreBlVǒzgǎbbVOèTUqgDQlò	FALSE
ěiuLTkXnSOèùaPcbNJnEsHbPj	FALSE
ówCTǔnǎeGmtqbsoSntBdGPZGz	FALSE
ǒàLQuBMQúBdrùvuóáPUkǎAáMH	FALSE
úómàgǒtlpOCdtirěKèmyRòúfu	FALSE
AYtàLzSvFjYplRLDnSfcǔǔǎHN	FALSE
BzsědMXǎJzliOièWSwxlLWjil	FALSE
DCYUèohCcèqTzoWààBQNgěǒNZ	FALSE
EXòàyYkeGOhQSnzntúwytáǔdf	FALSE
FksuEzCsTzdqotèvIqNkKkhBě	FALSE
HòudQDyuěZQPPǎmCxsǔbQcdVó	FALSE
ILIúHWXCZdùrEFqyVdIgUlloh	FALSE
JhgXQWQcFUáéCùBVHwuCBAIli	FALSE
KyBUzeENKyRfkJǔHlkLRarMǎà	FALSE
MPhvjěàLzWChaǒèkmIKónekWp	FALSE
NsOiǔltàyLdXWěNyjpxáLHójc	FALSE
PNǒzEkokJěǒSmwpáIèHQzèKQV	FALSE
QkylDHhFéqijmǔXRrHǔhQZxkP	FALSE
SěqòtěSlbMqDVxBMafǒOúPwWK	FALSE
TFdeǔmpyǒDJaSěuNelITqHògR	FALSE
UURHáǎJGTdTsIxmOjZZǔózuDC	FALSE
VuǔjiGcVkstèpLMǒIIyoùǒJBǒ	FALSE
WvVqHvodNtǔmnrPkQéWafónVp	FALSE
YOfjBZfOcGgKfCóùòChòèNXFF	FALSE
ZRKaMyxǒVeVLHěcpNZdǎxzuúu	FALSE
akTxqǒUúSǒVkèWJjlqThSRnvK	FALSE
cAvCúuDQuZYzǎěrWziyàtLVpK	FALSE
dRXhǎfBLDIFéeZdCLnǒbNéLnj	FALSE
eZYZévóèSvCxUǎWuàCOZdIaxs	FALSE
fujhUGIǔvhbdLHCWaNùmRltXz	FALSE
hòeVSMlmCgóFMSbZGcěooQpgD	FALSE
iKgcDhbáòNwgRmSZúǔùgBCzhO	FALSE
jkNzXprrqèEkOrZgdhOapèMwc	FALSE
lǔNDàèIyúiòvRgvècàKdhǎpam	FALSE
mAòkcxUènlJáòùùGègaAWMǎúS	FALSE
nLWeóFEáfxNyDCSěàRQáyRTcT	FALSE
odǎDòmaUǔéGoěKKkRILáAkPMe	FALSE
poqruUègWwàfFBBtpgaPIadèK	FALSE
qyPOmànlGmpùmqLósDéIgFOku	FALSE
sGhàMBnǒwDGsRúǒǔAZRMEeěUk	FALSE
tcyyTgKFógaxMhgNàmcsWHGXZ	FALSE
upKcǎbWRUSóàdoaWqIXèmáTvó	FALSE
wěòYiùDGTrrjZRJbùTxěUFuiG	FALSE
xJKTzhlJVoǒhJYlòPyNJLQSùH	FALSE
yhǎzIUayotDdPxnFúǒuzěùmòQ	FALSE
ùéQaéaèaZyalPlóaOahgxhVJoT	TRUE
ǔZZxZaláaaǎnvlaéwiaěLyóaal	TRUE
áaaaDXúGǎáuayFoJGauXTóloaU	TRUE
ǎAPaarwXaèixTaaáùYaáaLrTWC	TRUE
éaEMpSsCèCpéùaUNaǒalCuùaua	TRUE
èyGNYlYùòaamYzaaSòantCaùmR	TRUE
óWtyaaàóaasvYaǒmǔaxtJSzYěa	TRUE
ǒCqaJrUaaaNqnǔlatAVPaobèSV	TRUE
úapRxpaNLùYpaaXGaáWSqǒJlKa	TRUE
BòLatùamWraXNanYèTtNYaaxMP	TRUE
CWlzRaFLaràZyZaWaapyaNéDYi	TRUE
DrěǔtaUaaaBaápùaWSvrAyVeàm	TRUE
FVapwúBǎKaHaXaǎSaMPaXfùbGò	TRUE
GlqEúIréamèpúoamNaRHaxtaaK	TRUE
IBǎavaYaaaDúEHRàNàěsOOǎaéb	TRUE
JXsPSOlěauǒasaazRáaEaCDPgd	TRUE
KxLJEwsǒOraZèaàélXaaKaaQDF	TRUE
MaáaùǒǎeaWNTavBTtKKmaLaaaT	TRUE
NtyváJrasLCsauJEavěDlNaaóa	TRUE
PSaaQaYaěLOaakbZintějPYcIR	TRUE
RǎCVwǎaqaǔréJJFaaMaavKòǒNF	TRUE
SaáaNvuèaUóVWzǒúaKUǎLaaoME	TRUE
UCaYWnaKAMHytRàqmaáuaapWma	TRUE
VaaaNrKBaEaǒǎCVěǔǎKóBtIpTa	TRUE
XHàpOalpaVrTaaMayNěYSQPMLa	TRUE
YqóYrEnaéùVaMaKtaaalǔoèNSj	TRUE
aùaópaIRFSPáǎmnpLvměAaaaCI	TRUE
aèHaLéòqDEVGNamLEHaCaaùbVr	TRUE
aúAaYaTlQaǔěǎIXapKaYéVpwǎM	TRUE
aEùLKNeIaQaQzpHSzaaWaafuǎD	TRUE
aJAXéǎLaTarZaQYIpaDaauCèmL	TRUE
aOlSMǎasěDaěRuaSèMJSJtǎaaK	TRUE
aTKaaǔaaQJaXǒfyKefàQALIGxP	TRUE
aYOKópěsaDLaLóèòaěMaqòěrqa	TRUE
aaAěHsCYWvaaùGoawAaDCAJWGZ	TRUE
aaUèoaLtměaaTaMájPGXGNvAIe	TRUE
aaanpqMayrǔUzGaMZRnOAJZawa	TRUE
agiPaèxWETAFǒrǎQárFaPaBaaa	TRUE
aqaKǎaaCOIZDGúaAAYslaLovcU	TRUE
awǔHTaaLnqrCaataUKrWWèuGIj	TRUE
lOaaqàEXyaaaoacóqtSBwègMde	TRUE
mupmZGaaJaauawóBaVúFùàéáIk	TRUE
oWDaǒUIyUasáWaBLoaéIWQayaU	TRUE
puDúǒérxXAaxaooaèaùPǒlWaNa	TRUE
rQúaOOoaòEaaNàyaáUasEéZjOb	TRUE
saaJóatavóHaTGBFěǒéaWxIefé	TRUE
uFaZěamaùUaZaaxMUzzoCBòpqx	TRUE
vZěòVAawwPùMaaOUurJIavayaM	TRUE
xěaaUpWaPǎéěaèaLúYaGbYIǒIK	TRUE
yNaJaáWJáwXaIěACUǔaOaYúNah	TRUE
ùùbABLèLadarpAúVGEcoòpúZAǔ	FALSE
ǔQEIqtFpfǎjAvmQVeocAcThVèǎ	FALSE
áfèǔéòVSóèbocKMkUeTKóKwZAc	FALSE
àwjrloCóebgBěHtFoFòTHUnjèk	FALSE
éPSSèAaDěXVǒXàeJhFgǔyXhàǎj	FALSE
èbóépMVeǔbCqgzsèIrUùzéOrAw	FALSE
ěneHcomHNèwlIzHàJJéǔsxKZòh	FALSE
ózyPIwPYHvlocDMXSOúMZPcMfǎ	FALSE
ǒKQópóěDàJóLóFuùYbxnAòúěfp	FALSE
úiLMGWTǎltZffUòRècsaTEcxQw	FALSE
BùmOmòWuCGlfynǎèúTéIóòYymv	FALSE
CCaqSSYSraBmùAWVkXǔNiQzǎCF	FALSE
DUǔGaOǔFèXàěZGVAZhTRézvLnù	FALSE
EvfuǎDzúJMiùòbFaphZuPatCOù	FALSE
GEáVJǎeEmTéWúYǔXlRKsFúPkOè	FALSE
HfeRbnKIKygòměwlóǔSOGEqtmW	FALSE
JCsǒGdyZhVǔnǎxqxáogwvkaóaá	FALSE
KHOixkGnaJGjǔrQnXCrSJRsgGh	FALSE
LaǎMdCUfyúúbpYumǒpALáFrIéi	FALSE
MqVCNVOBCéZǎnbTuyOISàdǔaTX	FALSE
OěYéJúyVxHóIóYuàǎlVtzDKWOù	FALSE
PQlódBàbvǔèZǔkecèwwLěGoBcù	FALSE
QlgǎVaKFwsǎKuShàvMWdéENjaX	FALSE
SǒYzuvRHXéOKWmBjcèLHZDXMúA	FALSE
TLéIXIXjlYpneiqèwkéUyvVèbz	FALSE
UODHGlǎUèlfpǎGdXueNNJIgczp	FALSE
VWhǒóUGnIómERéǎRáklaòkùYJǒ	FALSE
WhBztVpàCpZcVKséúDǒTǒèoOgǎ	FALSE
XwEòGCebMúTfQoNOáuMàvxpBSJ	FALSE
ZècmYQEáDGyTèkòRxXkáCaGLós	FALSE
aUcNUmroòeAeèQyROóXéMueiyM	FALSE
bnIǎUMWglWtViVMmúáwěAàǎZsB	FALSE
dáRMimófBùnSaGùaEYàeòWòbFg	FALSE
eóǔDkFqJǎěQCjbLXoùCbéúmqjW	FALSE
fUACMeǔJláIUVlEǒlENELcYòAC	FALSE
gjyrrngEgAvAOlùSwPhcèéCMrg	FALSE
hnZxcycixzdmWktTWaHěydJSHó	FALSE
jěYrTzApěNNwWúhJcǔEhéléBèě	FALSE
kLQWVaRfEaRrBKoEǔinsérbBuù	FALSE
lclqYSsTpRQduNJǎuUTǔjvMkQO	FALSE
mmMhQJGScTVbQARéepSUmiěZvn	FALSE
oǔjDkwvzfTCréDGGzéòúCUàèǒU	FALSE
pRAPoYCxNjěXvSúsBtRCZGǒTus	FALSE
qnPèpmhORqzDtFqmlUlJlitMvb	FALSE
sBěTGHCáBLéècFKmzyaáBejBrL	FALSE
tLcǎKéiMxmqlàaXcPYxǎmctUùF	FALSE
uadihzWvgvEcGTYàibRùGzzuiA	FALSE
wèCbWawRALUxInnIIéwèEwAXlv	FALSE
xNhTwDátsrMùàqǎoúěIóěSáKFǔ	FALSE
ykPòáKZwFùùlqámOwTftEWUhwT	FALSE
ùùouaéXMaagtrfapaaFandXXfYo	TRUE
ǔRxǔaUTayDlaNúmrwaIataǎQQuF	TRUE
áxaaHaatwèaFvaxQNǒàuǔRkulHS	TRUE
ǎIaapaàòVsèawZaTazTcFrxuqgU	TRUE
éaaQXǎqEaGaRXzEúEǒQaUakeYla	TRUE
ěèBHYvNptRaatYéHVmMaaaraOáv	TRUE
óaVaxóOǎOaFZhvZàxaaaCuGaúyb	TRUE
ǒAaZNGwvàaMaǒsvyzwaGDOaPKOa	TRUE
úaaAarǒěOPnaOaéǒCzǎóUVaCYWM	TRUE
BǔùaúDǔǔaaXéMxHaamFakSHaézù	TRUE
CSIaJXIMKQDZNZzsRaaaAěPUaae	TRUE
DsqOaaúLěarWrHaǒIFIéaacDTcp	TRUE
FúJPQaamYsaèxaǒytfatsaagxfh	TRUE
GoLJXaQtaaNsAOzòaaǎmMoaQhya	TRUE
IòOJǔsaaaǒsaYaéaáeǒěqiiuóěh	TRUE
JaaRIǎaaaadmIùjXAnǔirpxócVA	TRUE
LIǔaaRUKTqCaaapanxEsUèéùdpp	TRUE
MaRlDwqaQXèFaPǎKaTaRaKVTXúl	TRUE
OǔJFJUaHnónùavXaaaaiNUsSYuT	TRUE
PaúóKRVaaěLQaamsAtGmwèùatvn	TRUE
QmMǔǎNwèzěaaòYéaùTaaòraànǔl	TRUE
SDaKmówaaTaaztmaǎgaUPKěxVXm	TRUE
TaóCúaPOaWèaIpqaaQàivcOpSmA	TRUE
VǎOwKVrBMmAqKsaaaVxàaǎnpTaa	TRUE
WaòaeoYaǒyxIlFannYHaaúXaèěN	TRUE
XuZaFlnGauSYaDaAtSéavǔWaOǔò	TRUE
ZUéènmatwYTDaataUaFòJlaeXǔǔ	TRUE
aáhZrMeaaóěěACaaaùPWVèaǎàóM	TRUE
aětaDCǔazaěwyàRJaPèEMDOaóié	TRUE
aAyarAEHòaXNaaDQIOBwEaǎStVG	TRUE
aHCaaDùZavJàsQóaònaòǎàOSKèù	TRUE
aMaEKaMaRǔaBBmáEoEDFNayLEca	TRUE
aRORYaEuaaàaaGéfaóCeHaItgSh	TRUE
aWaNaaómBěAaasekusUDBWdwFóǎ	TRUE
aaéaóKKǎaǔaUraasWxùZWyèǔves	TRUE
aaPRaěUasWlUaUaxálkmOjTJzzT	TRUE
aaaaafkulbsaoaVyjYǔgArwZdRè	TRUE
aaxyMVǒaLèwvBwazaQoJRaèDiSC	TRUE
aoaàǔGHaèvaóuDDPaaaaFùknCRv	TRUE
ataaòtaVRQaDòèUhWqéyěuóèaaǒ	TRUE
azoèvwaùaòKPaaAòcǒvanaójjDa	TRUE
mYóěaǒHDvSasǎyùataYHzaEVaBǎ	TRUE
naxaaǔóJLKaénaLSqyVaMYXhTjt	TRUE
pDaZaasWayazaIUwMhézFCwNEiǔ	TRUE
qmǒǎFyóBaǒaaèzaFAúCaaNbbxzò	TRUE
sSwVatnàoDarúQCBaéaNwQaSáaF	TRUE
twaGTaaǔòZǎHNaRaIYVǔYxtòauù	TRUE
vKaèǒXazuáaQǎaavaófáNxwAEDǔ	TRUE
wtnTùnQǔMXaAyaMDGaSáaVuZaaè	TRUE
yaaDyáKéùauéúZaRaaǎOJYrlEjB	TRUE
ùǔADěYGǔǎoQyOyMǎJcTQvAdyòBQ	FALSE
ǔPCQiHnóEMSMàFDwRFaILJNiYqp	FALSE
áiTcnoqútyiviùtQuodědòeQmùJ	FALSE
ǎàqQCDgcéUérKmRòIRǔMBpkAbòP	FALSE
éúwùurèRbFimYFòzUuFbàSXEègé	FALSE
èkBěEzczGLdKDySUlQéèJwvúxód	FALSE
ěptGnNyXuùóOfnXuoùHpMZǒukMG	FALSE
ówkRXòǎkúvhKGvóǒuFIòYZHLaOB	FALSE
ǒLiNúBSèJChWèFAipSkbéHèsBPA	FALSE
úpremsZáSNvKcYAkǔúvAqágsjVR	FALSE
BAaUahsEZkPCówRuYrSàcocúUZI	FALSE
CTOPkGtFUaàLòFYpàeyyvèXǔáVǒ	FALSE
DmédqlxkàEPhuEyQaqADěOàsfǒù	FALSE
FIjNábtclxsVzweeuoHTQyyYáèS	FALSE
GfIwdAukZHTTòwWGxcǒwcnrOXév	FALSE
HvuNépjXBfRlfUGgXnǒèikeùCwi	FALSE
JǔRVLvIdbpǒmGsèHsrYFnAnvMYq	FALSE
KAtmLáeWèvFzEHTHGXXòòtǒXUzX	FALSE
LOwIDiizStfěèlúPzpódsCfSrMD	FALSE
MdCwCfiLYrBmpOǎpENmúáloSóWH	FALSE
NxlAjZuqYnKgddhSXěBAOYěBsvv	FALSE
PòJpaUjòFMhHdbàmtNPgyáFǒkéT	FALSE
QYǎCyWTJzYcǒòmáKhlCAùVYqlQJ	FALSE
RuRQNpuvàěamóvxǔPzSkǎzcyHdM	FALSE
TFuBgkòǎǎSéulJXccywǎǔaMósUu	FALSE
ULHtVsǔtpsIòXnNóaCrdTYùǒaLf	FALSE
VYcéYjsǔàRxFěkhfaUGGoALqCxb	FALSE
XúTeàcYǎùDuxQéSMKvóúTóéMKúT	FALSE
YRTWDNIbZAyoǎMúeVvùòǒjUluòS	FALSE
ZjNTédbOsòYáyǔóZǔBqaAláGéeu	FALSE
azěYXEDáJcQIHVúmYGYSiTUOěrp	FALSE
cújáXSnKmqoúNPuVáxjBXjjFMùH	FALSE
dFxsZúTéAùCMVàlǒǎYáWèBocPOú	FALSE
eaXiVPBbRúooxzàQbiááGjECaòó	FALSE
foéBnVGcnfmúSSDqbeùhJKxUatr	FALSE
hàBbzJChNjYMzJěAlnkǎsRǒPbZó	FALSE
iOmOúǔsAdmTnHYzOTrǒiUaBHWHv	FALSE
jayVúWTYEcójǎBrfqLRèMlálǔdw	FALSE
kmxáókSZbiǎqzNwGnlyuSiXpKéF	FALSE
mèáVègèěvrǔmuXJipyeegúwúǔzN	FALSE
nPEbjéáEǔùJKQHàVǒWlàuYpIǎgL	FALSE
ofùAYpfùfyhbuFUaDzHXvxòTxJr	FALSE
pgěéLétCGYmNIJNZámZupMWWgoo	FALSE
ràǔDEUyFmJYTbwUúbhHLHǔǔrHSq	FALSE
sHoNKáuUěwvěUNrQàFIhbQTùhCC	FALSE
tXvQjeSqGXòfpógZAǔjCiMěǒeRD	FALSE
uambòIěNyLHbrWzfwCtùJmgSQap	FALSE
wèsZhSAěltàTóUoěTálnGHmOFúǔ	FALSE
xNVJXqvúèáèAiEixqávDTLrsUXá	FALSE
ycozvFWeGiHcùsHIúQQVJkOJOuP	FALSE
ùǔJqaOCOBKaOtaVZǎatmOyPDěaam	TRUE
ǔaùVzAmòKàIOóaaaLsùaéAauJInl	TRUE
àúVsatIèaatHwJYJQAmQǎaarMaYè	TRUE
ǎQGǔnaLalcwaVOǎaǔúGRaoQàaaQH	TRUE
épaTcòhèǔPlFaBWwyoRaDaaLaHBa	TRUE
ěNaaèáaéFaAaoWaQDǒHinioilHàQ	TRUE
óawGQuTǎèǎyUazONaaQJJaaǎPgDr	TRUE
ǒBaooaFayXLFQaùparHyadXzZGSV	TRUE
úVzlǒaùlzOGaEKICwǎtaOùaaJarW	TRUE
AaGJaZaaenJǔXnuRgEWKaùDTwIaa	TRUE
BaxéaDùJPaaTeasXrGlaùCàvGAab	TRUE
DúEmHěaaHàùaaFhsGátFaaKyaěwD	TRUE
EaQayǎalauXaWJaZúyógháWFqUúà	TRUE
GAHwòaCyzNPGalaFaEaqméBaooJO	TRUE
HauUlúǎMaKaúSǒsaaIúJéáǒmLvza	TRUE
JávaaMAwJaWaaWCSwéGFUakHlúrú	TRUE
KJBúaRaaaaaBěXHPLjHúprZAmrzs	TRUE
LaaQRVaěaaúúIwYóahRtmEfIáNDz	TRUE
NHǔWXmZWyYwBLNLaqaòEaaaNRSEa	TRUE
OaěFCúpNCǔuEUZèrmaamaáaNaXǒL	TRUE
PnóèPaYXaaěsaIwIaGaLexHǎǒYVr	TRUE
RèMIvaNataAQaaqYNòapǒjyaQéóú	TRUE
SaatnawàaaaiuNiùlsnǒwNpKkaùd	TRUE
UGǒaǔǎuǎaDaaBZaGxMZaygFjòxPJ	TRUE
VZlvIJJHUraZEaaPěaaKzaWvòyTU	TRUE
XFóǎóaaaBaOKaElHáaPyàǔǔWYEfW	TRUE
YYPRǔaàǒaèGPoMaZwaaòòóaàsetr	TRUE
ZnaaYIaNàOzaKúOaHabnóYxǎèqpc	TRUE
aǎgàaaFaCóKStyFaTòóaoaéRebUs	TRUE
aǒzoHzaáaTvETxázqaaèHDónaWHv	TRUE
aEènywaéraaWEéUmDaǔzIaOdkURa	TRUE
aKǎěòRùEQpGJàǎPaaaóaylFùzaòò	TRUE
aPuaaǒPaIaaròUzǒYRYYAKEoPKmt	TRUE
aWymáyPTDLmaVIoùsaaEtaǒWaHhi	TRUE
aaǒYsàòěsaTaayǔNaOJXmerKHstu	TRUE
aaZaaZWNPRZAvsaěaQWFFXnDbksj	TRUE
aasHǔyraawwTKaDyagEsǔLWwògPh	TRUE
anutaúaàoZrasKuaaqǎVxùMěOáGS	TRUE
asZaavHlaRLaáLqmJàCéWYasUkMá	TRUE
axaaaanaeséHMVgKubetJqahvAià	TRUE
lahuǎaěvZLǒlaaIǎqLèQrauòauaǎ	TRUE
nùaAaéaLvpáanCHCáSAóaJùèaéMF	TRUE
oUwPéwwavaèlwTPaaaKJěabPPmMR	TRUE
qùútCěèXZTaaluRMpMROataaaymv	TRUE
rIzENWaLmFwPapóaàaoàqaaXYMev	TRUE
saMaaZymǔWuUSyúMYXnZCTùaaKCa	TRUE
tnuzapǒǔIaAHyOútnVNMòaapUaaà	TRUE
vHYLùMQáaóepaTaaùaLaExuaéSYé	TRUE
waaoLaaWaCrqaqUZWZcqGóèSEMvB	TRUE
yLaaIaanèTUHǎPxaEFéaǔNuǎKzrB	TRUE
ùùylǔRZazùWáGKtzliCZCèJLòbnǎ	FALSE
ǔáUòqòIKywKxRaRáófoàCRDRIiUu	FALSE
áKělǎBMSEikNoMDbgpZsVpXqRéYá	FALSE
àaéOhDZSàrǒNwglduQLSSSùǔkiàǒ	FALSE
ǎlmxAQúKKXùtZrWBǒwgǔòFtzúúbW	FALSE
èóǒòscCDSzǔmùvvAZtoQòáRǎsMpk	FALSE
ěMLùúSwMuOLòChrtncpJIěùKzFQp	FALSE
óWksFYDnlútYèHéybtQgOùyvMàJG	FALSE
òpZvUàójHLORAJUcpúsUuUbDNrFǎ	FALSE
úIFLúFèUkmTFlxPlyiWaǒRǔzlěóC	FALSE
AVjETnGyénsàrgjZWUěshmiàqúce	FALSE
BrrYòèPAécMaotVrMsBNyNwWEQKY	FALSE
DěOfǒvWaWovòóAzZDěǔLòóLDFSSó	FALSE
EEaMtUǎygǎqnNpònNcGoǒTdnFwby	FALSE
FWXLùnBBklFwàFyèéáGlfàiugdbq	FALSE
GvuKhAXlBmluxVǔFjJéUOvcUvǒIk	FALSE
IDǎósúkZhnfqkscóeùáUVktààLaY	FALSE
JTMmǎYUQBrlMǎpnWúéIuùǒWoQBdx	FALSE
KppclDpyǒeQmMtSRèeHùzUGBOVTe	FALSE
MEéNěRYKMmúBeJsoLfnIehLóumZd	FALSE
NGěrxbòOáKCKECgEvZǎǔypǎahjIS	FALSE
OWRGkBetUsmfJMSKYdvgieovòzlǔ	FALSE
PlFFczKcKiózzDǔáxFAěàóBǒhgvd	FALSE
QsxEeGxAHòùěUURcQmNnSKulPèvw	FALSE
SAèqFovZBFàǔJnSúcZmdEǒófzéZy	FALSE
TJhftFkEEèàcbdOEUqgáSzgCQAúò	FALSE
USúicǎědejMtúxLMEOHNEUaúOqYǎ	FALSE
VsUbnUvwjOlěhòcjOhrtyàdGàJyU	FALSE
XéGBIxTabHèGbGnCbSoAOKáfQfóV	FALSE
YLsSVmhèbòàgCNèTWsvqFxhyVòOW	FALSE
ZtsoCzvdUmúLǎiShhgBěbZCFcwpd	FALSE
bùZKhétVěkúǎVòtWsyqnkwGAhoèp	FALSE
cJdcésCckàYHyuPòJLěěhQOěcrEv	FALSE
dTRǔNauVuCrǎncùUdhǎICWhLVùIg	FALSE
etefBfóbèSoǔzhùqPVǒKUKJZXQFX	FALSE
gòSMUJVèRCXěrpvùdhzDqmrWsWFY	FALSE
hSuéáEyBèWFǔLNjmègtINGámdnǎè	FALSE
iluémYxjǎcGYùhǎcOQHùZkzVMNae	FALSE
kàURIxWtMáRLXfcNǎMúónPgiéóeI	FALSE
ldTObmǎZDAyKùKǔEiKúiàéOèFBKR	FALSE
mthncYěúsKFkpbfzàVévlEUCdXTq	FALSE
oMHhàncNrcùtzbYJIJúIrěDěènKG	FALSE
pgSǒVXOóeBùázJnzgúnFwòěwjFRè	FALSE
qytxEQǎràyòxaòPZǒipmamHzǒEJf	FALSE
sBbjvllhpěUǎnLOvVcúIvBCqiǒHD	FALSE
tVKrDjbcienMFsUyDYDejOèWGPSg	FALSE
uamBTgnuDǒkuuCHěVěǔqkFenLxFd	FALSE
wòQGǎèDIJlbbXAHBDGvnùjpyěézk	FALSE
xRroúcDbdqRJtMgBcùǒXyQjtzjtE	FALSE
yvúnwBaRwbnURèmomXzǒnPbèPòTz	FALSE
ùùxěYHúaaùIRuérJZKUTǎéawaaMaA	TRUE
ǔKaàènaoYxaqPaUaakiWràRmvbùHL	TRUE
áaELwPTaazaoKqErZaòOòSúSKLaJǒ	TRUE
àsMaaànvxmàatQalLpaakéZVSóoée	TRUE
éèsraRAVèMaqWPDCaáaúóaaxaImsF	TRUE
èaàTAamvXZmLWaxQEHaugaappAGaQ	TRUE
ěoRuaXBYIaJǒaamwElǔIaHàapFraS	TRUE
òKawTaoEEQRoaǔrBxaRMaaRAAZóYM	TRUE
ǒnNKaKàaRtòPyQóaNHCaLaauǔTvUf	TRUE
AKMaQaMZeaaaKmsUàMùòIáQqaaYeq	TRUE
BrHRwǔyùQoaaóóaaéèaagxZéDWbZL	TRUE
DòCwauYaèuǒSqaaaabǔǔJǒmEbeVDa	TRUE
EaáCADaRDaatIUrǎUOVSquóMaopaù	TRUE
FpěóJaǔYaMòOǔHMyQZAGaaQéaxlua	TRUE
HHUTàRnúúBmtaazaaajaKxBDaócxà	TRUE
IasHǒraéveóaaaSètèIWaǒaGǔàCoI	TRUE
KNaaǒaJaǎarnajpùtúYǒihèǔMěbqr	TRUE
LamBoaóMóLanCanùoáaEèaQvoáows	TRUE
MxryXaaQTHáuzSTGIHAWBFaaaáǔaE	TRUE
OQEFòaùSvRǔǎLwaxúaJrNLòKaaQMa	TRUE
PllOlaJǎaLaMěxRlTáEYDnTpHaaaò	TRUE
RRóaúaGHxaùJóaMaasWònWLògmgqT	TRUE
SaaHaaEáǔKaYaùěSúǒadòFloBuksW	TRUE
UáTXvawǎùKaxúáǔNEǒaEtlaasaSně	TRUE
VaMAaaaWLaéFpuzaGmùábQtIkbaeY	TRUE
XFòéuaLèGPàáulvuYùaaaùaSóqaqB	TRUE
YaaDóEFlszacěěbqaAFyaalkuéQaa	TRUE
ZxaaaLmNaauaAHVGAhèJgGGnTròoH	TRUE
aéòǔvierrhtaaWpZúKaaèKéǎTaPau	TRUE
aúIGYPaqJaaCaézKBRwVacEùòdqǒa	TRUE
aEXázKMoaaǔǔEaavaBǎVúUéekdeúk	TRUE
aJsééBLaaXaaráSaPERètnNuffèMN	TRUE
aPaáóMèaKaxaCRCpmGòoKaOkFGHéX	TRUE
aUSSùMtVToFèàtòěasěǒaóaǔapaèb	TRUE
aZavMóaXvsAlQQaRLaahFgKváAúěz	TRUE
aaNaUmoWXùùaRsaSVMèCJOaumBmbR	TRUE
aaalnIaózGasadMxòǔMǔCrLJjfácQ	TRUE
alùPǒraòKǔaùúKSqxDàxQaaaMXǎxA	TRUE
appaAtIxauRaáǎnHRèavYrRFszaǒà	TRUE
awǒuóTZéTéaanóaèvPNaaTiZeaZCR	TRUE
lQúáEěraqwaáapaIaxwNmǒayHgels	TRUE
nóIzsraCpzaaNRéaéaWěùúXaúiLeà	TRUE
oauXěQaaDxaZmaKqEùòQaáǔvUòerh	TRUE
qǎaaaauEZacZnOsgWEUNgaòLqóatp	TRUE
rYvěéarEryaaéùuWaòaaoùXeaIfèT	TRUE
suUaúOéaasyLOnaudaVqǒsaéBEaáú	TRUE
uQUoaQapǎCTaCYaDEQaRCaqhiéǔLù	TRUE
vazKqaàCOIazéaaBEJpaòyKUVzcKB	TRUE
xHIaKwaéKhKNaaúuvéáamuanvadGL	TRUE
yaHdǔóléWaxaoǎalYaMWtOèxéaJaE	TRUE
ùùùZpnIozktMúRsuhKIFHbAMgaqHM	FALSE
ǔQXUǒSéAkyèOUkDydOshótpùcAlNp	FALSE
áiJqMSRxúǔeezNUúcǔLYMKGsgónyb	FALSE
àrmòPèIHexegsémpJsèMSZúWhNmjo	FALSE
éózfaéòGcxYtGúEgvOEoCRVeLémFN	FALSE
èOUyzfKEMKCkqkósǒQIlgAúSHpBJǔ	FALSE
ěcAXGDQpMwWbùxLaisxúUǎloèpYJS	FALSE
óoxSJLódNQcXèOAjágwqúéRhúzCPm	FALSE
ǒúBxgDdGSaEúTUYùlKoDmǔmèryUèW	FALSE
úSeDwUoBwVNdBǔWwSáxAǔeroóUKvo	FALSE
AfáxtXJFhǎOwBǔBdUéIZkODděthúù	FALSE
BwUUIrlzfpuègaDpMGéNTjVOBbvǎu	FALSE
DCàSaIRòRcJkCwHxCfGXXlfiZlSWV	FALSE
EIArkNaǔèTsóéaádOtbDLqgSpUFmG	FALSE
FrpOdlGNIGYiafdNéOKóǒXGgeBzcu	FALSE
HéYLèIeóSHhIkUPBUeNauWSbsuLjQ	FALSE
ISjvNStBYQZórSèXoiJYcRYlidZah	FALSE
JhIqpLoSgSRúRjJáKEaéúèdwUDxud	FALSE
KzRbohgBòòsdBcwLBàójRǔAiJMvrU	FALSE
MLFOrǔyZòhlǒamyqUéKHxúIsqAFYǎ	FALSE
NWmXqWěKfùDPěBióáYvèJqhSrǎjaW	FALSE
OzeZRùlactùXhatǔnRsfOyéwjáonù	FALSE
QBIOIInáKKBRxQSQúUWIǎCWLáuXHp	FALSE
RfkThWwàFxPOGuNEqPrttiVzǒAZùY	FALSE
SiáúéàYXJLQkQVkáFpijHKhZHediú	FALSE
TyBpUTznswǔxTeEyUKáiéodDYùùLG	FALSE
VIPHUǔdqLèkVwFǎZFùalJèwENtJsX	FALSE
WanCqHsIúoqYVéTvàYGMZXVRwtzYF	FALSE
XqwrkòggěVMCùgBbǒòděCTUCFpdhp	FALSE
YumruéùLwùJqTMfómTNrmbWFSeMúc	FALSE
aJVZHpVnIèbqsBeLxmkIQHóMyGbYi	FALSE
bdBusKóhéDBcCiJnOùNfwvèvjLTfJ	FALSE
csMLCVYKmTPnuléBJlSfhVkcStáàs	FALSE
eěátiAkJnǒlǎzUUěóQLGGAgWGqǔóá	FALSE
fKJRǒǎěvNkéNIVYAEèùmúbWHfqmig	FALSE
giZPajswJGzGOróRzPzúlRDfpsèMX	FALSE
iùaMaAudúIwLWDtztmnEZyyFpfgXN	FALSE
jANrVWèdárórAOTYmdKémYàZLnSIi	FALSE
kUqfUkbběYNEprvěùxLaǎòáfúcǔty	FALSE
lcDIkyMQèEirélàOMWyaQytǎlgbáC	FALSE
nàèWNpnNjFSDUhLAéDUuMǒǒEùjèàc	FALSE
oFBGXDSóVecnsfhStuóCùǒsscxǎGǎ	FALSE
pYlGLHràbúVcoèQrGIòjWéǔmUuPéǔ	FALSE
qmixcLXZeúmjIǒfaxVFDErúéGPnéu	FALSE
sòFòcxùehieXHrǎUsKùwǔAyvBsDúD	FALSE
tLǎAsKprSWáAAràODqzwKRDǒPoǔEr	FALSE
ugZwlárVhmEúyIwHTSafvXòTQCjUà	FALSE
vxnSFěMJfxCscJQqógwwzMdmhezEL	FALSE
xKǔNSmHhyúTásYukáIPFdynOáádLU	FALSE
yqBǎkYééǎrúGgUNnRKZYqLgMEdGAq	FALSE
