ùǔJàaúPrkTCcqPZKPynH	TRUE
ǔDUSQUagqMjOHEqYěuwM	TRUE
áRzlaJwFééVHpFFZDQws	TRUE
àqvàúDwǔǒOaiqbYDruYj	TRUE
éòHěèahrcdyUvDóOàFoS	TRUE
èOEXUaùòJKQòPàGomsem	TRUE
ěwBvBvaSxǒlGSkPjúvKá	TRUE
òCzMaGyǒfQGǔPEIbXǔEH	TRUE
ǒVFPèèyqaAeruWZMǎFmè	TRUE
úaBòùrbcqBKǒjhbYVSzZ	TRUE
AyaeóKyxCANIoSJIkZòE	TRUE
CèSòDnèaǒlixógpGPeRl	TRUE
DKmNCyFaAzZUnshiXzMv	TRUE
EvraLesǎlRTDXóoIcfiQ	TRUE
GJQávóIPRYaièYzgELIx	TRUE
HSrFǔyèNalèTHatgǒsHN	TRUE
IlóǔùIFóǒarvGéyiUoRi	TRUE
KáuéoqzùILuáaaDtáIkj	TRUE
LúUxaATQǎBbomujLuDHS	TRUE
MrIéúxòrKKùTòagEBfvL	TRUE
ODWFasoéóUqLJéLZóòTO	TRUE
PXaVhDérdSpdàǒǎtJklm	TRUE
QaODkDwdnǎUpQeGdǎiCd	TRUE
SòàSwBUaòcSrRKútIǔdm	TRUE
TQwuèlJlvsFnuMxEUtaǒ	TRUE
UaaRWǔOFUSjaNiǎQnxèh	TRUE
VaeGtvjMSsECHnoFlUiR	TRUE
XóLVadNpxcěZclVyzwVò	TRUE
YMPRzaoULBkJeěMPBTRN	TRUE
ZRúLaptsěCingXYCYSbV	TRUE
aǎeULéEALwujáZblJǔsa	TRUE
aAufKEmGrazmùòFOTKnD	TRUE
aHJNFhJAkgJLècfYnǎoC	TRUE
aOFLeàNrCěRrgYDQòqùn	TRUE
aVXqjyIòòPSAmJSèFfsQ	TRUE
acQjXTězNùúwúHwMǔǎùu	TRUE
ajébrrhbǔSCJvNKCisGV	TRUE
apKSnhěefOǔtxLjúUzbM	TRUE
awútuekJAòERstnMKáaà	TRUE
lawéTowAHJcMaóBmqTes	TRUE
néútXVFsrFCaǔbǒmuIáu	TRUE
oVZaLNlèOáZMZǒemplbz	TRUE
pyyaǒVěctWěFuBDqCǎèé	TRUE
rBVqaPSQXAxQCzjqTvVo	TRUE
saúDHtMwFmkxFJLZXRSQ	TRUE
tuésTzKaqKàKǎAùwfùOf	TRUE
vèàNBEDaZYcMěèMCIiJB	TRUE
wDTalagéǔkOKǎbhCzNWj	TRUE
xYRWmavatNXgùWIùEfǒò	TRUE
ypèNaáEDpDPMVúyióǎxe	TRUE
ùùJyǒEoDǔPQqjZěcOxùg	FALSE
ǔWXjLVtLEJrBoAeHnSnR	FALSE
áioNuqzTbǎùtlYwwFZmE	FALSE
àpǔVbIóoOlěvzǎjImgàě	FALSE
éAFǎZgYoJQógǎCávEàTI	FALSE
èdTMZAngknRYVkorFeEg	FALSE
ěiZcatPGUGuudǒěnxǔùE	FALSE
òǔnǎgyúBKǎtkQUnMiRjM	FALSE
ǒYQAbFzLèrgSGrcYzOLw	FALSE
úqqEbJIáHGǎóykTvTKUz	FALSE
BEhfbFyEqobaxAfěǒNoJ	FALSE
CLWitěoEpeTOLěyDáAmú	FALSE
DYéMQHrKiBSPěǎGyàNbp	FALSE
ElhlOGùmPlǎálǔHguèKk	FALSE
GòJYfDkgeFòQvqóoTVss	FALSE
HSlJOOòYúxObráYtjLFz	FALSE
IgáamkoXǎgěéUepVpfěá	FALSE
JpKYSWjCǒwPrfPSgCIaǒ	FALSE
LLúXgKnnhkTPděZúǎbjǎ	FALSE
MYXrbàǒtFDáJTomǔaǎXa	FALSE
NjMBnwǔJCWměǎáDyKrcr	FALSE
OxJYGATgczǒvtDpGTDQR	FALSE
QEǎHFYxAHOòáǔKZrèúty	FALSE
RVXFPULGiěǔùiúlEcSKe	FALSE
SjéwQNpllóImééóaoNǔV	FALSE
UùéyclqěeEEBUáVkBbpr	FALSE
VGǔukǒzyǒqzaàaEqèvuk	FALSE
WQléǔniRrylùhoGDVGsú	FALSE
XdMXEBlAùBmieHéUIDGV	FALSE
YyTWGdwZKxRRtúěkezYé	FALSE
bOhùSixǔèóMbéòEYTVSh	FALSE
cběǎbóOUvRbàqkCcáTxY	FALSE
dfGELéěàmqLòrBCJGOǒt	FALSE
fáUWcWcúKXIkdyCǔpswM	FALSE
gAVNpZlDbQZpRiàDHLHr	FALSE
hJFVBWLfOQrwIJAéUSuè	FALSE
iWCYGxKjycUrgemHwObǒ	FALSE
jjmàDoClrwòXtzyMFyèB	FALSE
ksǎNugzHijàFǔugtújaG	FALSE
màǎBRdNryTbAwORJqXnU	FALSE
núSAyàYàIErTeúUoùaúO	FALSE
oXeGSmwpǒtóTóEeéDbGd	FALSE
pkcRpJMǎKǔrUbqqDyHHF	FALSE
rCoIXeoOaJZxQxbjUAǎC	FALSE
sVCngoozYPTóTéòXvQEF	FALSE
tkàáWǒNTSvjáKqěxXWvà	FALSE
uumLYcxTurBjóxùcěBMA	FALSE
wCgOgQpUZFjewTNféOúǒ	FALSE
xJVvZcMùěAYfúTDLkDPO	FALSE
ykpéuáIbzumèzhúyzxbR	FALSE
ùùDWaTQcAEdJcéJKSOfúT	TRUE
ǔHSawfMcǔzQóòKXfNwOáH	TRUE
áTEoaSuzYDTáWWBAyAàua	TRUE
àaNPhNvxPxqoIǒNdpWbHb	TRUE
éùNLǔvJaeǎIlúnRQAYMúe	TRUE
èKFRaLDlREqXXSOLANPEZ	TRUE
ěWaòzVHkKVàwǒGeDlrXEY	TRUE
óaaIezxwAáóàMfVéMàCéù	TRUE
òuPǎRtWaymSwáqnnUyàSù	TRUE
úúFSqwmOakEúRbWWRǔHzZ	TRUE
AaAèZeǔǔàZǔVWBaǒǒóèap	TRUE
BznaeXEZpMǔzDBaúxáèwG	TRUE
DHIèóaCrùRleUIvckǔlZw	TRUE
EYaùVCHQEYósUPLmdBmOd	TRUE
FaySTAogrLVHěVǔciùQsà	TRUE
HòavsQvDPZmǒBoSgáMěxy	TRUE
ITAwEúaXpZLHòxZYbHTCc	TRUE
JaeFEǎlIEdVCměyKLǔuoW	TRUE
KxǎqzHyavQPxztBrúěJdò	TRUE
MLlauCǎbàSǎLBhójVLAXg	TRUE
NraItraQrCmùroèAKèéùú	TRUE
OzǒEuZKǎaUOcSlkvCNvsf	TRUE
QóKMyUDaèGǎajǎQEǒeáVú	TRUE
RaLKoFùgrNAytCGZmNIbU	TRUE
StRarKYrǒàǎKFdqYxQWQV	TRUE
TsFKGǔuVnEnéNlwpúHaSe	TRUE
VBoXaǒcDtNCgXIèzdLZKc	TRUE
WaàsWHllòfǒwEGpsQKgàV	TRUE
XaYěyOóQxsuolovùuFlǒk	TRUE
ZùafǎmDBCaúlDǎfNiQòvw	TRUE
aǔMévTulwZOjjAèBbBcDs	TRUE
aòsVǔqáNèCOéwRòàBoǒSá	TRUE
aFfóqOGàXBiWfkQpxXègK	TRUE
aMoCmYpLùSiQkóJlWLròX	TRUE
aSRóKaVLsujGxCRAuQASù	TRUE
abWlPèUMùéwuòmóòmxCjó	TRUE
ahláLsXsHeAEJlPumNzYr	TRUE
apbJwǔBxoAoǎHceEjrvAà	TRUE
axfUzSIGKRóOzJóěǒhpZá	TRUE
lvafPóHéwlméyfǒGuFáǒá	TRUE
nDanQKBmXfěgpmsóxmtis	TRUE
oJěNUaNMKbgěóNKgozódu	TRUE
paHaǔSKnèxcbEVlAFvWOb	TRUE
quWǎIWaWcwóóuòLEqwIàè	TRUE
sPqPWWXSHàǎAQZáSǒlaǔf	TRUE
tlFCòaoFZwuOhcěeCWFJH	TRUE
urrzǒySlaócǎxǔGiòpcVW	TRUE
wǔwáJqXHéJqCóvaóbùVqF	TRUE
xPJàěnǎIrwNXǒOKnqFKàa	TRUE
yaWvzǒDtJěOWTáyǒneuǒy	TRUE
ùùqsVgeNJPgiGMRnnyXRw	FALSE
ǔJVEbDǔPvGáeéèǒèUNBLó	FALSE
ákwTǒuhCMFǔQJBTǒóIVRù	FALSE
àxfBrIJhxrKacbZOPXaxk	FALSE
éOǒBdGlNǎLTYsDQwYRèix	FALSE
ègcCvBklkoùtLbzěváMǔa	FALSE
ěoúoTVxLGUsmǒFnBévVQL	FALSE
òúuTNNtǒGqhàoAhúvǔDUk	FALSE
ǒNFǒWkràCgqoáBzmPAesk	FALSE
údxiEswěIǒDǎAkwMdJhóX	FALSE
AoRflXkThckóBúSUcHNjù	FALSE
BróftlbgFèboWXjloZDáx	FALSE
DǒzòúbwdàAǒvPéuWvpQUǔ	FALSE
ENVKUǎmbRBjNtBuǒRFǒTI	FALSE
FnjúFLhxHvǔrrVuěDXeNù	FALSE
GxzRRèOPghiuótǔfFeěǎP	FALSE
IǒfRnalájKǒuLOuwkGxNB	FALSE
JYNèàeléDjóCIFaLAǎpàQ	FALSE
KyùàoZgpKnzóVépMvfXay	FALSE
MóZcvGhQásVPoIsyDòJòá	FALSE
NZYHNkúCArùFiFdIuvǒqD	FALSE
OlZBèělUOPGsààéùeTǔqj	FALSE
QǒLfpHHwóXJQEdCdnAIòL	FALSE
RdQRYTIlsěGvbxbùǔnDùó	FALSE
TEtNáóéUUoIpNObDùúdmZ	FALSE
URJLrècegǒèAERǒXyfRùS	FALSE
VnnAénMdbMiHXElIJmooX	FALSE
WjuXPYnCaóBàǔIjkKPóiJ	FALSE
XxáCojòIǔTavkisSeSLBQ	FALSE
ZèNzǎLbéYYFcjcZiàFkǒD	FALSE
bEeèXómnOòvqPSLwbRCsv	FALSE
cOùǎěǒlBueBcbóMdpkVRP	FALSE
dSzRauzIBěpGXjwJmOěéě	FALSE
ejsDěNPZzétGwlócUtEuW	FALSE
frěTyFRéYzǎiolrzègxúb	FALSE
hǎpnjzQioRzpUtòZéAZǒT	FALSE
ióYOtOHtǎJKáàhǔQQPùos	FALSE
jJvIifFemVWIezoZkǎwěv	FALSE
kPbLótazáUzGFVjrybECr	FALSE
lséAWbzdùBOsqimnJòVgV	FALSE
nònǎúfaYyOéùéruvuTtdK	FALSE
ohpGǔùaWJXénBbbpqùAgě	FALSE
pqéOzMpQvWVMIveréOSòR	FALSE
rèlHDJmrPgkszlHvFěcTB	FALSE
sJDOèěYěJeWuòQZoéfrTd	FALSE
tqJetoZGRèonDZNIocQUK	FALSE
vCkuUQaYèAòflPCbdgOàó	FALSE
wGsFneùheirPDkKéǎJasa	FALSE
xWwǒdPòyEpzbOpoeoàhàM	FALSE
ydyduééwúccTVTsLwyOAO	FALSE
ùùAztaLQZOelFwcNcǒpBkl	TRUE
ǔQrEsysTVáUBwItajKWABě	TRUE
áaLPYěǎRǒémhuJASFAcúkf	TRUE
àsayXEQWAáèYdlNkěntSiè	TRUE
éHWuWrawpnaPsLLxBkxzdb	TRUE
èXqaMěJuWPBGuZrEyóffgC	TRUE
ěaSlǔXEBjNxáZrMTGwdEJù	TRUE
òABDaMòěáXálbbssFrDIYQ	TRUE
ǒaCkqsIsvTǒRTZUOǒùoKàP	TRUE
AàyěazrMiRzmèOcùèPhmPa	TRUE
BZaOóaePǔmóMHùUocdAgdA	TRUE
CsSSywTCGaGrǔFBóòwZwaq	TRUE
EVQòaXKPhpěWbUhESigGhb	TRUE
FavAǔiúchhóPJiJáRmǎDwG	TRUE
GvtwnZMéǒaaeHóUEwěkoDJ	TRUE
IBáQFsmELawèInfdóvPNPK	TRUE
JQúaBtQjǎgboǎúvLevqaun	TRUE
KVYzKWúoúòGanéPhCwODSV	TRUE
LameEJEoLúuEKIaséèAHUH	TRUE
NěLvAaěǒQmqFDfwòǒdělDK	TRUE
OTzrasLpòhqLòwCvBǎKOzǒ	TRUE
PXlTGzVùEasezCdSkYzùeb	TRUE
QapLDǎCAHòtbvcVmeTbáHy	TRUE
RruqzyùGaǒaùuJóyBéVcWu	TRUE
TàvLaYZGXrfMLaLujONéBH	TRUE
UXaǔsckEBKmùvpkYNèàúbW	TRUE
VaSBtokOrOJnpúmmhBrèàv	TRUE
WpnRǒEVnaǎgQHZZkJvKkQǎ	TRUE
YèARaffuǒWCtdtèTcZǎPéD	TRUE
ZBAánaHIKUnhMmtjqDpúkó	TRUE
aáRykǒyIAePEwRàHSDoàǒD	TRUE
aǒkxoòhùǔaRSǒěxǎxEYóèl	TRUE
aGěùXòohJBgMSxQnabTáǔQ	TRUE
aNàMúévécAXPúTáoTcǔtmM	TRUE
aVǎMJdóuoJZgZuqèdrǎyTc	TRUE
adǎItoKTbYxooZXbórbLhW	TRUE
akGenEXCltèmOaPUwtPióě	TRUE
areIRjQHǒòBZòvzèùǎùNeH	TRUE
azmgBǔbTzLxqwBKMQjKóaq	TRUE
mGahpwúáNXàKǎqYAòndǒlB	TRUE
nTpIqaVhNJòBèónǒsODáea	TRUE
pùKacaàKXhvsdáhúQBOeoH	TRUE
qBFLèClòXéaQvDoéGVǒièu	TRUE
rRnKRNGxuwovBaxVQUDǎmu	TRUE
saùèeguDébhfRitszfDGNX	TRUE
trtWlGpaPMDvmwMIjxsSQt	TRUE
vǎǒYawjcǒòtjXWǒDiWrPjù	TRUE
wOSmluauáOfùZOóRwXěoIW	TRUE
xYaQmúkKKobFSfkYALáúnù	TRUE
yopYqǒoxAEGZámEáǔNLDáa	TRUE
ùùeUnfrYQKVbvgEJóPYùCù	FALSE
ǔDjúIúwjDNPxSviYWQNwRV	FALSE
áeèlNiěVpCNǒCHúmOAòtyB	FALSE
àpGhèLxJVěrvǒVáàbnVpǔò	FALSE
éǔImlpbVtáùxSCáwórpgUT	FALSE
èQfzQóóXpZaziòHjhndNkx	FALSE
ěmXwenxxkzhSBèwúbtLOàd	FALSE
ózNOzYlIUdDMhǎGROfèǔfB	FALSE
ǒFAdùrakkOXùǎòcNaǎPaoZ	FALSE
úSjPqSTJLúDDvAUgWCLVWQ	FALSE
AYgbeynúNbuAVáJXiwjYtA	FALSE
BpXouénQòqùvXǔWCóQJWLZ	FALSE
DǒNùyEétKUQNwěfáBdHéaG	FALSE
ERCCOyDhHYbopúfyEWCtvg	FALSE
FgYRFAèMYidXmVǎYFmiUfS	FALSE
GvCwóàntxqTǒǒPCqSgéMJl	FALSE
IáveMárwétgmǔúhǒǎéKgRi	FALSE
JXěQkosJàěMAaZsqoUàVfO	FALSE
KcKTmhYMkBAltúGiókǎkum	FALSE
LxoOòGCxèPOLAIFWGOFèqB	FALSE
NIóǔSěxtǎykpaXTnKnxSké	FALSE
OUnHxěúfrBddùǒZǔcAOZQo	FALSE
PqtswFQGcKFèwTHrZeèPhó	FALSE
RòqnYXààéDùDiàMVYPaEpè	FALSE
SHTpRxáSikyBJKiigTxǔèd	FALSE
TUdlééúAYzQibNqkiddByv	FALSE
UjábvéTnéVùlOSsCsXqěSe	FALSE
WánLWěétwlVcàóHěǒYxdǎe	FALSE
XDNIebosEgUYShdvèTǒhùR	FALSE
YWRJnúkoPúǔnQSSVèZkjsv	FALSE
ZmgZZFrpǔlBWEáayzwǒUwi	FALSE
bxkáCkgRyuèòGwbrDmǒBJl	FALSE
dárMRJPmǒEAAJcuPTǒWCjD	FALSE
eókpIQCxùUPáóEPdkvCiSc	FALSE
fHNévhqBěCIgBsymMztèbǔ	FALSE
gIBTòOáXVUǎceLILSěòtzO	FALSE
hQLǔěpeTXZetCwWJkZEǒlp	FALSE
iblwjPYJéAuwPOàMGRsEve	FALSE
jisnbèǔdKggvgpèfSóàCHǔ	FALSE
knúgaTPàkIǒUBlaitQNNzY	FALSE
mISuǔFjǎGRqegúǔLTMXúHl	FALSE
nOdKZùCféQtHEbǔèJópwlG	FALSE
ohciMOkUolhIrémqmQEěhc	FALSE
qùhCcZpLvalùRJtdYSYúXR	FALSE
rIWòGMpBIǒǒòèMpáéǒCORl	FALSE
sudDLZpiELmTǒtǔQátnaIú	FALSE
uDchPzGTPNòVHPfLǔVGvtn	FALSE
vWMqculdkhPOjpowwRdkúà	FALSE
xèútPODěHyàUFdwOMZVǔPm	FALSE
yYdnWQgKkfdǒǎNóynèátèh	FALSE
ùùuxHJnGzXYóaIhEúepUǒKg	TRUE
ǔDUZèwaeSHsaMnCCPFsGHfK	TRUE
áWnaǔóèkBlúùòNRlǔQsbEdá	TRUE
àuKysMmoaàzTeárpDdòOyǔs	TRUE
éǎaBnchúPMNwUàCxlěBóòUú	TRUE
èPRNaěhMGégJrIdoěóEINHw	TRUE
ěVKǎnyIaǎPjuóQvylRqFéhm	TRUE
ólqrKèúlKQlKalYSéCqiěéA	TRUE
òzuzESuFǒwWǎavWVTGòúǒPu	TRUE
úEpqanWdveABòvyùóiètcàb	TRUE
AXùHlarMòPskòrcǔNmlznBp	TRUE
BarRěbwcóusMcqQOcoàǒagu	TRUE
CajèCXxCtEnjKèSiWFMwnbu	TRUE
DnsaHBdTQfHiHzQqBmàǔzKt	TRUE
FGMavGjZqlQQHzIkǒXvhvln	TRUE
GaQoKdbǒPLlcONWǔkyǔfrùN	TRUE
HpNKsAELAQDUVvqaEJFǔVXm	TRUE
JóZSyawúbHrzNóraHNEFoaJ	TRUE
KZHvKaPhǔáPóUBqTlòGǔuIX	TRUE
LtànCaXàLpJtújbòYUeUPtǔ	TRUE
NQěwNWYóǔóùlJSvèQaxeqaA	TRUE
OatNbFuSmGQùRkdXèvVwqgI	TRUE
QóJayúǒàXTùodbZXOOrSǒWt	TRUE
RMwùnyMsusluRVFTaSǒwMbt	TRUE
SaYbUFezěUNePòfJqàcàTac	TRUE
TsIùwǔKàmoaLěwcElzUDefè	TRUE
VEùYpPYHǔTacóIùzkjòùzos	TRUE
WnQěaKàFBycùbéISémFoROó	TRUE
YěǎOèwaOXbmHJKpidúDbKhX	TRUE
ZaéWfpàKWNIhtúyZkDeFCVǒ	TRUE
aǎpeXIWWxxyHǎlèóPuSIYPó	TRUE
aAEǔYDvoosIEcyèaBipZAbó	TRUE
aHPWJmyfěoNěrAKjàǎctlnc	TRUE
aOWduGVdlYMAǒDgmqeNmHwI	TRUE
aVlMùNoSPkcbffoGNvpùnWw	TRUE
adIaCOSXǎJDmiOnaoǎAEUUǎ	TRUE
akSVWiǎDCcymPuBKXóBRSRu	TRUE
arEèmWbocMLRvǒwYcLDǔhPd	TRUE
aywzěùluǔWBVSqznCóGdMkq	TRUE
ltaBáYBéǒefCàOKokJZSzsF	TRUE
nBONěXpDuGNXOazrgrytèwp	TRUE
oaèyàXeVETgjouUvVJdoURǎ	TRUE
plKYDYVùHsòYRFRaUEhěolt	TRUE
rǒpEIèJHPakoMròsweEǎBBg	TRUE
sLlvnFTzǔpWàLawfeǎXYQhE	TRUE
tqzěòFǔTáVFavyazyòUpTOa	TRUE
vòsKRàTsòXaRenBJoqcNiǒz	TRUE
wEamPWHzYědǎbbhxCaúszyD	TRUE
xQEGaǒgZRtGǒéBKóAtPukKy	TRUE
yaghHSwaloJcKMCQVLhǒUáq	TRUE
ùùàFIiRzěXFiiMujsùsúNnǎ	FALSE
ǔPòtLgVyěUáqeúyòyvbDyúj	FALSE
áeáHòzNùVXtCiFYXtúQArXD	FALSE
àrfubcIQayójUSbělocRDWo	FALSE
éǎàNǔAzǎUJNetTondpwYpǒk	FALSE
èQAKlJkZVUXDruDEFeDOùTq	FALSE
ěiUùpnùMfóiòWWAáEyBuùEH	FALSE
ósGOSMqKSfftéPèèúcwrBéù	FALSE
ǒCZiTwWnNZyUfDàSbQAǔFxè	FALSE
úVkKǒoSVqvSHmfǎnLzIJDpz	FALSE
AjtOcMièjvòLRhOábéNYcje	FALSE
CěbNeqkéTpnjKáqBKmCUbbL	FALSE
DMBVuAnUzHXòZGDrLéMZǔix	FALSE
EfUùGrcicjeuǔbǔbdězxòGy	FALSE
GCtùrèRcǒVDOBDHLLěKǎxFV	FALSE
HiyTFdǎpJnMQěǔékBúCNnfm	FALSE
JǒScmHGǎùQéUjiǎàǔRizmde	FALSE
KDǒèDDǒlqAózTjhMRjUOǎRp	FALSE
LSúFvrFphImXzszzIVmóALX	FALSE
MzTPAǎHRPdòNEǒjáKBJrGnE	FALSE
OJkuYěTBgéeAjFNoúójaáxé	FALSE
PScǔHoěieVǎFjhǒOpCKmépù	FALSE
QqojèUjwdSlRbjEmyJEdJaú	FALSE
SFRgXEqěKBòjuWǒXviégǒvc	FALSE
TWicgtSáieǔZnoTRlIJCVlZ	FALSE
UhàbJǒfǎKóPááváClllIwaU	FALSE
WécqǎhdǎxóvycEapnǒgàmtó	FALSE
XMluNlNONeéǎtǎdqAǎMòcCt	FALSE
YowUǎdAùNTVGeaèkoYeUsEá	FALSE
bééIHtRGKnǔldfTXXhmGZql	FALSE
cúvnBCdcpJeGbèjDYJxaòpa	FALSE
dKcǒsàgscDBǒoWKWewrEDAg	FALSE
eRmwQǒwùǎkFEoémmAUdqzVM	FALSE
ffùWOvATáDVLTaòàqFzLàwN	FALSE
gtQsghZátàúZsocUǔeúUáMl	FALSE
iúóěoUcàQóxsǒSKKkujxmno	FALSE
jMlDlOzusunRXOmRnòBWgáG	FALSE
khMwhTùNzòPzóIIcIGǎEjtl	FALSE
licpLPsUXDiiyláRKEùzsmè	FALSE
mngEóaGKYuwèaMBRrkaiiàè	FALSE
oANZúJècXlJlmMlUèsXTLDF	FALSE
pBéDàSGkGSCàhtsyMDEhNWK	FALSE
qShěXlaMónúBYxagAAcYBHn	FALSE
rZqMFǒMMbwòBWuwgykgFcym	FALSE
sgEwdmukǎOwMRLhòvAFUqCg	FALSE
tsveXNietMNlxùhgǔipQIsD	FALSE
vDèálFVxúZDuosEúJGwhCXv	FALSE
wWxgeUúóFěUQhvékǎènBbóS	FALSE
xYvFhupWVHjkoIMSdYLJxIà	FALSE
ylCVeAAhtQQFSúNyRAXsfUK	FALSE
ùùaCùgQmAPFjGEMjiUAfHDwO	TRUE
ǔGIPWTJKǎaBoXǒsóùbBCfjwP	TRUE
áaLMKěIǔǔèèBoǔǒcjtdOxZaG	TRUE
ǎǔYFGoSòaHkEBqwHèòiútLfO	TRUE
éTTrQBQrsXWaéOIbYtkwhǔrO	TRUE
èavxáéOCPOiKZPoUBSTdǔFPD	TRUE
óóWǔàǎJàLaXHXaYáYidWCcòP	TRUE
òTTqěúaèbuQMàoqàVIáqfkùw	TRUE
ǒaJWTeauNǒkOACǎbZPPějgRC	TRUE
úrHwèEúIKWtòpaNezNasútsL	TRUE
BùéxmKaǎxeDCèǔlǔagoéòHiP	TRUE
CUwBǒzuǒwamZkMvfPRCwfCnè	TRUE
DzGóJwoavCfMNUROǎJatǔaBǔ	TRUE
FǒXahYzúJlvǒpqRhòódPeZOZ	TRUE
GKayHNDCzgituoǔróuòUnYul	TRUE
HamútógwióěiyATyNkaùbBEá	TRUE
JáóáFàzFYUagzpzUyDVeǎtLN	TRUE
KMaxAKfypPPǎòvYPágZplzYà	TRUE
LnaNEZèIwnBzèWwOLIUéyxCw	TRUE
MrKApaQKéRBDfDMúVRMoBUkò	TRUE
NwatóayùdWkòrABaǔHGEDèSR	TRUE
OzHzpàURvǔaWúdxcQIzcùqbH	TRUE
QKǒBEIauùéQehetBrswXAFcH	TRUE
RaSlǔtrOóslyGqYTANaKèvaU	TRUE
SxǎZtNTEabfIéòxèqZsrNòYI	TRUE
UóaVRTOZNMqěeffǒWúúófOvě	TRUE
VEVQrFàHoFǒxèQasyFVSBxsǎ	TRUE
WaqALéKaWzEáQSǎOaQhkòVhM	TRUE
XnQaòoAMěgúktvZǎrǎomQKHP	TRUE
ZóDGèǔrěWDáTPǔptóqOaùaWL	TRUE
aástRAqAUTùoNSáYHvmlMJje	TRUE
aóyQodǎQHpjeRèiWùSiRcUúe	TRUE
aEluhqOSQDAQNOyòGèéǒxjòX	TRUE
aMNWXtútFzUzwrèNHYvKzmEc	TRUE
aTqWZóEOeJRóFOLftrmlěTǒN	TRUE
abRSyNXzEzTóKzSMYBàpPnpY	TRUE
aifgKdXdòBUWcóESWhJDVXoE	TRUE
aqáoúHoTzùshPIǔgròsJěNdM	TRUE
awtKPEvùcHnWYjTwuáòuòǒxu	TRUE
laIuJmAjCFòNéOǎEjSvěòGMi	TRUE
nǔXzùVǎRrXǎézWaéFtcoalgé	TRUE
oHWǒSQFTHxWaPùéIMkcRNbxZ	TRUE
paPovvtqKyfwGOJHèpwáXǎàP	TRUE
qpBEBpEOǔDJGéCTamgjěxúbd	TRUE
sěǒsaǔYáxiLcéěxmpúEVGcbW	TRUE
tRxaBvKèZǔáChTaFCdpZRuGà	TRUE
uaZwMkBiEVóssohǎcNiUéhXH	TRUE
wèàVlWPJPaúrRHLGéěcWnLǒě	TRUE
xJǒpGTMrWALRzImIǎmalóDfG	TRUE
yaOWDznpKEuHéǎVeGlMùqéxD	TRUE
ùùáòGmèKcGqKOǎrGzWQUSOòi	FALSE
ǔQǔfafzUDbWnneWukàFBXǎeJ	FALSE
ámvBòyúCPMJFcxèJpQNWěKRq	FALSE
ǎěwlVhQcjShybTPoMYdùMIpA	FALSE
éTFeEQǎnCeMèǒsWYsRSCLfIA	FALSE
ègOfGSKfOAǎpoQoszfbMpvUM	FALSE
óùNéoqlǔrmiáUrusxPWykqUm	FALSE
òOKópmskuMfBalYapjQdqNYg	FALSE
ǒgFYSǒUqrVùhiRPDXǒGUcRNP	FALSE
úxAFàwcǒfvwFóXkQvVmwxòTg	FALSE
BCkoèaJéáArljuHyjǒDqVdòE	FALSE
CSúnfJWoQApGYNkěfZDwjhMT	FALSE
DsSObUrTaKFUPTpDěALháLMy	FALSE
FEClěěMYkGBkkmPZJGYBzCGá	FALSE
GRGzOkǎLgoùsIyaTDfCǔRèfI	FALSE
HgRQEtFLQésètbyhooHWIKió	FALSE
JGECWùZCeVaXhMlvǔUěRRpcǔ	FALSE
KYěgvěsyRáYiYoètTQdCFSUà	FALSE
LvǎòIuàzòzqUééDtOèMěàMúe	FALSE
NHyúóǔHdhxKLùtCNiécRetkL	FALSE
OeuBàaAèoUQbNUFPEùvùgèOo	FALSE
QáúgbHINǒctRéZPKEaǎùěZvO	FALSE
RBgMcěàtzǒTFFSSTjdiQHbNú	FALSE
SQtábǒdIbBCáMgáuawTHeGaS	FALSE
TnèpDgBWáYxsfévMVuymdèfb	FALSE
VAEùTIIQǎǒoxFYbgFgKǎkLeY	FALSE
WOsuluPJrscYBbwCCùIèHIEN	FALSE
XTDvèúbvtCUNòxNàiàjiùleQ	FALSE
YmQDGoNjjGgUzFYǎqhzEBdTK	FALSE
bàmUòSFbàFoYtpIIRZMKzùcX	FALSE
cAgBCmgBHCyiWxFAcAqiEéúu	FALSE
dYALSxmWfwuTSGSzCnwALmOá	FALSE
eoteUóubMTóǔùfZuFùúèzjIR	FALSE
fwmlQGSMuǔZLhbVxǒXRáiGáG	FALSE
hCzPházWǒKhrtTKxvbxxuqEo	FALSE
iRPcèeYDCárHpCqwVàSlofdB	FALSE
jalXMXǔfsùBGViǎaèLhgLèòr	FALSE
kdkoxoNěyXhiHBuIeLoKǎLEú	FALSE
lxuBQBùXrQufDàSǔxzCCYěxq	FALSE
nòufYMiQǒfrKTVuVLùYMFRXt	FALSE
oFFAtBMǒcàaOèèáFuYùaTJqa	FALSE
pNqRWwǒúééǎbcAbxàzdcDvùǔ	FALSE
qVqonifbmynxaNvákHnQoPqú	FALSE
rfkqZàéqclSTàEQèWpfIVPùf	FALSE
tèxZPBQxrzWějddrWúòxZěiv	FALSE
uǒàvMJAkLsKGGpǎWXCeàlLèr	FALSE
vBMCZxoóxoAcPóaLXhherbZe	FALSE
wZSOEyuzRùTduǎǒěqOifSHVQ	FALSE
xfkEénCǔJUióáZsfǔCòvOOék	FALSE
ymKkátpyjYùgqciMQUvàféOT	FALSE
ùǔDaèTQYNktcgzvjǒbwBjjsàF	TRUE
ǔBTàaaBěǔOáLǒBWSFéeǔHSVgv	TRUE
áOètqaqǒWQNdUagieòHUAShNQ	TRUE
àXnZórMlRzaùéglKumnúBDóBt	TRUE
ǎqAémAEttaFqhCaHSXZBRdvàP	TRUE
èèPaJGhnTmpóyfǔǒéLawTxfáǔ	TRUE
ěCrDahAécáGbzyróHújlǔkGkě	TRUE
óTàazèpBYpònxqhIYpéhXLVàw	TRUE
òUOadIpfUEórǔǔGgKiùjiRǎùH	TRUE
ǒsWǎǎWuùZòRDOPabRnhvqKNtó	TRUE
AFóàVNKZùuZsrLVǎaùeSZIhYé	TRUE
BVnStadUàáNAvFáZRHoXlqSEq	TRUE
DùZHakbjWLnǎnGyPkhLòcnǎJT	TRUE
ECùFàxKrvaXsZIáSàcPGRùGFs	TRUE
FLòóaIáhyxJbcgOBwLáUaDIDù	TRUE
GayoòmYPǒclfulǎfpǎXJmGhTN	TRUE
IáuOGBWQnàLNaúúAkqtJAlqxv	TRUE
JIXzvENakVzynPlevpáQzFeOC	TRUE
KsaáVbèSuizXEòBAǎzUqTóbML	TRUE
MèùAǎGHéOLGEankùlXònMùZik	TRUE
NBéWùózJlyrQǔàJaPóiěěqyeN	TRUE
OXyzuaamjFBBsWVòCQREhKòyx	TRUE
QèosnPUQyWEaCBóèfKCIcLpFQ	TRUE
RMlèàsPéRuLOYlarǒVEfǎFufA	TRUE
SXǒnaTKARGùosǔnPáúLxóQòtà	TRUE
TuAaNùycàGuLúdmrmòXIPùoXz	TRUE
VTDIúěEUǎaSFqlTóKleóPZimt	TRUE
WatòXzTzbYTCDDgNXBvpqùǔgx	TRUE
XwGYnKPqahNqòKjnsubwdhròQ	TRUE
ZIqaOěIǎáòbJSXaHjékTègùLn	TRUE
aàkcnLěoTádEòóFfràuxLKgQl	TRUE
aúyYǒáUrQBbYVYhǔCǔVcHIěkV	TRUE
aGgGMyrxèHrcáqPòJfSymǔwNd	TRUE
aNóMTǔùùQkGMYǎHogScǎbHkxz	TRUE
aVBGHukfàCwszypuáJPéárAaI	TRUE
acǎgèèǒrdóCECǒáPyxRWLcLoE	TRUE
akFMlnKAByǒcòmúAlHQVèèDqf	TRUE
arǎJriHhRPòOtBJězevSWbtqě	TRUE
aygsyHwqoòHLǔhNPMéNjgsATK	TRUE
múàtóZFááaGJATǒùyHqèfonyV	TRUE
nMrHrzNnWněrakkztceOòsvmR	TRUE
oTRYǒaqwaDCóQúódéDěpKaPmV	TRUE
pacwěpgéǔEYLěáhSóúqTqjQEI	TRUE
qtzQxmqǎBtGápZGISazóqOhùl	TRUE
séoaBàòòBDqǔTyǔbVǒIvXDàdy	TRUE
tNǔMMOěǒszyǔYaěkCHzBsWóec	TRUE
uagTénWoěHMrǔExàòCAbàLlsY	TRUE
wóRáǎLsZaALPǔáSUBvvfjItlq	TRUE
xOlWDaiIiéOWnUjaZGIgHOwRL	TRUE
yaáqDKèIVOrGòazcnzQǎZbPWg	TRUE
ùùNgYXKěkkfhRRèmóJBótKBBè	FALSE
ǔRqUpnèJhěKqěAOkvQVǎóeBeU	FALSE
ákMqjfǎěnWpZViHkyjUbBFAùǒ	FALSE
ǎǒymXáúFuúàèFQdzMiPjEyésú	FALSE
éYùNázMsGvZùsSwZùǔyoCǔCàG	FALSE
èrUcJèqrPnxárZwXhGGǒrAFaC	FALSE
óěFKqyfcyYMZudVRSimvùlěMZ	FALSE
òNGrjcèqZèixxǎkúXuNGéhury	FALSE
ǒcMYòlhVóárYùOtéGqYzèAQuA	FALSE
AùeáHnéanzuCsoweLàSjqZwnm	FALSE
BNKěvwRéěNùmbDTěóSCDèYěem	FALSE
CTOCqYXEQeCAbijùǔajietèǔV	FALSE
DeéZrùymSECACzEnLéUelèwKa	FALSE
EwSWZKNluwOloWǔHóNMXOpKúǎ	FALSE
GAtlvkèxehWqěDsěiCWéAtjéW	FALSE
HPMPóICvWWNVérEáCWmboràěU	FALSE
IpùlFBèKSOàNJrhOVAgXǔàTsS	FALSE
KáBcgCkrZsVPyOjèxXDqjYUDF	FALSE
LENràtpUFòMěYvexxKéùvJasK	FALSE
MQLUhJpwBZjVEúqězJVjwsJfX	FALSE
NVàvwyEiIdJRRVǔngKYtmHIHǎ	FALSE
OvzNlàMLQòDcEàPisjeNYqcrW	FALSE
QFYnǎgAUIaúGéighLiUXNúèzZ	FALSE
RqdgIbwěWYgwqRLTAoInlhxsǔ	FALSE
TéújkEohiópaǒPxdkUXòVàPZI	FALSE
UGpvEqCxùXáǔvòùyYNwòOuzdh	FALSE
VYZdhAiraòqinSSXyfGAPvUvT	FALSE
WrcúBHYvPgbmUáěotǒpBVCaLB	FALSE
YǔrxkXSuěTmaEHIaǒAvnHǒmVa	FALSE
ZòèuPWǔYswHěoòKefQbǎKpIgn	FALSE
bDVhnmxhaǒUBaogmKyYHáqòúX	FALSE
cVhhérWzvZrěèlLéfHkaúsxlD	FALSE
dkHXJpcrNPzgzHgZjZálSEXhě	FALSE
enUAnbǒútIbǒDoOóngóoǒFeBX	FALSE
fruJfbvHGrhkáǒqpàJgozqúGò	FALSE
hàOHǎXéSbóLnOtróVuWkhDDFj	FALSE
iJùcǒkxǔóWHgcélcdEǒCdvYVY	FALSE
jGShVkJZjǎjWYoúYwneTaASèx	FALSE
kSsúùQZueZèIokLǔǒàHòěIHHV	FALSE
lhZǒbHáHSéHsBgOjGǒsUsLZYF	FALSE
mudKQèhUGùvrXyádmxhrùyGáC	FALSE
oàDRùYeLèkTNlTcHnùdYACfTi	FALSE
pIIqYHFógGǎqARgwǒNObCùspá	FALSE
qbrgoǎozyóGǒPnjYàbWBKGěCú	FALSE
rykHdobòzPXJNDoàéShAZcǔWO	FALSE
tòdgsxwFéiPLRRoEèJǎlhzkDd	FALSE
uZuCjSRJoiSPnGrùkZXYùBcTó	FALSE
vuqupnCxjbgQPéMKUwqǒáǒmzá	FALSE
xBVhěuwEZwbàoiTDMdHEóeHàò	FALSE
yenGhAúǒYKoéwQěànkùLSEqóǔ	FALSE
ùǔaǒbhdTTwCěǒiéLmohVaaèIzù	TRUE
ǔFóantúúrrsOéDWxDxfpshYxóA	TRUE
áaWXuRcMmNáMǔUfdwRhDǔcáeàé	TRUE
àrPaǎhwLElDěnLFáǔWbéòOàYSm	TRUE
éAazMěǎòMNùúgDAQEsbVxǒWutI	TRUE
èSaeǎèWùKPǒYchbLqAěnQcèdVZ	TRUE
ěoaBMùáǎffòèáPeéXYfhNbqpIj	TRUE
òǒaéKdbějbjǎDùèóybFaóQzfNR	TRUE
ǒaǎSEVeHhTrJEdSbLNtàsWúúGV	TRUE
únoahéǒZéIèTapRlhyTdsàkJVW	TRUE
BAtRázVqèYùOBatLMehoèUǔiuě	TRUE
CajYdGùèPAmnEPpxǎhéyvàRwew	TRUE
EééèaBKOOWKěǎJNmsZYeoivòWs	TRUE
FèJaòècowvjMYORóCóXOyǔyQgL	TRUE
GYoǎPaUdlóMoKvfaúúfEXúSexB	TRUE
HlèRpmFǒaRdTHdIBbsOegěcnyú	TRUE
IzòaùaDǒèàjRWJXgyheǔoúǎěcH	TRUE
KJSèòXaFxFjYpAQtVéHCXěaPJC	TRUE
LRzVSSKǒùytòuaoòIàDòHǒbáfj	TRUE
MoYAPěYZéSasòugivJRZtLNWCE	TRUE
OòRIaúrRkbúcépxKJoùFiXNWWA	TRUE
PMQNDOpsLUaǎùhLPaBVòvDèLdM	TRUE
QaYtmKéěYjQBLzSVòTzJkEURài	TRUE
RwWmTRTrMablzwhTHaáNNpsèLI	TRUE
THNǒalXpIruMhèáyEpaUálSZFE	TRUE
URlOòáKǔafxééóUHLDséwbLkán	TRUE
VaRKeCLaěJClgDzJMWwIGylǎXs	TRUE
XòtNaěGǔùvFpàTWzJRpúamEPOw	TRUE
YGTGmLTNvaǒùoòuhMmoHzHaáKk	TRUE
ZlěuaJiHGBlwofQǎysxáwWeUùò	TRUE
aélǔAóRznùAuKGkRèUbKěbWrDE	TRUE
aAicfdùéfEfmDǒòAáYOxitběPǒ	TRUE
aLKévúxBwsónoùhMlkǒmZAsOPv	TRUE
aTpóDqzjKmnucZǎeǎwPvGTgAPú	TRUE
actReXyěeCXvvuJrlajIPEHsHP	TRUE
akǔqàTiAsGLoXyfjWDǔPRújqǎó	TRUE
aqRAóǎoEùhftrcAùPPfgóeLTVT	TRUE
axlEvgVàaKjhVTWjkcGJǎutCMó	TRUE
lsFvaOBhQsúǎqFIHPQawCqkqOw	TRUE
nóLuVǔWPJaCHěfKězPTwmJSòug	TRUE
oJaWLUoTcoyWkQAmHFyZxkCXvC	TRUE
pQAmtwónvNtraJDZGLIzGImOxá	TRUE
qTwrèwpAàPQawrBUCCqldHSPuè	TRUE
rarnaCMòjKwóObaàDmAASúYKhě	TRUE
tǎMvHzàóvYaHMǎmèfYklyXmCZǒ	TRUE
txLTAakyumdOCPPúùkSJéRMèIE	TRUE
vóvanplúOVEXěHEUerTTQóxiTj	TRUE
wYǎaǔFábJtyùiDlóèGrquIJEuG	TRUE
xaeJǎeOMEGèuGeXhOjLlúùKRòè	TRUE
ypáùOaèùhyHòěShRyzǔwTOSsHo	TRUE
ùáLěhCsZǎHVHpTǒávLèNméYFPO	FALSE
ǔMùOeǔDFdBvěBwnqSòdOVUZqId	FALSE
áXJKsdJUNezMjDZánèèLáoáùgA	FALSE
àjHkkvEvuQZrnBvcàslxaIlXcW	FALSE
ǎnLXPáèonKófděǒYOqàzGMDChN	FALSE
èóWjhǔELIkuDAùIcLRIQfaRóOQ	FALSE
ěEIPFósòKqàhèlyRoKékkSNahn	FALSE
ódùéPrEáyJzRCbHAxIykjXIZUn	FALSE
ònRnyOqéhQFWLEXYvǎRutáyhèà	FALSE
ǒuěNQGglKtFvmswbvUyfòJXjyá	FALSE
AàǎgáNOfdOrFEiGLFwtǔlXFxex	FALSE
BébEQjzǎòàIWpmLDMDlusGyrKr	FALSE
CKTáBfoZffZcèOJkaBVhrcFèMR	FALSE
DfóPoěgLúOEtHLrLouAwuàXEHT	FALSE
EpàěZlgAsuúpWJWySNYCMBPMOi	FALSE
GótCKqrFǔKDǒfIaòDàǔùsZlUHù	FALSE
HWLktPlòǔVxZèSVlòhúzùójWiS	FALSE
JáoPsXwǔéMHéDeèAxkJGVěeCàY	FALSE
KGódhòùǔsCGǎzyǎDàSBfvlTvcé	FALSE
LOútSwgBIbǎáDèDdJúDXxNIKèR	FALSE
MShópcIjBLWZuhpòKmLPXpZnEG	FALSE
NfnOULàEKcsCDEANVEdZkǎvCjA	FALSE
OtEDFDKvóTújdJòlLzxwuòǒLNè	FALSE
QSBLòqèITfùEùfsCDfWcfRlMóě	FALSE
ReRpQYsONlkYǔèhǒTMnééúGóòá	FALSE
SkǒùqQTIFRsGtMtǒZYgQXLǎDkw	FALSE
UéééRBúEnfǒúTdyjNwàysNMǒfI	FALSE
VMYWbZgWStDQxcjMVùǒcáuàgQM	FALSE
WkvWBǒOOCNdtǒuEoWVowJMǔMěa	FALSE
YèǒwzèGùEófmZSióKxuCgRneàG	FALSE
ZSúèvnuFHFoBpMùOJKyúKmATJǔ	FALSE
biósWWMiUYYgùGgùMMmLěIójlS	FALSE
cxmuGZtwMèuESQBèNVcénFeèhd	FALSE
eéBUjWWBRcjAǒZnDLtrpAugǒkW	FALSE
fIxMaměóROáIwQǔHyěBgFùyBXK	FALSE
gXdFsOócOBdjǒpZrhLdqJAàěCD	FALSE
hpZěǎVosXaàzXǔjYaNXxKSMUsá	FALSE
jùòPyxàóWěIòKLSRǔJDlmkcòZP	FALSE
kDgpdHǔVhDmAhawèsùJáKmqaak	FALSE
lóJTELuxgǎòxvXxnDmdsIncěNY	FALSE
mPéPOlVXzxfzfKAvaSbLPQCgYc	FALSE
nifsSRéLOBpáWnZiuDobrèAàfm	FALSE
pERǔGèguIZǔJBmvUSǒRjSvPKkǔ	FALSE
qZZQoYljweKaguhMDIqFlwBBAP	FALSE
rqyRAàònvLGLéǎúXHBOSHfěQǎN	FALSE
tTINlddáVùzCoNYDnǎEtrgCXWi	FALSE
uYěemEzdǎUhlǒSǒQjKnoǔáCwEù	FALSE
vvoebéskéBúNUwWZAǎUnLbàóIv	FALSE
xNkAěǔóVXwRObǒRTdzpgRúdiIK	FALSE
ygLwwxǎixpXyAàǒhcMSBóqàqsE	FALSE
ùùěAaIèShOHDHaDòCHpJjGZzwhS	TRUE
ǔOXlxDOaSSáJTùFJùfEzUxGòYJP	TRUE
áZySCraǔQntúéjbJúrcANǒRVHuù	TRUE
ǎóQvóPNCOùPIXOlJIòùqKWaCxér	TRUE
éaucSgmRǔMdvgYjmHàWVlNTkeTb	TRUE
èpsRJrmVantùLgJQxbDLděIéeIò	TRUE
óòyaBjǔRIQqLtTcèaěxcEFXyMrm	TRUE
òPsaBpPúPZébǒUwǒWsMqbWAYbOm	TRUE
ǒavSǒUzsxèfyHZJuFttXurxpRpa	TRUE
úvFwaéFAwóteIàSzFǎǎUXRdyzNa	TRUE
BGaXwaěèTakjzFKXzúVfQmòuǔOM	TRUE
CMěòóLuáqaFphjPmgzvjWápczaR	TRUE
DahMǎVdSWVebiúExweUdsOikàzM	TRUE
EtqFmKooNMadWpóMèyǎUYOúIòOq	TRUE
GàGppǒuaLZáLfKUóěUwòhGàFxOs	TRUE
HJLUHpVntwTsaxDcKpěPAéúóúxu	TRUE
IVoVFétòéJDQrFáanIHáIJhJzǎb	TRUE
JaHǔméhJXǎKDjáCSàòaiàdiǎùJn	TRUE
KwèoBBnYSGntVěLXNLěoaqtǔwěF	TRUE
MMVQáYuaQGtXXxǎǔCǔMzàIVVDkO	TRUE
NZAahPpFhWDZHwYGdwNupKèGàXn	TRUE
OzmHRrǔQèaYimZàUděLaáǒGGJàK	TRUE
QHPǒYpaúTphmǔǒáCědqtqiùOioI	TRUE
RTèUDGXCoyěUpCAóatFzfóúArlé	TRUE
SaFmùoZvOaOGjeyWWRèDéùwhcBé	TRUE
TatěfDYòiúZzqkòXxRSùTiJAèyL	TRUE
VCawVǔDWEujZogúLhJmǒWàAzyaǔ	TRUE
WaXgáòQěòiEàuEéRKKbPKnKIáPa	TRUE
YǎrtavnòZwVRBwéfwjCQMǒchdfy	TRUE
ZRSTrFěARFZwaCzáúzzVQùǒHziZ	TRUE
aǎDKMòèdúbhsYneòieòwUVjTàáV	TRUE
aAǒMPpVkxaeògXǒxSPZautǔLcOQ	TRUE
aICánFzòěcIrJcpEuǔZmoùǒZlzW	TRUE
aORRlhmlWrkENxCeTTRjvzcRcúh	TRUE
aVOTqJDCúǔbDXQBhùuvVTàPHOVQ	TRUE
abiPWhHstvtiLzzCFoAnkwIHPip	TRUE
aiaúTěUiebhdǔùáUlKATzUǔPhzv	TRUE
arGcxxkkdDòmHjnshEixzsLLiéj	TRUE
azeSvpácqVaINfKGeěkVUTOJYKz	TRUE
mJǔXJaGVaéiqǔgérxLjslólywwy	TRUE
nZOPrqaBówVZWoéUotYoMáCàókó	TRUE
osěacǔtkMHnabGWǒhqziPǒDéròL	TRUE
qúúMSzǎaěeáUvCápKXxEzvpSGEc	TRUE
rLaCèpPóxěHòZiwlNacTkiptjeo	TRUE
sVòónaxmMiUgpTVDiOrtSUVJnéb	TRUE
tatqhGtAResAXcòǒkgùkchhFjeè	TRUE
věOHèqétETlEFQUxUèaàbpDǎLòV	TRUE
wHPafeEǎoCùCdAǔCPQěccaúvNlw	TRUE
xaǒjSzKyáCITInZáDbEgoúomYQu	TRUE
ymQaAxCsyàLBvYiùMcnanjKFoěà	TRUE
ùùSzNǒógvlGRkMBtǒlIóiqRànpè	FALSE
ǔLùZymZǔZhǎòójYáqǎǎFTSéFqIt	FALSE
ákbZúhBZǔKbjxQtCDfěcǎvUòFkW	FALSE
ǎǔZYǎURWGGpHèzLúESàHǔwqǔYDN	FALSE
éúSiZǔMCxHǎGRfùèKúTHeVoGVmQ	FALSE
èEóòypSmPChJèáKTalnBácrfěmk	FALSE
ěMěqXézAXhaNòùcwàeSGTYWBèǎC	FALSE
ójBEAOzDáSaAYuUTifkgFDZyCQě	FALSE
ǒàzsàLǒJPáMFtgǔróGcWbMùjJjě	FALSE
úǒòuoesbhxúfeKǒTpǔtEDaéYòGW	FALSE
AJXǒVuHAǎoǔtRldjùávoPèzWǎCu	FALSE
BXZLSéjkYexEFzxgEóééqwGJádf	FALSE
DùyhmBnRdzKèàeóMJhtZQqóYdtz	FALSE
EúLxgLUbYuùòmòAYjMgtWUGúCXé	FALSE
FRQcàgIexGEcRKéFhyàeqBáHpig	FALSE
HǔWnmvèUékbnEOlSZvYeXmCvRVu	FALSE
IFOróxWwOzHòdJǔémNscoómJOeà	FALSE
JZKVzRCbzwLòvVVPùWdCgalàzAú	FALSE
KwfrZǔJTsóéiXjsDEJNvEǒOWfpC	FALSE
MǎòTwádKKaszDBázFVTééUAcuVq	FALSE
NHePèMSzrdnqUFóOMuúCWJEúúXá	FALSE
OXtwUbóhwEjěMLmdǔUmàgmàXzyB	FALSE
PhVpaaePúcqaEéGǔrsúKyPsRIáo	FALSE
QpwVbLǒDqhuHpǒcěHWAHpèzNLòc	FALSE
SúuFrXhYpFDUlkùeXǔWáxòQNQdj	FALSE
TSéiǔlreǎǎzǒhJSyJúPPniznóMo	FALSE
UkDSfcwbmBVpuZvTéǎMáodzrBut	FALSE
WòUMréJIáúǎQUNrbihóěCnWZezú	FALSE
XOJúcVǔSzjZPNnǔdgSěEkfHèièj	FALSE
YmhkahPlQfěfkNǎQuXfBdǔUQǒSw	FALSE
bǒRHKzKOqLQYóǒèBrRhCsáVcyòT	FALSE
cKávBòrYFóBèrVAFSsárfwmǒpǔǔ	FALSE
dWCAcùěVládwCJdvpàòMYǎAèǔYl	FALSE
egwqZYZáùlǒckjifnMfaxOCUBNJ	FALSE
gDYylgaDMěSMǒJngAáiPIépbàSn	FALSE
hLZěǒOAéèúFòHJVóùRàgHéxUoQó	FALSE
iSokUaZxtLéALodPtěOCdTogèwC	FALSE
jWVDSPOvjRCzSyMxǒáNTJIkRAǔu	FALSE
kkkaBùBbSIsmóeZxfKjUZHlòpés	FALSE
luoPàǔàTGàuoxrNǎvEAyvrqGfEǎ	FALSE
núóóǎIEiàKQYFURGixáIagEqKdS	FALSE
oYJǒHdZFfwǒeAéǒxmanDXkybXòò	FALSE
pfWIáuKécsNǎěTXeRXSpúSnàrdp	FALSE
rèDóKJMBLQfqqzagUIJjáqLòjac	FALSE
sKpGQnfènXZJòNpCZòGDùcMOYUP	FALSE
tVùKùEfsNòaHUwLTúHFùriFùktL	FALSE
uvqIoěǎOuvUvwdJJSwhsSBaJIPq	FALSE
wéJtzBAdJUrvóèoheMùifgxvjeH	FALSE
xMěZbfbOiubIXCDǒwjóCǒvXóItú	FALSE
ylREnucPóěóTQuxfiwSDǒhitlMo	FALSE
ùùDaiDééǒqCǒúyèFàúsxBMdvLTJG	TRUE
ǔDaútZouYZzǒSvúAòMieZebjJdàx	TRUE
áaXěèǔEouuqJxmǔZPEAváǔetǎzop	TRUE
àpaykVPHpuàWVdSWrJHrLqéDJulD	TRUE
éúyaCYuǒèPQzXjyEOfYGNgèGyáRV	TRUE
èOaěJPDzalwSCQsuDxDvbaHBOTOa	TRUE
ěacamáǔhNSúoXHbLǒDMVSwmǔHxùo	TRUE
òèMěvrTKxàaWrHJQqùGefIKQOgǒó	TRUE
ǒFILLvarehùvIhRǎòAtnuMROmábC	TRUE
úHZWUTúPWòvznNaaYyeéezRjùPhd	TRUE
AVúroRDXKZúǔéǎTúDakǔWbjǎrcóX	TRUE
BagRPcqNAǎǒnTuLekvmSQOècJSrA	TRUE
DéaKgéaéolmrNóěhnyWyGtOtsYkd	TRUE
EPaGáWVwKqoaBAzwyJAiófNféuxg	TRUE
FZPèppCěóUěRWCawpzhweùwěCóóH	TRUE
HómápaǒúobiDdoJwlTtxyBkdaUnY	TRUE
IRoaYNFQaiYǎPIáxQytuAáehjogf	TRUE
JoaáVyDěèsúMxYěǒGzXGuQlCAckQ	TRUE
KxawHGéxǔMExoèpùcVTtXDbdasin	TRUE
MòWUaùKmhtlBàòJùTcIjnUcSBQJQ	TRUE
NNaǔpNǔaUlYogyèXyǔLwotVZptHB	TRUE
OXFGBaNsnSGdFxOmalQiFQàbGtXD	TRUE
PtaUúvPòrIjLtbBéChvpǒvbybrMm	TRUE
RJLaCǔcKgéóùjoùlboLlvVVtAkiT	TRUE
SméNàRLFopaòMvCCOKaǒòAkYoePo	TRUE
TyPèàJaKFójlùúǒdqFcǎqIPùfUòY	TRUE
VABKZǔXGafoxUúLPǒúSkǒǔJeTaNà	TRUE
WUlaqjiáfHtfaòáojàFǒdHavnSǒL	TRUE
XzMàpYlSVGóNaèLǎVuKfNgzOKWWa	TRUE
ZIaùOKlBtYFěrpǎznèáeErnaCmHé	TRUE
aǎǎAyùěVSUwpSdCFuuGOòIoAwUCm	TRUE
aBǒèXuoQZóVàTóyVlRLalLBudKeǔ	TRUE
aHrFùkCnfùqbBYbTcpúKlhTKIEiu	TRUE
aQOCqYvkeyOymUXǎttBbádIpeǔKl	TRUE
aXeǎVXràrBXUxXGzbǒCNuěfdAeǎe	TRUE
aeóWKvVnANvlěhtsXFaGèNnmZiěi	TRUE
alFémtǎǎèéǔěeběvěIWRvEIXùwiù	TRUE
asáNóCDàfpxèvlVzǒkàXLPrAfVěD	TRUE
azěEmbaiAǎMòeógmDuLMzMBgoVwY	TRUE
mMCoaOéyyjSèQRèDáehmspfoólfǔ	TRUE
naDnryqéidéǔlsàGKáVǔeyvsvǎǔǒ	TRUE
otGroDXPDèSvAyáaATàOdǎHǒojfh	TRUE
qúúKoFaQLhUHàoqElEkpHMdsjBǔh	TRUE
rKXémYtHFaNRJOoTúGkLsKjòhBJh	TRUE
sapéóhOtUBeúSBteNFfSVeúězoKǎ	TRUE
tyEHUoOWoNúWRMKaFxIéHutkCǎio	TRUE
vDáTGCòQaBmkRaGVsgPBǒáYéRtHz	TRUE
wRAaúYuwIUFFrWHUnocrúEǒofNrá	TRUE
xrǎlaYěBùtmyZyàNzSSXZfIeRùCe	TRUE
ypnTCyNaWdVGèleaonCoTMSEPLbn	TRUE
ùǔbTRFKéùfWwJǎCPrèPuzkQNCǔaR	FALSE
ǔXyQWeFYDMzmèLaFKlúgkǔútùBGU	FALSE
árShWSleàhVěHRàFhdfQvIQUuHvj	FALSE
ǎCǒúhywvyèèáǎcSjKékEozPdòeMh	FALSE
éNXòLtNeVnArvzVéaxútfHLeHtzE	FALSE
èoáoHàXwùáBáTCoRqLXǔsKèlWmbm	FALSE
ěsCgBHiùxQRAédrGIVébcByZFqXN	FALSE
ózvZáábNùTsRtéWnhQiclZzcrqaǎ	FALSE
ǒEàHAéqúFMNetWIVvOěRSpzòàWuò	FALSE
údUqjVPyǎrqKFDeEblHOměwxònǎq	FALSE
AnwáJúlǔMWiǒHtVòYmgzàKǔLTéǔo	FALSE
CHùPXSèUdEHěJjùckVEkBQfLzáIz	FALSE
DMéáZFěhòngmǎrpweviTgBrzpHòt	FALSE
EcdeSǎóffmOáxvFHFǒgPgTGXúift	FALSE
FopenNtfHGǒòààòécdhóLeǔqYófh	FALSE
HápóhSRǒóFRNǎdAoOpHEPMzǒwJbY	FALSE
IVkàOàRwsUTREàUùàQcOJSxHGsca	FALSE
JoVHeVhSfXyNRWcvKcGlxKWlLrUW	FALSE
LHóJéGjvzdubybebvyNfIVfovIRi	FALSE
MmCZiǎIuèFJuwbMtbocsAèYdyAsú	FALSE
OánOPUDvwtrrjMdDǎuMOùGejexVF	FALSE
PJnOltbmrsQzobóMqdeiCKtJuòar	FALSE
QchCPWPfěKljwfǔùnOCiJKhfAUVT	FALSE
RpápOTǎHwesùwQOèmàxéeKuniLěe	FALSE
TèXUùèikHNgòOiNWwotFmVntzutS	FALSE
UOàoóGvdsSBHòBXhLtOǎCǒkYTBmC	FALSE
VkMEkPIVqfpIJqwTkZbSGsàèarOQ	FALSE
WvBlKeóLTTEèIHcxAlúuUFtOuLnu	FALSE
YéGxǎwiváóYòǎhvévuQfátOmtvwu	FALSE
ZEJséáKxryNJxósXoyDzFAtgqZQě	FALSE
bZtfjRsXLóUaUècxySTpZZAxxAAs	FALSE
cpjdózúyCskKǒeThupYóéAǔQéYUm	FALSE
eólVjGoVeqèòúXéDǔèǎBYuscqQEs	FALSE
fKNeyjghùuLWxYkpXJǎcéJáFvxyò	FALSE
gKQhigOebúyùOnRmQxhàUhTóoNàO	FALSE
haPěBqXBgFKùMfIàǒéaqIUvǎqxǒq	FALSE
iinRCJóúeEIZUSedVXqiIOjǎVESc	FALSE
juCRlxZOùwàSHPúXHUdrXWbwqERR	FALSE
lǎpUrelbǎGQlXNeěěkěóRèwogNáE	FALSE
mRLhsònaSǒùdnRjàrmdsRWòXPéáD	FALSE
neQglFFGqLdòèaQJWOémuAaàWhBW	FALSE
olàěLòKGyiOàTNmetúBJAqògvCfǎ	FALSE
puXěěRkIbSieQǎBPOóAWLNTQNiyk	FALSE
rHJPvMyXIéVgěPORǎUffBKgVKesá	FALSE
shXùeWIxhěǔYèvdòùóáàcUgifYáU	FALSE
tolSfOVCmyElàfHoYgXWlQFlěkrl	FALSE
vAxòGmǔhúèbydǎxZlEEàAUUQvcct	FALSE
wRsixGGěǔYccézplàhàúZuIQuRqK	FALSE
xZLfHgsrMUéyúymVélXnùnZGlsRù	FALSE
yfUAClxKgscacQǒǎQIRǎEBqkMwùo	FALSE
ùùOAPáěaxyfóbTJBoùáòssMYRcaùè	TRUE
ǔIzóupyamFRgBVfxdáǔGùxYILàbǎL	TRUE
áUaYTlNTvQNǔEWIZFZCàimKéaYdgv	TRUE
àmáéytCBJzZWZNànsòYGBtqWQaǎrf	TRUE
éěòAaodwPYwbèjwTúDúéOxáǔǔǎhph	TRUE
èJTpOaSúGSǎVlLhámùcǒFùLTXyLuQ	TRUE
ěMMBnpDaěIMCAóDvǒpwtPǔQěèěèǒě	TRUE
óaeYyáOSWóCǔúHZàBoKffHAlnVtàò	TRUE
òsaèFcqmpbLUdgHJuùHHUScAyTTmO	TRUE
úDLqSWpSaTZQJvenòdǒyyOJEIFgFC	TRUE
APuLaáTWqreAnAESHfMàóxěwrFlFZ	TRUE
BoTùUtǔQQaáGǎSéǎǒOEEǎmnNxaéKě	TRUE
DBvadxEúqmrcFZeHúEuǎiUXódlamr	TRUE
EMJPQZapMOOBrúNJCúdmWWXmCJUqb	TRUE
FmakéPMpcQtKSSěǔègVVHhácúpěEV	TRUE
HGaáTYèinǔNHyBàNCiQoKùoHěǒwúm	TRUE
IaSsFPùLaǔóúFquhvIUqXxfqNrdGn	TRUE
JqèTaYoèIoòMSYAúLnNcyIěTàHàuS	TRUE
LǎBsPEnvúsandWAgLǔxsKòtùJZgòD	TRUE
MKCUǎSáGagHfǎZèábFwòqYcóòItzb	TRUE
NaNIFaBàmkIqjéèèCzěgMccSnLmBp	TRUE
OqUankuAUSěYHAOMlnnyMěBVqùVTw	TRUE
QǔPDzFoLtǒaaqnCPsdáddteúǒCsǔJ	TRUE
RGúúaKhKròeeRaeDbsǔilvdQqatIQ	TRUE
SYDósaBYCEJEúpùGsrICTQFmèàIǎc	TRUE
TmmwáèHXanùJumMBúbcoXKǎlměórO	TRUE
VáSěDoDZaXóBHayiěkmOàTtTpmwtY	TRUE
WOSaRRedpkKxeúrAJváOPUákǒrMLz	TRUE
XahpǒAaǎlRuRMYoVMjHCDdQKuhóGa	TRUE
YvúRQHYúEpKYLAanùéOPoRaCǎoAàl	TRUE
aáErHrKUácmArESywpzKlIwkaDniu	TRUE
aòsòedgxSUèjàitnaùDIXmMzXsúéǒ	TRUE
aFjhmúǎDèaNúSèvOòZdIxSgPZNCǔó	TRUE
aMòzGgávǒViFùOèGBkpeDààyMCtht	TRUE
aTǔáùèmhLXviAvMkIùěùèNèjòsNSd	TRUE
aaYtBsYOOvWZKMǎkMqHgafPRmChMZ	TRUE
ahkjYaWquEùSnJzpOYdPhTǎuVTjdL	TRUE
apWQóVtNúgVPJRàhyYJFjòiybQPhk	TRUE
awCjutòPZaVZWàIóúvháFGlkEyúUU	TRUE
lQaUzoyTOEoOěZsǔsCCbMQùSViOcú	TRUE
mpǔéAaPFVtDALfgPFsPlvDUWǎIFòò	TRUE
oDáackeǒmùNSànTrrjpDhWiLnhkRm	TRUE
paFHYǔhyrIòalqPpzǒǎZkDNLǔùOvú	TRUE
qyaACaNùreOuQxlgBáFhvnPAgwyéI	TRUE
sǒUlsóTMùLCWZtJaágǔRékGSrùObN	TRUE
tZuaFOJvPtDGpěBUVhòeuàLrlsèkl	TRUE
vèaRàáǒFMQhvraSOYSylAéyvGojQn	TRUE
wCFJaRácéIamXótkǔwnZéNbCǔezǎè	TRUE
xWzslrEEaNǎqhlkCCsxkquawLcSfs	TRUE
yaPzSòQwWèwrkàQHǎǒYoUúHIzCǔxn	TRUE
ùáNFZYIzVlqWuoJdNtPSoEóXcExae	FALSE
ǔKUjXmèQòiQXòtWCmxACNHIgssòku	FALSE
áNJDuNcjKapAYJKQfzAǔfoòzsHeWr	FALSE
ànuEcwYgvRkRIEBmòXmuéuópèLXqE	FALSE
éěOItpfDámAJWADmKǔèKǔsYéqdnDá	FALSE
èNdhsNúblbzWaàcFwVúúUaSGTǎTAK	FALSE
ěeyREbKòCCatúTvúFFEEaFGOxTòOh	FALSE
ópBùlòJLYZvUeKcFwòSóQùafXǔkBf	FALSE
ǒěYièpOknLwǔuzzQBkyǔsOǒOFNCLǔ	FALSE
úWYqpdsZgmCeEtNYAǒPyAAqgWaUsè	FALSE
ArhhWNmgěópdYPzItUǎyqUǎQSdúsO	FALSE
CòùernHouxàZúgěJfofǎrzméOépGx	FALSE
DYdéEJXKvIXdmxGaúwyHeáéZyJpRZ	FALSE
FǔoJOHuczLèěawIvSzAbGXùBLYùDd	FALSE
GWhWGSkWxwaámJYDáxóMTǔáùuGFNL	FALSE
HnqtXóéQdDòbCGAbǒúáTǎZǔúMuèzè	FALSE
JFpǎvQtooeToINXtCǒpóqnWXSDLdA	FALSE
KTewbfèBúmáOmsMUWmTOAaBùáDbBc	FALSE
LZCgMǎpndFAETuaGACfAkxáSjuáls	FALSE
NóCTùnddSsáéVùvStùeoěOURàDNùN	FALSE
OǒNěHǎdépuPTHIffdSNWWbMězóqSW	FALSE
PRWHKwcóHqjJNjvAkVtPeyOòxsSnà	FALSE
QWEtMBOIěboácbTygóXqAqcHoépzN	FALSE
RnGiFXqXéáeOòlaxSXzùSyLzUěcaG	FALSE
TùeAjvéàblyBǔHFúwUxwMtoiNyPǒN	FALSE
UPLùjǎOhFàǒVQFěUxùmpCTgòGéqau	FALSE
VjjbjHlImàèOúMNóyòBEMáǔgfVRXá	FALSE
WvniǔyizyǔkáhvùzyHWoèIDněDèrù	FALSE
YANxiYdǒGǎkěJxàstHKFsiUEǔEzáQ	FALSE
ZUCdèèRXàfXNOaLcJFěMyxsveZkJD	FALSE
baeTTtaDUKDǎOIquUDzksǒiuHZfkg	FALSE
ciǔpOnKKDxYApEáqBYUsriJccàYVc	FALSE
duúHdsěǒPKPnXǎSQyFàCegfáHAsdy	FALSE
fúJòMAUsTSbiRbWOwlMiǔONqvfzCl	FALSE
gLYWykCNJPěbmiXDgopXjǎaksGKGù	FALSE
hXnéěfólskáIeorCPtDéǎcnXmgBRy	FALSE
ibQFHWěXiRǔZwqPóàǒqVUěEbTVdpU	FALSE
joHDXùLUIfsXǔavjdkGCKWǒZjNvAc	FALSE
kzkùrFùoSěizóXccYCnèvAàiADaée	FALSE
mBkPhdvXrJoèùOgsáúTúǔTiòNáàvQ	FALSE
nTmbrvěéooXtzYèKLDéLNèytVbóLz	FALSE
okjùZtǒGDvIuFKEBCZhRúpBbdLfxo	FALSE
qàqxjeezOepúIáXkòYóVjfjJjUeSE	FALSE
rGKSwòLRuBQPNdskàTvqUùVPxCNéd	FALSE
sgàyRsDEjAwJéoGvyúNùPdViáuéwz	FALSE
tlPBùrCGbiUèQèZFázXNcnyznGǔká	FALSE
uqoLlLàAyUSnKgòáfjZYWBTIIYRZI	FALSE
wóNygMWbVcXàjneYMeNvǒYhtKTYSR	FALSE
xQZGmDGnwóDóYpJNěQRGZSwERfTǎM	FALSE
yccLzgěCEMjrIéměGijgáVxzàMVjé	FALSE
