ùùéPXxèRmǒǒLruǒJFèSátàTVáǔtDTkF	TRUE
áYbnYzBLeàPcMJMDaKeZzOkǎOWèIyCn	TRUE
éàOjRZOlbǒnoQRjiCòzAáúzfHJàPIeU	TRUE
ěhiéAxDyJoMqaiSCGstèfsHcPtxukDz	TRUE
ǒǎxPqèUjHDxáǔwdatàtvBXkKKúMYKHp	TRUE
AfHHpúbjXKaǎIRáIcèǔǒdBCbjdùnEco	TRUE
DèGwLóǒLYXWFWBVòAynǎVrCFOeàKcAú	TRUE
FeǎoqLnéqkSfeèqàwèNtlaàwàáfOAlS	TRUE
IGGyWPvEělwXxòeXSLwMOFmáějQHkaN	TRUE
KdLJiQFwEáDóiXmSáGeryiGcICvEǒàd	TRUE
MzDGwCccCQZxvfeuxeméxbYùtfDAzgě	TRUE
PdNURuyGòGjkJXàGèymKcfkǒfvwCADg	TRUE
RyYUafáhSéXpYVIěGaXDRzLzYaJNfǔj	TRUE
UqHxǒǎRdádòFdAkVJGSǒDgvaaUǒQBBn	TRUE
XIièUikQBJtFEúàaósUmozfLèGùbjNj	TRUE
aǎeRèòainXKoúodúǔcecbBàPbdYmDùp	TRUE
cimvyykTǒSàFpysaLèéfsiqJHbsQffw	TRUE
fBYZiAUDRCZèèeFCYòQóuéeqǎxéGNòH	TRUE
hUonqàùgZcoQǒhpiZZěěWměTSěCěaià	TRUE
kálsPgpFHjWfúǎvLwAsMèQàvVéKáNIU	TRUE
meZvHbHOoěqzlGahòèùslQSwFǎòIEòj	TRUE
osWaúPhělěaNdIXTMPPTnyOSlóàjxHR	TRUE
riòcDèaDrěXXyRHGyièctǒTèpkgAǔmm	TRUE
uhRèCILóbyěPxúWsXLúǒòǎQCdúkǎHXN	TRUE
xYéknùvfXjfèAxQiUQfeàAHAHZmborw	TRUE
ùùhlcppaébApXszaqóKWSTǒbvàYKcéL	FALSE
áàéRěWTaǒǎKQKěsàèQòiPòkabaDbCch	FALSE
ǎabérnǎóHlpǔǎǔRBǔabirfJSSQǔkFRó	FALSE
ěèétiWoKJYkeaPèWábQǒJZnuTaQxbrò	FALSE
òaUěTSbJéaNǎunbòeySKtbAFYoTKtHǒ	FALSE
AZRcsAlIgskCǒàRèaIóouqǔqbtZBabx	FALSE
DifBTdǔcgktFQòàeGJHnaábapbLCKOg	FALSE
GdaéTNbaáúqubKphoùéuLZrJnùCgéGQ	FALSE
JóúpSfZaCIUěPKIéóbaQzFblrLsuébJ	FALSE
MTsaàVwbPXuITětrNaúǒTlPoásbǎwóǎ	FALSE
PIóaCpbaToSmbBEyóXúCcpGǒHOoAPqc	FALSE
RgbDDmǔyAněRmuUmzJpúmTgǔBabmabF	FALSE
UAqmMvhdLùcaMPTěUbaNbsqpqWNUmóD	FALSE
WuRtPNxàFgKtUXabKabOGdvxHcuSèet	FALSE
ZkazqàbKaxmWwmYouyǎVùQǒLFTSWbei	FALSE
aVWAzmèéELbósJnpGayprbvTmBpkIKq	FALSE
bHEtHLBáCaYZtDběaXbFwlóǎmèfgMjé	FALSE
damOSxbHGTEONoaJUZbzFèeOcFútdám	FALSE
gAlèuoiMgFGaúbatènomàèPúbwLVSmF	FALSE
izJnárànkizaùbZtoBMèabGWWFyqàSJ	FALSE
lsSǒCòbyxqzùqxrJDbùawbGaoobaKba	FALSE
ojNLcwcùsJaǔEpZàbXJǎóaxQbTóáǔHk	FALSE
rfudXoIvLJrěabòaMFUbDZGióiólYsE	FALSE
uYaEbAPuùpxGEǒqBvMǔHZOVaùJOwCbV	FALSE
xPaoěǔbabNbúsEúcguOáHmǎdsHXGàmk	FALSE
ùǔtèTcádITèfweeVGofsQvRwayBEZJLb	TRUE
áSAjcjnHCtgǔCELéfOúPbwáùéěIBjuza	TRUE
ǎnOcáBToOIUqYxmzEUbúLcHIěRjbmoDA	TRUE
ěotBZajnXJqnǒojǎjXvEZòucquKzxxéK	TRUE
ǒhgOVnDgézrMqBXjoXUùǔeSUoAtGKSnh	TRUE
BXXunXrálEAgLFPècqOǔStenVGkVàOIo	TRUE
DtyfXSyzxmCiYKaùJkwEáCsuXǎMFMcJW	TRUE
GFqQOLrǎǔǔuWdilèvvópegDEAnbóNFQd	TRUE
IXGJǒǎFGùiHRdhbqtbIoIùóPwpMXCHgS	TRUE
LùxnlGzǎǔbwRoTcǎyFuzǒjaAcwxkypYK	TRUE
NqxháLwYihQqèfGWJGzàMsFhlggaoJuA	TRUE
QRZLEmárèkZDCkwMéJbbvuCSèoúhxjCr	TRUE
TěáádadQúgRqZdEiměTxúpfqJziúKáfM	TRUE
VbbóJqYyǎmkVNBKCBoèMmYLèRLPóùùoá	TRUE
XtDGózoǎànnyGbàHJàeZzRGMklJXySnW	TRUE
aúUpHqlyZfùRNDVeǔehLQěúEoěrěWědL	TRUE
cdUgTkrarZRUFèRFjhZJǒYvAGóACnPTV	TRUE
fFqprnwNeòDARúǔèJGuóGDsNsiNàdgwn	TRUE
iBNXFǎLiáJwUoGArúZèrvújKQNxsVǎdA	TRUE
léDuYYTiútoYyfUIRXGOkDgwRXTLtmèǔ	TRUE
ngǎxádzmTLcnIájáXrRpRáGaGPàgfXGf	TRUE
pdVYkUznhnOdoRswERZCBjNUhtǒwěmǔO	TRUE
súězrizWFFǒuqáyòútwlněfCIlRflZZt	TRUE
uhòhgǎzlbszaPógPLvsDytMFGGeòXJtU	TRUE
xCHáRáxGcPaJèhǎámvJCZǔǔkěTYDúdOS	TRUE
ùùKGPcrgnLGaTbabRBSOBdaOAqsúNéRX	FALSE
átwxFǔmiǔOMhǎǔyóěaKbòUabvekaàDyW	FALSE
éidMdnJqapbOaàlDFpGbSZOlsWblzBjP	FALSE
ótaxòyútquybEzyówaéKàuéǔAměsPDbL	FALSE
úvNǒQskxHCKJpabCCIxXRaOàLòqOébdQ	FALSE
DǔpOewzIAvwqbcKPaMbmaubyázKApVcL	FALSE
FpRzeNkavábWDvsǔVGGaHǔURuNNbXrBF	FALSE
IaXběOéSnaSbhOòújRmyYnmǔbqKayqqI	FALSE
KxQzLmBmQqnaQALwFzELétòěHbǎaPbùI	FALSE
NxzQèájSkùyocúddhéabVaóbpǔXJdhFc	FALSE
QaWqvbSSrawEbSJzdùIsxIqnMGjMCyfH	FALSE
TJJJzKaDHUCbaMEǒnBWZGòbpoeǔBwdtm	FALSE
WVBaOǒbzWAǎJFNaEwQbmoVúrewHQHNMù	FALSE
YnaVxlazLRèrbZéoúXaJóUGqLXbúuúuD	FALSE
aJaàXObCaěqTHzbWúMqCkógIPǔoKlxDF	FALSE
apRúVMFpWǔOwaéopEónLvRbLaPéábwuA	FALSE
cDbǒúàaVèDntéIsDbspIǒELaHwbsPKlú	FALSE
egWémamXbàòqQYIaLAqAbPIzXbTáfóFB	FALSE
hGkécFgOOabSIaHWúLùmàRbAnQcXntOm	FALSE
kěAdaùvbéBAaáEòtzPbjtokmějefwulà	FALSE
mdZbcgoMaǒbǒHlqLlVCaLbMnUrDǎNJfw	FALSE
pNalOOùǔbùaTvvPsGboDxRCfgOǔRaRòL	FALSE
rzQvrvsùmàZwdpyQSaxLUǎZIbpAnabZW	FALSE
ugèyúLúaèqXáIbNqúáBBnnǒGsúaóMbON	FALSE
wucanúǔvbaǒUVQztàERqAVYǎvòáVYbor	FALSE
ùǔemMGSrjàsǒlèXHDLuabrwZonRPXLwǒS	TRUE
áRtgLyLúúabzfáWQpoáxzRwCèàwqydǒùú	TRUE
ǎkIAòéSYyǔpWCehBojZndxáVwJèHmàVfj	TRUE
ěǒcPpDěóldXJVyèRoojeùvuvjHAèjEmkV	TRUE
ǒBògùójEùoégùclIPQOcóxdmlYCùIùAyú	TRUE
AěgǔdDofbéAvzdéHǎéSòáVWVèVpWbàráó	TRUE
CqrààmtXIVěúhèHxIiRRCacdIaOujbǔǔǎ	TRUE
FniDUOmgZfJgReLzivJFdxǒàòahONgmhz	TRUE
IZòWIOxoMòLvUXzppsǎhoRěsOBáZoHùsó	TRUE
LAoqǎubtHIvùeWzàòvúLàúévdIxǔypùfA	TRUE
NTǎázKvjaljacmrEIlCpGrYzIKSRYaDǎv	TRUE
PvWXbvbkdòJKékdydGàWyǔOhRCcéoútéb	TRUE
SQyóècsDIQFIobQěxRǒtTVFPhGéOqMHòY	TRUE
VLDyòfòYòOúyjèDáVjuniNRXZLQqATDAU	TRUE
XxWPlBVIYvrhoiùAUòiDcSèvRnJéNùYyR	TRUE
aěLǎzNwQóùMQVǒAaumsIGXptkRrSúěéeK	TRUE
cQTIfvOqXlòúHvvRěkàhZSyáRMKěòtlFv	TRUE
elgcpsIRTQèwfuútnQVOéGáCsxpGnqVàà	TRUE
hVArqvYòxGJOIxYfIZóòVERěXFbjHCiPK	TRUE
joPVkAuHUsèǎCsùKNATcqFHáIAyHGnOeM	TRUE
mGsyúáùǔprFALXuéùLOPěxzOPgGYQqkàF	TRUE
owHYUiCRféáòmlóvlqzpòQmJSKxBcùQFP	TRUE
rTLIETYFdIújIáAXEEPHMPbfáLqòWsvUG	TRUE
uòUPQUNǔnCfvQDKwRRfdǎǎoiěuYúàKDzó	TRUE
xákIMtǒEùBANùǎtvOkqIqKNéxSxFwfNsb	TRUE
ùùéùXhGkEbéábqǎaFPsybabIéEjAkQlob	FALSE
ánflJcdmwUKaKqùSVbDQFlzlwaěbRǎǒmk	FALSE
écHsarbvaobZNnkèIZfTièéGoNèéBUOáh	FALSE
ólúSNRtWfdFǒabaEIbǎLZGZCKèpTNRiLv	FALSE
úRnyZRWNaCAydIqxáabúautóbnjdùséyé	FALSE
BljPHpoRfTInCFèOǒNQOvabSaMJSoZèbè	FALSE
EádùemLěLmlLàiqáIiǔababykFǒNzeRIu	FALSE
GRPUckúMFpqQaGKbEabDLZlcDuFobLǒiY	FALSE
JEGáAfùěJǔòòEáJnaaOKPàbǎKasHbǎǒeO	FALSE
LjEǒlRJǔVVaONVUbBDulCMàlaBùbzmǎrà	FALSE
OHJababfwTSAabRsRèYǒDSnkPBANSLhjM	FALSE
RDzAáxGěúVqáěaZúěvXbWauQBspbPEjmé	FALSE
TjFVXXWPvOabrWúaPzGXBOJbáaMeNhLwh	FALSE
WSǔabalbàdEdóèPCúgaHrVǎèzWhvbkàpr	FALSE
ZczèiZtaVUèbCQabPqyiJyRIEnXhJóeóy	FALSE
aYsUqYSFoAFbRKWèClèXaombyKyqLfyIl	FALSE
bIsVùtùtNNLdvòarúúDbWAóaxùFTbsyup	FALSE
dxyXyLqeeTúeatyabJlěautFwMóCzHbYJ	FALSE
gWówxcklNúJoQǒHaùábDBAKaKlbomoVaK	FALSE
ianOébXmóéKTèaFbThtPòuáeKǒěaááWBq	FALSE
lAeuěWTáSèheéCabqaǒbBMNAIZjóRjáOh	FALSE
npcapFVQUnyObMáayoDmpQbEbTAǔǎTKpP	FALSE
qabàèapúTútbkemjtRATòvmxAvWtvDzàG	FALSE
tXoKWFukpAróKabaòbùǒSNèyJQqjqeLVt	FALSE
wcǔynǒUrUMvpQcěwWaěbSaMUǎJDúpbǔTY	FALSE
ùǔCétKázFwZfWOcEJHmCbrgjkHjbsHáYpO	TRUE
ádHcúOEfǒkWóPeQècpqbEǎúMMúhLZbdmXJ	TRUE
éDAhǎdIǒTsSěRQCDpzègváèKsShWsXrinb	TRUE
ěkòPhxFòFéOqZósěbòfjLMzSvXoCiSǎéaó	TRUE
òkbIvFWlEtHZàphUqnmJzCaǒYúěezODLEb	TRUE
AóěoǎlfCQBPizxTUùCwduiDyhǒéMtLèFFb	TRUE
CizRLaPXǎMDYfTěMGmpdhǒJáYdXábòufky	TRUE
FFozǔoùodfbǎěSkǎRfETviFbewFàixoúXf	TRUE
IòiJgZòMǔMtUTWEYBXnxùáóduvXeTbeSuq	TRUE
KpsJúFoAlMjTDúrtTvóxHniěccǎéLJOqoZ	TRUE
NKgNtJPtéézdmWǎqàcCUKtXMdcAYmsCXVá	TRUE
QAEtBzkóNRàDNǎFPZKǔYsIálwYjDVúEǔKb	TRUE
SjvQcIdTsDpHépsǔbOBǎúopéMjfěGDLáǒv	TRUE
VòBnwcIzysFmBóOXècoRXǔVoùFQUlǎpTuO	TRUE
XThgqXlávqHUCmNmauáKTMIkUccNěVfuWX	TRUE
aǒóacYWExqědKGZZWAhàòVLwADǒiloaMyǒ	TRUE
ctFzQǒqádáQmǎzsWòéógRtzǔTbJrgPTǒQm	TRUE
fgWatyyAtEàRàAeZdùVrSQGéSDtTVwZèhó	TRUE
ikVKdlVqIyTAhjwàxSSUHSvxhAZUVXòPèO	TRUE
lBMkMǎFEyóèBwAdIDáacmèBuèzúCvUJPZù	TRUE
nlojLzNzjùòtTtgCèdVácLéUǔMklTfLSùm	TRUE
qKDgiBhSIGBXǒAùQKFxTaIfyóXLXpvSHTy	TRUE
sfaoiEEOXYVkaZǒAǎéqehóèéADenbuZèǎr	TRUE
věHǒJZphXéIsyRsózèèhaZéwnOVnTóeCUs	TRUE
xLNAéěnOvidjmknrRwXédFNIVyòlaoXHòR	TRUE
ùùàúTallbLǒBOuAAowaápKbqkORxǒbpPOx	FALSE
áxJáABYcǔIVléǔaOUCoWǎbuBWaèéCáǒUěb	FALSE
éZtǎéofaPsFbòDoóaqIǒAVRbTiAVcèùòsú	FALSE
óAmPirjabNHmCaváNYRbVTauóěěsbqéSGz	FALSE
úexWqǒZtàgaěvUbAzKCwxXǔaNúlpbjTLěz	FALSE
CúǒyGcCanNrùBxSbnáwaZászzAblvdcBkp	FALSE
FXǒecVěùSVtbàmXQabwǎaPmMqbUPMùèYcO	FALSE
IǎjZJgmVuúaoǎuTCpSOPlbaFbBǒSyCqPAa	FALSE
KmaqrbHAHaZNHnprCuǔǎbZPúKQEbFHféiP	FALSE
NazCboabldúǒpVEhVěegumzòYcwGjáǎsóA	FALSE
QZpEkynXyaěobSZQaPsbáQsqhkBózWLlrs	FALSE
SdáeabaéTmpICJFFNubóMhSómxzzzzKvIr	FALSE
UmaxǎWMGHLVaOrǎǒwáZbaùJùOěQUqáVáxb	FALSE
XúYtGYnDǒuTHGfdhpDhnǒPTabaǔbMOhǎAk	FALSE
ZsòAAUGozzùroGǎUntbMWabKùazúnKVboI	FALSE
abèHNpExMaGTTětěZbmzéFKkUTFměfRǒOC	FALSE
bGfaàóQOybLxWabfMbeNxvpejEgtpjǒkEw	FALSE
eNRHLèDHaikKBaEěxMrRZáGJXbaboRfdrǒ	FALSE
hFmTòàpfaéǎVbxéMCǔAYlnxNaNDCbByáqB	FALSE
kězrFiwGdHuBVǎaDZHUGYénbaObiáWXXWc	FALSE
mqjwULUAPMrZabBlqnaáúprbPAùecpXaèt	FALSE
pPLcaMEboàBarZoSoěùmFOEvGONbhěáàuj	FALSE
sáXxvGPUaXHQFLòYbmQlPǎMrazyFSúbGvr	FALSE
uqgwtrUfágùǒSpGoZcóitababátEyDkqHo	FALSE
xNJVjTPcKZiRáaIOǒbqàKXaǔHRbmifèZBǔ	FALSE
ùùAmCiiájJQZnKgmyǎeóèúyjpyBsrprPódS	TRUE
àApvZSǒmROttvpCǒdBUòvMbUcIDHYóMǔsCp	TRUE
éfdLFwEEmaqXAlóOZjáXYàWCIBcCMIdFdmd	TRUE
óèǒBtàSQedKJjEZǔòagàDběǔOQjBfycéVqú	TRUE
ǒYgòBfMQcWFDyxòùǎWODrbckADnAvykFVLA	TRUE
AXHKióGoeàbSwrRLKnWJcèpqKéóǎIQěǔEáD	TRUE
CrRNcaVXǔtDjuWǎTáoúyOEǒiiáIhtDlfuCQ	TRUE
FSghGcuQtéRtUkHECjHQNBQǎFYJtZrgéǔHa	TRUE
IéIbqAéJTóSnuěLGómFYizBkVNOèMóOMJQC	TRUE
KcJhGNàcdisxAJáafPsQZDJZFyJMǒàqAHhF	TRUE
NHǒVjTóLUéAtrqOCěCàkjLiěfhdrHsNfasW	TRUE
PgROéUIǒHrbMòMnwòùIPǔssqúUMtòREKKQf	TRUE
SCVmMfKéóFfǔscJnONvygdkkvòRoouOPByU	TRUE
UmóVADWysGMKxmtWHúǒYáàCJlǔPTEfsFěfe	TRUE
XCGRáOjBgúDuapcYLtWEáJsòúóoMdKeùhKh	TRUE
aEóSvWkqEchěOFèamúMSamyùasOrXBWnyqP	TRUE
dàvnGyVtdóodMeóWFùRqpàKRbGVDzObJqKH	TRUE
fYéCVMsǔZANqtQěEǔCAVOVSmtaǎHMXlWeòV	TRUE
iJiHbuzldIMěUYsHǔRaPOqmGggpxéOsdǔda	TRUE
kZoczvBEànmwMWócǔJdóqdòHúUTBKòjWFZè	TRUE
nMPSmòáùnzJwYyLvbFlMúbXZuwDbxAbiúuǒ	TRUE
plmfDIKIrReEAùwvSáJUdvKGOǔlTeáqYYOc	TRUE
ryǒèejpuuéCnEYQwUAqxbfNRkUmeěèèlZeI	TRUE
uptóOòUqCYáhápjcrěěBQUKotǔTSSàéNWaq	TRUE
xVgRtoFUúdǎáVùMěewfrsǔaèǔwǒOSMAOàfF	TRUE
ùǎcFennHjtHòaGsbtóéyoaOxbnXZAeImQHc	FALSE
áLdWBánǒDaélMCWaVbAqVǎBVMǒmYWLTYabQ	FALSE
éùiSKSpaOáZQQNoJoǒtbaěytQEěúyKuUCbi	FALSE
ěFhgUaóMvǔAbáóKmSaǎlòTbXGZécAàDCǎVH	FALSE
ǒFAǔmbaqCMlCULZWsbxPDéabHtNvQulMDǒǎ	FALSE
AuKAWjGRGaXfkòéaKHDbFaZUwèqHlYCMxbM	FALSE
DRùúLwúmxEqZAaHYSKbǔsTwIǔUvélqaWblL	FALSE
GàèCnáùzZBàaBloHěWèbààaáxbCIǎPxEǔóx	FALSE
IRaAAYXIGZfatHbaáAǒQoMDPbSOTóPěpěkA	FALSE
KmúNòějpNyOoòPǔloAVmoǔaxTCbOLambNsG	FALSE
NcSèvNFVsuJqEdiSúóWEéabóxtQGóatóǔbG	FALSE
QNabrGaQbPkYKOQJǎèJjrBSUgvUwVxàwpYH	FALSE
StwklScěaEEXnbaǎubumezbZPDbzfDdZàQn	FALSE
WabMzáPCúěDánanSoUóàǒbhVqUfInQBNòǔa	FALSE
ZéABrgiKRudKEoHaYLbUaIQlGbGnhHlULFi	FALSE
aOoěEùlBèNaOYBbTaAbayXěǎkVtUéGprKMb	FALSE
ayqTǒJèsabLLEǒvKauqWOquPùVbidòcvǔhS	FALSE
dgyjMwaGLplXQgvǔabvvaEvzlYbRPòfWéLi	FALSE
gVaYYrFtbúnKòJúTuěoEèaTpyVòRbhWWFàJ	FALSE
jVǎKGMqqHaMbaOEKORòEYMqbàeDWapAvEHm	FALSE
lsEHhaóbPLTBMáěaAOrMFbděOǎòXoQqJQzh	FALSE
oqUazěRTXoMzwZCǎúěXmbBpUuIAZabVRqsn	FALSE
rsòFàAVYeunMùGanHběaùoǎbJMékrFFWǎSp	FALSE
uraRWZbQDIásTHPoPaMIáoQsVLrbkEGjeqK	FALSE
xPxùwaOwbWRUcǔwCsIgMSapLbaybótjoùSG	FALSE
ùáǎsvDúòǎFMJNKmhfvmQúáèYEcBfJRTYěWWě	TRUE
ásyQKqpYLbaàFqùmsHLxSáiòyBuvàWCbzTNF	TRUE
éNfZCùéAjcMtvóRmoUJtJoEpdéqxsqòááQkY	TRUE
ěvùufYRǎeàPoHǎěǎTfLQGfàǎsǎKGXmWikkqn	TRUE
ǒóǎhUnUlgAcúUxGRVǒpǒiClbqiúHnVGǒaRVè	TRUE
AfOSpèPpYZQLúYúgcèBmBQéTDmòèMRXNhCèj	TRUE
DùpáúcECDAfóiwYGWnlUQótGUtWlOiLVòEIA	TRUE
FmujijòfóADmrxǎqojufWiqrKǔélsàBáNDgu	TRUE
IbeáéaXDhGAjYCVáDòsǒEzuqoàěcoázlǔCvk	TRUE
LSzQDóAUApjròbépClGPxPòLnúZtlQSàalèt	TRUE
OúmCěqmǒMHZicttàPClCjptMtlsSBZjillDo	TRUE
QCfǔKOCsgùsvsXOeráaCHhbDtgINùflwGǒiN	TRUE
SjxòStYkWCrǒOwHHfPCZAXVSHCEzcdnótwzp	TRUE
VGDrXLpFZkIUǔAVèàhWǎYCǔXBěaFYupbóLcK	TRUE
XzàSEúIèeEJDcTfoúKVlǎhcéguqJáǔLpReLX	TRUE
aCèAoRiXoòiXùaUYZmfǔzQězGJfǔgmwmměAA	TRUE
cxèLǎmAowvúByTHǎuiotDKUgCJNGgiMǔnfúx	TRUE
fEùpnfDFòmIèpVywsAénóunJǎrsTEǒClDfPG	TRUE
hCèyYZdHènǒúYmljceLóBúBOVsáFKUUvcKPL	TRUE
jiúbxTháùrTájrFQMMáTOshHvPǎyPtFSàǎǒD	TRUE
mRYaUèFaiǎètRwRorbJòeDOuCmSTjwKJǎgáb	TRUE
póěBvěRfmDZěfVxUXFǒPvemyéYóJxàTiúwJd	TRUE
sápgukTScALúccdQújáYxuàòyǔymXBawUxWT	TRUE
upàWufooùUAǔòVXXdLryNvTOlHuúyXnYǒhGB	TRUE
xUèIrxlAHEǒkijSEzcóǎbggZIiTSvScBNFNà	TRUE
ùǔXztxXAQójéwcSEQjEOBoyMòaàbòauwZbéF	FALSE
áhcMLeXujéAamRbDapbjNwPewTCaZqǒXsqWá	FALSE
éVMǒěQEODamqZúzZělóYbuzqmaǔEEbéCqKjw	FALSE
ělǒjaAǎàPǒgxFèúópaoGxuQbSVóaóHxǔbhǎz	FALSE
ǒǎGxLdiáaXYzmYAZbWáMWmoòaǎùèbóMZlXzW	FALSE
AZAěBIIsbjuvěvBTgùèShANfUSjaRbSabǎQI	FALSE
DIRKaQBJUbLWaXbjóǎCRFyIhaszHáRlùKèDú	FALSE
GùlCùAyOxXXbéCMlCOKauTèUSlbaosúbvtró	FALSE
IdraLùnVwGběaòyAEǔuQbobàRxPqhVěóbcaG	FALSE
KyLnóùDapXwbLMSapDHLZbkvaGwqZTJúǎtPp	FALSE
NjvuemDFfTmHòǎǔóròapbósBěabsúDssúJNg	FALSE
QXzBGMabàaOǒYělAbcmàwAǒaWneúǔBLFáxGv	FALSE
TIkRRǒeUnaǎvmběsXTaěbiIPClKMvGvwIaxú	FALSE
WIlehqǔUaTTLěémCbúnaKTFDbKúyòkWfDáfu	FALSE
YpMtfgààBgàYJhuoáazbWóqZabBuBMrǔzxoǒ	FALSE
aKMóèGMjúMSxJaúERDXyxbaFrblIèǔCAYkJg	FALSE
awUsàHubFHBFSqIGǔǎXaAěUbYǒXrxbYiXwvh	FALSE
eIúHvmtexsObaALSbàaSbKcrmtcBkLMcaVGB	FALSE
hóǔJYxLFIaOǎàóHxNFbsJGWVHGúaGHsbtukl	FALSE
jiaYQUbvlHYtaTámAALDsǒHòLbnhyrowikèm	FALSE
mQQèCSádFǔsǒWaLGbòtTuèZMaáFěBUVbBfQq	FALSE
pàNQlQDlpúQTèálanFKXobòCvúHàlrAHabga	FALSE
rlsaboYaYàbtòXYKItkDJHbbjáFeUMMCqUJs	FALSE
uavAlbWùValóàxáělFúbSULuQOLKYWǒSxNtě	FALSE
wxgaRzZDgùòáZCTòòarEbIwwJADnZǒDěaxbz	FALSE
ùùKesúLqǎòrQázPtǔSARmZPngdaáguTǒnSKcr	TRUE
ákjCWRAaIzAvmGNHwjltBòSYPZKParvONǒLJW	TRUE
éúAèCJMGuHFMèjkneěQóeòKǒiéóàcSjFvwUtG	TRUE
ěIASHbèKNVJàSgylNbáóDUIqrPTVèábIEhXmz	TRUE
ǒNprNCkòòfviBlàRKvkdwVpjàedqtUGSmXéQZ	TRUE
AjéMqèújǒBkJYéNóaIlBmJJaybàMúǒwTcbxnJ	TRUE
DPyéàóRórǎlqǔLǒkhynsYǔěggěGfphENWsome	TRUE
FeóyAnjbnFUùDOjStóyBKqYBgRóqYtEyádmkW	TRUE
HweXáoxGòpDAAoòRUǔTVěMázBNTǎKváéFnúHD	TRUE
KjEOěfCqtxùzèEzIàhihzLuǔgQOěméEOAqúIX	TRUE
NúHmmWRúeáeuxRIeBbGǔèUUqàQiǒpSGtiNhqN	TRUE
PUoLVúzYbpBjèNtKCEuFBldeOpǎqGúùmvXHpm	TRUE
SLUBaTsrSQPfdòUgpròKgCmwkdrjYwKDelógP	TRUE
UzTYútòKhFYUIaòBEjúofhINdvruléòXǔayNM	TRUE
XsRěúàǎTaNméúERxzddxQPwRqNújùǎXGmǔCFJ	TRUE
aPwKjkǒPónwdrRmnVlbRpbVQèěsvǒITWKVgiZ	TRUE
dàyKEǔbyǒěHwzCXúàDPuoVMǔSdjbPJQáodEVA	TRUE
fǒNjùIdoPsRrsfYǎáVzvjdeWgòkZgoǎxmFYxj	TRUE
ièZAeèMWahǎpàoczWMynEèZNLBòHMZSvyBDùY	TRUE
kpGyúláqóziàWáǒtQkXGPkCtXUREpUjcHQàeM	TRUE
nxéXySlpOǎónRbCNYhVwglǎaùwǎFHggPjTǒVE	TRUE
qChDxnědtzPBknofJyóEFaQlyZpriINúIUBgw	TRUE
sNvOwáLVùǔAJfcgǎufUtfQfNMPbáqNBErúgOM	TRUE
vèNǒSgNHFdǔáUécǔJéóPOvMWNěǔPSApIMòdTi	TRUE
xSóJgjnmryhrèBvTGuòúZVCTqTrMUáVtóúguà	TRUE
ùùnXXúùǎevSiaàGbERxXCabJtjwzèáTAMqǒit	FALSE
áWZQùjòeuCWCcKOcqRZFniRrabHDéLaDmNbXV	FALSE
ǎnNWòxǔuawuTbAsǎaréTrwAàUVánPVbúvMeěU	FALSE
ěWawGRbDǎZaKuòàbBQEUfBciHRSuéhavlWHHl	FALSE
ǒàdraJòFPUwbròaBVwZbKcóXdTrDgahéèmAha	FALSE
AzWbOùItZmaǎbàùoaàHbQáVCMmrOYǒrpSóVLé	FALSE
DeisFhěàLěwrBSétésMpRTcCǎLnvatVlbxaǔb	FALSE
GFaùòbàaCvYXTrlOvPxyxyGSKPMblbfCkXXJp	FALSE
JěFLpSDaYyJvgbǔXPaQùoǎPbwPòypabfAǔegq	FALSE
LlváAúTObòarMHRNTUKòHǎMuMKOǔCòybSCXab	FALSE
OYUǎójkaAbprwétyozòasbgYpkvùsátòéyrFá	FALSE
RFqǔòYBaòWóǎbaRǎúbgǎKAúsxDKHJjáKWHRTn	FALSE
TtzWwdjudAXoyFZOSégauǎeJǎnavabPǔabKMv	FALSE
WKZmèAècumòXFxIXhSPnlNNXQabaoDbkCwZgP	FALSE
YmihjQLoykaǔwězztbIQWǔaěwěbQJVQuòetàB	FALSE
aKJbKámxǎaYybUidViǎATiJGKbWGJqépnoEéQ	FALSE
awGáPǎuǔabǒuTǎTùmaǎbSEktàvoáěLSWWvPGY	FALSE
daCtAolBpXGrXúoPòwbNmtmqqǎaèěbFSaEǎùá	FALSE
gQlDPdGfàVhǒSùWhuIaRúqǎàJbúaAónbICUKz	FALSE
iuWzjàúlwUtabrrECnVǔGléaYRRéUOObcogBP	FALSE
ltEaéIMVwéébTlabYUZRZcXQhsáGěhkTHZPhě	FALSE
ohaIwyěumvCǒlFúèbaRuqbYlǒgǔóHjBVZLNYv	FALSE
rDELYúaǎSxmméQIǒNXbAyzǒNalóUIRqyězvéb	FALSE
uKáWaǒtǔERèhdypěOhNaqùVmpbKawQbZǒúǒHt	FALSE
xǒhvEwJMTbTùdarIGYúJuSmùDBbQFDsnabybM	FALSE
ùùnJèzrFEkSgAHFwpoGqEPgPKéDcKǔrOxsTJFB	TRUE
ásekHxOkzsKèPfCjfúowKdnmnHXtQěpYtwNhàh	TRUE
éLhRPoùeeóuǒNVPdjYbpqòHkzUziVKrgEbuCBm	TRUE
ěsEiSwBxpHjoXvtPǎdqDhjViFzdúHtSBXfKuǎJ	TRUE
ǒúOHǎéàJUówJlIrajCzjóǒDǎYPoVSgIhpútFmc	TRUE
AhgrNóRYEǒèáGCIqiPRAbònmOótEkmyBjèuǔvǔ	TRUE
DBrséRRXècFàSmàVFXǔwRNkděáclSLnéYxhtGb	TRUE
FjúJRBrùUPéxoAEsHùmSǒUzEèòNCEKSeitNVyw	TRUE
IMtǒǒgsPNClUzLsYǒFFJcETWcYúpabǎNWRWóZM	TRUE
LRéskqwmzjedèqIqóxPófBàFKcaxtmQBtKfnnǔ	TRUE
NhaTeùMoqXraéóSFffáoKhǒvPapUAHéZyggYbI	TRUE
QaGmZzHǔéceGbdLǎǔYaáOXgfǎvAGzjoQYǒjoós	TRUE
TAUSCGWěRBQmtgúJbKioHycXGdkeFEumàKQcóZ	TRUE
WàCnsóRUtCxoyLOAdbéFgTněvSfRuBùěùǎéúia	TRUE
YússwWggEKǒMRáUYXNdènǒjcUáóùQYKòODwjěe	TRUE
ayCnéFncbsàXXfyjHdHnXVóBAJóBǔDqàVuIekó	TRUE
dNWHǎěosùJYUnIBdQúNLcvxehzoORZwtsmrRJù	TRUE
fzsěDNsaehèTDéehCěvEySǒéSXáMegetEXVLNE	TRUE
iftcDUxFvAXǔòJWòmAnèRcIúTùmáòáLpYOAWHi	TRUE
lFghERwàáǒVWgvèěLAKvVnadJùvzeDèàvhǔXks	TRUE
nuPǔPQysèjMbpSFzTǎAóZXQToALLúksMyěaUzb	TRUE
qGexJfNjévfFoPěyěfOxbákxáOWJfúosAsMieó	TRUE
svaJǒvfmǒqOUnqnaúněánVILdnMEkoDPDAbwáP	TRUE
vCXǒLyFQdùUkǒYInFAGRúPtěǎáNShUòRPèpaùǒ	TRUE
xjKJUtdvPùnGbAoǔmptibpuescbwVtPICoVSTi	TRUE
ùùAúúuúàykMàPevJYJsAOBfaburRuaěVbóQPsY	FALSE
áqJEFàvJKhLaBNyWbapsuěúPZDUuQbnótuodPd	FALSE
éfnXCNǎúǔǒéInarbEFǎaqNQbwKsǔǔáBDVzěOún	FALSE
òAHhǒqCěǔAvFFRSzYGèóasZFbuùaèrCòHbtSòB	FALSE
úlpǎtNcàbdǔJWaVDěbzrHZaLmWEbòiWYKbYsIǎ	FALSE
CdmytipěczazLrpùùxbONěGXmabYéYfcbǔǎefě	FALSE
FEhjFTFMréWéaèòpxuZbKXùAaNbUójrmnCúeqé	FALSE
HkaYbCraJnjóhdptzIsatDybatbrhWbxzquEùǎ	FALSE
KXOJTIEóKFgVwPXpcabúKCpsǎSnCalMSbSKPúZ	FALSE
NWTppěwfWYaQtxlqèGLnbpAùaěǔběàrHHAúàGX	FALSE
QOAULnPwǎlTiLRkJSxanPFlOtERbPEwTarbóRD	FALSE
SjdzèeKCflZCkrpSóWGácabaqCmlbzcEetCvXv	FALSE
VTéTsyùTjsjúgwvVàAcóOaùObTVWěěyabJBHbT	FALSE
YfwmKLYUMszvfbmeSVarbSyJCQGGawóxbOwTbV	FALSE
aGsJJDyODbàxEabsQDmlhGgWzlpàùcmIoǔxnYT	FALSE
azèCǒbWqóssQyěáámaqmmúBbuVTúLxròlWcèwǎ	FALSE
dqYPCRSYVEwèabǒaFbLxlgoDKJKǔǔpǔZHòpPéA	FALSE
ghHEEǎàWAǔWěhNtarmǔvèjabuAsPUènCaWWwCb	FALSE
júǎnnmWúiggeGTabXQDMéǎuLréxǒlabZxyZnVě	FALSE
lYLZBTrwúaOHPrxxúKDYbáKGYòaóKKwGWnIbbè	FALSE
nmRNAxFUxTlSQvabCJVLúmIèmùDóGaúxbpGděH	FALSE
qTPJxxnǎéZzmQpkóPCZqSapCObFùIBSHrtǒabX	FALSE
samrREbQpvryVxwCQJúFaRbnwǔòGǔGOCAWzùrr	FALSE
vóǔaOYDRùkwuxlǎtzilDGkóXnùHanèbabyDsca	FALSE
xFgǔXèKRUdvwérjáàPdwmaSǒbělHFǒVSvJQawb	FALSE
ùùANgTzoRnCTYlpjóeuPILjoEJIdftOyqHátkkm	TRUE
áhUGIiòDěaOYWAJèuxVZěPǒFjěXVwdTQrNàHDYP	TRUE
éIltRěMLFqánBewúǒuBàwèwSmXàCěMgHhKMTEzC	TRUE
ěfèJópBAYǎǒúIeHiáéěBàQznuGVgpwěBhhKQCòz	TRUE
òsIFbQTěeXhóbKbfSaèRJCéyúppQaàGúùséiǔfT	TRUE
ABéUúGèuWMcxbYAPBLXèNmZGéIqKbIPQkóGBNtǎ	TRUE
CjányěMYoiemUctciQméWjqYPzxǒrXRǎsèàYeùá	TRUE
FNTTJjěVóǎpYǎiǎaSvasueaHǒhVsfJézCgzTnǔT	TRUE
HbzSUPmtàvgYǎàRAeútHoZkiyyyftxjǔGjóvziě	TRUE
KgYPúAǒYěMyiKRQǒNǒǔFckjAMfbětWPOpSqpuCO	TRUE
NkbèePrbZVWWBuIBóáLóPǎùzèMqEWjDǒqwGòXMF	TRUE
QCmKFrcǒáGTsgCráyCWǎGǎǎòdDuEksLLDeiWbFF	TRUE
SbzóPpfgǎsùcòGsVaPeMSlJLúDDgYDLvTHSòuMT	TRUE
UnMPSJQjPGPVàeFLBǒBjQjxWběóIiZrStWrLòeó	TRUE
XJùnfJULqTBKéSlàlOmáieóuùYNzérclnápmpHl	TRUE
aěLBàlyoǔkOsWǔzSljkUOrtwVMmFáhszpáRdrmc	TRUE
cfkǔEòǔlǒáéMGXjOrvLuLrnZsqpFENǎScěndmBò	TRUE
fiaumxPdFuojFBoǎójQfLxIWNYBěDYFdEèDDSNy	TRUE
iódphùOWHxQéNhCèhfkZKSgBVpJNOYbVvSǔtHvN	TRUE
kfTéXébxuBeizCYgqPFMVCXTTésXHrEbLǎbàGjh	TRUE
nǎqaǎjWBAMAùǎàHsmIHWkvTXYCjMdèòrXyǒětdT	TRUE
pXZwEòKbeQOIrǒszkMrtfkJVUCjOùònxAǒHohNl	TRUE
rpLúNtsraoávétzheXxnXǔéMIYěfúoaxDrTMJku	TRUE
uMùTTUJMKeúdRFXPǔVmNDVvCGrjùUólKyHàRYvy	TRUE
xǎkáwxoUbǔoTqǎǎTxwRprèKIyáoRoábzkùgQwpx	TRUE
ùùéryBxVXóUxóugDolarOǎtWěVCObwZxaóbkXwv	FALSE
áUaSIěvmGHbabèbtCIONMYAtgFIohèolDGGZVèN	FALSE
éaSAysVtDrlěYMǒlybòwqabmcCECEgtàǔJvrèny	FALSE
óRpǔóǔwaǎumPvboávòKopQxpAxynpaKbèfQjYàú	FALSE
úXupúoMMóIqYqéfXdviLdatKtbětlLaAEvNHbmL	FALSE
CHfǎlFuǒùèOvTambQzlSXayImNotxBHPPùboRjz	FALSE
FúLótǔczblLáqeUTISVvéPúNaòábèRěQCabhogX	FALSE
IèIěXdWIWRaAǒgòYRVnRUaUQRxbaómbfáSRGRBò	FALSE
KjStcHXWILpaxWlúnGóCóAAITNSǒUbnǎaàYIbqZ	FALSE
MtGBXHùeogěrGxabnaùmùVěHbaúKáIwbàhhzfYq	FALSE
PYVMúeSCabaVKFYǔBbKǎgJgWDSncMZECàlLESXm	FALSE
SàESdLQBFùRasbzélquNvvyùaábsvtkgwiquLol	FALSE
UWqAǎTěàeUfoJèazùRiRCZkààNòabaoǔbXheiwǎ	FALSE
XQMTxohavOKoTeeHwúefaèánéHbUnoòMaCábáty	FALSE
ZsjùLoqàaBZTQáQQvrnbaIbǒdpNǒVpSWePIYqrà	FALSE
abRzótKǎěúNǎǒlyxaoZoFGubzPdúNèóákrádǎóo	FALSE
cMjSwNvaCbXaèwUbCWAFzzBóànuzUmwJoKfYScu	FALSE
etYDAwèZYqpwaGZSbaCusWuyàéRozbWZoàIpYeK	FALSE
hQaFDuǔCbǒóabchblAúoiǎòUoyqGúAkgUQóiytG	FALSE
kèǒQefYspmálBBquVùòèaǎXmbaLJěUwpěKúbdMX	FALSE
mtǎACGBǎPyaINáAbàqZTabènfàeǎxRiYCjQVmJG	FALSE
pYaVèxèkSaBváǒbòPaYbéLrVWkòVWqZnZMHRójl	FALSE
sMalMNbaúZCIbKngèMuelOZmsQRSǔcbXHJǔgtYR	FALSE
uxBsBǔJTSèéùǎzúUffdPHNxxzsabtPnyrabSNrg	FALSE
xMZmucùaQúOAvDqEěǔybómNtIèJalbeèPciaLJK	FALSE
ùǔtHLSeZèáéQǒpòbuGiiVKèBTtWzirgxvYNdLvtU	TRUE
áOBKWǎMóPNabaaCXTsólQwkAPdDAusCnnpcSGsFw	TRUE
éǔSVynúèOfènéLBaPéuèKBkrVHǔoQsOqMTPéZmGá	TRUE
ěQBEeHkcPuáLCòáMTcLǒgwjAáǎhcQUiNfVqlkjhQ	TRUE
ǒQHcùarhGěLUsuMlónfIOktbLùPvràpaèsMBBèǎW	TRUE
BlKyáǒàDTeDyDYHǎIBFBolOqDbàǎzcnlosoǎKoxù	TRUE
EFtEIREfIJSYWlWBTǔsdJǎpéCàkòfmEvrozJǔbvB	TRUE
GcqkrúuúvCBfápOuKǎUoQsnJWNgpmwéQúǎYélYěA	TRUE
JJBoGfNrIèNIdvunjǔnSèIlHHImyuKùsùdvuZAzs	TRUE
LwǎChoǎáfUǎFrǔALGáěHèfǎaeIIegéǔiǎLCPrQJc	TRUE
OOumSòbUkróFXLlGéDxUàOhVKràcbmqéJòrNglǎx	TRUE
QrymrEGsJǒtjdoOòSzmùiǔBDRxmiFǒktàMmpqpdZ	TRUE
TYuDWuIwèénQWhǔRYSácwǒCFOfóùxiUaPYObXóOr	TRUE
WRmPgGmjDMUòSremSèBktSjòdnIVOmááTrdwjYeg	TRUE
YyDCMSNqBnSMIǔdPéùFòTexěgrúbiPyRěhóSibIL	TRUE
bQGǒLèjfSsóxvALpukěEzbzǎJàbZǎxkCFdtLmJct	TRUE
dtucEóòrzǔoKZthǔǔqàáBjǔùeBéěqǔǎpNHKUkegz	TRUE
gMDzqZmcojYfpidGNéLmàlHbIaFgYàǔpáúúQǒáǎó	TRUE
ivbúSbPZdMelZvwlrUEóhǒjfUGEOIZeLiWYěèhlt	TRUE
lXòpoUsePègǔPwQǒǔVndRmejtAòqàNcDcòúaAPǒM	TRUE
nnéTTǔèqDDHBvddóǎXWTáAyùVǎtEHelSdLěGòúfe	TRUE
qèszXdBQnJSBěyKfěEJoǒOzXXLEiǎyGǒAHbnjókl	TRUE
sIWhǎTWOàJhtǒwhAoZbqHzpVMURUNFwHDùfWóBKb	TRUE
vóLlèmsQàITúUaáǎǒdIèmùèǔhqLENRQfZóMSWǎSu	TRUE
xeMUǒunKwrcòǎKVijFznwKǎáptWktoAGoǒyěpKIr	TRUE
ùùTUwwlPAROSaYRmábWwUóEpavNbeCBhAòhJuAdL	FALSE
áHZMgKKáoalHWbùwpNabèhIMMxYVEwTòUǒyǒjòZD	FALSE
ǎkxEdCèLVjéěqpyGùouèoaQǎXběHpaHéqWóZbBIT	FALSE
ěMgzabNMYabùǔnùhykiàTBGYkKCGtOYrHǒMplzòf	FALSE
ǒàùqFěNmaGòǔbJxVDxquORaSHlbQoAǔbeSxǔjdOn	FALSE
BáabaAUěSpEzlQyMbMqnQKoYTéMKáXDwWfBaCXmp	FALSE
DlǎsGIZaěǒhzamouWPtbabVMHLpNǔuGzViHBwXéE	FALSE
GaàZBPInábǎabǎlkWCtZTqfyDàUoǒèlSZMQpypOC	FALSE
JMcáDàéCúKòtaóǒbaUCRàuvvEYuǒbONǎóxétgAxa	FALSE
LiLbFMBWǒXZvKsqtáVYOaJbRZamàébbwnLBLqMwm	FALSE
OTbMiVàVǎKVǎòaobqKòVUáaàěbDPukDǔUéJbMSCj	FALSE
RǒRLkèóJKúvlFoOlFIqeǒVgKYúxabPlWauKntbòu	FALSE
TqnoáFàGYǒjGuoyǎnEwpSúàCabasbWMǎeqgǔflxE	FALSE
WgcwMèSBmoěáoyaXnMHoBlbNpǔasbúòóCyxǔbSKa	FALSE
ZVkmUIMdzéZRWHòkWRtTaoeabSpayDbhùwóyWhUt	FALSE
aSáǒfběamMtmTOǒùqKràbavCnVbcjáRJaǒwPóDGò	FALSE
blǒhxCdwǒTTaZDsoXbpúabTùòCWCXqDtqùGSǒàMh	FALSE
eqUHUmSxPXZPRknwGyrwvabKùVOCTsTUabMWuWBr	FALSE
hURyRLǎlwSbADyázWCEoěAGBjawòvǔbzzlGaěvUb	FALSE
kFúVǎèabWRZǔqCǎàásNENèááxCabáHZzpGxsKrTH	FALSE
nàkoKxSEyNKFǔCùGSkIqěKqptbéaNubǒosGCabùf	FALSE
pZǒúǒOMiFGRUàBHgùJiFyǎpijabULvǒPaLVéráLb	FALSE
sMkrTsLkSaǒàsěbabrxǔVáywFIssSPwVǎLSKRqàl	FALSE
ukQùLNàǔabxWCáJXawòéábqEzEógVùuyùctNJKǒF	FALSE
xOǎEUWàdTaRCvXèbèHDwKáLúanIGUòpZúLSrQbmv	FALSE
ùámBqZLkitbbtUJeùMqKěójěJeAQGuàjfVěLVTkyD	TRUE
ásǎMUNuùvwOWDeaKwǎWbvùMvKQcwlpgqbèfWpcVǎV	TRUE
éNPlWVéYXǔWeuzUaècQóSrEhòBWawDwvàZzuxKkǎF	TRUE
óNǔlgSFkCVbtáLFDVoWNntSTUCǒóóeNǎnxDLMòTip	TRUE
úǒfpTmKqsZxkǎoavUòKvaGOHBzDNSDBòQzájnECeI	TRUE
BbáǒápESmǎeQhvKBòdòJKXàécGPòUTTbGEQòNòlFS	TRUE
DtgUmVjfvúTòdaèPAwǒmKáSFewàxrxAJObPSclRhD	TRUE
GICoSáàbYoglaéàSgVESBDRugjúYZúǒjfOtSàáHXz	TRUE
IjsóGKHaFBUZVbSconyhDòWùrzswLrvtǎwpùIgQBv	TRUE
LěYmkoeJXzDgDLMKFczOpFThizNjěWQòSiqtbàDkH	TRUE
OEQFěPúbǒltDOnyhXtUYlóaèlèViHáùqrgáSúécqh	TRUE
QhoǔtDéhyUJvóúBàIXdeiièbpkRDyfAIgèàIáJóáz	TRUE
TFěJEJdPnVcEuJLUàBCěǎèdáxWmyǒSkBeoSùdqéBH	TRUE
VYóNlvDyqágJDoEhpSmuàIròugBluóWUmaWkNGoId	TRUE
YYLizávIèBúEyěZYPaFàǎVvùmIùxgOjRHùlVDYuWL	TRUE
arPHvvPUamróaǎóèidǒbpHpǔCiqRhWqedóSqPPgég	TRUE
dSAmKècpGoCwEóBAànDCDqJhoZeLFJFòPúEdthPZl	TRUE
fsySpxFéǒFQǎwéOipùgàTeYeòvùnǎǔjfNúuàYOǔbè	TRUE
iFgyDúúpNtWdEàlKJLàVkogòaRnoěahCLeDGófDwR	TRUE
lèóGǎZRPJAwYKweědùqIGtpnràqLZbúRTvvVPěǒús	TRUE
nJFfCgIcpgYbfQǒòHORrVMnCsRJzlǒgJScctjTHéT	TRUE
pkǔWBqyunRYNJHvJiKvMPesIYcTFMxndPQqcùjEMd	TRUE
sKASTVhaUóaJiLiFjousqsǒǎjJxuěccGMzJvAGZFJ	TRUE
vápkòuApcéHDItBdtgòùnDùàFǒNúaqcbbèWuZéeúE	TRUE
xXLhLcRěSugmǔXKxúuùzFVkgtyNhHOxRWkIFlqǔHó	TRUE
ùùZoǒúbiépjsXFzVǔXVVúlMIZnxaEěMbwaHxbKnaN	FALSE
áldrUGlǔSuCsCaZCQxTNbCLSUabVsèòEyrPWkárqi	FALSE
ééeTIphFuMraQUmúJáNOGsrbqpHOaLSHNZPSUDPtb	FALSE
ěYxyBuoyLélTúTlOBBvpAóyLqaǒrZbKoaCKqěábdb	FALSE
òqheDUisNHyXraqKLSUKpéIYRréRbanIYQQspbǎFú	FALSE
AekDrTpcaMúUbVNaICTWbnvebveGhòyHkǔLZaQèkY	FALSE
ClManéWTOáQBuòrPaòbaHzbZIbQsqóMBIgCydXòYǎ	FALSE
FjnDjúfoLòuǒáKNǒǎReTCaǔǔrEbéMmFHǔabvàólBJ	FALSE
IgndNáababweòèXúGUpWmcuyHópóeAùOmmbkVYèeR	FALSE
LTjXèzaQSECauùMMtBbabGxútDónZòěGEwGUqbjPw	FALSE
OóòChDwlskafmoúOFqCSQabuoGIlTYauxbLHólQàM	FALSE
QjvaàYBmbabENòwGmzraǎtaDFqóAúTéaSWYjirjcl	FALSE
TYqnWrGǒóǎBvvùJLGXápQúJPDbǔaNúLbvGFabuTEo	FALSE
WuǎuXabrJarvóǔwJCLBORMúbǒákXXxcxctXxtqOéR	FALSE
ZbDkMákùièwduLRabYmaWéyúNTéUsǒvGLAsboELTO	FALSE
abaǒOxOnRqbumsáLETIióeQlSqfyTSCBwafyFAXùz	FALSE
cMeVEaéFévjugnPaJxbWLXsuùIaZwmovǒXbHóǎenx	FALSE
ezuOJǔcòrkáOTǒèóamǔèrYěbqJapòbQcùSZljVxiV	FALSE
hwyoVcsGtWcabKúnvaDbRòúǒqJUDOOsUFVRérròEx	FALSE
kǒRAMycaFwáKnQYòbmaJvqDbcjZtǎòxIúNIGndhJU	FALSE
mfZéieLIfhIáoZGǎpBlvvxPqDaéYSnnbuamqTMYbE	FALSE
páqéEǒǒeùkqJǔdBUharbyOǎaKǔwǔbáLúéxQàéuěsó	FALSE
rEsmDxèPzZúxúQUaGZIsǒnNbabJHeròOzWBǎòZlse	FALSE
uóXDDèIIàúFQfxTZlNǒLLZAHěqvLsúaWbMaSQyHbz	FALSE
xGdqiVkhwiNJHYaJúMrxVzvèwěyJaàGěGàbaPbfby	FALSE
ùáDólRnycTáésTRPcuqdtcFúiTǒLTpTWópémxnéjǒc	TRUE
áóSfpYtgNsNUYéqXGrhùCóNYoomrězxǒoELSDàOIHb	TRUE
ǎcQxHhOǔUUobǒUajNqgwAXcjǎàxwbGGǒǎYjScyhDey	TRUE
ěBúIúhbqDǔùulJuiàksAùSbejMlJraprjsàkùàGgXh	TRUE
ǒǒzèǎěrzjpYHǎiUIUgybXfúYHNbǒYYPpnvBcSwnLál	TRUE
BCrǔxHPudfaQawctnsAuIyùǎlúépasCaéAsGKpmcHn	TRUE
EǒGBàtxǒcPErBVùOiévTGqDsCCǔFAQPhQIěxVùaFkn	TRUE
GQàwPiOjǒùRDRáiVStZěahbgrdeERwàéùKRdáFVèyp	TRUE
JǔHCjxXòAKRfrécàLoTǒdDBòeHSDàAMQxVfoǔǒGàDN	TRUE
LSIéOIyǒAjCǒHàucWòxnzbcCiAYZUěotùbNxEIFoFs	TRUE
NnwmORéslúETXjIJZòYoZóaPLEDecáTsvIǒǒědzIIH	TRUE
QVóXFKsDěòùbwejúHpùDěXxOuùMyúuJdwěLJěGYáEI	TRUE
TófwMnáXJQOPùhKǎvAójZBQqfCòdadFúXFBǒePàgNH	TRUE
VqseCNóIBáúiuhàxHYdPbAYJhDqjchvàHWlggaAAku	TRUE
YOkRxxùardOsBLDJǎGugYùnKeFórZXLlZSpJxqOHTy	TRUE
béMXcascpbwUsùXUvvCdHZǔAFKrTawjeóUnRQXǒlgS	TRUE
dRxkeLEokySInYcMlnhhMmiǒlmàpnǎMCUèIbkljAFN	TRUE
gHXJrIRèóFnxàKivPZDvCPáEUagdFHLyúxZELNYeiN	TRUE
iMJYxǒúnRhxǎFefóHtsJgKXrBRunéaùnZápJrlysèj	TRUE
kddbúVNHhySCrYiKTǎcSdpJputùigèóèXùgUzVEbfC	TRUE
nDCǎsfùEádrpàqOsCRRzqtgFxEHèuoiyFbXéógztNC	TRUE
qěàAAJtntFreXbbJQùbòMvSéNǎJevgwòkǒAwgwwudk	TRUE
sGfBěWuuùtěùUbLMNmQǒóGcrbVSéWbfRLjELQǎmiRi	TRUE
uzreótJúFIKqyxǎTWǒNSxiYGCǔZòptgkkàhxQxjXák	TRUE
xCbTKMlLbZRLpxvLrKUMeDpApAEUààAaiZGSibKrWě	TRUE
ùǔuxMyqǎǎanBbaBàbéiCǔrrPésvUVwóJlǔJúHǒǎZsO	FALSE
átabaǎIbòpJVVGntAJCKCópNzvWéèǔqDAEmtLXDpuè	FALSE
éWlsaUplFòpǒMzóbǒSEuJLoyèǎXǎèaEBSUbnQBágùó	FALSE
óòǔgùZDxěJqogàaèbwaPbùhbygQmBVSinzéTCàlǎOt	FALSE
úCFoùaèbèTGRasǒJTTbdWdCsGùvGsCSLléàCnàklBF	FALSE
BtvUdvgLPéCNVéúebOiVěàaàIúbaFǔbDgUfXbròNàn	FALSE
EblcLúnEǎhrkUàǔizègátyUǎmInYetItgtarbáaYmb	FALSE
HgàsúrddUSzaPZyèábòoApzOEutvèǎBaMbBúJWmúgè	FALSE
KPáwWrXhcpLaúóFOoròuyùbúéULErùùaǎLbUrdwGWd	FALSE
NKeSGsjRiGOipaybáXězSMaUbòhOdjùmjLòèUǒGrCP	FALSE
QògcWyKéskNǒWTǎCOpBDněaAbéǎalMEbBbXDpGIeus	FALSE
SfRaǔJbBxaLqbKpsBbbArRVùvoèUfěGǎHUtBmDDoǔǒ	FALSE
VPǔNGoQVùoauAàbvěvvǔwNYBaDsFswěqMbèoOkxQaC	FALSE
YúéyáǎYaovFbáóRtaboùLKlJHhǔckiqSCMFtRyXǒèU	FALSE
aFFsNLbCaOGEbjèlRjétoEJǔúèjGǎnaǒbypGùǒàěCz	FALSE
aybaAoZAPBǔěUFbTFcRòifGEVévTyrzǔtJNpúAéǎté	FALSE
dUOjSàJGeàSaèmotùGVápEbQAQaòIǒXpHbEyCòcuòj	FALSE
gàaèIYCvyxbISaKbFcǎUUóDMvzHCèéGoYbàQòDMáHS	FALSE
iSPohdeLkòADeHAIKaUVTZbaSbnòànnuVJZEaOkǔTl	FALSE
lóPùHědGézsGQgXùaXbòOaStXRzMǔGéIJJCàbMUǔAV	FALSE
núbèrVCaFvAcVBJóCpydǔYnóaúMFVsVSpbYatHqXbF	FALSE
pdoRbXdptZlaúGMBAvPZǔGYáǔzuySpIbabWeqùqféú	FALSE
sAěǎAǒXyǔlIZPaQòbYxtaFXbvmuRǎòdBPgXZbvòěTM	FALSE
uTUsjZnIěqoxkSěadRaROùbSNUělaXbHPNiWSěDCUǎ	FALSE
xFIóJwKěěympabǎàónàzoUěqǔaùpALJbòmnjzkjjJz	FALSE
ùùowVVééHBcGrhjEáEOúPTUHUYRùgisKaǎHhǔjJCAxě	TRUE
áOwBvVVVnKAaDHdoPQěHMàdIùèZùààKóLFuúPXòèSuà	TRUE
ǎyǎèpMyzvFAǔkǒyEòxBQúYjOflFlgkjsbuqWPEPOhzX	TRUE
ěaǒuZoHHqXomTSǔqyéjiEmVkSTqhdǔKǒvoGstgKúsòl	TRUE
ǒHáOěssáegúUzpiEsVEuúgcǎowAYèFgǔlkHuǒoFkěeó	TRUE
AdFnEkOgSeHCěSóǒěIPWpxkcefsChjDbOEpdxZBpeIC	TRUE
DSjvCfyTyLQUgjtDǒèUzLNEVlúKRRùRhIGǔmqzxYàbM	TRUE
FgzúpQNIJikOQnxuHpshKpódòoBHǔMPbHOWrǔDwBàSw	TRUE
IQrGYzRǒòzúsEdxOóhóZIYGzZLEbktquGAèoNBoàPǔI	TRUE
KsǔǔóbpǒǒquAAJXseGùècbaDWtrvbjXWùIPUDlZzOey	TRUE
NRMEěuǔwOeMǔXUlFDàèuěeKQDǒZàRXpFǒǔMmhIDǒiCR	TRUE
PvpàRAvMDǎLAéFúVZbùFǒQúEǒǒzAvQUXsoAáézádnqS	TRUE
SZRjQsSyoefsmqQjlVèYáDYǔXxJXlOòxsKEuiBúoJWF	TRUE
VúJhfsPMuCeTnjHgBLlQLXQIùBQZNAuegXdJxvdàixě	TRUE
XfPévuHWúéSzxBJvtIúTjQfàIiàWǒEsódáfUNóǎèRzS	TRUE
aòWoòHNoEUYǒZgwgpbǎǒjxěwSùTǒeúùiàaurcOùPsrd	TRUE
cmKǒmixUZhúgQkUǔfuFYxědNYptJùjWyUYXXdUBdUěK	TRUE
fgCBùèUlfYKVóUAéLvXYbLAdcRúqthuFàMpOtàzáSAò	TRUE
hpǔěyYXjpesaLJúǎáeǔpljCéOZúéěrběěsèlZKwHEUU	TRUE
kPXǎJtnJJoéiàrfQoCJkSzWNHYlfǎqICzBptaáǒváéě	TRUE
mqPàXrhDDzZIBmQoycXVǒqgAuDfàzvPczHóàwPyùkii	TRUE
pZOYúZòúǔfhEZoPSkpUNLQLswnwZsLEDǎChFǔVaáRvA	TRUE
ryopHáZatQzKjNtùwZéěuTMHàOcúCjsCigúqdGDakáb	TRUE
uGINrrQLWEvóCmRTKFàtWLúDMlEaDUoMFIZMSUUaěWà	TRUE
xùXzZzNFǔHoáXSfBzàkánaQtEWàTIǔqǔnqhvEúzfdfP	TRUE
ùùlTnùaxQOpubǔàqaéuybièkWjsfpRhiFEYUDùǔYgdf	FALSE
áTgxòBayùúCbabFRǒǔXDàXZrCNwfQmàYǎèáfjHcúfLě	FALSE
émZyǔQNKjVhvUGaèmpěpboèWèxaBLNLvEMbWAóRlOJó	FALSE
óNhJtMZlGJǔaKHájúDabKwaèMòRDqVbKzúEqoǎkǔAnc	FALSE
úàWváXóAMJàrěǒpmaVslxmabàIaétqóǎbHSQèaVDiiB	FALSE
BEDTQPikǎaKbCPJYaVUqBNuèXlIǔbboUlèùwtchòdFC	FALSE
DuuIFUslznqCuwhkIiudEDeǒáFofǔaWYbCLòarCbjfp	FALSE
GpYǎjCQvqoàGImtòGózàaybSúsvCabǔScXPEáBrPTIR	FALSE
IxIQJySplěrmJjXàSnSàèJclAPavbaàRábUhTsǒVvhó	FALSE
LceòWGSfwgDàéaboQUQúóIaCrěJòTèGbǔYwoEgzaěeR	FALSE
OBEógyéHgnVOFKZFGoǒzaZAréVéBKqKMbPNaUEěbqSO	FALSE
RDaFGPouvmbBúXMěaVpXóvWpbxHqRXVdWOrEjGlEttR	FALSE
TxaQCǎIGMěYDJqúòHbaZQěBBuRbòoWěùJSbCuǒúáRYV	FALSE
WWZwOyluaǔaǔYuGbwXllYùambYGbNqbTTRúvjòfOFùó	FALSE
ZùhrDopLúèJGjězsZlzYòLkǒKòYàaáěàrèXbaóbjDjI	FALSE
abèoǒoaWEòáOGzLěSbèAlASělsòúwHGYkTWcQVEsGgé	FALSE
cDkòMQtKsfvùaHàbaWAXFbóHQuTěBǒwSěyhǒkhrrNvú	FALSE
enpǒGvRYlGtRwAJbkǔLDqMowavXbxaMFNèbCóVOGCǔù	FALSE
hMttcXnGéWQHòaHlXCkWPAǔWèDVzIaVAAběaǔbmyèFb	FALSE
kSetaSéúbGxWSaNQbRkDógOBXLmoHjěLǔTǒzYaúSQMD	FALSE
mméFvGRavGJgòaèbúvuàaúxVHbáGǔOěKByòwNGcJXjh	FALSE
pOáxějBǎAcJaúFbaYulbVuahigMàAěWoxIpèNKùbBiá	FALSE
súeǒCbSsbpMeJAAanDHxFbAyFaCIópbǔóiYoQMééKRZ	FALSE
urjhHDdawlluPèJjfámAuzHqwNbqptiarFmběCabáoo	FALSE
xYHavàǔWàPROexoéléěttuǒhQqfěfabmǒaPFběKàSCy	FALSE
ùùòCgIOfzAmhǔSIFuBEGbJRrvmCEòZlFvqǔENùgpcjSà	TRUE
áǒWjXjCwBiqǒèHnnUfwvWCDcùeClPàUfVygNUvoXQnsǔ	TRUE
ǎTDòhǒvfLUxàuSsBàroòEICmiěùGyábUdOHHNattOsWù	TRUE
ěAoLǔYxOǒNfǒXyBǒúAàOYěaùbùOaXORóQuóěLùLFplEm	TRUE
òxàěòtděpěkdlpòwǔWqtLApùiriqǒSkBJǎpàùEknxyda	TRUE
AXxTǔctGHaxtqYAPQDQMǒogBxxOZJVjkePREéùruWgqB	TRUE
DHyhQEmEvBzPyogxdVVnWTJòheLMvZXSNbǒvMCsKSháO	TRUE
FFUgTCQkáFjzògIúfoyfáptGàbNxOTsTkffpgávrTtaq	TRUE
IǔKNLaZSIǒéjhùéPVóygèDPrvpTPaǔBetKVAùNǎCPeNw	TRUE
KjVqàIxmnéqdZhVpóBFoùhǎDfWDúéTDBùǒzFuYkùZQXZ	TRUE
NliIaHNVLlcjWZBáQěosbtióRWWǔápDupDAIóhgQcAng	TRUE
QHrqoaToèMoNnGbHtRopXvUcHúLVUFimARCkmebòúEǒt	TRUE
SNAHfBògvrwNvěóoóeWBYNKǒTóúnàMaěǔBPxóuènErCF	TRUE
VéDjGWFùWjrrkbpFYxCěPwjhbMwrgùTǎQXJktnVwókGw	TRUE
XWHdkQyIlVáèDDGcFJoPMluKdWguěáhLǎócYXéDoóègw	TRUE
aBkOéáDrtJlOmjcOBjGvZyòSONámtxxsFHtěòóuzJúYm	TRUE
cXCàGyòAǔIEptHùBRèéDJwkěZiRbwóagAbóMdxiqzBTb	TRUE
fǔyQIcrNymtěoOCuFEuEmàwYAyVfAyáǎeOǎPSVKEHèlě	TRUE
haǔMabtWprsTRemFqrFERMQqmětyǎgyIxDǎJEěAJUMǎH	TRUE
kEvEktmBHKxDuCěfKgtNáLváqJQcXléMRqvijkXǎóàKú	TRUE
muUuejPGbgyeóxzQúWBàPbyqaURxoóyJXcuORGécYEmJ	TRUE
pRUwéjgiDSGEZqEFUkXeVtjGvrùòFfàstnVzgqLiyRAǎ	TRUE
ruwOcQnOècwuiYFnèòQhQǒaMEPlSkqkBptXxvUhpLNCo	TRUE
udVPRbǔHYóCùLùkWNěMiNfLTnàWlùyhEBDtMGgòDǔJět	TRUE
xLVoàgéWlZèFézldpvkHuAnótDXOkiTùntTóqktsyǎFP	TRUE
ùǔaTMóBtXryáǒvQbzCzEySrabgVKLHcOEEQpsTàOUbèH	FALSE
áWppLJDèrmuXzèEjùlmabǔěóayòùbsgpQTdAEFǔZnKzH	FALSE
éFRIHeéJUèqevWTaXbalbcǔsubKáYàùXATxbLlhùEzrX	FALSE
óVqvǎJěWikùhWTFsFFaLúJJzǎEzTbYèǎOIaàBTUbsǒKh	FALSE
úKǒápGWIRiǒúaXwbXSaGúbISPupzNAaCHCaPLjiǔLóúH	FALSE
BzazxavòkaWFǒúZábBaěuèaǒAqKběúáǎZOaSééóúbVOú	FALSE
ErwúOWmZáaAYLǎObrloauCubTqbFmiaUlǒmeYaqcicON	FALSE
HhsàǎùyERoòWYCLSzLàwúabaǔbGSmvbèKzTúlǔLEàubI	FALSE
KěogHnCóbásOswzLaZbQPmablxazǔXaJóPěwglwfekAC	FALSE
MaSzVzbnlyaEKHIIuzNsFoEoAFWyybCúǔcOxXNasHrqò	FALSE
PaLcKvabRǎéEXabCIpGZLHYWZpNqúxúauiSòóóòáwhiV	FALSE
RqhKàgsAasbsKTOGaHbWrZMdFásMKpaSRQaehùOǎjtǎb	FALSE
TzWúLáytVUuúeLaYbóNCsQzTvTuáWSWHQvEKpabPèGNé	FALSE
WoóòjòGejvTgxYiúùeaǒvbaJvùxZZNzwbémǒDEmcefzK	FALSE
ZnLóabnYXRóěYEKUaROqzòDuòEBGXHqJRSbcVEAFZEnd	FALSE
abmYéLéPxIèzǎaóbùzwéùzǎZAóYdIKzvLnéAPZùAǔDǔA	FALSE
cAnprèyURneTúNLQěHezMaúǔOVǎYyxFóněúěbaqéEbwò	FALSE
fùjwoQkGáAúZWJaQbàBǎvAaDTYoHAzbufJRxǔmXqgǔUn	FALSE
habòayábZmǎNqBnsáudylávQěKkájjfsYvCifTǔuaěQA	FALSE
kKXkESWnkóQaàJbaxòObYHxRkuhuoKrFBuQcjXMèěOhr	FALSE
nǔkfSZmBvwèembatabXprráàUalLbcrCèHywINRznGtn	FALSE
phSwOazMFrYHXFúbLǎaǎoObgicUútsIIvhEùàtMBsalc	FALSE
sIEHàjéeaIRuZóWZtJrmImVǎúqmTbáaYTAbZtftEDéIě	FALSE
uxHkǒIHOáEYaBǎMwvPbJaúǎJàbNraOrMTyěIKwěnpbIm	FALSE
xYUqAwBasbJGEJIFaQquLsǎAbJImonvěYtùyUùpEEǎom	FALSE
ùùvàBbGSDRBUQùAmsYbCárDxzsVcěJèSGmxěǎúěOǔèbòY	TRUE
áivsurèGJùlbOFǔXéhFZèlAAókMAǒRIeáVVsKmKbdFúfy	TRUE
éúreOHoTbijAKFéBbLSěLǔGnnsHYHpIhǔWWibuQIVXINX	TRUE
ěUjqKzNùhuáBQhgJjmWXpFILqsMǎDWWApWZWyUbèQkpKú	TRUE
òteCWEcjzlèHbhQòsCfWjěàRHYqKóéOoběSJhmgYorTdj	TRUE
ASexègpBleǒkòXmFòqeqlǒyWFUióùRǒshYéTEMvhHZTqd	TRUE
CeEXòUaLfOmYsHKǔFòrUnWóEqòópXoáǎNAZmHháěUDXec	TRUE
FPbadRgòéAmkfbSSGXěsǎylPDmXIccàǔǎOwHYFfznRùct	TRUE
IòOéTiIHóòxùlxiJréOSoǔèhWAémUmǒEàWòHáIBMwòrSc	TRUE
LùYCJuQMDúgoJlKHXLóoQhéMáJPúPCoBKáNjFdRiZkVHa	TRUE
NYkFLtepHTòaJeXumvRSHXKSéoàENkyRRddǔXbJjJteFO	TRUE
PlFòǔoovfUHqMSYUSSTLKvnUDPUbǔǎǒòmnhTKàbJrQéDù	TRUE
SfǎnBaDjǔsNOCánóvSúYcùHAlezmAsoǎbZszToǒdétPhT	TRUE
VtSNucWDyúCCMèqeFfiNGBoFMsMthXIoIUCMxInCǒIBmK	TRUE
YYQYuòèRMWAGKgIgvUùPcqmWeBxèǔcsKnEtCávàPcáèaó	TRUE
bàábuzqòóùfZvGUSǒOǎQwAqilúLFéirPUěWXncfTèekHk	TRUE
dXóóTayRǔAǎALNěTǒXuòTáPVfpóIwróxèǎmáJǎiǎdLlàJ	TRUE
gěglEEUBXáaQěsǎklPMXNwUAàNEEóébFFKyKNGYǎUdàUd	TRUE
idEhGbfVexkǎDAExúéQwàUNmQàJPóuPěCrúaXQǔMbYjMà	TRUE
lěHWuòéóǒGnùYoIúBòdUoóóóbóOuxhoáLKaZgFpoYéjék	TRUE
nZǔfyzRòSXWFòoopwWDPTyeòBbxHkGpOuDúvzùCjGspQq	TRUE
puOSzRTucJdrkdtáIǎsKóHqùCOCVtPWěeypácàQPfEEùǔ	TRUE
sEgòFiònIhCvMJfwZGuLPKòpècCrvGlzlnfjHPóépuEày	TRUE
ufbuóyxǔòiáeúúúOǒúàDǎULZwDǎiRXkHzúCIǎWHvNSIEn	TRUE
xMèKùzùZnHCvAAIǎòsúúTGYBlàcBOXhòòBàRqAùòbkyPe	TRUE
ùùSGěégéHássjyeDdFBGveaRtnwoyyGssùCFCJbRaYbvó	FALSE
áikcDxHYLgnXolvFEéaèúSUúěypǔbaxFbbtQXpèwnYuey	FALSE
éCTáwěbFUkáqBaEěnYlsbIqOMRYGtLòaHFRbtVaNVVeWC	FALSE
óùzkUqIwOóthěYaobaǔěùpbSoVàèySnáZùóJpcBèUǔaVó	FALSE
ǒVAshDOaǒTpybmaEéàùrxǒèHRǒTàLRětQMèpFpbFRjflù	FALSE
AwpKAèabaVbZxnvUmEMIIaLxězùByUGMǔCǔòfLmHenSòè	FALSE
DeaǎbxvLabábhofNǔPBzxscHCXFpQDLIùzqéQAMbyèbLY	FALSE
GGǒYUǔpbaáNuYPbVvoUYQXKàěFrBěGasvǔééòGtbùiTzB	FALSE
IOaavǒSLGwǎóLMCOWièKuaQnKqLòbMMnòlǔaUyKnZbQyJ	FALSE
LútòaDxǒěazbaNqòQbDIZgqPPbRǒYUCopDZuáVtDdǒeYy	FALSE
NfhEzxpvAùCFnWěMwyǒLDabyáYIúPFNnsěstMVHKaQIbJ	FALSE
QQPYxENèRaěéMòèMtbqtKóéNYùDǎrQMòǒapNumbspgùAQ	FALSE
TègwocWncJoMJcáòatbaOCzWbaHKDdLISFUxvcNBěMǒFY	FALSE
WǒqéaIBbGGUǒuéPaXAúNbeaFPziepcnNJWcnrtǔhDálPH	FALSE
YRIXTaTXnUbDQQAwXzvèaétObKxDohzfTnoxǒbVQxcOPǔ	FALSE
aFbHwVKaLAtBRǎyàIBbGlqXEOgZAecKaMKeIimNǎvYdPe	FALSE
azbSUWzMRaòbJCgRQSSTmúluHIQPMvvéZèlèrXfIZQiER	FALSE
dlgpòHysaWVuBǒHnzbVaEJbvIMúBzAtoáǔGgwRèxlNGjS	FALSE
gmZgàaCZPòbrSsNxrùzICvTéaùsRbXXmHǔKqSWnysIJDQ	FALSE
jubSkynàRǔSvéIàáOěyaǒnPǒbSXPCmprIWnHMùXáaxFbó	FALSE
mMGJHpéPwrǔQfhóYěgKùǔGbnCàiSǎaRMQzSbRmmYabXKe	FALSE
pCǒáěGrAAEjRfFmApnaDuhvUáFaévMJWbDrvzZWSRàayb	FALSE
sǒAsǔWesjYlUésRdmAúrNxbaběXéGaáqxQXSàTòCBTbgK	FALSE
vúqlósoùIèèèòuroOpaTOzKQǎéóbúTADEaCuCbRDpězYj	FALSE
xopwéaZbúoǎaǒǎuYùlmbfTáěLMkpVeJXQCQYOEcKFLǒěà	FALSE
ùùTóFmwDYZPúefhvBZCnXKjBMQioEEQNfùrUǒùyuYaGRic	TRUE
ábLdufNGXyzVSNivWfMòxmtYlaUrfnúcrnSZwsKěhaùadv	TRUE
éóOAéJuaOjxDQgFúFeěgVBpAgnlvnyǒrǒuTcyAqURhhcYK	TRUE
óàòNODèjOxWOWKPgbxiWNmRCHSTNóEkogǒIháIiIQónùYǔ	TRUE
úǎaiVLtoYhPfùiWimfúwOhfhmiLaěHtnHrKvqǔcISGéPQN	TRUE
BZiěanVPAfRàCdHòúXnrpúlIGFǒiPrtkHǒZùnpfòNzóZǎa	TRUE
EMàewOáFoéWEǎRCdézVLBARmndVyIPqòWPTAeJIpwNCǎzr	TRUE
GvHWǎyòfhQYěHVǔkHqrlKàLfMdowfviǔǒǒáyWvdsGNtnZě	TRUE
JRhMjGdMszèZYPvéuVVLYqjuUTtRméúxVQFjrtgěFzORèú	TRUE
MǔmPnWuBBAZNwnfPHuWgHFOOBklcnmtSàBwPAjUSRaplRè	TRUE
OamDpHJvěhUZngAYěuXóéGYHIóBějYOnǔSEǒùhSwepTKǔY	TRUE
RGZCZEùqUǎYěváFMqJàeòúycnfpKaDǎHiAyúùéCNFèOzlD	TRUE
TUPTlqSoǎnlCICIEuaaZAKKGXZyHondYewdGsdèJGcNuèp	TRUE
WCpLWdspTóhǎyeéèúhJòǔcShòúKFozLbkěXúbvwSSTBEUP	TRUE
YksoiLEhPPvXAudpkeNXMgLaQTǎzzjUrqWgqbeùKRTXáǒB	TRUE
bBkghZiDnchrMPfNOnWLWéàùQhCoDeVPKEUxǒuAtsKxAAa	TRUE
dsWBTZhZǔSǔqPǔGòèWOgCòOwDvPùZVTǒYRúgbuKnfvWGSs	TRUE
gGùMRJfENàBgncùPOěeAIFEkyhàKJiGkZLyàtKNyLpaAzǒ	TRUE
iZRmBEZQXǔùEùlEězxIèúkèpEèmqglrvOtGcUGěDǔMóBúg	TRUE
lTóafBUfjGJPéFEdFCaxxOKQqAUéoòécYWMRaLózftNfEě	TRUE
nxTGXCSzXYXóqzEoJZàfhSNLwLvEEǔFTáǔGupbGWFvBěvY	TRUE
qVmUdzyWáIuYmTYzuvcDDKoYBKècRSnáRPgBeurfpwOófn	TRUE
tBFpǔoaXrxěBYtmgěHǒrlǎpsjbúLòěeòoSDéěiKǎósǔxMe	TRUE
vIqJoòEMkKlbpácYYSLIuSGCVRbmKTBClábbNuǔǎthúWHp	TRUE
xWgCADJhhúIórShmpBRéèYkcVxsàNPùùQlkvrxGééneQjh	TRUE
ùàOUFDLYUǔRéyGcAéApKǎvnkSraǎùbKazàUwZmbxsxJXOh	FALSE
áefgAvǒAlTaVùbJIéavbFzNiécSTáxèǔIlǒfSvkuFyxèUi	FALSE
ǎqxúOihoèbqaóPòPaFzDéFGzrybaùěOKbEòáLwcNsnùwls	FALSE
ěáWNuǎFfRaSLǎPpurǔbBabisOnNBPPyjgVzjwYgKpDmCOk	FALSE
òGuAHhhkùsǔèaTboLùqapJbLlbPiùulQVkTLSXNewANBUJ	FALSE
AaOqbaǒFqǔrTyDsFàxTTHAtsAXbSàSAkPhUXFSVtěblsòè	FALSE
DǒHqZmsMthsIǎaKFQWbOěuVGOaúMbKlNDMYGxIlvktDcDs	FALSE
FujximáSCMfeSǎaauVàOobTàHaSáblUàgItàDytówiéssO	FALSE
IvOLxWhéOafKabaáoàMwvTbjúnTsCvKǎIZxxòTáùǒluqKM	FALSE
LMsufFúoǔHytQoVCaTYAUxèbNTlomàwaPKbdùQólTFěkyE	FALSE
NyQFJàYaènenCyIrfFBaLGzěVGWóboSàǒaòHzèqǒPnǎbQs	FALSE
QZUnEàǒZBzjatspbVòmICyéxzWwWVRDPFóéabhgáBzgfzG	FALSE
TùwvPaMwbaǔMbzàjHèamòǔxtHTKmKfMWoǎhěúFJRIJdbóN	FALSE
WúJéQdǎacZvǎCpJIuHBIaVQúPCxpSèwEGbaRvzNětbjuQT	FALSE
YUeUvLéGklmoVénaAbóZUTùXaxVsbxqàLwhóNESǎuòOtHS	FALSE
aJSWjiǒclgsBágeTSùAhOikěnOǒfmDXpZǒababIáxǔAHXo	FALSE
bYjqFDaQbSááaGnGuúoKávvZbBbEeJRxVfǎHeItoIfSsXJ	FALSE
eùfDMaYvóFěPpsCbKqWéYarAVvbHnJveckiyWtTBcéVWOR	FALSE
gHkxlapJaFbsRtánmTéAaòěBUúbqófDǔiusRFeJqmzIbQg	FALSE
itǎǒVwOUBvúcèYfcóQáqZMwDEaúúWbùRaǎóOCbujóPZnCk	FALSE
lvkqPmtǔiwáAFcceYágúIaNòlòrúEbǒúQǔavGtFnòběèàZ	FALSE
oaéVUtyúeabaMlWHsCBqzZsBbǎòMETùfQqlcNBybRaMVJg	FALSE
rIWgǔxukěJzjWgFéaXqcSéTgiaVósmCPCáǎObnaRAbéEEV	FALSE
uàYpBSHmMMJUXrYIgKaySábWmAùavVLYboéqóGfacfoǔYj	FALSE
xùpàQjaésrBxsOùbrTCDSANrabJLMZqrtòLKQiFjMúmSZi	FALSE
ùùúcdvtXAekéèQúpúǔynTěuPSstpskhCUyMAhapRBqwěrpa	TRUE
áántMUAcǔpàúùloCPHòUTVAVUOvueQEǒNěiěpòfàúZRlǎdè	TRUE
ǎOsNAqzlmKbócaEèeARrFTBlǒEgáqeZXJcàòEGjǎǒcDxrZL	TRUE
ěèItpáSWmKVOWSbgVAlOzbgVèajFbúIfrměHOQIuDǎTǔemP	TRUE
òxnOAZOóóDlSǔEPyZǎjDsupeXTSùsXáxORFwfXitpOeóiùó	TRUE
AdrfzoJTúgKvkùtYǎhùěQěàéJtOxúYARttvpúnzXáYaáIke	TRUE
DCAeuocóYbKUGySkDMtyrCyDdkiBsSěèROHLGusébzSlVSD	TRUE
FRAǒOHUoIEsbNTJzòEdDOhHOcoóVáráMKvHIgDBAvbéóWXE	TRUE
HyzhóFǒmnvnhWùYǔCCZSěyhyòrúcGLYèùezzKstFrkIAbQk	TRUE
LNzyRjkZmvGpiárBeHrsDvanoGNèPúBwsgúoLùHtGánfuyJ	TRUE
NiTUNZdijQmǎmBhNQZKLDnjhvHǒZěgVNúàflmeOgUPǔKVJé	TRUE
QItòàWbnIoUMQGikbǔkIUksvDvzPóéeIEpěePugVoòóMněs	TRUE
SanùcaSàBǎQfZǎMIewKMplfsDhEAIeeVahxxgàpǎVàcCyef	TRUE
VfpvVhScxGdOgPòéúMóyvpigVlTQceǒǎwnZǔlgDSěRáAXUV	TRUE
YúitBRLWdtdjáCMCDZTrBWòáásVVEmOèqQFoqvǎàclPtMvo	TRUE
aYscěcMFkèYChDktEnǒTIǒBMZgVgPChFàlMiéhvQYwQKtrj	TRUE
dDsěPǔxgSSODěIàWjqópǎRQǒǔZósǔRùjQOFhóàáIùyCRPZG	TRUE
fmLSmCCYOMiáèǒéBuhUPjoǎSxraéibSyzèkfǒcVRXgdvùuX	TRUE
iěHèRdrSgOdlkqUfóówuyCkeroéWZWHùOjWjWIOFùsBcZoq	TRUE
kINgHǎrXZǒWVJSàLèéxObvjMrEuCYFǒsévWMwJěòúuMpYtY	TRUE
mgbBcQèwPpPJqòòbuEQúkoOùHTèZùHǒEPǎSǒISqfAqNezua	TRUE
pgAMvmVDWónirSNEQjPzOpwsáUKkGpzcwógiiHjtòàgtyGO	TRUE
sdóXǎHDAàoéáJlORfpěWóVBBWoMbDěoelVRVuèSbCOgoMép	TRUE
uzKYZmAFwcqDuOlGqDǒgeòxsPùaéjFHEfXOMdcaǒócùnmaq	TRUE
xLOgZEzBoTITěLcPqiLWJèùǒFúwděmchǎěeLSPqǒǎDuétik	TRUE
ùǔUènqCLEaGWtAuHLBlEOphgzaǔsbǔBGyàaTGQKbLǔvyrZZ	FALSE
ásuBhBéTxRǒèǒMfIWLqaǔbtNépPMéěáPòaYqpTsyOWqéúbv	FALSE
ékáKMòwaZynKxbAaùZqRZXvrLàèYnJNGFNMoIbKiHxPEHIg	FALSE
óNòdTalHěmèTanPZEORbwUaobhQZosEòmǎEòmáSgymAQxUù	FALSE
ǒoEhzyYqewúUpRaLMfDúVaGzbǒtaTěWNlObXEWybBvQFFBi	FALSE
BJvvtqQZSGǔaRmSxAkaoYbwasúbóYáLEacwTǎbèLYveqméF	FALSE
ERaPlVfDpvdSXaQGLbzAaBYáKSèMbpqmQǎzáVTúngòpyEeW	FALSE
HúóRDǔTAéMěIYclVYéèThFbéSYKPMmanbrDabUAFTzZNfǔB	FALSE
JfzàéDaělKHRbqaěYáěéFbmskWLlMVrEbùJRWcùkiDfùgóf	FALSE
MSěHDowúAQYtQYSeruxOùaTBMwHMAxéěVólDbGKRravbZtó	FALSE
PUèvaòéMbabHEǔMOQwICǎOuEoppùnLákeFDGbáfrcramCOB	FALSE
RnVODdLnzoMǒPgtAASvmèaqúbpZqaóGSZISoVTMOàHzDGvb	FALSE
UòaRàèùxJEBbávaTǔbǔeYVBFtěrtAeICóQEèdTèXěaDimWá	FALSE
XèUXBǔXèyséGǔiRnNdaéFEbmKyVMaTpbFKPlcXQěpǎǔjòBǔ	FALSE
ZOwiunxgBabmROxVtUněBRHCaVuFǎzKbtvèáDryKfLsFùCǔ	FALSE
abaǔEyLWWòErǒKùVbQehQKěúziàqRxvOzděPOǒAGPsWxùvH	FALSE
cXaGZnòxRglrFawAXAKEnbóúrIàsaàltHMMzbòxiPSRǎpòr	FALSE
ejOvjDDbáóRUFXKWùéYaCObKmPPGvěòàlúaAǔCNbfmYàBwó	FALSE
hjièSfǒblgHaébWabxGUwtdCeCWlúcNěéqúgvqoCrECSOEP	FALSE
kKswAZSxaIǒaPábNúnCóQXUsǔèYTéXlCOaxbvtújóaGRTHH	FALSE
myRRNsBNfPóFSěáwfaobéGwǔtéQnDmmraDVHùǎmbúAhAYGA	FALSE
pUVyKQVǔinQgabqlǎaèrLóèbTygQǒcsSéeWTToVyBvXuMiw	FALSE
sPcKTRXloUgBuKWdánPyecPKydèWàjrǒaYbóQNqXLaNpbHw	FALSE
vBfNYrǒvlUFPěYpvǒYfZfabYauQbVPárjQoMyzúKǎEzOHdl	FALSE
xeymaběMKTHyNtsúIMPhlDpPAaòlàóèèRYmbOuDaòěúbySB	FALSE
ùùeOsobgNgoMCGdWAUǒówrTéUfLCniLTáiIdtqwèelǔǎHzSM	TRUE
áCcáóJveZCKXdTqWuWiLfvzAHlnJúavySvàùJéaBǒFrZVxKJ	TRUE
ǎkgàǒKBèléǔdWdMOiqkITSFvLXUpUěxúEfLZmsMjkLCLQMCá	TRUE
ěùvmFzXSJqSéDpzèZaZdèceOùGaWbǎWeFǒeflVKǎaYEMrqhk	TRUE
òToǔjDKDLVGqPǒoJhISFFRKvCévFáUàGsgjWIIǒKOyizwYSY	TRUE
APTǎMQKáOFMQNsěǔùúYMBǔTyVLPPTDéówXxSxMqKYWEgAUùS	TRUE
DAárMBOFDsNúsoéóXpLJúǒDTksGkèúpXrùIEfyoZPǔáǔEùTg	TRUE
FxěùXjdélfeònAcèaqFQbHùdoóSTpdGpwiZPvRGLtàHmǔèmw	TRUE
JèLSIBéoBrbbOVfNvuRcBVúoULUhtnUElIúIàyBYmQjFUcpE	TRUE
LkeHKhahZWfoONNHtcǎbCòQUdRZàFjpDUCaHoAUcSAhHkwàJ	TRUE
ObQukéHwǎDXDaaHepFmáLQùTrjvshúeǔkóVRHYALxùěoKmbs	TRUE
RBJdRávFměiqEéUEóVHOuNCJAnEěLùvǔúFIúòeXMljdmlbvA	TRUE
ThGXàcdòteVoěěáDJMSYhVFóhoZéENòzhhSZǎǒnlAǔJszpuB	TRUE
WǎǔsvEóvLXmhsOwTázwXǒtLTLwmFAuYtKPhGMaQWpǔUgpeòG	TRUE
YCJlayjMDjIxXUbàPVcwWpvSpozRFjhdèNóǒtThURRsyDPTY	TRUE
amfTAZbPeTúgRWUPxóLtènábAWWwkǎqArDdFrTěKbOdLóPGù	TRUE
cutǎcòYùjàxVWoJàoBFsǒSjěFVùJǔISZOKikùfkZgrUiKHpG	TRUE
fQWFǔkYLǒiJuzkDáUPnúrhoǔáZuhGuebPziUhCRImVEzJAxě	TRUE
hqrpqúmùOkMrRtPaěPKǒYǔOVěZlJáòksqFSQBMòòiOBhyexk	TRUE
kEPGAwfgòojqCwcyaosTKNǎRQùIàzkOQABduiHLCvHbPlrpé	TRUE
nǒqEjǔBTEPeùàAipZǔáhFeYUóóǎàQsdFóGEǔcqùòjMóǔúpmù	TRUE
pLrTKrǒlWGqgRswóǒxIěuDMrJYzaèjxzènásfgùfáVeJlIyn	TRUE
sùfSzJKkáJMòsACoKCdjòJoCjvRswHywùùkTCuJsǒjtMiWTǒ	TRUE
umqPYàrmoKǔqǒvumZéQQQBTfXWáùXèòDmtZVáBUCrzBZEoTK	TRUE
xKOPùyFzDLPQlGúWkYéFAáPzNúùryVwwWAFKoiKcǔvyáskFq	TRUE
ùáBǒkepVrXTHwQdéODaNǎMVbaóYyHJàNxáJěóybViNwUaODs	FALSE
áLqiáǔǎrúRCVvéaváòXbJsFQYrazVqTnbbzrrCCGRtcWúLùu	FALSE
ǎdgéMVùXaXTsAnQNHbaòèqUHRábIcdnpUQOúDhtqàUlsFècd	FALSE
ěYcǒcNěBKIqUáàllMDóhGǎězaUXLùFFTbQaàùbVAòHCkEbtx	FALSE
ǒDaPTbozúúaEbNhtòCtqLkhùlóeEuóHXúérZoqBPYQuoqUEú	FALSE
AiMaPihamEIúàVSyGRnUǎDbJabYpjixBnojIMRVcyTvUrgTa	FALSE
DTxcTvùAwaépbCéWOXXWàyqòalRèàbùaàSiháZAXobOsvNBI	FALSE
GPDǒhHaBùOVèàésvnRbDDèGAAaáYTbòUfàYoXYNnPiUhuNaf	FALSE
JòQbZXxvItòǎqvdzWLSsVabPǒwZwǎvóDJwSCVSaUbvzQEFSé	FALSE
LdaǎVNběěaébFonùéoǎdóbOYAPwQěNKitIUwRgxǒyXCRsGfè	FALSE
NwRáZWwowabamlPóùBLùópóAbsXMéěWǔcSXLmPVyfBbSfiàd	FALSE
QucěòFdOǔCǔnwAkégNKèKSTéòwYaRKSUtbpqZICaWbjJqOcY	FALSE
TWèwdogǎKáéKosorrhWwòCPwùxùUcaáTbòpabuǒYNAzLJbDc	FALSE
WEùǎaéeùwXaFQóEǔXMWMbGHóJTzuqZùazúEFQOQbzqzzfRJǔ	FALSE
YvǎxùPěXvxUOóyQaZsynóèUYPèvěbèabSTDěXǎXpqHTUAAlE	FALSE
aLqbBǒététGBuaěTFsMbàcugHQWǒQNwúAHěúùǔěIOòuPKkOM	FALSE
bYuiAdkaésjxèHcóéJabAZóPZóauàHbaszJmxǔYHèkvǒnGàé	FALSE
eěóhòacaNěCehciUaLKObéItKózDOBosaRùHGKEǒǎòqMVzbW	FALSE
héRIFoXdtqDMepSéUDUthuěaLbxEGmIòapBSALùKPTClbxLp	FALSE
jnUVuvátònNàVnsipqyOHDkRXdCbQAYveaYKbStJalyDbuVǎ	FALSE
mklPKùóLTúZOqJtlarLGDPbMaKběQssgwgMFHtòaUTVǒoěCB	FALSE
pBKéGOIHFjaǎTbpslùHAsBtKsxqAVEaqqbǔiSMTcXQiwSèrB	FALSE
rnUòóETJáFQàQGàzùhǔoaúnbIǔóxabúáaFàòòNriOàCOWDNs	FALSE
uiókcYHYàjFùeoBbpIcàfPHghéffpaRǒFXǔBaVYbùèòCayUb	FALSE
xPǒRaSèbPfpFúpCOHǔuSlVatqKuúAbWyóalvKKwbòǔcNYùǔs	FALSE
ùǔAdèOòeěwJětkNSXXPhBóKYgKDBgMsnzǎCiZQjòDzSUxùHml	TRUE
áDCjWqQUnqVxwnáhhhUMksGkWcBpNvPenAèJhkLgQéHsqxJàX	TRUE
ǎaHzàTCpqXoǎyǒjxExLvyccVlijòhúànedPrálàhoòhóqvZòǎ	TRUE
ěúJAóPúQlXhLchcěNǔàUbRyJaSBRBójPsóCmàjóúOEldEEWDv	TRUE
ògHaòxMGUqTSnywHpxHéZtvpúadǒleBùkáTcAiàNhoiùtUVQǔ	TRUE
AóiSppJqáǔglěNtvjNǔWAJPAGDǒeFèWDgxHAOèpgDfdSAJMèY	TRUE
CmàméJLpTcbPRBUFckTVámfNpǒsáCySRJZěpIáfGEòwbpàLrT	TRUE
FóixQóàmbtjJònjCjkBZvánRltaXYGstúǎWqéPàIHxVéqáeqt	TRUE
IééwYnRzwqhhàOáSwàǔSEyTkDUhměiMòòóphqXèSdǒpyAáSJé	TRUE
KVaZDlJkERdFcnjOCQuǒZzéOYPPeowbJdocúBmMPgznǔxNdlG	TRUE
NNRvPòIszXZZèYěpráuJNTOkIláEǎwrGqfQdERaEKPnwLCǔiè	TRUE
QǎTmǔxLUwqákcPwjsZndLIIHyUéuPaZEvèyHzwèAóvhGNùAEo	TRUE
SiqtjMhNúBúYYdpmWtAUUlmnépiàcNgoYnJCbàIxywPtgnaRx	TRUE
VFtFDwyèpWPùùMXwòBKsáèlltSCěGuWzklrúQVCnjbFrcLkON	TRUE
XcGkáfoájjèǒgtXúǒcfǒZéykAóOǒeòǒRěòMàǔXwfGpúJRRvmV	TRUE
aPHrZràzNIǎéxUKoóBsbǒfNéGrVgyyUgALnGwiSyYPLéIúlùǎ	TRUE
dASdEvǒBàfěàAjóéuǒtjFDZGvIKRhYTIGTuólDWùGZàDpzeéH	TRUE
gùqpSòěDXxyNKèiApbNwdOndfǔCǔWlYJUySěrNóNUKrsLhkLa	TRUE
iidNETmPPyùLZfwSvCópéědBenSCOZDócVFgvGgJóykuspTxq	TRUE
lggbQoWFGòxteéAbBǒYWZpwUǒLDéKDFKbmBSCéǒxrdǎLipqtY	TRUE
oǔgAǎpAhVéIdMpykklafrJEásǒMFóǎQéǎnpdùgklǒHKáqBFBp	TRUE
qhCDqifAOqiúMmBdǔJoWcvYástDzrvMTQáófdHsloègMYUéNW	TRUE
tòévèLQRgefgYNqHBWXàkxAǎvNhélPqsjWqPXTZZJQGjmvRtz	TRUE
vRAQhYěuvxéerBopcKNbǎmèPjqYyNcmVGárágBdeartǎrèWau	TRUE
xaDWEwJjdNTùwfXěPajAKuFùrAcǔUGXubǒNzQTFFCZèPàDhsl	TRUE
ùǔkuurAuJFǒRCFNabnVvPMBpDQaxbWkOABjBǔEfTYIéEǎXkǒz	FALSE
áfFěHDúFYaubòsFYXRaòboBbKySàfWiáMqIGàhMUáxèǒifuwF	FALSE
éOhRéTKópSpammGǒàbéGqESIOVúMaborxiPvbGGěYLZhPaǔen	FALSE
óáXúěfAnmCmqsapǎGOǔzbǒAòabèUámfǎVdjPJNHtabGHTQàóy	FALSE
ǒiAVxDLkCJWǎbLédvLjpTykmOǎléaùSmbGKEaEYbnbcjkáǎót	FALSE
BàóabútABǒBalLbeXPOáVǒcTVBEěpobKzbeQjégaWAóǎdwòěG	FALSE
DlùóQshMPéRsbómcxQvZEcRYhoǔǒkaMMbùPǒmNxAaJJbUtùVJ	FALSE
GIXbvYaáMKvuqIébǔtáabtlKóUlMjtpEubLNKpǒYéǒWsǒJnGx	FALSE
IsDěèTǎVyèCbQaZvbRUXùaCUbNǔYOZkZQtèckǔxàppZIJtpKw	FALSE
LeHJmqTWGyaKEǒUbòVǔVAZóabódhúRulBBqrcqgqdJtPKygho	FALSE
OabIaúCǔmLbǔwóQLòFtFYEàBLjQaùjzuùovHhǎPTfkcpcrfbX	FALSE
QzvèdIIrǔWHQéElNaFòbaxobiǒFwCùKCOnctiYNSmdLWbTwxú	FALSE
TiúFaNwxNYnHPFxbzWAPáoaǒUòVZǎDKmbkLwriddSzúèPOxbY	FALSE
WSdSOzrdyQDúùjkaPnHǎzuDěéPEèàGroMzmǎvBZbǔaěpslKzb	FALSE
ZNJfmKnuáRSmcdPHRaèóùPTaBbaWUZnLrqóTèslbiCùámeDoU	FALSE
abrAawmrWRbqyvbOJmǎXǒsNdMKvEvygqgbYvuBǎzúNNǔYùBeH	FALSE
cxloOóKTieqLXBQǎPqùiRatǎbMròyTlmaTěGllǔNJPtVǒvbòL	FALSE
gECnOkhAOCXxzúeúSToaLEZbaGbfúvLoMǎGùbpVùrilQgcwrq	FALSE
ikUàúbMlóòAǎQòraùěGTZǒbqlELHaAQzxsbZCuVIOhuTnǒYBg	FALSE
lGGQHTsáEYPWuDRǔTPJwOgǎrèǎbrabàVaCxobBXuáuaaAyKdC	FALSE
nwàTuiéErQaQWYǎQvIPWIbsrqazFGvLRMùéébTzPMGbóKDfǔo	FALSE
qǒIQèvfuaNGHBtHǎpěmbJLùHǒtEòBuSùǒJaXsMSuzsbMwDOǒx	FALSE
sCyLáTjXawMúIXMéǒapXtbvpúEsRuǎLZVTalXQMbáanáNYJWǎ	FALSE
vùavzMyNáJbYòLǎGROrNuznnaWZǒúèbCnnèoEHěWòQótAlkOF	FALSE
xPqvóxqévǔfphQrèlUCòeZVUcJYgIazzNněYbnVuGoàabtIDj	FALSE
ùùwfàjǔxòNxpǔTéxvfbPZnokěàuyǔGóYáHExMQEpéǎAcéjXxcV	TRUE
áEhdoNxJEHhNgcabéǒǎáIVeòváIòPnmAAùEqdkVLkáEIháKǎhC	TRUE
ǎfCcwyRAFáúweóPqsòǔYhèdRVWáAzYbkFchpcJǒdBàyǒMXǔǔǎU	TRUE
ěùúbpàùuzěXCWVcWjǎNPypFùecRwCJAOòhOǎúzHùGièUxòdtLE	TRUE
òùAcenpFFtdigmǔǎòKměYTǔěùAVydùáùJRcFgǒFàmEmúPhuRCt	TRUE
úqHzJáLlkCYGwDèQcèyǎébsXJHmllAéXJrhRYWRAdhLshàfpmú	TRUE
CnnzòòǎBtěKzúzUbngKMlnusawrmSlMTSsǔèFIosSFèiúWpHǎU	TRUE
FKpǔBXdrYéjrSfǔèútiwyGvzGkwaZóvnfǎDěrNnúOLaTxXqQěò	TRUE
HzWmNpbǎguOtDzùUòéAVdTcDězwuAsXPRDTgàǎTUdTgóeèOěyN	TRUE
KQpcěVuFóbuǎMrěúHIpòèǎèCQcǔlqǒiNóEdsmYóUrèǔkJmPǒòf	TRUE
MvxèoihZJcMPUèNyxoéFúCPbMdRnuLzpJXzUXòPGAYSiPJěLTě	TRUE
PUwasLvOtjdKkqyJVXgxuóPIwwqRuQNYTxněcvzlTxhrSòbúáK	TRUE
SéjLhǔkmFRQdCNcMnZGuuKZǒyUdǎJhvǔwVwdBááPKsESááàxTz	TRUE
UwMFqdbnPkǎLěRysFZcnǒoàYFtǎautHNhDPBgHàUǔMùnúéXvěò	TRUE
YǔhrFxKCFpQhZkàdjásBudZúzNOLKosVgsAjěiyWDùanikZaDU	TRUE
alùLětccpúòǎEuhlOKhwaUDYLGQRYǒǎrQJNGnOxeóFJnàlěǒBǒ	TRUE
dKéèáLELBBágcEVèGRpAjAècSpwphmPoFBChEZǎKUHSIUǎBxeè	TRUE
fLhQwměfwaccIòbúNwěpDhdjsYgcNOOgěrPpRǒAbAyóYSEjlXQ	TRUE
hffǔzEEihSNěùYěHǒùUéYEoúCrXNVxHDAZHhlùvmAeiLLǔVRèl	TRUE
kLUNgGXxlgyTDWBfkeIKuèUfFáDEBcsNWàCǎekntiEQǎkZAxHd	TRUE
mSzǔKuXluùùàxqfafooéUǔwSUǒrbwcVGùZùùǒǔNLènOóvèOGùH	TRUE
púRqáǒkvǒQoèLqDBggCxǒóǔzUhfùnùYWFRLEjlGCSzarOLjtéL	TRUE
rIOckWpYuQMhǒdrYùGuiFoQgSKgsRǒdvǎáVbQfdyyUépFoZhbó	TRUE
uEtLCágafggùáèùKvzxLqDWXěfǎhiErènáǒLúòIéjDmVǒéACUB	TRUE
whkyOáKLedIBEkCZZGXgFYBYFJXanfVahùuPLmEOKzveǔXCXǎó	TRUE
ùùkjNaWDUnúzbyRabledKPTǔmYMBěeqKUqqyNqIfásBXúrShye	FALSE
áaóMQbQWMTalǒqBZCKJbsIáaǒRSvóǎbfCZkOiòǔxQhRnièaHbI	FALSE
ǎzYòfZXoJǔbnCqEmTòQjTTgBNyYabnqěáKYyoaUábzpJirzkúV	FALSE
ěXVbdoItXǔCáPkAqǒyfipóohEpVkDcqàFabaùérǔéRbPmmàjMP	FALSE
òwméwUǔóLCumdéJpQkDQVLèvráQPBGàkQtaóbGuaǒAblAéJnǔX	FALSE
AZEkǔúvzRLIùǒǎnúCTDǎdfQabXMsarBVZMbvENǒqóòǒnRcZxOR	FALSE
DògPAáèYMǎtóTěkKvOúqCaNtbabgsxJEVYhàǔùGEChùtJzéNYG	FALSE
FdaybYaóěbJPFsEXǎǎRIvSZPzzvSFǔBrjǒVFezXùěmPnJYBbòh	FALSE
IGòqPaócgǎDCámlǔázbdaKYoǔbaóZPbHcòútfAdKáfZǔsXmsrQ	FALSE
LǔGIjndCǔáGRNúaXxXHmbsazJmIVbmMǒmYeZhaRQàúZeZxLdúv	FALSE
NhoXWaMbIZUbnaSSymMáuRAIWIbWǒaGórNSbMAhéfGXhbqékim	FALSE
QVEWptcXTTlCǔRsGbMùrriFepHprabAqaáoobuvllefkaoVǒTJ	FALSE
TBWbgeabnabBihǒuQUKSrNaGRhzrNWLoMlléHěoZěldTèùXWǒG	FALSE
WEekCǔTǒgrtamUǒAyělOaCěGWáúmZJbFQaòvpǒnpbYóGoXszfà	FALSE
ZQJDASBXWdeSóqVCNNFQKabPxaàsbmbBBHOlǔlǎǒUgwLztrlQN	FALSE
allhmSKlfActrnoQhOkabùOéàúUauxbrHDwéiSCfEqMQSdqòDǎ	FALSE
cSdòaěbzaymòbnùnUǒGOěRùběxJjòhzJflLezcixJFhálMfGèI	FALSE
euEgtgPamQbúNUùúnwCEJyNGǒabQAxnlXTaXuzDscrèàgáXòfa	FALSE
hcmUFmǒmpiTóhNúnPBikQtygaybnKtAáanzòCDmtbWAèlUcnLè	FALSE
kJKfGmPDEPabàAXměYùsPlXsanbRykǔZzúUáǔFlDaBwfVQùgOb	FALSE
nǎZagILcQTsezoóoaǒzbóIoVpúaoYYNbBmRòQúQLhBTCxyyEYǎ	FALSE
pTǎLdmSTCyswJftiUQuSarIiYSKFaYùXbLaǎóàDbwiòWHflǔvG	FALSE
súmdéWPxXfǒNǒnPzfrawxlqxUObQSuUxàFUěùFúHmHBazvbaEF	FALSE
uylmNǎMzRedrejyQkRúlCUqYǎKkrúèlYwtYEabMPIawbysncml	FALSE
xihMótéuòaLǔYaMěbLTGxtDúJIDóaáEáUIIyvKtbYmóJJOfNǒO	FALSE
