ùùjMdbGGcùnèaaěoIBfKgQyaaIxoWGh	TRUE
ájNdcZYonaRaúLZazyaNGfsKrWòóǔǔf	TRUE
éJzncMdyBsòVaEalaòyQrǔqMDFloaoC	TRUE
óWocàFhnTXixOQaaaSmNJYúSEtqèBaǎ	TRUE
AEOcyaaLEieàoyGdOaèáaslvkCAmGqp	TRUE
DYVreUcaVoaǔdJaěEèMtatxgtǒòPqeS	TRUE
GNmxQIcògaqVLnQaaFJóǒPmúaUBǔMǎc	TRUE
JAcOxóCnǔYBYěàFLBmsRaaRhatèISáa	TRUE
LpàSeWlIJèCcaTPǔùsqoMabaǔaOgAXá	TRUE
OzrVRèPOSEuUJcjIeSaRyLLvMaxměaa	TRUE
RPKàcWaáQDǒQnuayvòǔEaKCMǎmaoùěS	TRUE
TmMxzǎncHjaarbjOIlBywawzaUeVVBU	TRUE
XKxYlǔeycaraLRPùJvvǎlhJaZaVTàUZ	TRUE
aJLUbcXODMsvbdaòaHCWirhǔZTéZaoa	TRUE
céùùtlDoqsoócSaCMLǎElaQhzàpaaLQ	TRUE
cOmCnéǎxòwgkefLMaaòmaǒǒSSaurssè	TRUE
ceùxZyaDJóamròavAmQNòtCaúwKPFVg	TRUE
cxjuaUADuaFsAaěLVqóEǔùHaúàdTTǒá	TRUE
ffvyTKlàWZzxeBYscǎǔoòaQaaarKmJk	TRUE
iUnKoǔérIqcraMoaaMóaGdiIǎǎLjǎGP	TRUE
lqHBVcEBLxawévXqaqàXJaaydfùáyqU	TRUE
oUTcCfǔkVétoLéaòPUuNJRFaòùUUaáa	TRUE
rQZcWéNvaàakbàBJòraCúHqGaGhNQwS	TRUE
tsCKIRcXXqaaYRJigjǒúaqúépmaFVsè	TRUE
xócaANàwèJRMáIJCCLapòNreaùabZGH	TRUE
ùùjMdbGGcùnèxaěoIBfKgQyaaIxoWGh	FALSE
ájNdcZYonaRòúLZazyaNGfsKrWòóǔǔf	FALSE
éJzncMdyBsòVaEqlaòyQrǔqMDFloaoC	FALSE
óWoLàFhnTXixOQaaaSmNJYúSEtqèBaǎ	FALSE
AEOcyěaLEieàoyGdOaèáaslvkCAmGqp	FALSE
DYVreUcaVoaǔdJuěEèMtatxgtǒòPqeS	FALSE
GNmxQIcògaqVLnQmaFJóǒPmúaUBǔMǎc	FALSE
JAeOxóCnǔYBYěàFLBmsRaaRhatèISáa	FALSE
LpàSeWlIJèCcMTPǔùsqoMabaǔaOgAXá	FALSE
OzrVRèPOSEuUJcjIeSaRyLLvMaxměta	FALSE
RPKàcWaáQjǒQnuayvòǔEaKCMǎmaoùěS	FALSE
TmMxzǎncHjazrbjOIlBywawzaUeVVBU	FALSE
XKxYlǔeycaraLRPùJvvǎlhJaeaVTàUZ	FALSE
aJLUbcXODMsvbdaòaHCWirhǔZTéZEoa	FALSE
céùùtlDoqsoócSafCMLǎElaQhzàpaaLQ	FALSE
cOmCnéǎxòwgkefLMaaòmaǒǒSgaurssè	FALSE
ceùxZyaDJóamròavAmQNòtdaúwKPFVg	FALSE
RxjuaUADuaFsAaěLVqóEǔùHaúàdTTǒá	FALSE
ffvyTKlàWZzxeBYscǎǔoòwQaaarKmJk	FALSE
iUnKoǔérIqcraMoaEMóaGdiIǎǎLjǎGP	FALSE
lqHBVcEBLxawévXqaqàXJCaydfùáyqU	FALSE
oUTcCfǔkVétoLéaòPUuNJRFaòùUUXáa	FALSE
rQZcWéNvaàskbàBJòraCúHqGaGhNQwS	FALSE
tsCKIRcXXqaaYRJigjǒúaqúcépmaFVsè	FALSE
xócaANàwèJRMáIJCcLapòNreaùabZGH	FALSE
ùùzRcǔlTǔsPoaèWOZNGaòòUEduhtùóaa	TRUE
áNnLcGGeyvbOaHúXaRWoBYziHAQEaaNn	TRUE
ékkfcǔqaMvxRNxIǎaXatEaMéwòPmzmEK	TRUE
ócuaaParalUgFdǔógVzUsxPWRzáàajzr	TRUE
úiGqáPEIóiǒǎcàFNmuHsGUaPaéǔVaaEE	TRUE
CsáYIYShMciáJZaafVKtXaKaVPOUHwNa	TRUE
FgckaCUěǔIaRúKJAelmEaBVTsqpúpLVa	TRUE
IDǔecotyPbǎaFaoCbaáoùQaknàcQěWúy	TRUE
KnpèQLNMcěLǔùgHObaiaaGIZbEaXapéz	TRUE
OEmPQycfofhavGHaùCtòotǒLaJaǒdgau	TRUE
QxmùwcěCkmtAFaXoáaEkURaOWPzXòápa	TRUE
TZqXǒxYTStScǎjYpeOSRaBMèvlaHEFaa	TRUE
WIYuěrNèoMǒcnSsaxntEaǔóJaxqnQsao	TRUE
YqJicávěxxWaXaJJXRaraAnqjpuISúZi	TRUE
bvICeQTctGEHbǔaYùZaaHěYDùassiwOe	TRUE
cHGavQaòQǎAhcúaoǎtnaIkǎZWéVLlhsn	TRUE
caaGdfvRGerSááaWMKUùNPaǎLdgVcItI	TRUE
cwaaaIzBXIJnoTawVKvǒKoRnOqáMzDào	TRUE
fPmpWMxSòMIcrAàrFRǒèaAáMóàIaVǔaa	TRUE
iMcGapùàAafInědaXwBJacgéyxvwOLJb	TRUE
lGcINanQDèùnZacòasMaISFmBTRHǔaCk	TRUE
nivwáQgDlhHàcCàaarOaaqúèuOkZcCIB	TRUE
ràULMbtéCàcaqaòMèQhWlJYfiaǒsàKaS	TRUE
uEáLXgJcBFLAfKtzqKrpúuhVOaaSIaaM	TRUE
xQZhQbTRiyǎcqòàaUWDSaucrǎièGODaa	TRUE
ùùzRcǔlTǔsPoaèWOZNGěòòUEduhtùóaa	FALSE
áNnLcGGeyvbOaHúfaRWoBYziHAQEaaNn	FALSE
ékkfcǔqaMvxRNxIǎXXatEaMéwòPmzmEK	FALSE
ócuSaParalUgFdǔógVzUsxPWRzáàajzr	FALSE
úiGqáPEIóiǒǎcàFNmuHsGUaPaéǔVpaEE	FALSE
CsáYIYShMciáJZZafVKtXaKaVPOUHwNa	FALSE
FgckaCUěǔIaRúKJAelmEaBVTsqpúpLVka	FALSE
IDǔecotyPbǎaFaoCbaáoùcaknàcQěWúy	FALSE
KnpèQLNMǒěLǔùgHObaiaaGIZbEaXapéz	FALSE
OEmPQycfofhavGHaùCtòotǒLaJtǒdgau	FALSE
QxmùwcěCkmtAFaXoáaEkURaOWPzXògápa	FALSE
TZqXǒxYTStScǎjYpeOSRaBMèvlaHEFQa	FALSE
WIYuěrNèoMǒcnSsaxntkaǔóJaxqnQsao	FALSE
YqJicávěxxWaXaJJXRarKAnqjpuISúZi	FALSE
bvICeQTctGEHbǔJYùZaaHěYDùassiwOe	FALSE
cHGavQaòQǎAhcúxoǎtnaIkǎZWéVLlhsn	FALSE
caKGdfvRGerSááaWMKUùNPaǎLdgVcItI	FALSE
cwaoaIzBXIJnoTawVKvǒKoRnOqáMzDào	FALSE
fPmpWMxSòMIcrAàrFRǒèaAáMóàIaVǔa	FALSE
iMlGapùàAafInědaXwBJacgéyxvwOLJb	FALSE
lGcINanQièùnZacòasMaISFmBTRHǔaCk	FALSE
nivwáQgDlhHàcCàfarOaaqúèuOkZcCIB	FALSE
ràULMbtéCàcaqáòMèQhWlJYfiaǒsàKaS	FALSE
uEáLXgJcBFLAfKtzqKrpúuhVOaaSIaM	FALSE
xQZhQbTRiyǎcqòàaUWDShaucrǎièGODaa	FALSE
ùáVUvàFǔPEoacRaaèXdIMǔVGoRPPauaIo	TRUE
àǔczěxVrqjSAaMHàGaáeěLǔQeGSkVYala	TRUE
édjècǔǔuxaaaaBeèNúiAùMǒBMWǎYòáRGs	TRUE
óúDEzBHóVcxMǔpfbeuPaGaIaùtaǒyrrùB	TRUE
úǎofoweRJlUcaúapOXLOòiXWeaòDraBfè	TRUE
CGzBVNAcàCqOWsGkaéaZRxgeEoqSawYab	TRUE
EqcoVHrgaǒalSRafAmMLeBmasHLAǔQnaH	TRUE
HkRrYàKiHúépkédUOcxcZDraJaǎTjxaaC	TRUE
KQmcěbǎénamlToRàAaùwǒfeCCiaěsRPah	TRUE
NUNYMKCcOaaZùaVDaQAódEEQLùgtXmDmJ	TRUE
QVcmataBDmáSJfKóIaQIWuZSYrGBaYrjU	TRUE
TNMTùvgzwéùfcQatzanSàkehaaHykfeiR	TRUE
WFruRkàlcWdiXLpǎtaMtùXarGEWlSbaxa	TRUE
ZcewBaanWIiúnJaDáaǔáZwsàEpOLAlRMà	TRUE
cǔPCěgvóóCyaHěaDEEYcaFjraǔaNpixhV	TRUE
cIGǎgzfóatalppctWboaOfweáǔéKhPana	TRUE
caóSTNDaòáqaǒalèúdaOmIMKwèlVFCBih	TRUE
cpasaKGPamòùaHěwVFpyjàHahEóOJTDdO	TRUE
ecěxCùatǎWwaKGjfEěéfnùqcǔdERwaǎěa	TRUE
hǎzovBàDPóTFbzCǒcòuHraailCbauWàaH	TRUE
kRXroRbDvKicáGǒmZaJùaQCùǔǎúcLMúaa	TRUE
oǎYUàéùQjcxbQUghaòLwáFaáySaadjjkJ	TRUE
rFáòZkNabzKemzàcPAùPaPLéaqzhayéaW	TRUE
tcaáàoaXobkWQBáOwayóQǔauPZUTbYiXN	TRUE
wepLcXTPfmgIamMCKrěamZFdBXtaXsEòa	TRUE
ùáVUvàFǔPEoacRaSèXdIMǔVGoRPPauaIo	FALSE
àǔczěxVrqjSAaMHàGaáeěLǔQeGSkVYmla	FALSE
édjèUǔǔuxaaaaBeèNúiAùMǒBMWǎYòáRGs	FALSE
óúDEzBHóVqxMǔpfbeuPaGaIaùtaǒyrrùB	FALSE
úǎofoweRJlUcaúapOXLOòiXWeajDraBfè	FALSE
CGzBVNAcàCqOWsGkuéaZRxgeEoqSawYab	FALSE
EqoVHrgaǒalSRafAmMLeBmasHLAǔQnaH	FALSE
HkRrYàKiHúépkédUOcxcZDrpJaǎTjxaaC	FALSE
KQmcěbǎénamlToRàbaùwǒfeCCiaěsRPah	FALSE
NUNYMKCcOauZùaVDaQAódEEQLùgtXmDmJ	FALSE
QVcmataBDmáSJfKóIaQIWuZSYjrGBaYrjU	FALSE
TNMTùvgzwéùfcQatzynSàkehaaHykfeiR	FALSE
WFruRkàlKWdiXLpǎtaMtùXarGEWlSbaxa	FALSE
ZcewBaanWIiúnJaDáěǔáZwsàEpOLAlRMà	FALSE
cǔPCěgvóóCyjHěaDEEYcaFjraǔaNpixhV	FALSE
cIGǎgzfóabalppctWboaOfweáǔéKhPana	FALSE
caóSTNDqòáqaǒalèúdaOmIMKwèlVFCBih	FALSE
cpasaKGPamòùhHěwVFpyjàHahEóOJTDdO	FALSE
ecěxCùatiWwaKGjfEěéfnùqcǔdERwaǎěa	FALSE
hǎzovBàDPóTFbzCǒcòuHraAilCbauWàaH	FALSE
kRXroRbDvKicáGǒmZafJùaQCùǔǎúcLMúaa	FALSE
oǎYUàéùQjáxbQUghaòLwáFaáySaadjjkJ	FALSE
rFáòZkNabzKemzàcPAùPaPLéaqzhnyéaW	FALSE
tcaáàoaXobkWQBáOwakyóQǔauPZUTbYiXN	FALSE
wepLcXTPfmgIamMCKrěamZFdBXtEXsEòa	FALSE
ùǎieTácWMaOavVòLRuòaoTèazúJGCcyàfc	TRUE
átsUXcRZTjHaèmtAèaqhGAyáúDavrRVaQV	TRUE
éRzyǒnzCjOlèyTmEqJcǔavaaaQgéǒKdrmú	TRUE
ócbDltzlQaHaMgaóXyzaOMGjòrktǎZLeLY	TRUE
AáXfeGcǒGàaúIaxaaGOmEhěáaénpKxluhB	TRUE
DècJJtSQpUóbaBaPlBěwěvjpaJNnIVaóTH	TRUE
FTcOYrYwaáětěraaaqvUkèàéDoqOsGPAàa	TRUE
ILeěfBFpéUaOEcvróàaMaSSETkywEbapaw	TRUE
LMVoJcapàFzWaJóěBGáádàǔaMosGRMVabR	TRUE
NqWbIkbcIEiwaaeexxaaXǔEHáxIplezCbd	TRUE
RǔcfùmUOkAdiEcDLúaòUaGFròBNapǒmQai	TRUE
TkcqaaWyaòZaYúhnháztHapYǎGmehénXTx	TRUE
WǒwceyaáyěqjLaqacǎǎWRawpmóèoakPIVa	TRUE
YctIǎAǔgǒNaéRKVaNqǎúmKSPtFTlzaaUks	TRUE
bdVyúèbPrncviFaóyCOwxAasmZTnhubaaX	TRUE
cKjkGnIéLěěCiRpzWnugFNzmaaVǔaaòzZc	TRUE
caZǒlZaóaséaIéSuvDjwáejXǎJwKRěCjFB	TRUE
cvnDGúónYKǒàlnaaéhiaǒaodNpORaCqátC	TRUE
fèqàRAucaWǎNSapwFIaUrROqDǒGtBYóBaV	TRUE
iùEùEncGaaFEatQǒVAZsKrásóaǎyùpsNqk	TRUE
knèIgMbcMEEjùayEuaaEYaYELfUéwhpLEj	TRUE
oTdfEPhhTJùPzGócalěǎazEoYaPabòáběM	TRUE
rVIrlMébBSáHEPFoIuòcéóJèRaGSaczaya	TRUE
ucuVIǎeZwRoáaegAaTèsBvzGawóGaaHKnP	TRUE
xCxGOǔSqceacòjCdaénvnpMúaaaFocITDA	TRUE
ùǎieTácWMahavVòLRuòaoTèazúJGCcyàfc	FALSE
átsUXcRZTjHaèmtAèxqhGAyáúDavrRVaQV	FALSE
éRzyǒnzCjOlèyTmEqJPǔavaaaQgéǒKdrmú	FALSE
ócbDltzlQaHhaMgaóXyzaOMGjòrktǎZLeLY	FALSE
AáXfeGcǒGàaúIfxaaGOmEhěáaénpKxluhB	FALSE
DècJJtSQpUóbaBaPlBěwěvjplJNnIVaóTH	FALSE
FTcOYrYwaákětěraaaqvUkèàéDoqOsGPAàa	FALSE
ILeěfBFpéUaOEcvróàaMaSSETkywEbapEw	FALSE
LMVoJcRpàFzWaJóěBGáádàǔaMosGRMVabR	FALSE
NqWbIkbcIEiwaleexxaaXǔEHáxIplezCbd	FALSE
RǔcfùmUOkAdiEcDLúaòUaGFròBNabǒmQai	FALSE
TkcqaaWyYòZaYúhnháztHapYǎGmehénXTx	FALSE
WǒwceyaáyěqjLaqacǎǎWRawpkmóèoakPIVa	FALSE
YctIǎAǔgǒNaéRKVaNqǎúmKSPtFTlzaáUks	FALSE
bdVyúèbPrniviFaóyCOwxAasmZTnhubaaX	FALSE
cKjkGnIéLěěCiRpzWnugFNzmRaVǔaaòzZc	FALSE
caZǒlZaóasécIéSuvDjwáejXǎJwKRěCjFB	FALSE
cvnDGúónYKǒàlnajéhiaǒaodNpORaCqátC	FALSE
fèqàRAucaWǎNSapwFIaUjROqDǒGtBYóBaV	FALSE
iùEùEncGaKFEatQǒVAZsKrásóaǎyùpsNqk	FALSE
knèIgMbcMEEjùayEuaaEYiaYELfUéwhpLEj	FALSE
oTdfEPhhTJùPzGócalěǎazEoYwPabòáběM	FALSE
rVIrlMébBSáHEPFoIuòYéóJèRaGSaczaya	FALSE
ucuVIǎeZwRoáaegAaTèsBvzGawóGabaHKnP	FALSE
xCxGOǔSqceacòjCdaénvnpMúaIaFocITDA	FALSE
ùùSTRuǎWqcjvDUgVOaaǒJúZǒiaSúěvFmayw	TRUE
ácǔWěOgOSaóQURapgrnYàúkLcgaajǒMhòiP	TRUE
ébjRApptYéQcveòtoCòuaéaǒèáoveuǔaoza	TRUE
óOéaueùZaWPKsrcmàaEmyYZQptaaFaáBǎii	TRUE
úDurKcKxaàEjéSTrOdméeQaqaSUaQDOsxaK	TRUE
BNYIcTlBiaRavclgbxèFXYaQOCwYJZyùILa	TRUE
EJHEcWqaWFwoySJDaGwViNzèTaKaqFècòǔH	TRUE
HNiPóukcvbaooǒúaIǎXoErarèàaáqòuQǒTc	TRUE
KOlKRsRVǒceotóUǔXLaTIaaǒěwavJnjPIXy	TRUE
NúàHJcpsLàatpQSCadèpǎkwophfOoTùaára	TRUE
PhQPCoǎǎzfAbèEéGcàVQDxaIǔaawVlSmaYY	TRUE
SrcVaaaéIsǔtnCOrrXYTEXSóUxRaRQéxhjU	TRUE
VcQsaADIWJzRuahWaaéKuúěQWslCOsXmYěy	TRUE
YYAINAùOJZZuQTCBcVaCzDmMáyuGòaFaǒla	TRUE
baycSDRizmLǎxaMSaáXitNaGrBTyaXJàQǔg	TRUE
cHOCHǒǒSsPFYHMaZgaǒyarIzbAauVùMacǎf	TRUE
cawǔvagqmOFbapJAádWdǔmawaBHfZeZGáRS	TRUE
cyFyódflZSALáaYOHùaEèccbljsshZkòaaY	TRUE
fksZUooXNrDcaLaábcMaěoǎsLrMRSvRaOHJ	TRUE
jAáEScaomiádvavJnBqTksráFVauauYaaMy	TRUE
lcacSIWaòùéwxAóJsEXadaavAealBàEEMjf	TRUE
oavàǒJPfcFNvgóaGaxDtzLCaGXJPuMMaqIP	TRUE
rǒcSiCmeXHúCOHAaPaHpóDaǎaVgúsǎHzHúp	TRUE
tjbùZoèLòLblXTbbAbIQèqbLMhǎcTèòVYTJ	TRUE
xLUcaaSzéPtáQwjqéPGǔáGoglxyiRFYFSaa	TRUE
ùùSTRuǎWqtjvDUgVOaaǒJúZǒiaSúěvFmayw	FALSE
ácǔWěOgOSaóQURèpgrnYàúkLcgaajǒMhòiP	FALSE
ébjRApptYéQcveòtoCòuaéeǒèáoveuǔaoza	FALSE
óOéaueùZaWPKsrcmàóEmyYZQptaaFaáBǎii	FALSE
úDurKcKxaàEjéSTrOdméeQaqaSUaQDOsxmK	FALSE
BNYIcTlBiaRavclgbxèFXYaQOCwYJZyùILk	FALSE
EJHEcWqaWFwdySJDaGwViNzèTaKaqFècòǔH	FALSE
HNiPóukcvbaooǒúLIǎXoErarèàaáqòuQǒTc	FALSE
KOlKRsRVǒceotóUǔXLaTIcaaǒěwavJnjPIXy	FALSE
NúàHJcpsLàOtpQSCadèpǎkwophfOoTùaára	FALSE
PhQPCoǎǎzfAbèEéGcàVQDxaIǔaawVlSmoYY	FALSE
SrcVaaaéIsǔtnCOrrXcYTEXSóUxRaRQéxhjU	FALSE
VcQsaADIWJzRuéhWaaéKuúěQWslCOsXmYěy	FALSE
YYAINAùOJZZuQTCBcVǎCzDmMáyuGòaFaǒla	FALSE
baycSDRizmLǎxahSaáXitNaGrBTyaXJàQǔg	FALSE
cHOCHǒǒSsPFYHMaZgzǒyarIzbAauVùMacǎf	FALSE
cawǔvagqmOFbapJAádWdǔmawiBHfZeZGáRS	FALSE
CyFyódflZSALáaYOHùaEèccbljsshZkòaaY	FALSE
fksZUooXNrDcaLaábcMaěoǎsLrMRSvRhOHJ	FALSE
jAáEScaomiádvavJnBqTksráFVauhauYaaMy	FALSE
lcacSIWaòùéwxAbóJsEXadaavAealBàEEMjf	FALSE
oavàǒJPfcFNvgóaGaxDtzLCǔGXJPuMMaqIP	FALSE
rǒcSiCmeXHúCOHAUPaHpóDaǎaVgúsǎHzHúp	FALSE
tjoùZoèLòLblXTbbAbIQèqbLMhǎcTèòVYTJ	FALSE
xLUèaaSzéPtáQwjqéPGǔáGoglxyiRFYFSaa	FALSE
ùààǎùHAcBTWsawaavyǒotLqFaJHjWslnóleǒ	TRUE
ábèàyùFtouàscyoAQIgmbukaǒaóBéJaVaǎNC	TRUE
éFcanXùxrasènaxězYAaSOfzZGhQSéUVáVWó	TRUE
ěwgfráaràcfUeaEagrtLvkaúKPmǔnPtǒEJla	TRUE
úùcmgODxJKbaúùSwùǎaamOqNrYuBáTaláwǔk	TRUE
CǒcóLěMǎrěRwúNpCdvDiUeaXDaǒvaFùagwlj	TRUE
FYfuèùbMrcaEDaLrmnMbHjóhXeEGdHBléaQa	TRUE
IcibǔAnfěWǒZasLaazànSMaRGWsjeqNBKcjE	TRUE
LrxǒucaQRPawiLǒFǔpoeóVfgovdJSopaakmn	TRUE
OuLwOcoaNQtatDxOLáiMaoAJǎUnaHGòvxssQ	TRUE
ROckKnaZmxKXLaarTǔVrJéUqaérrOQCǔǒèoS	TRUE
UMMǔnúdqjcájIoBDdéaTPzPaCkHéòNaaòǎWn	TRUE
XǒOfCèSJvùàcKYVaSOrPywTaGrayyaisywGE	TRUE
ZlHpvYvcpǒvJxvěJaBrAàMaYOKàǔpPaNySaw	TRUE
cáFznTbCahǎóXaòUOoNpwaǔèBAxLǒVàazàam	TRUE
cMPYQayUaSZúWcaéǒHJǒahùàěCnsèpjǎepbQ	TRUE
cfnàáǒsǔgYóaIauxwtEHOsèiàóaVMaKCMuoq	TRUE
dóslcaiLěTwXaGSLBaXǒnbEfúaaóǔlrUhlèy	TRUE
frecàkJbwjEmNèzuxmJruaqRúsradaǔěKaMX	TRUE
iNcHGòKTóaaSamDySzPúapEèfKgLchUuéěǔF	TRUE
lKAERSxcaasJWàjTnaòyáaYjèséekxǎJhxdQ	TRUE
oMtKcpaaGaDǔǒpvùòAHFKazAtpIUzǒyoQWLC	TRUE
rFZgùdlFlZbcTPYhXimaaanlrKǒnYaJànzfù	TRUE
tuqJXucqPtzNNigEYaLòabNSǒddgaawécCkh	TRUE
wvSPTǔWQRKAgckaaùQZhaLqaèifEqRlpqLRo	TRUE
ùààǎùHAcBTWsawaavyǒotLqhFaJHjWslnóleǒ	FALSE
ábèàyùFtouàsEyoAQIgmbukaǒaóBéJaVaǎNC	FALSE
éFRanXùxrasènaxězYAaSOfzZGhQSéUVáVWó	FALSE
ěwgfráaràcfUeaEagrtLvkaúKPmǔnPtbǒEJla	FALSE
úùcmgODxJKbaúùSwùǎaamOqNrYugBáTaláwǔk	FALSE
CǒcóLěMǎrěRwúNpCdvDiUeaXDaǒvúFùagwlj	FALSE
FYfuèùbMrsaEDaLrmnMbHjóhXeEGdHBléaQa	FALSE
IcibǔAnfěWǒZasLaazàbnSMaRGWsjeqNBKcjE	FALSE
LrxǒucaQRPjwiLǒFǔpoeóVfgovdJSopaakmn	FALSE
OuLwOcoWNQtatDxOLáiMaoAJǎUnaHGòvxssQ	FALSE
ROckKnaZmxKXLaarTǔVrJéUqjaérrOQCǔǒèoS	FALSE
UMMǔnúdqjTájIoBDdéaTPzPaCkHéòNaaòǎWn	FALSE
XǒOfCèSJvùàcKYVaSOrPywTaGraiyaisywGE	FALSE
ZlHpvYvcpǒvJxvěJaBrAàMaYOKàǔpPaNySJw	FALSE
cáFznTbCahǎóXaòUOoNpwaǔèBAxLǒVàazàQm	FALSE
cMPYQayUaSZúWcGéǒHJǒahùàěCnsèpjǎepbQ	FALSE
cfnàáǒsǔgYóaIauxwtEHOsèiàóàVMaKCMuoq	FALSE
dóslcaiLěTwXaGSLdBaXǒnbEfúaaóǔlrUhlèy	FALSE
frecàkJbwjEmNèzuxmJruaqRúsradFǔěKaMX	FALSE
iNBHGòKTóaaSamDySzPúapEèfKgLchUuéěǔF	FALSE
lKAERSxcAasJWàjTnaòyáaYjèséekxǎJhxdQ	FALSE
oMtKcpaaGvDǔǒpvùòAHFKazAtpIUzǒyoQWLC	FALSE
rFZgùdlFlZbuTPYhXimaaanlrKǒnYaJànzfù	FALSE
tuqJXucqPtzNNigEYaLòcabNSǒddgaawécCkh	FALSE
wvSPTǔWQRKAgckaeùQZhaLqaèifEqRlpqLRo	FALSE
ùácJàkzHRzlkaqEHǒaunBFkiaaóCAàhtwRtgL	TRUE
ácvaGtvGOJaòWócvAxAsHFrQgòeaXNKaàlQMo	TRUE
éYBùcgzqàjaZArKvéáXòǔsaěRǔaǎJmHwIxQaX	TRUE
óTqxcJàMnMòpaěaàDGěǒffUfkVWeeltPaNaěQ	TRUE
úLuWrǔkcqǒHxgwOyaatiǒQóéaaAJOyAóJǎlaá	TRUE
BioylkJyAcaaVǔEèjmIbtrOǎaayFòDóCTXmrà	TRUE
EjǒymUWQécaaMLlrDRRogàhdLBaaiuYrEágOR	TRUE
HgeHNVoxǒWyǒcYeaWúaEàUHyXwFUazszoFVao	TRUE
KcBUVhLǔazCwaeIsnlaǎsUYysUNazmINVPááv	TRUE
NXlkWJáOQbzcWnrMVaTcaòYaaěZZùaLòwBǒpJ	TRUE
QfclocjycrzprfeBqúRKòZnJǒTaUCaHdaHaLr	TRUE
TácJBXhBLTfaCrtqpGIùtaPùógjèQPmWTlaai	TRUE
VsQlrsǔàUOwǎcmaWUǔèmDtúKóIomàGakBóaPa	TRUE
YwǎLxDpcNwxaaSFRUjWjZHmoaǒSUOówarùKxm	TRUE
bcaaCáZQpzOSyJǎQBNVáJùséRéFAdEcIaaubǒ	TRUE
cHevjhCsawBaVěfòCeNSausRIauRKúéExyjSò	TRUE
cdaazgQòòqPDébaNlaDbòqZěFkRQtmúTEGcWu	TRUE
dwCmcBaáOBUXóQǔFZYaKcéEPoaptwZNOzaeZò	TRUE
gBaáuiówcHXèXarsRIrùIAHGaóphaWvLrNJaX	TRUE
jòDcsPWáaèHóxLaǎbLáòBàDaTvrěyzaàdèdTf	TRUE
lobqbnvùtMbébRǒHbóàHrHóùQmobPLBSSapéb	TRUE
oacyǒoFHapaUpòRúqoovnèWJNTfPDuyhsaSùa	TRUE
rAécèqohYaXùaauHaúYHpjiéKElPxàefknhQm	TRUE
uùacùTǎaajtgòoatáǒGzmGZóYàlmaǔUpoǒòfD	TRUE
wiúSúsjecAIRSJjayóCMǒWOTsXaIzpavJaCsv	TRUE
ùácJàkzHRzlkCqEHǒaunBFkiaaóCAàhtwRtgL	FALSE
ácvaGtvGgOJaòWócvAxAsHFrQgòeaXNKaàlQMo	FALSE
éYBùcgzqàjaZArKvéáXdǔsaěRǔaǎJmHwIxQaX	FALSE
óTqxcJàMnMòpaěaàDGěǒffUfkVWeeltPPNaěQ	FALSE
úLuWrǔkBqǒHxgwOyaatiǒQóéaaAJOyAóJǎlaá	FALSE
BioylkJyAcadaVǔEèjmIbtrOǎaayFòDóCTXmrà	FALSE
EjǒymUWQéQaaMLlrDRRogàhdLBaaiuYrEágOR	FALSE
HgeHNVoxǒWyǒcYeaWúaEàUHyXwFUBzszoFVao	FALSE
KcBUVhLǔazCwaeIsnlafǎsUYysUNazmINVPááv	FALSE
NXlkWJáOQbzcWnrMVaTcaòYaakěZZùaLòwBǒpJ	FALSE
QfclocjycrzprfeBqúRKòZnJǒTacCaHdaHaLr	FALSE
TácJBXhBLTfaCrtqpGIùtjPùógjèQPmWTlaai	FALSE
VsQlrsǔàUOwǎcmaWUǔjmDtúKóIomàGakBóaPa	FALSE
YwǎLxDpcNwxaVSFRUjWjZHmoaǒSUOówarùKxm	FALSE
buaaCáZQpzOSyJǎQBNVáJùséRéFAdEcIaaubǒ	FALSE
cHevjhCsawBaVěfòCeNSausRISuRKúéExyjSò	FALSE
cdAazgQòòqPDébaNlaDbòqZěFkRQtmúTEGcWu	FALSE
dwCmcBaáOBUXóQǔFZYaKcéEPotptwZNOzaeZò	FALSE
gBaáuiówcHXèXIrsRIrùIAHGaóphaWvLrNJaX	FALSE
jòDcsPWáaèHhóxLaǎbLáòBàDaTvrěyzaàdèdTf	FALSE
lobqbnvùtgbébRǒHbóàHrHóùQmobPLBSSapéb	FALSE
oacyǒoFHapaUpòRúqoovnèWJNTfPDuyhsaSùs	FALSE
rAécèqohYàXùaauHaúYHpjiéKElPxàefknhQm	FALSE
uùacùTǎaajtgòoakáǒGzmGZóYàlmaǔUpoǒòfD	FALSE
wiúSúsjecAIRSJjayóCMǒWOThsXaIzpavJaCsv	FALSE
ùàpùSUAHcLAxxépbóGqaWEOOaGòJgmaYwRGaèn	TRUE
ácáǒSUDaaaCaeòaKNgèbfiYVEWAkKmHmEeabIH	TRUE
écThèHǒKéJèAvǔzlěéFaayGdénaáǎAlanptǒéq	TRUE
óZHqcdkěSwOǔarRZnàDuyMUacaYazeCVYáKgPà	TRUE
úFeáùEgWoCcHEěaGpZagWzxdCwcLaaéGmWfěuh	TRUE
CěfDJXměOgxyNgyPcvuaaVarQxZHajralEUMsB	TRUE
FěuùAAwQóhPoHrPPúcEGǎsaaDaaùàéybzuOSàj	TRUE
HhhuòQJBecaKvGoBNAùIaXTYyMGPasaJWChFIF	TRUE
KWAyhèPxQmNVdàKZuoiSZxvVcAeéCaaFǎaòQma	TRUE
NNypOjéXFMcBDEyxRqAaWajfKèSowaVuaǎuglt	TRUE
PrVqTSqaCHckJCFuWàEcQRóaéIùáartaaEcóLS	TRUE
SyJXaBvJjmlǔfFrfějNǎáVcúapDafRùYvǔbPaa	TRUE
ViJlHDěFYhFNmmJpJcamaTaCaèáBáTZǒPlPAúI	TRUE
YBvmàNLáaèUcTpòMéarZUaiòCsJzsáuuaéabqǔ	TRUE
bCdVVMgOǔùǎcgSqeEùyMZLaòuzaǔěngAaWImah	TRUE
cFLbWMEvfaáBPUaubLǎYaáaxǎnWáSUfpmrfzòS	TRUE
caaxrEwtěsZCnxKSmaGCLTèGqaQUǒnlyéóNEbX	TRUE
cwVhètóRpPqaéǔajqǎHqGQZaaSMxgTGHTXéǔMo	TRUE
fclaaoǎùyypkǎztàěqǒéEáavyBamógyzLsNojZ	TRUE
inzàdScDXéǒáYěJuOraaIQúMCTxDeTyNèǎnBaa	TRUE
lNlzhmIcfǎXòIaaaéuIaLyFéYéZǎójLIúgyMUá	TRUE
oàdJylZèòDscùǔLbóalaébKpwhpAjsIùaZaeyr	TRUE
qxcPVBYBldNQtazǔNAǔùOnUaRèyWaKTHawúóǔB	TRUE
tvcKDaNaòzVISPcroaawkǒOTbvatXúòBtYpGrg	TRUE
wfKzwkjGWqbcuóàMMǒùJWCanaòjdattqáxICna	TRUE
ùàpùSUAHcLAxxépbóGqaWEOOaGòJgmaYwRGFèn	FALSE
ácáǒSUDaAaCaeòaKNgèbfiYVEWAkKmHmEeabIH	FALSE
écThèHǒKéJèAvǔzlěéFaayGdénaáǎAkanptǒéq	FALSE
óZHqkdkěSwOǔarRZnàDuyMUacaYazeCVYáKgPà	FALSE
úFeáùEgWoCcHEěaGpZJgWzxdCwcLaaéGmWfěuh	FALSE
CěfDJXměOgxyNgyPcvuaaVarQxZHojralEUMsB	FALSE
FěuùAAwQóhPoHrPPúcEGǎsaaDaOùàéybzuOSàj	FALSE
HhhuòQJBecahKvGoBNAùIaXTYyMGPasaJWChFIF	FALSE
KWAyhèPxQmNVdàKZuoiSZxvVcAeéCaaFǎaòQia	FALSE
NNypOjéXFMcBDEyxRqAaWajfKèSowaVuǔǎuglt	FALSE
PrVqTSqaCHckJCFuWàEcQRóaéIùáartcaEcóLS	FALSE
SyJXaBvJjmlǔfFrfějNǎáVcúapDěfRùYvǔbPaa	FALSE
ViJlHDěFYhFNmmJpJcadaTaCaèáBáTZǒPlPAúI	FALSE
YBvmàNLáaèUcTpòMéarZUwiòCsJzsáuuaéabqǔ	FALSE
bCdVVMgOǔùǎcgSqeEùyMZLaòuzaǔěngAYWImah	FALSE
cFLbWMEvfaáBPUaubLǎYEáaxǎnWáSUfpmrfzòS	FALSE
caaxrEwtěsZCnxKSmaGCLTèGqùQUǒnlyéóNEbX	FALSE
cwVhètóRpPqaéǔajqǎHqGQZatSMxgTGHTXéǔMo	FALSE
félaaoǎùyypkǎztàěqǒéEáavyBamógyzLsNojZ	FALSE
inzàdScDXéǒáYěJuOrafIQúMCTxDeTyNèǎnBaa	FALSE
lNlzhmIcfǎXòIaaahéuIaLyFéYéZǎójLIúgyMUá	FALSE
oàdJylZèòDscùǔLbóalaébKpwhpAjsIùaZóeyr	FALSE
qxcPVBYBldNQtazǔNAǔùOnUúRèyWaKTHawúóǔB	FALSE
tvcKDiNaòzVISPcroaawkǒOTbvatXúòBtYpGrg	FALSE
wfKzwkjGWqbcuóàMMǒùJWCanaòjdattqáxIdCna	FALSE
ùáTlJjěXcaDEUTéVěóaǎFdlaùHYěSYaáBóhcjTt	TRUE
ájòZKEfQIàTVèISIqAFFfRiPtNélcaúHaFaacoǔ	TRUE
éMIcǔmkvùanměaǒbiKjaBHpOERómBěmZyóHǔòFa	TRUE
ócmZsIòkrdxǒaTuaGěbTaatùJEèHHLNTIRTjQQR	TRUE
újzVHBDEWrdéchjaYQěVéTBzaàPrmaaVTèNjWsú	TRUE
CcěwǎBěcǔpymaRMLxaéóǒbKgǒèqnDéaLOaRkTěn	TRUE
FàégcqYchBXYNUApWgPfmaaùdhLèaaěGQáeǒàjX	TRUE
HyǒCcYaaéaaUhàdèqùJMuúǒěVEjXóeòǒQdólcBg	TRUE
KmUlcMyBaZBaGéFaIFPTvRlwwzóyFSxaVtIOtSQ	TRUE
NmxEXYIAyéǔyúwRjǎácaMǎaTBNóálVaoahmRQèZ	TRUE
QggLácùLaaAǔOòpáuvQTcBǔRGaFEvxJaDXùnàqǔ	TRUE
TcóàLybQFJěQLjedměJSEkauNùéaaaágzBRáǔAo	TRUE
WàOeRtogǒnFècVǎgcpDyZaqDxNXmIúEéwaaMaáA	TRUE
YlcsAǒTZMSqièsAYaDuzAavlzAYxzioFǎNcXaKa	TRUE
biǒBohtcdpAIDZUqúǒéùuXǒRuúPdNanMxajavSa	TRUE
cMaaDWOBINaRqnzwXaddBjhèVFěLladXjLNKYqy	TRUE
cfúEOpsAVXYòhRǎlqbhLVeěaDúèaaPXèqaAKPiè	TRUE
dUGchOTlEffaLxwóWaIeMsbákSOǎapèrPaWěGSJ	TRUE
gcèctvYQKěápTnRtzóúhRHpwKrBjaSYIlaPaaUz	TRUE
jBúcQlǒKIaKzóaáaaógsěgBgjEEǔdUmòXzQfwèG	TRUE
mMcerQToǔNTCaapSfzjcaHǒàwovómǔòaéAHspcY	TRUE
pIeTqzicNóJYplMVfèQùDCEàantMAúUWUaAaazo	TRUE
sécxrféaQǒEaéURATěFQEǎǎFLEAJCCaMǔǒzaéǎp	TRUE
uiǔcIféaAHEaaMGWnaJgCáRHjmJZWBPUǔbáXóFB	TRUE
xPqJPRjUcNUhaHaoáoNLatEoVEémZrzNaDdrwtx	TRUE
ùáTlJjěXcaDEUTéVěókaǎFdlaùHYěSYaáBóhcjTt	FALSE
ájòZKEfQIàTVèISIqAFFfRiPtNélcaúHdFaacoǔ	FALSE
éMIcǔmkvùanměaǒbiKjLBHpOERómBěmZyóHǔòFa	FALSE
óOmZsIòkrdxǒaTuaGěbTaatùJEèHHLNTIRTjQQR	FALSE
újzVHBDEWrdéchjaYQěVéTBzaàPrmafaVTèNjWsú	FALSE
CcěwǎBěcǔpymaRMLxaéóǒbKgǒèqnDéaLOQRkTěn	FALSE
FàégcqYchBXYNUApWgPfmabaùdhLèaaěGQáeǒàjX	FALSE
HyǒCcYaaéaHUhàdèqùJMuúǒěVEjXóeòǒQdólcBg	FALSE
KmUlcMyBaZBaGéFPIFPTvRlwwzóyFSxaVtIOtSQ	FALSE
NmxEXYIAyéǔyúwRjǎácaMǎKTBNóálVaoahmRQèZ	FALSE
QggLácùLaaAǔOòpáuvQTcBǔRGaFEexJaDXùnàqǔ	FALSE
TcóàLybQFJěQLjedměJSEkauNùéaaRágzBRáǔAo	FALSE
WàOeRtogǒnFècVǎgcpDyZáqDxNXmIúEéwaaMaáA	FALSE
YlcsAǒTZMSqièsAYáDuzAavlzAYxzioFǎNcXaKa	FALSE
biǒBohtcdpAIDZUqúǒéùuXǒRuúPdNaknMxajavSa	FALSE
cMkaDWOBINaRqnzwXaddBjhèVFěLladXjLNKYqy	FALSE
cfúEOpsAVXYòhRǎlqbhLVeěaDúèQaPXèqaAKPiè	FALSE
dUGchOTlEffaLxcwóWaIeMsbákSOǎapèrPaWěGSJ	FALSE
gcèctvYQKěápTnRtzóúhRHpwKrBjaSYIlaPaiUz	FALSE
jBúcQlǒKIaKzóaáagógsěgBgjEEǔdUmòXzQfwèG	FALSE
mMoerQToǔNTCaapSfzjcaHǒàwovómǔòaéAHspcY	FALSE
pIeTqzicNóJYplMVfèQùDCEàantMAúUWUaAafazo	FALSE
sécxrféaQǒEééURATěFQEǎǎFLEAJCCaMǔǒzaéǎp	FALSE
uiǔcIféaAHEaEMGWnaJgCáRHjmJZWBPUǔbáXóFB	FALSE
xPqJPRjUcNUhaHOoáoNLatEoVEémZrzNaDdrwtx	FALSE
ùǔVcǎKOiNMeuXoměbalaóPZaaBeCHmFzwKSPfkDE	TRUE
ájnXocVHjJWěǒdùLJǎJIaQaHěCgaúaXOXhMowDtQ	TRUE
éWgkszxcIárazaèBJěaKyWQǎDRúMyJúFINzSǒaGW	TRUE
óěIàRNLewgPcòZYmǎQǎaaFgVsázaOwQZTmlaǔǎBq	TRUE
ǒcéMétkiAékDrxaIaZGLiQpLFRěònSéBMaEBnPTa	TRUE
AwǒcqOgòJùaǎHéLxNUMaXùoKǒaELùàòmémaKěùàC	TRUE
DqSyáTybcdaWDNazkaEvWVOPXXùrEahZpFǎXTHlo	TRUE
HùfmcZzfVaStéáOFWúsMnpaMweSauCrDtahǔTJié	TRUE
JoúQgxNbJěěZAcújéVMScRaaIpxDcaěEóúLIǒRaQ	TRUE
MWfHXRcOCaǒHqaYnpKSMkacJèIWhxaUYFKUèassk	TRUE
PXLWjyhwrSáǔKGZRǔcRZoaooLótaáPpJiěǒmqzaa	TRUE
SMcòaQKYvMavFBugKéIènRLDlwǔoiFQaàadùfARy	TRUE
VKaMuóUQǎcNhYuhZXiNaFPMaěèSóǔnaRGxNathgo	TRUE
YPTczwuuHFFPKtǒòLlgdǎaaXéEOAaAPQyaěXCqPH	TRUE
búaazMYBsxzvPVCEYVScKsókaǒXCBóaédratRùaU	TRUE
cKěǔǔDwaaOYbkGyǒYyZoǎěpnǎVsYknPùZlaáYaFè	TRUE
cděaváabDǒWrnVWaúYoùafǔgdAmlvbxsoéaFZNak	TRUE
dòoDJIyZámLègGMòZkBówrǒaàcaaǔsaafmicóXIL	TRUE
fclBaUéaKXYHǔOàùgaùTWawHóIIsIáWnàóPLbQXá	TRUE
iǎrprIcòFaNDJWagyAomfKBiMàpnùrAǔEbaaùxǔF	TRUE
lòCcáaqpòzǔTaWjfVqáFjWKYftxsuZèaaǒvtěǔWò	TRUE
oOcMTgzgòaDmépSFAWFézaèdYaIvagZòáBSpGkXx	TRUE
rcgOǒaòYCNZWàajAatJwaLpUMWYmltEGhJùWMSRe	TRUE
uBmrXvXeAècTjǎaaaHyrZYoGyGOùNEoaèQPVáHàf	TRUE
whZǒoDAmhocytAyIMUǎaJXFFvJJXakMzRzaallIj	TRUE
ùǔVcǎKOiNMeuXoměbJlaóPZaaBeCHmFzwKSPfkDE	FALSE
ájnXocVHjJWěǒdùLJǎJIiQaHěCgaúaXOXhMowDtQ	FALSE
éWgkszxcIárazaèBJěaKyWQǎDRúMyJbúFINzSǒaGW	FALSE
óěIàRNLewgPcòZYmǎQǎaaFgVsázaOwQZTmlYǔǎBq	FALSE
ǒcéMétkiAékDrxaIxZGLiQpLFRěònSéBMaEBnPTa	FALSE
AwǒcqOgòJùaǎHéLxNUMaXùoKǒaELiùàòmémaKěùàC	FALSE
DqSyáTybcdaWDNazkaEvhVOPXXùrEahZpFǎXTHlo	FALSE
HùfmcZzfVaStéáOFWúsMnpaMweSauCrDtIhǔTJié	FALSE
JoúQgxNbJěěZAcújéVMScRaaIpxDcaěEóúLIǒRhQ	FALSE
MWfHXRcOCaǒHqaYnpKSMkacJèIWhxaUYFKUèǒssk	FALSE
PXLWjyhwrSáǔKGZRǔcRZoaoobótaáPpJiěǒmqzaa	FALSE
SMcòaQKYvMavFBugKéIènRLDlwǔoiFQWàadùfARy	FALSE
VKaMuóUQǎcNhYuhZXiNaFPMaěèSóǔnKRGxNathgo	FALSE
YPTczwuuHFFPKtǒòLlgdǎXaXéEOAaAPQyaěXCqPH	FALSE
búaazMYBsxzvPVCEYVScKsókaǒXCkBóaédratRùaU	FALSE
cKěǔǔDwaaOYbkGyǒYyZoǎěpnǎVsYknPùZlaáYuFè	FALSE
BděaváabDǒWrnVWaúYoùafǔgdAmlvbxsoéaFZNak	FALSE
dòoDJIyZámLègGMòZkBówrǒaàcaaǔsazfmicóXIL	FALSE
fclBEUéaKXYHǔOàùgaùTWawHóIIsIáWnàóPLbQXá	FALSE
iǎrprIcòFaNDJWYgyAomfKBiMàpnùrAǔEbaaùxǔF	FALSE
lòCcáǒqpòzǔTaWjfVqáFjWKYftxsuZèaaǒvtěǔWò	FALSE
oOcMTgzgòaDmépSFAWFézaèdYaIvzgZòáBSpGkXx	FALSE
rcgOǒaòYCNZWàdajAatJwaLpUMWYmltEGhJùWMSRe	FALSE
uBmrXvXeAècTjǎaaaHyrZYokGyGOùNEoaèQPVáHàf	FALSE
whZǒoDAmhocytAyIMUǎaJXFFgJJXakMzRzaallIj	FALSE
ùùuOpGGAèAZrdcnaaIJpautIwáàsIáRKGUAafWFFn	TRUE
áctDaVMaúoptóNrénbdòǎntPilfQnpYPKvTiatTXa	TRUE
éǔDshUscPǎzcòǔnptKòavaaScNvlZcfBaèSTaKúEJ	TRUE
ěhkgùscěLqMMErxwVTGeJixóyiaaiaúqmpǔOèWaòà	TRUE
ǒScXSǎZàphYqaIEzraMéaAJáPBěAlaHcjZEàHFWSǔ	TRUE
BeiqSZacDYUǒSkPhiEaùvěuDaròběObfAaaCJbpyd	TRUE
FáQEáóùcxjYoMaPXǔoIúlwEaAjAMnaaBJsaKYáONq	TRUE
HZPèùékrgutfZcpWaaxǎaBèIǔúRMèLaQBRRuwfvkg	TRUE
JphQOczóGaaXMNTaqRFuBBkIaOHěaTstóDoráRlpe	TRUE
McaǔCQAaAlNGHRqqzòlXgFòwǎHàNaaěWEyindsvtl	TRUE
PkxOvuQǎXwOgèpàǒcHVaVByamidJQmtYǔAXqIiCaa	TRUE
SeGcCDèzOMufVPyaòKHXSùgéBmaáaúěVòǒèWYaMaò	TRUE
VGèqQúMázpswcGdavzZGaXǔǔiàóuVVjjJdqSaěaou	TRUE
YǎáóoIinReWcaTXaOZgOúwdrXàBǒKaáapKnAGuVqò	TRUE
aeCeácYBCxqlǔaaXassEDmGaNTáJRyIloAǎěNDgAá	TRUE
cDhaqazmlwJózZùaěQpOòúǎzCaSsnCcUéJǒPKTcmǎ	TRUE
ceSpAéóǔuwxasarMaúafórqùfúoJPHzrKLdMYBGXC	TRUE
dochtbZqUZhHáǒRVvgàoZaaiaBòUInZawiJAPLsoc	TRUE
gcdCHRDaYahmùaèQCDeáGùěKiégMrcǒozaFBúaCéó	TRUE
jcFtlOaHaaǔaHǒcuZòEGúhJlDLVǎIgTlqókBqGhPC	TRUE
múGàpkyKMǎKWZcaǔTDáaiVnWèBkWfaèMafKhzéuqn	TRUE
ocZóPóJdOflǔyvJOOóVbxPrnaFóEaLcùaajppFlOr	TRUE
sǒswcWNéxrABzCàtiVClXaaLǔXaèuǎYxPaǒDELsáǒ	TRUE
uoǒIcqYmYMqypCTOjaaaiPGùpCaBǒúIVsǒXqAóFùa	TRUE
xIǒyěcaèaBtàNFǒpQeqGjuólǔkAdcěòdrQrfaaqJr	TRUE
ùùuOpGGAèAZrdcnaaIJpaukIwáàsIáRKGUAafWFFn	FALSE
áctDIVMaúoptóNrénbdòǎntPilfQnpYPKvTiatTXa	FALSE
éǔDshUscPǎzcòǔnptKòavaaScNvlZcfBaèSTeaKúEJ	FALSE
ěhkgùscěLqMMErxwVTGeJixóyiaRiaúqmpǔOèWaòà	FALSE
ǒScXSǎZàphYqaIEzraMéaAkJáPBěAlaHcjZEàHFWSǔ	FALSE
BeiqSZacDYUǒSkPhiEaùvěuDaròběObfAOaCJbpyd	FALSE
FáQEáóùcxjYoMaPiXǔoIúlwEaAjAMnaaBJsaKYáONq	FALSE
HZPèùékrgutfZcpWaYxǎaBèIǔúRMèLaQBRRuwfvkg	FALSE
JphQOizóGaaXMNTaqRFuBBkIaOHěaTstóDoráRlpe	FALSE
MhaǔCQAaAlNGHRqqzòlXgFòwǎHàNaaěWEyindsvtl	FALSE
PkxOvuQǎXwOgèpàǒcHVaVByamidJQmtYǔAXqIiCaL	FALSE
SeGcCDèzOMufVPyaòKHXSùgéBmaáaúěVòǒèWYahMaò	FALSE
VGèqQúMázpswcGdafvzZGaXǔǔiàóuVVjjJdqSaěaou	FALSE
YǎáóoIinReWcaTXaOZgOúwdrXàBǒKaáěpKnAGuVqò	FALSE
aeCeácYBCxqlǔaaXassEDmGCNTáJRyIloAǎěNDgAá	FALSE
cDhaqazmlwJózZùaěQhpOòúǎzCaSsnCcUéJǒPKTcmǎ	FALSE
ceSpAéóǔuwxZsarMaúafórqùfúoJPHzrKLdMYBGXC	FALSE
dochtbZqUZhHáǒRVvgàoZaaiaBòUIinZawiJAPLsoc	FALSE
gcdCHRDaYrhmùaèQCDeáGùěKiégMrcǒozaFBúaCéó	FALSE
jcFtlOaHaaǔjaHǒcuZòEGúhJlDLVǎIgTlqókBqGhPC	FALSE
múGàpkyKMǎKWZcaǔTDáaiVnWèBkWfòèMafKhzéuqn	FALSE
ocZóPóJdOflǔyvJOOóVbxPrnaFóEaLcùaójppFlOr	FALSE
sǒswcWNéxrABzCàtiVClXGaLǔXaèuǎYxPaǒDELsáǒ	FALSE
uoǒIcqYmYMqypCTOjaaaiPGùpCaBǒúIVsǒXqAóFùá	FALSE
xIǒyěGaèaBtàNFǒpQeqGjuólǔkAdcěòdrQrfaaqJr	FALSE
ùàcaarOkúéNzfémàFoFpNGOáaǎéEackEeedéEUéDúF	TRUE
ádròòXqpScENQqjaǎmóùGWǎGazOsNPhXDaraoXzUcj	TRUE
èAcrǒmRTxfaqmGuáCHóKaéfóUuJùVIraǔaBáZǔqkóJ	TRUE
ónhEMéòhckmFXěHUaEAaRtaéWTěǒòèaBAúqXuèxàRF	TRUE
úejHéyBvaIQáěblócMúqèogHóRaúUaoNóbBěapNIKa	TRUE
CVWHcàRVqaěSáWǔèJěwxRYùùxEaúHǒpMktFRTaRant	TRUE
FùhYwkcWaéàKrEaàQOcBòBGfQUépáèruǎéfaaLǔYàe	TRUE
IAbaéxóXjlJSFyGEúcóatòLǔxqáPmusavNEoxaZDsa	TRUE
KfóNfzSáKHcròAZBcuaaèvPhNlHdxváIóHyěZaSzaú	TRUE
NWXècZGBKsxGéjéLjGamvǎaIPqwǒèJyjBraaùXVOzó	TRUE
QGJbùulrùfrpNQcsieNTalRpafMǔqMLnèàrKóXataz	TRUE
TEǒóócGéDWSRuúóléjaarEKxèmtXLùaECànvMǔuQay	TRUE
VwáexDtWoFYJàfJBóEckUbdèhHěOxcApKaaúáaanGl	TRUE
YgiJYMAxVYcérTǎEXvayFOTEaaEOLQSEaAJCUVLeDP	TRUE
báhclaròtXqXatóSYtkZcmEALǎòǎùásePnbeaPKtoa	TRUE
cIpOgěDiěódlCěéGǔùvsaCvIJVTqyenngaQǒaanazě	TRUE
ciIUbmdeKótúdEGyùqWVesXàUǎaMaQKuPgóWrdaǎaV	TRUE
dncRVaaéǔyPyUAeǔleBGkǒǔFmZmJuGèYIúrkyRaaXX	TRUE
gacZJóaámXyàaTRuiXAaàaUéQéylJéRUNUALqjǔǔyú	TRUE
jHyGymoscyrtaHCaWaKnsUYYǔWòǔqKCǎaóPdUěpQáq	TRUE
lsldyEsxdpQDVVsToùrQótkcmkAqJwnaaqaARvosUa	TRUE
osYNycIVClnaáAqXOFhBqVamwaòtXYUQóPhaYěaybú	TRUE
raNDBWcXNATaaaIOEúǒNLnpanAXfùTiDwàcYpYkaám	TRUE
uMRszsBkěmóeNAYlIucaMapVǒEkvBEuaòYakeàCùwM	TRUE
xYhúùQmpEYCQcEkNRKOerMoàěiQVsYúaaScaPNxlra	TRUE
ùàcaSrOkúéNzfémàFoFpNGOáaǎéEackEeedéEUéDúF	FALSE
ádròòXqpScENQqjǒǎmóùGWǎGazOsNPhXDaraoXzUcj	FALSE
èAIrǒmRTxfaqmGuáCHóKaéfóUuJùVIraǔaBáZǔqkóJ	FALSE
ónhEMéòhckmFXěHUaEApRtaéWTěǒòèaBAúqXuèxàRF	FALSE
úejHéyBvaIQáěblócMúqèogHóRaúUaoNóbBěapNIKf	FALSE
CVWHcàRVqaěSáWǔèJěwxRYùùxEaúHǒpMktFRTaRánt	FALSE
FùhYwkcWaéàKrEfaàQOcBòBGfQUépáèruǎéfaaLǔYàe	FALSE
IAbaéxóXjlJSFyGEúcóatòjǔxqáPmusavNEoxaZDsa	FALSE
KfóNfzSáKHcròAZBcupaèvPhNlHdxváIóHyěZaSzaú	FALSE
NWXècZGBKsxGéjéLjGamvǎWIPqwǒèJyjBraaùXVOzó	FALSE
QGJbùulrùfrpNQcsieNTElRpafMǔqMLnèàrKóXataz	FALSE
TEǒóócGéDWSRuúóléjaarEKxèmtXLùaECànbMǔuQay	FALSE
VwáexDtWoFYJàfJBóEckUbdèhHěOxcApKaMúáaanGl	FALSE
YgiJYMAxVYqérTǎEXvayFOTEaaEOLQSEaAJCUVLeDP	FALSE
báhclaròtXqbatóSYtkZcmEALǎòǎùásePnbeaPKtoa	FALSE
cIpOgěDiěódlCěéGǔùvsaCvIJVTqyenngaQǒhaanazě	FALSE
kiIUbmdeKótúdEGyùqWVesXàUǎaMaQKuPgóWrdaǎaV	FALSE
dncRVaaéǔyPyUAeǔleBGkǒǔFmZmJuGèYIúrkyRaHXX	FALSE
gacZJóaámXyàzTRuiXAaàaUéQéylJéRUNUALqjǔǔyú	FALSE
jHyGymoscyrtaHChWaKnsUYYǔWòǔqKCǎaóPdUěpQáq	FALSE
lsldyEsxdpQDVVsToùrQótkcmkAqJwnauqaARvosUa	FALSE
osYNycIVClnaáAqXOFhBqVamwnòtXYUQóPhaYěaybú	FALSE
raNDBWcXNATòaaIOEúǒNLnpanAXfùTiDwàcYpYkaám	FALSE
uMRszsBkěmóeNAYlIucaMapVǒEkvBEuaeòYakeàCùwM	FALSE
xYhúùQmpEYCQcEkNRKOerMoàěiQVsYúaaScagNxlra	FALSE
ùááoCZcWppǔxnCIǒVlǔnúéOaawaùKzsqaSwòòjurjtz	TRUE
áicHqaNfoTBxtumayaFNYIèJwcRGjskLwravmSPǔmaJ	TRUE
éKWúcheǒVlpUFetDaAYuomKOǎWmauvypnaaXBhsAwàU	TRUE
ěnuXwwOcMòòQjUKòqaEèlyaóCWěNjaYaNǔèJwèRcygǒ	TRUE
úDNáúnlWòuácIKǎjVǒaNǒéEoxsAaDòaXtMFòyTVariw	TRUE
BmǔJGǎjàěDwhGhwOdVLqoLcAjrfOIaVLǔúlmGúaaMva	TRUE
EDMhláécáwfaWaisáyògnJQǎFoaAXaPnEmVmUfMdfdé	TRUE
HYScbaaaǎIqhMLHaaCǎCdRórǔZUEWLjRmoenlòhXáTM	TRUE
KPUòcPGgèCEHhwaDxDHpaYzkPczuIóSěUmaxùKsmèaT	TRUE
MxzPMCLbsáùObJGbRbDnVòwuVxHZàQyzéèwxbFDbGkO	TRUE
PgěàcaKaǒqxeoǔodZdSOǔDdpàBYYMSUNaywòúPuùamK	TRUE
SòcenrhǒsAVxpyEOioMaèZaéáSfPohPHaoRoǔaàǎòzù	TRUE
UzieyěgbáIqZWgafTTOFAElcǎhRuòWaOAmBaravyaVE	TRUE
XlMcCRaèǔwUaedJBYHGFkUbàWmDUGYéuvZKInaòabWO	TRUE
acRrHFǎEJMcfcnuaBaěnUMaBCIWàMZqPIRGOaǔwrWOB	TRUE
cGQBXcnraPaoFmàolXgLǎiMHǔIEsLZkeYòYXCBaPXaL	TRUE
cdOuaQzòòIImJauTáHàVàIAolSvlǔéǎěEaSFOqaYlfr	TRUE
ddeǔZxiPhJnsjVzcSuúsaAqYacaZwaFptuaBúiPèǔHǒ	TRUE
gòIVcGpBaDXEtéZǔBnawvQxGoLhayúqqóàuVoLěGBua	TRUE
jUfEnwEWcpWěilHàEarFAǒDaWqEǎNfoààazFFàUKaPǒ	TRUE
mǎEIdúOsZRYvnPcJaùwCòQZIǒxXaǎviweoUéèZLDaat	TRUE
ocsnsúEEétZLlGLzRJfTùqeYTcQulaaQZvKaQRaJoèS	TRUE
rPòcéaVóuKqagèLIijZAluǔwiǔMèZVzWAlàLúKXéaaù	TRUE
uKFhCXòTǎRFCWhcrúUǒYxcNBOàaàǔaTZǒěkaWaIUFwo	TRUE
xùTòcraRtDǎúǎlaoEMtrHIDǔKUuàJlccǔAaQVzLúajM	TRUE
ùááoCZcWppǔxnCIǒVlǔnúéOaewaùKzsqaSwòòjurjtz	FALSE
áióHqaNfoTBxtumayaFNYIèJwcRGjskLwravmSPǔmaJ	FALSE
éKWúcheǒVlpUFetDaAYuomKOǎWmúuvypnaaXBhsAwàU	FALSE
ěnuXwwOcMòòQjUKòqaEèlfaóCWěNjaYaNǔèJwèRcygǒ	FALSE
úDNáúnlWòuácIKǎjVǒaNǒéEoxsAaDòaXtMFòjyTVariw	FALSE
BmǔJGǎjàěDwhGhwOdVLqoLcAjrfOIaVLǔúlmGúaaMvca	FALSE
EDMhláécáwfaWóisáyògnJQǎFoaAXaPnEmVmUfMdfdé	FALSE
HYScbaaaǎIqhMLHacCǎCdRórǔZUEWLjRmoenlòhXáTM	FALSE
KPUòcPGgèCEHhwěDxDHpaYzkPczuIóSěUmaxùKsmèaT	FALSE
MxzPMCLbsáùObJGbRbDiVòwuVxHZàQyzéèwxbFDbGkO	FALSE
PgěàcaKaǒqxeoǔodZdSOǔDdpàBYYMSUNaywòúPudùamK	FALSE
SòcenrhǒsAVxpyEOioMaèZaéáSfPohPHaoRoǔQàǎòzù	FALSE
UzieyěgbáIqZWgafTTOFAElcǎhRuòWagAmBaravyaVE	FALSE
XlMcCRaèǔwUaedJBYHGFkUbàWmDUGYéuvZKInmòabWO	FALSE
acRrHFǎEJMcfcnuaBaěnUMaBCIWàMZqPIRGOǒǔwrWOB	FALSE
cGQBXcnraPeaoFmàolXgLǎiMHǔIEsLZkeYòYXCBaPXaL	FALSE
cdOuaQhzòòIImJauTáHàVàIAolSvlǔéǎěEaSFOqaYlfr	FALSE
ddeǔZxiPhJnsjVzcSuúsaAqYvcaZwaFptuaBúiPèǔHǒ	FALSE
gòIVcGpBVDXEtéZǔBnawvQxGoLhayúqqóàuVoLěGBua	FALSE
jUfEnwEWcpWěilHàEarFAǒDaWqEǎNfoààazFFàhKaPǒ	FALSE
mǎEIdúOsZRYvnPcJaùwcCòQZIǒxXaǎviweoUéèZLDaat	FALSE
ocsnsúEEétZLlGLzRJfTùqeYTcQulaaQZvKJQRaJoèS	FALSE
rPòcéǒVóuKqagèLIijZAluǔwiǔMèZVzWAlàLúKXéaaù	FALSE
uKFhCXòTǎRFCWhcrúUǒYxcNBOàaàǔaTZǒěkrWaIUFwo	FALSE
xùTòǎraRtDǎúǎlaoEMtrHIDǔKUuàJlccǔAaQVzLúajM	FALSE
ùǔcGènáYfùYamuwqxFrvěymLuAaFMavGTuMKòrzèpǎai	TRUE
ásúDměoscXKIǔáOòoǎOǒaauaJùrěǒǒoAaxpfnzxylyMY	TRUE
éWkFnRSMgqKdbUǔhGòIBocICaUaoaaKNkeDQdtWanxyk	TRUE
ěpipIěiIrlgTcVjkxCDQpbVpCpCHLcphavsauzbéaaóP	TRUE
ǒpàpNsTàsuéácqtLNPwzGtùNaǒǔvauauPJwòǔBNaAóBu	TRUE
BbcaJYwwahZJnIebSYòiaHfaaDLIBRIRPAWàAuVSmèyM	TRUE
DqécyKgáALEwúYbJaùKúaháièQDdnúaPAmwKWypGacnu	TRUE
GPcdRsévaoyaipǎlGCdúpǒIvYùaruIJtatJhSǔRDHUrù	TRUE
JùZbaPIcTUjǔwPáòCaZǎèyEByvGóakbxVAǔGGúrǔanWa	TRUE
LwHiuiffvJPsncTaCòPuqùWQVǎòTéaòzǒgZaaJyXvJǎv	TRUE
OcrRMxCMúqaYSCatoZhxàAoGUEaǒmrnǒErIOOúDlTZùa	TRUE
RPUtdXQcydhěaOááLEabCcMWhJǒhaQǎèwaǎeǒǎkàzLgh	TRUE
UMXNQcrèaCGNJwBGcjXbXIraacVsGbNQaKPoryáasCěj	TRUE
XǔTDiiEqfVHzBIùFócMueěBaaóéèhnsxZTOaEaJIRZǎL	TRUE
ZpcBùXWlPyVhKntauKóKéIaǒètHVtnuaotNasvlhSsHè	TRUE
càaYéaBIJeaPxQaQàRVèěDóYYDNjYUozDèpEeUòúLTlD	TRUE
cUsayVGagoRǎkAFpúǒwesǔCàbqFMawNèTwoDtaIzfILu	TRUE
cyBáEómaEonaOUaTtTéLUJVèCaRxCphpǔmlqtǒCZySTj	TRUE
fTNmǒRátPpcěǔZHQaazjagnGxgǔQsúCFxaLagNnnBgrl	TRUE
icufLkHYaqǒavDmQóaBaBéJeFPkAǒEòcmqXQFlúvdnéǎ	TRUE
lfMSzcgBrwYasFHuahjNRdúTFtǒRxcàǎhlQCaDVaayǔǒ	TRUE
ocpEyrAExèqqaàhWsWOIpoBLqaEúNaNǎaóIrǎJavLevN	TRUE
rKǔXkDLcǒrGZAJaúEzèaaWUZalàgúùdbicéuMdVvSsZú	TRUE
uIǎJaópWfGbjQkcrépbbEvěNòbǒQovúbKBbǎbǎQǔvzzs	TRUE
xǒGjèAuNDBjBuecrǎèélLKiaSwùBXaùaènAǎùmpóǔaǒz	TRUE
ùǔcGènáYfùYamuwqxFrvěymLuAaFMqvGTuMKòrzèpǎai	FALSE
ásúDměosúXKIǔáOòoǎOǒaauaJùrěǒǒoAaxpfnzxylyMY	FALSE
éWkFnRSMgqKdbUǔhGòIBocICJUaoaaKNkeDQdtWanxyk	FALSE
ěpipIěiIrlgTcVjkxCDQpbVpCpCHLcphavsauzbéaZóP	FALSE
ǒpàpNsTàsuéácqtLNPwzGtùNDǒǔvauauPJwòǔBNaAóBu	FALSE
BbcaJYwwahZJnIebSYòiaHfatDLIBRIRPAWàAuVSmèyM	FALSE
DqécyKgáALEwúYbJbùKúaháièQDdnúaPAmwKWypGacnu	FALSE
GPcdRsévaoyaipǎlGCdúpǒIvYùaruIJtRtJhSǔRDHUrù	FALSE
JùZbaPIcTUjǔwPáòCaZǎèyEByvGóakbxVAǔGGúrǔunWa	FALSE
LwHiuiffvJPsncTaCgPuqùWQVǎòTéaòzǒgZaaJyXvJǎv	FALSE
OcrRMxCMúqaYSCatoZhxàAoGUEaǒmrnǒErIOOúDgTZùa	FALSE
RPUtdXQcydhěaOááLEabCcMWhJǒhéQǎèwaǎeǒǎkàzLgh	FALSE
UMXNQcrèaCGNJwBGcjXbXIraacVsGbNQaKPoryáFsCěj	FALSE
XǔTDiiEqfVHzBIùFócMueěBaaóéèhnsxZTOakEaJIRZǎL	FALSE
ZpcBùXWlPyVhKntagKóKéIaǒètHVtnuaotNasvlhSsHè	FALSE
càaYéaBIJeahPxQaQàRVèěDóYYDNjYUozDèpEeUòúLTlD	FALSE
cUsayVGagoRǎkAFpúǒwesǔCàbqFMawNèTwoDtIIzfILu	FALSE
cyBáEómaEonaOUaTtTéLUJVèjCaRxCphpǔmlqtǒCZySTj	FALSE
fTNmǒRátPpcěǔZHQaázjagnGxgǔQsúCFxaLagNnnBgrl	FALSE
icufLkHYaqǒavDmQóaBLBéJeFPkAǒEòcmqXQFlúvdnéǎ	FALSE
lfMSzcgBrwYasFHuUhjNRdúTFtǒRxcàǎhlQCaDVaayǔǒ	FALSE
ocpEyrAExèqqaàhWsWOIpoBLqaEúNáNǎaóIrǎJavLevN	FALSE
rKǔXkDLuǒrGZAJaúEzèaaWUZalàgúùdbicéuMdVvSsZú	FALSE
uIǎJaópWfGbjQkcrépbIEvěNòbǒQovúbKBbǎbǎQǔvzzs	FALSE
xǒGjèAuNDBjBuecrǎèélLKiaSwcBXaùaènAǎùmpóǔaǒz	FALSE
ùùcgéávùVbxáěotǔCaǔUIaúéhBqHGuFlgUGzjcaaCuRxf	TRUE
áIdéKKwxdOxcVùRlǒkaraUenóJapnToéFVèzàaosVydNp	TRUE
ǎsQksOhJcúùSdmKHXpǒaěùPEJZaJzèaVǒmaHxpTxBwxiá	TRUE
ěoABcáùèQúOupyóǎclXpyaYaaeǎazaOjněZCReáskEPwO	TRUE
ǒcSoIrǒótaalǔHETOOarǔàUGwaMgPwqvQVyǒvwcyDXfià	TRUE
BjuIcLVDùaàQRéǔètunèHàěAwǒavLěJGxpsváOǒVZaJJa	TRUE
FǔYǒcQjQhLEBùqzaPcaéOOYAJYTzWtèaaNaJhTpLNpKNG	TRUE
HysócYEáxzaFǎBóúaúáǎuFtàIEIDYaWyoFàúěSnǔǔaOJj	TRUE
KtLvaòdxozOéààQéGcPfúéiQaaǒavúZunPaMDudbPHGǔǎ	TRUE
NcnoóKjTNaaKyáBùVGwěaúFoǎTEópHGagUéZHQrgNǔgya	TRUE
QghWcqcEomlifNdKaénxzabQeqMzòJDèǎcawBpaBrlèǔu	TRUE
TZàoeeEǔhgyMcózwSfàělOWéTxXsQùVaàeNCCqPaCaawa	TRUE
WaNǔicZRCtWkboùatpmaZèfWlaapUhnǒJyYǎoeifCJěhc	TRUE
ZEhpiNBaSSxVAǒOSJóócgéeYStDaTaaZmEěvtWúFaVPNě	TRUE
btúuBxoChcèBaarTPVxàbóPfBkThqěǔpUmgCjQPXnQaWa	TRUE
cUáhaèMhCraaǎXNIǒhǔàfèiiFMVatěQBxròpEahhrnǔYW	TRUE
ciweIBaFlMRlGAiXasNyGUMèaáácóIamapvǎNUshúleǔN	TRUE
eHcFFPhiLǒxěààlUùǔaùBúaSkTèjrEGǎùHBaàlnClaǎHp	TRUE
hóWsAcváBéoáDxtNaIàCnaDóWXbxLQěadGasaLGLàXyoǒ	TRUE
jTcèNDaaàáéèdBYOwmTYaJCNaFZrKoMbTReUWpdAIùhyl	TRUE
mXlWPZaGéqúcPámIòSxcOnYáaǔZǒHááDyYàabywKWQaaQ	TRUE
pQSPcnyyjHǎgBòddhlUZpzUpeèěWáǒǎawàxamvamaLféd	TRUE
sNlnvccnzKvóCebXèvǒǎESikǎVKǒòaOJmBaúRèéaawRóǎ	TRUE
vúLJwLgòfyěMúUǎcùzZùKyèáxaPoVaUaadETVcǎWánoDl	TRUE
xcòHxLuuNPsKóNaXapěvuHZaáóěyJaZebjépOspUFnwùá	TRUE
ùùcgéávùVbxáěotǔCaǔUIaúéhBqHGuFlgUGzjcèaCuRxf	FALSE
áIdéKKwxdOxcVùRlǒkaraUenóJapnToiéFVèzàaosVydNp	FALSE
ǎsQksOhJcúùSdmKHXpǒaěùPEJZaJzèaVjǒmaHxpTxBwxiá	FALSE
ěoABcáùèQúOupyóǎclXpyaYaaeǎazCOjněZCReáskEPwO	FALSE
ǒcSoIrǒótaalǔHETOOarǔàUbwaMgPwqvQVyǒvwcyDXfià	FALSE
BjuIcLVDùaàQRéǔiètunèHàěAwǒavLěJGxpsváOǒVZaJJa	FALSE
FǔYǒcQjQhLEBùqzaPcacOOYAJYTzWtèaaNaJhTpLNpKNG	FALSE
HysócYEáxzaFǎBóúaúáǎuFtàIEIDYaWyoFàběSnǔǔaOJj	FALSE
KtLvaòdxozOéààQéGcPfúéiQúaǒavúZunPaMDudbPHGǔǎ	FALSE
NcnoóKjTNaaKyáBùVGwěaúFoǎTEópHdagUéZHQrgNǔgya	FALSE
QghWcqcEomlifNdKaénxzabQeqMzòJDèǎcawBpiaBrlèǔu	FALSE
TZàoeeEǔhgyMcózwSfàělOWéTxXsQùVaàeNCCqPaCaSwa	FALSE
WaNǔicZRCtWkboùWtpmaZèfWlaapUhnǒJyYǎoeifCJěhc	FALSE
ZEhpiNBaSSxVAǒOSJóócgéeYStDaTaaZimEěvtWúFaVPNě	FALSE
btúuBxoChcèBFarTPVxàbóPfBkThqěǔpUmgCjQPXnQaWa	FALSE
cUáhaèMhCrwaǎXNIǒhǔàfèiiFMVatěQBxròpEahhrnǔYW	FALSE
ciweIBaFlMRlGAiXasNyGUMkèaáácóIamapvǎNUshúleǔN	FALSE
eHcFFPhiLǒxěààlUùǔaùBúaSkTèjrEGǎùHBqàlnClaǎHp	FALSE
hóWsAcváBéoáDxtNaIàCnaDóWXbxLQěadGasFLGLàXyoǒ	FALSE
jTàèNDaaàáéèdBYOwmTYaJCNaFZrKoMbTReUWpdAIùhyl	FALSE
mXlWPZaGéqúcPámIòSxcOnYáEǔZǒHááDyYàabywKWQaaQ	FALSE
pQSPcnyyjHǎgBòddhlUZpzUpeèěWáǒǎawàxamvamúLféd	FALSE
sNlnvccnzKvóCebXèvǒǎESikǎVKǒòaOJmBaúRèéaeawRóǎ	FALSE
vúLJwLgòfyěMúUǎcùzZùKyèáxaPoVaUaLdETVcǎWánoDl	FALSE
xcòHxLuuNPsKóNaXapěvuHZaáóěcyJaZebjépOspUFnwùá	FALSE
ùùrmfBǒéNScYwPǎavCaùnXBiOYSvrùFtZghiyǔsNraaLPI	TRUE
áSxcZsěwnTTěACMCwKjUEnYóěPCazLLTTvmabaaCouǎwió	TRUE
éMtGvyQVǎqlùpcVàaxvuSaócAgquaMtàóaemǔójNIzǎùpI	TRUE
óIèPówymMcaùnaJòáurěXXUdEPQpbHaMKOVamyHXòèěfEr	TRUE
ǒcpUIǒǔnTWàHqúRàuVCaGaqoaarnhhbkMǎúrclòpBwZRKT	TRUE
BJlGjZcCNMriNǔaZKóQěraóaaǔěyOCSèWpOytEicvóDjFo	TRUE
EùcUgàeSQàpBqèEtpCvzWmftaTHéXǎPuaiiaàèùEwáYTaá	TRUE
GcnKVaauRfkArùòǒYMecDqhǒvòZǎaGZWàǎEáMWYZaǒFgtx	TRUE
IyúNqǎkIqkJpcTlaGùuǔrXVaoMBnaIsVSwEvLaLǎhòmRSc	TRUE
LceXáwGrVtmǎLPDAVùTYéyaVqMDCaǎaKLLtGmDaOstHéěI	TRUE
OlsDjúQMaIDóLuBàVbqpTcIdRmaAèayǎáagpoTEúKaaNàǔ	TRUE
RZùlyoaEaQFòiAmeyèwùaYAycVfmèaóAútOzAFHHRazaaf	TRUE
VǒǒMuěcgyùbbéuvyèóǔaaClěiGxiLQOcAFèQZǒnkaòòaXC	TRUE
XaùvNǎCgEǒsXycOùfKFUǎvXvvIùPCAawéaúóaacMozZJEǎ	TRUE
aqQycjGKBDhBZTNywiaCwǒqVakYbKULólCatòSaXtiJlBù	TRUE
cHraKxvKaCpkCHrIǒrEEěVkkSFBǎèuglaCaVizzǒwvptgB	TRUE
ciXéUpléaxvyélFUnDayPòKJòNGhCaDkeaMàUéMOWJaQMV	TRUE
eDZyóCCtJcvhdchcFaHKaaxNaFoHjYkèrikVsrhékfIEBL	TRUE
gcNùǒrbIIaHaaZqmòaéCzvDbXPúdIPTTjiPMQjWQkOéFWt	TRUE
jDúdsrcrOEóPpaúlsYDXǔkewPasxXǒvrKúěaěùjbmQMLaa	TRUE
lfòxScPYZnaaRcRTCǎfYXsEùgóCbǒlAaaEpIEdfFùPmzěá	TRUE
ocrLhǒGrXJCábEóuúPzQeDdsQòzGbmpNeJCaBYóǔǔFaGaa	TRUE
rjWUaúIfzTqeqǎcsasòqVàTaaXNDsqǎMóuaNùXJqEúrtNE	TRUE
uIèSCcVjTGjǔBKodATòyǔáwxaaMEHyVqjOwrYavASWMPal	TRUE
xěJcèsaáxyHIòoaXPPèǔkZRǒOLjcapóQèLaǎèèòAòRógTa	TRUE
ùùrmfBǒéNScYwPǎavCFùnXBiOYSvrùFtZghiyǔsNraaLPI	FALSE
áSxcZsěwnTTěACMCwKjUEnYóěPCazLLTTvmmbaaCouǎwió	FALSE
éMtGvyQVǎqlùpcVàaxvuSaócAgquaMtàóyemǔójNIzǎùpI	FALSE
óIèPówymMcaùnaJòáurěXXUdEPQpbHaMKOVSmyHXòèěfEr	FALSE
ǒcpUIǒǔnTWàHqúRàuVCaGaqoaǔrnhhbkMǎúrclòpBwZRKT	FALSE
BJlGjZcCNMriNǔaZKóQěrqóaaǔěyOCSèWpOytEicvóDjFo	FALSE
EùcUgàeSQàpBqèEtpCvzWmftaTHéXǎPuaiiaàèùEwbáYTaá	FALSE
GcnKVaauRfkArùòǒYMecDqhǒvòZǎaGZWàǎgáMWYZaǒFgtx	FALSE
IyúNqǎkIqkJpcTlaGùuǔrXVaoMBnaIsVSwEeLaLǎhòmRSc	FALSE
LceXáwGrVtmǎLPDAVùTYéyKVqMDCaǎaKLLtGmDaOstHéěI	FALSE
OlsDjúQMaIDóLuBàVbqpTcIdRmaAèbyǎáagpoTEúKaaNàǔ	FALSE
RZùlyoaEaQFòiAmeyèwùaYAycVfmèaóAútOzAFHHRazJaf	FALSE
VǒǒMuěcgyùbbéuvyèóǔaaClěiGxiLQOcAFèQZǒnkacòòaXC	FALSE
XaùvNǎCgEǒsXycOùfKFUǎvXvvIùPCAywéaúóaacMozZJEǎ	FALSE
aqQycjGKBDhBZTNywiaCwǒqVakYbKULólCatòSMXtiJlBù	FALSE
cHraKxvKaCpkCHrIǒrEEěVkkSFBǎèuglaCgaVizzǒwvptgB	FALSE
ciXéUpléaxvyélFUnDUyPòKJòNGhCaDkeaMàUéMOWJaQMV	FALSE
eDZyóCCtJcvhdchcFaHKaaxNAFoHjYkèrikVsrhékfIEBL	FALSE
gcNùǒrbIIaHRaZqmòaéCzvDbXPúdIPTTjiPMQjWQkOéFWt	FALSE
jDúdsrcrOEóPpaúlsYDXǔkewPasxXǒvrKúěaěùjbmQMLpa	FALSE
lfòxScPYZnBaRcRTCǎfYXsEùgóCbǒlAaaEpIEdfFùPmzěá	FALSE
ocrLhǒGrXJCábEóuúPzQeDdsQòzGbmpNeJCadBYóǔǔFaGaa	FALSE
rjWUaúIfzTqeqǎZsasòqVàTaaXNDsqǎMóuaNùXJqEúrtNE	FALSE
uIèSCcVjTGjǔBKodATòyǔáwxǎaMEHyVqjOwrYavASWMPal	FALSE
xěJXèsaáxyHIòoaXPPèǔkZRǒOLjcapóQèLaǎèèòAòRógTa	FALSE
ùáLkáAZMùEVQfPcWXěcóNujécZuáayoóéǔzalSiAwaTaérh	TRUE
àúJgàPrHǔzdécPBKaTTtóaRwùdfKavXmkrVnoéiOágzsaaò	TRUE
ékcqdùMádgǔDGDPExàqěbYNoěEaxyrXZaáǎěáuasùaYdvdY	TRUE
óOcbKDǔmszgSRSWnjLéOdaězǎNLCaTjAuaòtolUlǒoòraRX	TRUE
ǒzcxvjǎaFaviRaDòXúabRlòfǎALEěUédLgcESònBlmzkdLQ	TRUE
CáFHNpbcévQNLzyKaaaUysùDwáIOàRùaZXeOèNúdApbDpoO	TRUE
EwzEdscSjaúvIpěOaNǔaǒntyNaqyDPeéLmFZkuLABWǒETJQ	TRUE
HcaGaGgPgbHòTSxMqqDǒZǎQéCxaBaIóxZùèpIwuqAGPGABv	TRUE
JyréTIòSǔBSeMǎbodPóciyaMLmaWpaFTèAtajésvǒjKVvgG	TRUE
MaohùécpEùFRfqyóéáRNIOiQOgaEvaikemZaapeUfhnORtD	TRUE
PIDfomVǎfCBhmAffuDdòlySJzFcHatTKUaEaaZrclzWRfRy	TRUE
SQAXAzGccQaZPlVQPRǒQàóCPEFvěUùGaaasiZHgZOhoXEqC	TRUE
VCduJdkddòMsRàǔxǒZcpěuCěHlBWSntNyaǔPNòVaOsXjWaa	TRUE
XthRvXcABYsjgLnauoajCZAPnáCByàmúYhQtNIǒeaaǒyáXá	TRUE
avylYmMáùOóBóMciPaFaaàPǒvòlAáINamfópmgvcwgóCVbl	TRUE
cGUfHqAtGfcPòDMaoyKaěnXOgléObaCuPaTKǒDYnDkYIúHu	TRUE
cihóraDàZáHaslQAHFYSúWComòěVaFJaLǒviòfqxlWgiQim	TRUE
dzSpYětMcaEquauBNjQioSwLQaAEFtafuǎNxhnGvkKùMéFl	TRUE
gSSávYxúyàedóTXtScgéǎmgùnZaBtaKlKaVRJSHJabEGCòi	TRUE
jBcxbxkGShàamáèLAHDUxsQWǎWDùúNDzINNuaàJèaaǒppóI	TRUE
mStHuAafěYVMpàOpcótsaaIYVQtePAtòYaayèwLlMIMǒCUR	TRUE
pǒǒuuyNbBbVQbHbbXàMbnsdgNCǔncxiVFkSRUGàXNgsqxQE	TRUE
rcwXkFoxdFèòxirYYbkNmWaMúútùatUsúEJMaGaiYezòfya	TRUE
uXǔóeùUǎéKkKùàyxubQqCEùbbxSbHérIsbvXxUqbngcnǔxT	TRUE
xFFàTùQmsuLOtcfaEIraLamHěǒvVTuppLWMXéaúbZUCǔuUl	TRUE
ùáLkáAZMùEVQfPcWXěcóNujécZuáayoóéǔfzalSiAwaTaérh	FALSE
àúJgàPrHǔzdéyPBKaTTtóaRwùdfKavXmkrVnoéiOágzsaaò	FALSE
ékcqdùMádgǔDGDPExàqěbYNoěEǎxyrXZaáǎěáuasùaYdvdY	FALSE
óOcbKDǔmszgSRSWnjLéOdaězǎNLCaTjAuaòtolUlǒoòráRX	FALSE
ǒzcxvjǎaFaviRahDòXúabRlòfǎALEěUédLgcESònBlmzkdLQ	FALSE
CáFHNpbcévQNLzyKaaaUysùDwáIOkàRùaZXeOèNúdApbDpoO	FALSE
EwzEdscSjaúvIpěOaNǔZǒntyNaqyDPeéLmFZkuLABWǒETJQ	FALSE
HctGaGgPgbHòTSxMqqDǒZǎQéCxaBaIóxZùèpIwuqAGPGABv	FALSE
JyréTIòSǔBSeMǎbodPóciyaiLmaWpaFTèAtajésvǒjKVvgG	FALSE
MaohùécpEùFRfqyóéáRNIOiQOgaEvaikemZlapeUfhnORtD	FALSE
PIDfomVǎfCBhmAffuDdòlySJzFcHatTKUaEòaZrclzWRfRy	FALSE
SQAXAzGccQaZPlVQPRǒQàóCPEFvěUùGatasiZHgZOhoXEqC	FALSE
VCduJdkddòMsRàǔxǒZcpěuCěHlBWSntNyajǔPNòVaOsXjWaa	FALSE
XthRvXcABYsjgLnauoajCZAPnáCByàmúYhQtNIǒeaVǒyáXá	FALSE
avylYmMáùOóBóMciPaFaakPǒvòlAáINamfópmgvcwgóCVbl	FALSE
cGUfHqAtGfcPòDMaeoyKaěnXOgléObaCuPaTKǒDYnDkYIúHu	FALSE
cihóragàZáHaslQAHFYSúWComòěVaFJaLǒviòfqxlWgiQim	FALSE
dzSpYětMcaEquYuBNjQioSwLQaAEFtafuǎNxhnGvkKùMéFl	FALSE
gSSávYxúyàedóTXtSǔgéǎmgùnZaBtaKlKaVRJSHJabEGCòi	FALSE
jBcxbxkGShàamáèLAHDUxsQWǎWDcùúNDzINNuaàJèaaǒppóI	FALSE
mStHuAafěYVMpàOpcótsaaIYVQtePAtòYaqyèwLlMIMǒCUR	FALSE
pǒǒuuyNbcbVQbHbbXàMbnsdgNCǔncxiVFkSRUGàXNgsqxQE	FALSE
rcwXkFoxdFèòxirYYbkNmWaMúútfùatUsúEJMaGaiYezòfya	FALSE
uXǔóeùUǎéKkKùàyxuHQqCEùbbxSbHérIsbvXxUqbngcnǔxT	FALSE
xFFàTùQmsuLOtcfaEIrSLamHěǒvVTuppLWMXéaúbZUCǔuUl	FALSE
ùAUcAFTHgisfsaSoCrǔaǔeUSOyypZOuZZǎnQLqmawáuaPóeT	TRUE
áaYrBUGETxkTRcSeNKikeixǎylǎáanzGavRuTDBTaéaDqPpě	TRUE
éGcaaxFbUcKXéZEéhKLCdpCNòpQlaVOlwARUWùaéfUùnMFob	TRUE
ěywtJcèWSkaQrajěknYnàhZóBúxHnQxpGwéǔǎhRMViIǒcaax	TRUE
ǒWYScódRèùGfZTiYdFaOEaXfmMSwùFWLKYwhkggJBěkHéaaT	TRUE
AzóacutaaNJIsǎblddmTrXvaxǔaedVIéěgǔǎBòPxúDTqeoLp	TRUE
EǔTzglwBkákcǒDlEeVqpaHaINsVWwáDISaLěWuǎaPPTKoAǒS	TRUE
GyLeǒiǎxCaǒaǎěcckHAaNbùlyQqMyDytaqsnǔaaěYzUadiěV	TRUE
JlrcqǔIqMaèáoDòahjòZcKHauWúWWúzaxUǎXiQtǔseTnDOjR	TRUE
MlZIZmròùczǔǒvSòfKbaWuNaIpàfpYùùhxaVavqBfpUǒàuIk	TRUE
PUuoCFDdáqcXphójgIaaTFnnYéàFěkEHDokTOúPaqaNnIlOá	TRUE
SaeòcǎúxfYSYòhmKYùawWwaqBloéOpdSòúIaNJnJaèěvRóMà	TRUE
VúészEJUrnhLscsmaaSvraǎáZaYlFěPIóyéòxòǎzyěMKAlTI	TRUE
XacZàdljQěByrǔǒMòUjěaaaaUJyèlRCFAxúVIbYSòNwmVhhh	TRUE
aKitLěXUoMIcaaxNJORYdóiùnjHGRiaNyèDlZPxaUúHáNùǔG	TRUE
cǒaǒǒRayaXnPaozOáIáWlKéèuCDáFUóZbàepyaàtǎyMóUǔéw	TRUE
ccEǎUwGèpmhOUanáQoǒCúGKèSBúǔaǒNǎDUdóxěaHraTSuzJE	TRUE
dbSkZcePNǔàOùjzóǒǎòXnLáaIéùarǔǒiaTagěělNhgVRóYxh	TRUE
gPPAAjtTAZfcèàBbaAYaoTFpZDàaMMFKzHHvrǒAsTWùaiòèf	TRUE
jùCqvùcnaBacJǒLmeaàsQóaQbǔbsnjYXnZWǔEHHèpYàrěqFx	TRUE
lUkOqCjCrWoOFùGlcxóoaaxeYhQampmùPapFyyogUiyfǎcxk	TRUE
oLUPIckqupùǒǔFmUNyDědpdQamgZykaàéCXǒWáaěaǎùFaoúǎ	TRUE
rFchFǒèdǔnzcóGǔjaaǔRáEEqpavnàǔPéyopórnaYikJpááAV	TRUE
uIsfbòiéùǎěvòLeǒXmWAztWLDrIcGNfDLaaoAHraPafBòǎbZ	TRUE
xRLYDxcpzbùgzgwMJònusxsmiaaVRnqkEnKoIHLLaǒaSDFgě	TRUE
ùAUcAFTHgisfsaSoCrǔcǔeUSOyypZOuZZǎnQLqmawáuaPóeT	FALSE
áaYrBUGETxkTRcSeNKikeixǎylǎáènzGavRuTDBTaéaDqPpě	FALSE
éGcaaxFbUcKXéZEéhKLCdpCNòpQlaVOlwARUeWùaéfUùnMFob	FALSE
ěywtJcèWSkaQrajěknYnàhZóBúxHnQxpGwéǔǎhRMViIǒcaIx	FALSE
ǒWYScódRèùGfZTiYdFaOEaXfmMSwùFWLKYwhkggJBěkHéaCT	FALSE
AzóacutaùNJIsǎblddmTrXvaxǔaedVIéěgǔǎBòPxúDTqeoLp	FALSE
EǔTzglwBkákcǒDlEeVqpaHaINsVWwáDISaLěWuǎyPPTKoAǒS	FALSE
GyLeǒiǎxCaǒaǎěcckHAaNbùlyQqMyDytaqsnǔaaěYzUǔdiěV	FALSE
JlrcqǔIqMajáoDòahjòZcKHauWúWWúzaxUǎXiQtǔseTnDOjR	FALSE
MlZIZmròùczǔǒvSòfKbaWuNaIpàfpYùùhxaVivqBfpUǒàuIk	FALSE
PUuoCFDdáqcXphójgIaaTFnnYéàFěkEHDokTOúPaqfNnIlOá	FALSE
SaeòcǎúxfYSYòhmKYùawWwaqBloéOpdSòúIaNJnJhaèěvRóMà	FALSE
VúészEJUrnhLscsmgaSvraǎáZaYlFěPIóyéòxòǎzyěMKAlTI	FALSE
XacZàdljQěByrǔǒMòUjěaaanUJyèlRCFAxúVIbYSòNwmVhhh	FALSE
aKitLěXUoMIcHaxNJORYdóiùnjHGRiaNyèDlZPxaUúHáNùǔG	FALSE
cǒaǒǒRayaXnPvozOáIáWlKéèuCDáFUóZbàepyaàtǎyMóUǔéw	FALSE
ccEǎUwGèpmhOUanáQoǒCúGcKèSBúǔaǒNǎDUdóxěaHraTSuzJE	FALSE
dbSkZwePNǔàOùjzóǒǎòXnLáaIéùarǔǒiaTagěělNhgVRóYxh	FALSE
gPPAAjtTAZfcèàBbaAYaoTFpZDàaMMFKzHHvrǒAbsTWùaiòèf	FALSE
jùCqvùcnaBacJǒLmeXàsQóaQbǔbsnjYXnZWǔEHHèpYàrěqFx	FALSE
lUkOqCjCrWoOFùGlcxóoaaxeYhQampmùPopFyyogUiyfǎcxk	FALSE
oLUPIckqupùǒǔFmUNyDědpdQamgZykacàéCXǒWáaěaǎùFaoúǎ	FALSE
rFchFǒèdǔnzcóGǔjaaǔRáEEqpavnàǔPéycpórnaYikJpááAV	FALSE
uIsfbòiéùǎěvòLeǒXmWAztWLDrIcGNfDLaaoAHráPafBòǎbZ	FALSE
xRLYDxcpzbùgzgwMJònusxsmiaaVRnqkEnKoIHLLakaSDFgě	FALSE
ùàsgyzùèǒhjUóCfkXcITatQNKǎèxYalaoěSuumaocNéuéDtwF	TRUE
áNOFVòfxjwVcaóyEqZósoHzlasxiFdwbaGTùétpAkpèktWaaǔ	TRUE
ǎqFJbáulècEétUGMǒěéYxaúùAxBaSúmwfTojgXaáǔBaHàjBSY	TRUE
ěeUQPòwfIàXazKVcPvqaGLaFaqaQlPùmsyóHPlCClMYrVtásh	TRUE
ǒidcǎúhanòXJUmamàTUtùxoxqzaBVǒMaxHSàCXàfvéAoorIBǒ	TRUE
BanVpXAMGcMFaJpqeLlDNsgEpVUGAúàaòmaEKaDwYLaòUWIàR	TRUE
EVSZtnJócawazLbsJZPXLǎaáFtAòúeehǔnweclOaRYoméPYaG	TRUE
HLáQclXúLaJǒgfàoaFMwargěWěLcYJaWèraUJWFKkiurcuGHV	TRUE
JuaGyNbZbYòoLCBEyvFAFbTúùbOYbBbǒiXǎZriyVLeyǒèYwlù	TRUE
McvsSIhaYyFXBLèPaòúGGSAsGqPoXCYěkchLQáMsaaUǔBRmdt	TRUE
PCOzmJPkhycWAaGLaóaDCaFxgTVhguZXéKǔiIBWHgRédǎySNá	TRUE
SNadOiZnúGCUvWǒhǒvpryacjOHiJaLLRIzIalxóqhaaqmibéq	TRUE
UkIáfaúsáǒdaPféYxZukzǎcwzaáAǔvtàaIaPVaeHùudfDbYQM	TRUE
XMǒVNèúàUvUZàájòQBUhNěécapaRVěqPpCazAOCoHaCLáwiWd	TRUE
aàvRgálcáaKakNǎclEǎpjrXxSXaKwaRHMrnQmdJěcdGryUáWt	TRUE
cDHFNqZJnǔǒqpwIkueǔMSAmvoèaaWwqoaùLPQIaJúFeKnNMmZ	TRUE
citSyjaoaNWsBèscbnXúùzrveáOXQěISRNXZjQCvcaaSxqùdZ	TRUE
enijSǒpGùDJqǒVáIERòJǎóNcděymSpgyaPvoFaóyUSúDaLaòǎ	TRUE
hérxěopJrcaafEwúkjfmNcUTximgMapǎarǔBàtrVlwjǎmJKiI	TRUE
kǒùGIětǔnRONjnCoùSBcjèarOarjlyvcfaaènoàAQfùhòVDtD	TRUE
mkJeBAòhgèlàxjBlRifiGTvsáFvnmcKLaěUyaZYlnNiaTaǎǒq	TRUE
pǎFjcRaǔatkVěoTkyaaVjeaXoFZúòkWlVrxeyWNanoCSHáólz	TRUE
rvCcTyóPliWugGButGèBMXèeúKòrJnqQěZxǎaUawnSufzaaqj	TRUE
uVWSDYùùúténKROECfczjaauwzOvòXougWkUvHfèfaaaǎjjAE	TRUE
wtàwHèěwǎYRiAhQcwDaazòVHgbsDgQǎjLVàPCfDkRuaèUrIta	TRUE
ùàsgyzùèǒhjUóCfkXcITatQNKǎèxYalaoěScuumaocNéuéDtwF	FALSE
áNOFVòfxjwVcaóyEqZósoHzlsxiFdwbaGTùétpAkpèktWaaǔ	FALSE
ǎqFJbáulècEétUGMǒěéYxaúùgAxBaSúmwfTojgXaáǔBaHàjBSY	FALSE
ěeUQPòwfIàXazKVcPvqaGLaFaqgaQlPùmsyóHPlCClMYrVtásh	FALSE
ǒidvǎúhanòXJUmamàTUtùxoxqzaBVǒMaxHSàCXàfvéAoorIBǒ	FALSE
BanVpXAMGcMFaJpqeLlDNsgEpVUGAúàaòmaEKahwYLaòUWIàR	FALSE
EVSZtnJócawazLbsJZPXLǎaáFtAòúeehǔnweclOYRYoméPYaG	FALSE
HLáQclXúLaJǒgfàoaFMwǒrgěWěLcYJaWèraUJWFKkiurcuGHV	FALSE
JuaGyNbZbYòoLCBEyvFAFbTúùbOYBBbǒiXǎZriyVLeyǒèYwlù	FALSE
McvsSIhSYyFXBLèPaòúGGSAsGqPoXCYěkchLQáMsaaUǔBRmdt	FALSE
PCOzmJPkhycWAaGLUóaDCaFxgTVhguZXéKǔiIBWHgRédǎySNá	FALSE
SNadOiZnúGCUvWǒhǒvpryacjOHiJaLLRIzIalxóqhòaqmibéq	FALSE
UkIáfaúsáǒdaPféYxZukzǎcwzLáAǔvtàaIaPVaeHùudfDbYQM	FALSE
XMǒVNèúàUvUZàájòQBUhNěécapaRVěqPpCǒzAOCoHaCLáwiWd	FALSE
aàvRgálcáPKakNǎclEǎpjrXxSXaKwaRHMrnQmdJěcdGryUáWt	FALSE
cDHFNqZJnǔǒqpwIkueǔMSAmvoèaaWwqoaùLPeIaJúFeKnNMmZ	FALSE
citSyjaoaNWsBèscbnXúùzrveáOXQěISRNXZjQCvcazSxqùdZ	FALSE
enijSǒpGùDJqǒVáIERòJǎóNcděymSpgyaPvoFaóyUSúDagLaòǎ	FALSE
hérxěopJrcAafEwúkjfmNcUTximgMapǎarǔBàtrVlwjǎmJKiI	FALSE
kǒùGIětǔnRONjnCoùSBcjèarOarjlyvcfhaènoàAQfùhòVDtD	FALSE
mkJeBAòhgèlàxjBlRifiGTvsáFvnmcKLaěgUyaZYlnNiaTaǎǒq	FALSE
pǎFjcRaǔatkVěoTkyanVjeaXoFZúòkWlVrxeyWNanoCSHáólz	FALSE
rvCcTyóPliWugGButGèBMXèeúKòrJnqQěZxǎaUawnSufzAaqj	FALSE
uVWSDYùùúténKROECfczjanuwzOvòXougWkUvHfèfaaaǎjjAE	FALSE
wtàwHèěwǎYRiAhQcwDaazòVHgbsDgQǎjLVàPCfDkRuaiUrIta	FALSE
ùǔuAeMscofWEúsjfarǔwqBǔavúcOLǎnAPEéulùXQmaaàKQòfra	TRUE
àǔqsFBcgROlHJǎodmwhHbǔàhOTaawújYhZgJjJeSNPCaaDqfRr	TRUE
éiWUqQrǒDúUXyfǔrcǔmFGenbcnǒěwnTuèaálMWaJòaCXtpaQǒM	TRUE
óǎcRaàwariscvpNUdaánUǒJvuKMèIPVadFeKǔǒǒLLDGcùbǎOèé	TRUE
ǒmMǒbPóVLLzzphYqOěNcKaQDBaNěiZLQaóaDpQhPIHépEhtehù	TRUE
BmyDtTtcaLCKaJGàùènKáùfKunzfkOLzfsBaHèaáCúZWǔZFóxQ	TRUE
ERTzwzQKscQKeuWaroXrXIakXreRxyTDHZVjóWòùsSězuXXaBa	TRUE
GtóLǎcUaqTǒLoSùQsavǔCULQóLxVDDéBáLAjcUǔaRCǒaTLZmǔN	TRUE
JcSteYaWYóvChPtDJěYDǒaTlěaIfpVPRiLùWhIèeaAXxIasVxL	TRUE
LfcrviazzadrLèHtLugièluóFjxXWnaaFtDizgJXRùJòéEèAǎk	TRUE
OóBpRzòcáEěaǔEBGoQNakyfEDVaZGopGJYClpNnóNLrmaěcBWl	TRUE
RàZBǎeBICSxjùávéwǒjchHTéHAMórxLkQefInFILaavjaariGé	TRUE
TURUcǔSBfjaksǒIAavaJóRaéǎtPQCPRòUUtEOvuELSUTaeǒZcb	TRUE
WURVoéQgcZXělyBGRdyxOóQGěUaECVaèItuaxèěGAMuoagHěMm	TRUE
ZáLàEúTvnPtWYecarKrvpHmQUóóaèpmmpòraOafnuaCcRàKègJ	TRUE
bzuYyObBecblbéǔowXHbQàábJbPZbsHiPHěAkiMUKpLgYhiTsá	TRUE
caNPsNHacJLaúKasRRBnnNúchéojfjUAKóvùióàLdIPkáéǎgwU	TRUE
denGcxOCxHlaPǎIFSDXóUaotsàTkhOgaòaqFHwLxWxIxXMBTóé	TRUE
gZVcFrwBrxcBhKFáhxùrTmǒWómjótoEtFǎaaòPwauDQODpoRǎa	TRUE
jScTvkkzfěaaUEòDGGRUGFéxǒjWZóBRsNWaXoùUQvǎaeúrUOǎd	TRUE
mNAVUócXáápcèaòwnVaFùùlàkinjúFaDésIalěydSsǔyúoZpjl	TRUE
póMXRbbiǒDAǔlJoxeǎJSGdkácèhEklaaytfùsóaǒlaUGFVbxxH	TRUE
rdRPéòMXdàúbCùǒUxcàBkqCwOOiXWRYBrězQeaasucbaaújWyp	TRUE
uZEùHiXGZcQLJuàkaoFéàaǎOFlTweùlaaPúZgrYGrLǔóMNWKky	TRUE
xQIfcciHaTyPEWIGěnahJIcquHvPDTMaElvLOagttqSFǒIGXPj	TRUE
ùǔuAeMscofWEúsjfarǔwqBǔavúcOLǎnAPEéulùXQmaeaàKQòfra	FALSE
àǔqsFBcgROlHJǎodmwhHbǔàhOTaawújYhZgJjJeSNPCaNDqfRr	FALSE
éiWUqQrǒDúUXyfǔrcǔmFGenbcnǒěwnTuèaálMWaJòadCXtpaQǒM	FALSE
óǎcRaàwariscvpNUdaánUǒJvuKMèIPVǔdFeKǔǒǒLLDGcùbǎOèé	FALSE
ǒmMǒbPóVLLzzphYqOěNcKaQDBUNěiZLQaóaDpQhPIHépEhtehù	FALSE
BmyDtTtcaLCKaJGàùènKáùfKunzfkOLzfsBaHèYáCúZWǔZFóxQ	FALSE
ERTzwzQKscQKeuWaroXrXIkXreRxyTDHZVjóWòùsSězuXXaBa	FALSE
GtóLǎcUaqTǒLoSùQsavǔCULQóLxVDDéBáLAjcUǔaRCbǒaTLZmǔN	FALSE
JcSteYaWYóvChPtDJěYDǒaTlěaIfpVPRiLùWhIèeaAXxfIasVxL	FALSE
LfcrviazzndrLèHtLugièluóFjxXWnaaFtDizgJXRùJòéEèAǎk	FALSE
OóBpRzòcáEěaǔEBGoQNakyfEDVaZGopGJYClpNnóNLrměcBWl	FALSE
RàZBǎeBICSxjùávéwǒjchHTéHAMórxLkQefInFILaavjLariGé	FALSE
TURUcǔSBfjaksǒIAHvaJóRaéǎtPQCPRòUUtEOvuELSUTaeǒZcb	FALSE
WURVoéQgcZXělyBGRdyxOóQGěUaECfVaèItuaxèěGAMuoagHěMm	FALSE
ZáLàEúTvnPtWYecErKrvpHmQUóóaèpmmpòraOafnuaCcRàKègJ	FALSE
bzuYyObBecbabéǔowXHbQàábJbPZbsHiPHěAkiMUKpLgYhiTsá	FALSE
caNPsNHgacJLaúKasRRBnnNúchéojfjUAKóvùióàLdIPkáéǎgwU	FALSE
denGcxOCxHlaPǎIFSDXóUMotsàTkhOgaòaqFHwLxWxIxXMBTóé	FALSE
gZVcFrwBrxcBhKFáhxùrTmǒWómjótoEtFǎaaòPwauDQODpcRǎa	FALSE
jScTvkkzfěaaUEòDGGRUGFéxǒjWZóBRsNWaXohUQvǎaeúrUOǎd	FALSE
mNAVUócXáápcèaòwnVdaFùùlàkinjúFaDésIalěydSsǔyúoZpjl	FALSE
póMXRbbiǒDAǔlJoxeǎJSGdkácèhEklaIytfùsóaǒlaUGFVbxxH	FALSE
rdRPéòMXdàúbCùǒUxcàBkqCwOOiXWRYBrězQeaasucbaSújWyp	FALSE
uZEùHiXGZcQLJuàkaoFéàaǎOFlTweùlaSPúZgrYGrLǔóMNWKky	FALSE
xQIfcciHacyPEWIGěnahJIcquHvPDTMaElvLOagttqSFǒIGXPj	FALSE
