ùùBpuòRIYPèCJěòàYúùpéExHZwLKIcè	FALSE
áWaNytsréazAjmàǔqCmòzúVTǒZùJUoK	FALSE
éáTPDyǎHèPkSYěwSlcJscbDùPémlIwó	FALSE
ělmZyYGjtěqECdéIxècisXxěúkxpsPa	FALSE
ǒAgIBizOàxxOòRǔKZtiogeKCTjWkbàe	FALSE
AiùQEXNwtréVwQMNCxgcéAdmRpěAxxn	FALSE
DGQmǎkǔRhǒópSyCYluCúèpyiQpidhkě	FALSE
FhDuéQnVQèbihEMVnJcpdPmDmDsUúUh	FALSE
IHRènlOCBcéqRedDUuLVZQmXcrONYsú	FALSE
KvcRCUNZSlHHqZwJzIǎkPYéRFzùPzIX	FALSE
NYzYNJGqsièLyéxOOéRZWFáaeDùdBHp	FALSE
PcfBTKqùHOúOvaúáezóHqQruxVSiBéó	FALSE
SCyfjOemSRSMhYkZqzWǎKuOSéHEòǔqD	FALSE
UvvJuUWIPlBIèROFǎRUóEázhǒrlMXiǔ	FALSE
XgDIpYkWzrcóLvVQLǒfxnpPgvqcDqsp	FALSE
ZokǒSHiDǎúèqNodTIKrgYwRǒùáHǔWFW	FALSE
cbvKlHVDjFóFǎeBPDtIHbQsDpúàPWmě	FALSE
fàKqósTbIPjOPǒzXXěkxqànAXdèTgéC	FALSE
hPOaUOFdsmXénhLlviùRzRáxúéfáEǎb	FALSE
kXLGěǔǔuCqMùěkIzGscTéamYBCJgDPf	FALSE
nBZǔKǎnUWèWǎúàwǒKgPBCjkǒèěwYDss	FALSE
pqAúOXmXSKkMǔZtJGpBahPRsǔuEǎUWè	FALSE
sVKVcdIBRLjyGeYǒKǒbxDààVnQItFQV	FALSE
ubéHAèyjòCQoGèaějxYóNwBjlKèVQǎm	FALSE
xàábCAtXxouRwurgaEtzCishóldtFtZ	FALSE
ùùlPQoěNVxDReqoáDIeeeEHUóSVmzéR	TRUE
álcaVòùasùbuzǎDobbbvMèǔAúóLqGbc	TRUE
éDóASěùnděǎNǔBoLddFpBHBdvfHǒnǎK	TRUE
ěVwérZMjzBjvccPHHycmBwcMRgáKùZN	TRUE
òydVCZwnVtoWHàòóQYZbbbbBgodTJsa	TRUE
AaLéaNèEMNězLavSTóvVIXuaéxLIMHZ	TRUE
DZǎzUěaaQIéZOEǎJGEZvzaaùèjrwNrD	TRUE
GcPǎzxZKǒúnscmUcHMxcěǒùXròaTpùH	TRUE
JJnúFoAǒòhfZéaUěYtǔCMFǒUWoaPaaj	TRUE
LlfTAUwYHqfdquYIùXCNsddzdcBSóNǔ	TRUE
OGùraZúfoMuaàzéaOǔGaIolQUHamáǒs	TRUE
RǎǎǔùbxRbbSSéébICáǒSgNSFnèSqplv	TRUE
UKvTuanbqàtéǒmfXAQORZffYSWǔúfzé	TRUE
XěfòoNáfXúúVpGffóYddMJǎèLnVVLue	TRUE
ZkdpdZpXmàòǎwádǎóndBUxùMYQehvWà	TRUE
bXǎǔZvǒVBNóJápCPbbubiHtaJáqiOGU	TRUE
dBWAdHdFodrènyZKSuAùWǎkVmGKuvóc	TRUE
eyǔWzmàzǔOcRwPffáLvFYNtfsNuwJfU	TRUE
hǎCeveeǔeLòLǎTPITFPUhúQàdXǎKNòO	TRUE
jUelZésFwwqPWJòeuoZoùewǔtSáToBe	TRUE
mRGhyMScòwlCcǎòGccRzváJTYRQAózH	TRUE
pJzsPiVaVVDWǔóVloYǒpazYWaǒaòXbǎ	TRUE
rZéVfǎiěyóvǔOvéNdqdBddCǔgtǎMhKf	TRUE
uGxàErYúAǒxSrbYIGaBaMYaèòlǔpaǔL	TRUE
xLPDmǎuhJncrǒscYrYFUcwWsóDcQwon	TRUE
ùùGDòXMjSqPèFSèWabaZJóyooaddtPYF	FALSE
áWroáràéNxEànFùyeǎèeyVzAUùNrPAǎQ	FALSE
ǎyeàYLlVHécǎOwXAYèOpMsPJGágRfPry	FALSE
ějOFòòǒDvǒwhláXexWdjXzǒKjèwǔSHKé	FALSE
ǒGuyXHcbxúJFxpělfHSOéljXtpORúFID	FALSE
AhTUhChiùCjejGèbiqdJLRúrJRAcdQǒk	FALSE
DóòàéIrGǒlARJJjTúIOJOFléúGzBěPbs	FALSE
FHOiZhnAFFOFéLNòdàWRrQUdJKWǔUutǎ	FALSE
HpúOgCéáMORMNqPbnYAVúXsKVdMGdaǎě	FALSE
KKCiAǔEQèjSrmMYyWáEMkànhfSdBntǎé	FALSE
NǔqrKúfwUcxeqsǒJdqjǒeúHEiTzònàèè	FALSE
PdrRSADvoMODTqmédVUéBLHgRěOGmlHn	FALSE
RyXěyCBMybMhWrsáéeòVetLTVIEgàXvV	FALSE
VFówMplǔwǔeKdEbbtfijYVAhoziiǎGwó	FALSE
XXaDYfvúdXuOJDuoVǒRFlHFmúnTéàkcù	FALSE
aALEzNáRàTsQEmavMSKVDǒTTáàlùcTYT	FALSE
ctHijèǎHǒùaixaqdeESCIgsLPgveovUz	FALSE
fòmHězfzǔEKDgBQCuèOqQKisǔòbèǔaKǔ	FALSE
iùwcLàeMAOyKZHHYpùéYǒǔgNQFiáJwYb	FALSE
lěfkzZFǒgbáXhkǎOéiàIggUqǔfGsJVǔi	FALSE
nCuVlBRKězifǒvtTWǒwVǒǒǔTéZbZTbsè	FALSE
qAAòWeógbVAúnúǔǒbmzOǔfiFòIbǔWYlR	FALSE
smHhKBLIǔpxéXǒǎAmVpóEfyHitvibpòY	FALSE
vFzǎTSKvyTQWQhgarycúwnòYěTNvsèùá	FALSE
xfhǎKúHóMHgUmYMkDtxTRPtóBuoǒzǔoa	FALSE
ùùjsIkjyFfǔbWùyùnttYbtbǔoKbkMǒLd	TRUE
áVPVěfAéRZPacwYMelYázHHevuerxebc	TRUE
éǎyTóèěúátSweHKNóAcWclKzòBòIcOcc	TRUE
ěcSYlBsHcvBàcDEáuKxcOqxSlykxQPuǔ	TRUE
ǒeéEgWXàKǎNiCOxDfftfVvWDZmTYWfMV	TRUE
BcFcápMUǎGVùGàécvCNcsFáhiZMHVùǒV	TRUE
EOáthxTeATàeWFRèlelHTefuyrěGGhoo	TRUE
GdxIdBǒdtédjUbyfCDfCEtǎiAǒatqpuz	TRUE
JǒǔxěgDqmcWěoUcywcpùǒGFcqeqDNZad	TRUE
MěZVěIYhazaùwRlùIqyòùazùarSoeYVò	TRUE
OKIPéDcznZXexZUEóeOǎeèGeòGKTLCjǒ	TRUE
RFdFcàRxYSCVccoRtuVàytǔclOyěWpan	TRUE
UǔǎFmOyDffUHmtATyFfflàiCaaYyXúaw	TRUE
WcxbèbGJGǔódèdèpdGYdXDóbJNHsfESY	TRUE
ZSXuVàěWGSGJòǎMlPuèUdǔuKSAddWéZd	TRUE
bLEOaUěǒPpèLasáǔwqǔNsTóOLénawapR	TRUE
cyRúTDMvntCZVPéóbffWyGlnofàYTqǎf	TRUE
ejsYiebrDSayyXiouBiSfHQǔYǔHHfKff	TRUE
gTUmCuyěeáùfBzfófǎéxofèkàszóaúzù	TRUE
jcinéoqTWRzFRóERtàAAZaaypěaamOUy	TRUE
lzeNgbLddmnTDmdydaGqzGàádepmRxòU	TRUE
oqxáěMúGuYQZGyhěExxfbábbvbYgDMPj	TRUE
rKCbqCugǔLfAfǒYfuyIzfnrápèèSǎeaE	TRUE
uàědwaXYvEaYòBUnaalvIdCiópgéFEkY	TRUE
wtóipfdortlBzMèsòKOóAndmèKddxUěù	TRUE
ùǔmOUEwRdsjúCxSYrJbgùJMtucZòzKwzǔ	FALSE
áDTgbZcpébYǒmhtXsUǒxémjgWóCzDYáVK	FALSE
éúJXizIEZkóKGúGùGtàwóèRBoUonSZgǎh	FALSE
ěkNhbJZPérVKbóùQeQSLǎévrUqTǒHújFp	FALSE
ǒMWěmvZkkàévcAéNngyǎxuBvTKbhyUBhǎ	FALSE
BEsbrkteSxMGOhásHVwjTàzlauLAtqmzn	FALSE
EǒxOzzdBelódNNKPnáaiOúbjWbèmovrSv	FALSE
GfPMPaaTzénègQZtvDniuyjQEnoǒHXtHG	FALSE
JHèGàurělIDólQǎCGPvmNDMqòUQtucèuú	FALSE
MǔwUvfèěGauLMrzqcláxùKóGQbBqJfizo	FALSE
OMZLccthPEAakupvqxVSKsGxěSyxuáPZL	FALSE
QxtotRlhGLOèhToKdXcEtfEemhAJJFFǎP	FALSE
TNimùIòyGtdOǔNótAzólSJésyèfvypEpf	FALSE
VlvǔgWPIùgúKHHOjUpclqèadúǒgQěàKhù	FALSE
YYZeKJEráúIòqěúúBùǒǎSoTFóQlpqteěu	FALSE
bHzrHChrDóèpěéǒlòiTSGEtxXLeDAoǔwF	FALSE
dtYBxpDbáfAdlǒaLQěQucùmdIDJěOGiWú	FALSE
gdlǒècNuèsXQYgVòNBKSIzzFxépoOEǒGr	FALSE
jùLaCoasJvùEFkvěeTUfEHjàǔǒDǒKxBWk	FALSE
lannOlegNòúbtZfphNylxcunAGóGěgxLV	FALSE
oàǒfePBesTDJcàdKslHòHgYXbyvCCoCCX	FALSE
qGéduVZwTqWHǎVDRúBhVùtveáWagLjHKj	FALSE
scWXegmqóHzsaéùMhGzzCGsDTrrhǎrUDP	FALSE
uzcqOJHwǒEMurásémwbVǒapéBBXudZáěE	FALSE
xaKVIeBǎiQersùXúQbBNvéRNóguxrGmit	FALSE
ùǔEǎUBáféAIIfZWǔqǔLèfXfǎeELRnějǒA	TRUE
ákudǎGUsTǔBGeetXwàMeYeúmSqjugIDAx	TRUE
émUieIbóòGUVDǒxFǎTJrUAóbHǒuùbvébB	TRUE
óXCLcXQUónàlLòpUNOHBydZdxdxvdULpa	TRUE
ǒkNwjENYHodeLěUvBaWRaaaxAféRlàElò	TRUE
BpbbóJVDbmbnAnǎoavumyfdOeyqcyXRQF	TRUE
EdPbbEbRàěóIFmólbUGHFěùěLwkǒLòTAd	TRUE
HZPkèfdGddùdlYxIaéTpèfzaáhzLgáǎuc	TRUE
KPqěfèFeúzyRǎZáUeeeúDZjYSeRóǎhNdA	TRUE
NDèRTRXǒógzbǒWbpVbbEàmKdDěNYZVvòǔ	TRUE
PeEnReǎluwFxOteqelgóiǔAdùNzúbéblM	TRUE
SúqǎVbbOtpXbùbGúaYéHVEDSaXkpoSóiK	TRUE
UrsYFhybRhYEǎtvdRèddXvúdCwFuzúáxǔ	TRUE
XcǒtrucXěWSǒěcúpùlroScaIQkIuěeHdS	TRUE
ZwWqMeéácèvRODccDtJoBcvSkcEnshǎon	TRUE
beJwYrWǒOGOUvPEbIdáHdSdUdAǔVUixǒx	TRUE
dPyxxúùLdndQrěXqHdàftJFóxTALhxvoù	TRUE
fěEFǔSfUXTnDǒURKMtéBBòwóZxofóMféS	TRUE
hUHkXmOfeTCúJùDeYtJvrSPXetGSeCkQǔ	TRUE
kGbbbàáyùNsMZNXWbèMnnAǎOhóAWPǒrBy	TRUE
myUTnyoraIaaǒěacèOǒJHBúRvkIzmFáEl	TRUE
pfóFnrtYàgEbYnéěbtbsyPKbIJěnǔSUJw	TRUE
sJfóGmágévběPxǒAógeBsǔoFQrZenoNee	TRUE
vNAOpLdòméXDovděqàldéNwJdGQógBCrW	TRUE
xdùǔTNǎaSPiaWewncNfGfzpCǎnfYufóMi	TRUE
ùùùèMúyLúUqOánWiùqZYatpùiGuGoWǔiXp	FALSE
áWǒWǔvjOVPrTyOòǎwěǒKPVYFcěVpckmóEP	FALSE
éǎyòSémWzmXòéEBjAEOmWLUèTfpQNWmóQz	FALSE
ětDoeMiàjuQVJKAàéfPByǒluOnIFOwjyNv	FALSE
ǒeHCCrsúDvAùUóNabòYěǒèàdsǔCòuyLkGB	FALSE
BhèéuQSòeUdáoPLHUwLYIZòbqòPnqYhYBú	FALSE
EIùJǎTòTZzLòxImUSGhtǒEdUKzobmBPuLL	FALSE
GngPkǎIVMZFUzùyǔǔuzMKěMéJùUlWzùèwf	FALSE
JaúòqoOZécrsXUTjiǎIěááiutUmVGDeWěD	FALSE
LmHivJpèWqSěéùfRpZaSóJMNNWNSèygWXf	FALSE
OòdWGéCBèMXěPǎkhAtXUggPHaqslTaǒúAF	FALSE
QssVóùXùSULATànfZQápaòsNDkKVdwBPǒA	FALSE
TfGvxruEèGSwryúGSUMeYDqRvoèFGWiDèù	FALSE
WáǒIEXǔpxStOòUtdyqaSzXEcUuEbtSGsQG	FALSE
YSgoAuRbPWAsayEvFénǔDùRéwáSHGIéDòT	FALSE
axǔFuBmúǎàsàáBěustDòMSǒǎǔbàúyEuǒQě	FALSE
dSǎxrTnBoKZnNóZSlYqzYútPGbPèpuiǔTC	FALSE
gépyàJààUVRwWùahCFegóǔèAPiúoudUaèk	FALSE
ibnǔhOBeqqiOmdácYJDFiVkWòfpwqfLOwT	FALSE
lǔuPGtàǔQQèějOQdNqèǔNCègyukvǔPjBúl	FALSE
nYaepèNjuǒysQNDPeWRmfèwkIhMùajruxy	FALSE
pxhqbbEkuéDXnXZqCAábaǔǒǔieIqiTlùhi	FALSE
sZbuQuGDOubAiòIEeùqyUAqnsSǔHgQvdkj	FALSE
vèTRKvWcncJjXěEhǒIwóéQéCTexBECòúAk	FALSE
xVIvnnRTjKocurHTJZǎhùtmcxMéápiElos	FALSE
ùàPbKPKGZXFcùrbAJòoDébuuUbópàHbhbC	TRUE
àóǒYLuEaaHBwèRúMlGUAmyèsroùSaqvaIe	TRUE
évBzzbmAtgǔpxafufRpfpENJfeDqwQòBCJ	TRUE
ócěPvpémMvttEwécWKHOSZcyJtScòěáMqě	TRUE
úCEeaVònSòXéaVaQúItVpaèDàDóǎMZTbuh	TRUE
BonuJgpRsǔsǒZXúsyFJOxhfWVrffWuPoAf	TRUE
EHèJaVcqúJctLGrCáěcmwZǔcúyBvIzAAGa	TRUE
GpgXDéxWaǔlnwxAcQlUfSJWEfvlzHrffót	TRUE
JXWjbàxWiIáDgǔetMNěYuqNóFZeDreeFEv	TRUE
MókúMdyáFMTrddAtyùdobCOéQHEekùjCXǔ	TRUE
OekǎazǔQMauéoǒalamxQSQTJkqYwmǎrJkó	TRUE
RLXoYáǔyNKùiRFWěùofèQzcǎcRRVGYcnsc	TRUE
TeǒVeereXXěùNbYXBàHVkKJáeYZikuéLDc	TRUE
VyùeùddNdxdqnSújnwmLtIFINlǒJtOtHYy	TRUE
ZémXèRóJxUltGXbbdFuvdwdMFCUdpbnvpZ	TRUE
bKǔhTcOzòQOqtdSeóAéKneyáeekUlaFaci	TRUE
dèWeèfDǎfVufěěqfóěFmmkYPoarèRvALPs	TRUE
eaWkHMaLEWuvéBSóKaaNJYèPRóNrZaeFéN	TRUE
gMiddúùqOódsYQvmǔHmIdFOPélBGngáZdǒ	TRUE
jáfEJIawuUguMvKwHěXbWùwuIbèpGbǎbIB	TRUE
lycBòEéǎlMròcùǒúJTěBccàMUGZtxGòdLG	TRUE
péǎCǎBǔraLKFTèúUǔMnǒaaaDqtpYǔylmTF	TRUE
rqàXLIsóMdSǒRQyFdINZKuTJdPtqFuRIds	TRUE
uvjYiclmzúJocqcCGckuthLTYǒǒXYSjiwl	TRUE
xúfpxyǎHkRPURMpYKbCnvbPsoHǒWIGNbbó	TRUE
ùùyzTxùjoMcKǒkùèilWBWOBǎǎeóxZbkRjyO	FALSE
átězǎYXcRboùGmèjVlùJFSǒXJqJTěbukLǔO	FALSE
éKjDKǔxVxqsuThùBAHNwkWbxfLéèǔqbBVqù	FALSE
ěmmOIMFuCuMEGEKxkùYWYGmǎùǒBVnGcjpca	FALSE
ǒCAzmPKvrdùLgqpSUzuróOvOùúHkkXwFhWG	FALSE
AhjkkBYǔmeGFrVqraǒUTZuWdByrLIsFàáóA	FALSE
DEjáTluWmssóěvéxòYIMYcRǒWhsxòúuWèny	FALSE
GAIxwlHlaLYZèéóXyDcPáLóhétQěǔEDáǎML	FALSE
IfXQǔYWAMáólXbfómàLzIRXBdmUtNJNrJYJ	FALSE
LXUààUjUSTdYUjVPWryyàciAIuCJlsBqMMv	FALSE
OLApéfHàYúpFéLPUaSKáYyTzjUbdMllDèDE	FALSE
QelMxbOZOcwmLǎRDehwNINqTǎǎnSwokCéna	FALSE
TSspfNqQnPNCEcáǒbNàbJZwpéFuiblkpjsQ	FALSE
VcaZHoGIúLyVTóTRqpIǎQvEBYóGáwcigusB	FALSE
YBrTJgvRqójqmMbtSDkIěǔveKoǔMYqnúQSú	FALSE
acPHIDrófàsYáunAhóULiǒlUySdǒKUFǎKSI	FALSE
dúfǒTwnAXěàFáTDejKyàǔQázDRonóòeóROǒ	FALSE
fksàTbCouLBáSkYěǔábAFǔnNAiéTNGfòFgj	FALSE
ilPSqkújèyPckITxnjzUgoóqòdeǔHTNAYIP	FALSE
lǒbWgzQlZzǎeifVuxpCEeèTMGIàcfsaěóOQ	FALSE
nsWyneǔConbDWAkpqppgibWNIfyULhěwtIǔ	FALSE
qUIHfáONLcNBánDhYvALVMyyymǎùěòeěkFR	FALSE
shxHósJrhKRIqXfBAǔvkEHaYǒiéfZévDéXC	FALSE
vǒwUdXòacjDbǒLMewQPeǒyUoGXKiSGpwKsú	FALSE
xUyóěZSXEGRekBeugùRzEónòCDDYkTEièPa	FALSE
ùùhzPrnbóXòéstxRémpijǔkaatUaaeézZYz	TRUE
àSrǔpJtògltVácWbYbyǔrěGnIvSbIHyTnbI	TRUE
èéZNcdydxLCIdLBYdǔFRBxěěǒGǔIúDEBZYf	TRUE
òòApPfTaaǒàZulaǒFaSYsPYYǒXEaNrMMásd	TRUE
úfǒáJfnùZUòǎlpwNfáovnYóoEfdwoSHXWSn	TRUE
CXhKILdJOqLdBADlùlqǎQwdIúpsdmGàVpǎz	TRUE
FHwBGòJqgiTfOucaHzùROeTeRIWwxeQyveq	TRUE
HnósrcrrSDCXyRǒruàVbDLnbKǎbǎéóóéspb	TRUE
KúpBgLRQefIZhmóOldKddGNséZlèPUdiOěR	TRUE
MYDfATgmmùpàiYnpHaaCZWApraéaFYòièMg	TRUE
PòfwdSǔQèDydòvMCVtJWòdOESróxuLYděww	TRUE
RcEcúTcsàHróUQcxrzqúájBzǎdpIinǔrTUx	TRUE
UǒHHcEzKBKOIvFǎYaóǔwǔnalTaùTòùJNaDI	TRUE
XEuěhZHùSútkSkóǒbcZpcéLcciěhiONrwBd	TRUE
ZeHáJJeLDKtcsàbrBbZbòJbéSfVobNàxàúb	TRUE
bMzLǎoEèbbbmCdMFéuzJmnZBCǎùKzòVRfem	TRUE
czAYeóQWoiZpLdKóaWvúELaVazaèǎFCoqhm	TRUE
efbaaQaólánsmRCǒǎǔpaYyqDIDǎxOclàMOǒ	TRUE
gnòAdZpkDcezsWxWyeLpySàeePóZyTrěXgq	TRUE
jbAtaeTǎGǔeVIWeěépYRejvGǎǔWùamkàFTf	TRUE
mRVbbǎfqHérEDfyOàLUfFáISfHNCOmááPóǒ	TRUE
pBuBHJgdQCpVéFLzeéWǒǔeeDewMmueHúiRE	TRUE
sBblbDbQXFbPòOhulLEsWtbmGbùkRIAFGMR	TRUE
uqTwMKiNreěLòoèSěǎEneHZMeeWwLRNIǔkA	TRUE
xTnFIúàGbǒnECéMbCbvǔbJIǎIiflǔOEbóYw	TRUE
ùàòáfkZVRaIaǒPavsyqIǔùóáSEVmPvoKvIRU	FALSE
áJùIKLtDqZDuqTuJzvúěhFvUHvVCěyNATkúz	FALSE
ǎwHUyǎaZmyJxBQěgJzUkEEmAPOǔxkeDòqhǒD	FALSE
ěAvòFwòYLUoBóàxcúVppùQJadǔpgRYǔGBfxc	FALSE
òOyOHiIcèZkóiNeNgLiapZLǒKmgùkVPpFvKw	FALSE
ADùjWJDDqtosRqAZjòoúfrIiújSzrOoNfosá	FALSE
DHoùLQvanéRùgRUXDéKLYBFkLnǎToǔRVrYLV	FALSE
GǒfaOèUPFKxóMeàhfFàpěGóOphYjfǔehAèAh	FALSE
IsBágUpCDǎyrǒnWKRGsIOvaNSPotKcDIskfù	FALSE
LjOgbmKAuCYmYmajLJpaOùiQagojùóhlhKdG	FALSE
OIBUHpmgSáDwùRdKǒYRVòqǎNMBtYjJpiUuád	FALSE
QgjDuUIcnnLuycAspXùJspDHrWUtèsZAVnHt	FALSE
TCJpYsměVWáCJáCiPQdPúǔàiǒayúǔǎDDàEwé	FALSE
VaúMPGZjjLuRdefùLèRèkiIoicùBèàKwcaEs	FALSE
XWlbèGEnmyphèéǎfccVRSYùgKSleQěZdEnhR	FALSE
aMlhPensoZJdwTKYnCnumCTaěWcayJǎúsqzù	FALSE
dèXúDMICHúbHǎTuaGòtrSZKAKIKuehJséWDN	FALSE
fXzrEbPNUSUGúváMRDRJVQxxgbSVúHamMjns	FALSE
iéMfgwǎSqeooDjpǎpmáóéHCVxvjáYèJéàPùò	FALSE
kSrqǎjiǔkWǔNhúcěùwěedèJHàbeyZyròǎǒtp	FALSE
mxwbpblHrXApLBpòOsédZntSúHáZCèLKpèbú	FALSE
pHgIiuzáKǔòHásJlǒWsqomfHbNnNǔMlsXòaw	FALSE
sèàhDbLRvuPyrZéTpkJfóaǒRileúxDǎidRlH	FALSE
uakIǔYǒmǒqTtYzDCùǔàusǔnHHAIěbkVLúNfà	FALSE
xLOWàǎdMǒèěFǎnáQRXOLTQylEsǎrǔyjBǔSbà	FALSE
ùáoZzCpaǎpVKOcyoZsǎVXYAfěrVfnfWUfCǒW	TRUE
álgǔǔptmèvhPybMbFéUQèbéèbuBaEzAFKjòN	TRUE
éeǒeóǒQBzRGZUúWeóLeǎpIKOUQJulZkzbǔZY	TRUE
óJzóaáěFHndqmǎěěwFJzèlcMoéGIcDccaBRi	TRUE
úLéHZpIUjeyJZRédRdFoBEùZǒdSdǔEuBWQUh	TRUE
BhRYQuéJUfǒvffTfRpSDòXwyqǔrxkgèazPls	TRUE
EbeéOTffoKGátòIURáSVEráqAmYǒfěAfqFLu	TRUE
HáadùRUWudOtxlHdòáVMTdóFcQGRwHPxSxǒO	TRUE
JttYiěUàADǔytvuwVjELdIFwòYLLdwdrdèsé	TRUE
MUaaCVTvlaqQEOQěGRMaNǒuèiioóTSSUmfKz	TRUE
PCLJkUèVGcxàCBéhbRDpVzKbMltòsNtrbbtù	TRUE
RkLǎUbBHàbbEPQEbErkCqǒmúóASYǒěwFězáB	TRUE
UVNfddDDFqdKCwBlvdǎYXIeáúbCJúwèHmVRc	TRUE
XǔLbZKóBoenháCzQyrJJtMUnbèeEsxJeeAez	TRUE
ZddMIFODmLHǎzǒáǔDQwOrdzEdXhDJOVǒǔrbt	TRUE
bTXòbNFávYGěFZǎEFLBLGlsqèbbNCòBQGzéù	TRUE
dRMzsélHbddRǒáóNǔzJzqàduNOTdZòJrùMPx	TRUE
fNCikzWdKjnúbDTIRMèǎMbyHoùbubLfàiéYi	TRUE
hFbótBNsmǎKBbáLryRbrUbhtOuòSfoTElJsě	TRUE
jqěRwNkOúófprnjsfacuNAUqcQccrPBěkYVh	TRUE
mCoáànDbbbvmzZFáLJRbVyùXěyùgmàCRéGrl	TRUE
púaaLaèIpPNáabrjvjVǔVlSněyuOOaóàǎUhQ	TRUE
rxGàglDCmWZOAadONdPKTIvZàáDdHédQYEGY	TRUE
udIhPUMjrXEKazaNaaěmeFPBàSqAQKYFEágA	TRUE
xMQkǒaawrUzaaNVrYǎDyFGeáǒVnlJZèSLǎYá	TRUE
ùǔYhIklǎOJbykIFDcKYáwǒqtnNtěpKDǒoLvúǎ	FALSE
áNFMzAkaXǔéWLvxvSMbwsiicèoipzwjèwáLjS	FALSE
éBǔYQORhOblsJwzteIóléDmǔNHféFLúǔDSěúP	FALSE
ěwéèZOèOMCnCLRJWerGnHúǎvUQZkNEvyLWEQD	FALSE
ǒpgwwlyàcayaógǎVyUàIoPMWpèáǒfbwEvuwwm	FALSE
BRFhlVézPilóeXYjgLxxfcgRQXIAqáúùFPzJǎ	FALSE
EMjǔoútAààáMgéùcABéIeQFaHkUPèfQbMàOWK	FALSE
GKIuqzKǔUàadedàJarlSǒLzAtqfKpVNsèiònw	FALSE
IaùCèpCJuwNoùkgjzòǒBoúǎòéèTěǔjkyNkúúà	FALSE
LYùMNMéeqBfQúJxDnIFǒàěǔSpszáFzUgàEIhH	FALSE
OLUfxòehúASNGtNtmxGwfxQxéYúiděávhgáóL	FALSE
QciwFIakIàCvoúòpJógójiQJGxdrvǎaZǒWZuǔ	FALSE
TEtzòwXkfezùhGBděEiiXfpfWAvWvébNàaguj	FALSE
VZkAPèfáeOQRBèěNXqzeGóúèmdFPDzpcúǎòZV	FALSE
XuAmǎbLbJLHgBOUmtkyeùdMcUFWLZVvwlCHáD	FALSE
aKYmIvFPnCPohBWucIgUtSǒětyěVǒtQàPàǎqw	FALSE
dHWmSáúbYfAMèpJvPǒYěszLNqǒkUKèZáDòpfK	FALSE
fXxdgxJWwcOWkǔWzcYAěmYdoOqhSjǎǒJKCFmj	FALSE
iùPǔmmypcnNgiOPmGájéLCATáasǒedqèúxzèi	FALSE
jxMYRQINrPǒZYZfNrKeùLzóéJfàógHcmICRàa	FALSE
múèTJúQcDazdèBVJumgJbbùvCqzǔùzrWNwgèě	FALSE
ovKkJGǒeùkunbxòjGAvNBejEdklCzQǎéMùéùt	FALSE
rVUèINflouyǔMKBlJpúérDméuoLàCUcRGGiyn	FALSE
uOCCxùUYXdmJuMYǒtFfPLWGiwwóTpáQǔTúSèK	FALSE
xGOúQǔPJgwwhxfwJAkcZFxǎvxEDódSúNbqdzá	FALSE
ùùzrDfMóùòófǔfIVfJcDrvbGKrǎFnyiEsahkT	TRUE
àǎRáyhddpGFdWǎvdòDòjJǒhCǔAIáEkWzúgdQù	TRUE
èKdádsJnóéědrzdiěUYjkjVmisDòkfucYmPMè	TRUE
ótòěPtnMdsKòHèCdMúRdǎáZwdUxiPNHcòsqQU	TRUE
úvRěAlǒáòóǔqtuHměbSéMǔZxvrVèbYùwúbzbú	TRUE
CXYnèdèGdèIKCPtdKCdúxwnQfúscslLǒRoUvO	TRUE
FYDcqOXùuěxGòǎúcǒòBcFGLRBvcuenjMoloǔv	TRUE
HxòsjǎCusgòbǎstCfZFhBovaaéDxaDaèvěbLh	TRUE
KSUwàelNǒQGJǒSRéJeETSeǎeǒIVěBwndnOwJe	TRUE
NǎqWKXBZqiWmóDXMYYyàbpXǒbTnbTNBbCúkMY	TRUE
PYeOHJSGQCptUeeJuegDExfMàpjféNxpWhSSǎ	TRUE
SǎNjymDǔátjQéMoHkKǎscigQUPyddmddǔTaSǔ	TRUE
UISfděǒiXLGkrNwnyfǒéeòMAááeeVekOeJJKò	TRUE
WufZfGQftRùòRzTZpyǎZmfàQyFèqWVZùLúǎTC	TRUE
ZIKusEWzaLaǒTsYàCaùYùyJaàiZGlVOPTàttè	TRUE
bMobvCǒFMBbbxYutXyqDpOsyaRCáYqEhGzǒLf	TRUE
dòédSùCGǔrSùLZóULòúNùǒHódYěHdPteUòBQE	TRUE
fàǎfòòfUrJfuuhOàòòùpPYjECiěǔvèyGTǎpóe	TRUE
hNòMxJOěMùFDDeGReeLeiNGǔNWcfIfòèǔyoùǎ	TRUE
kǎmYzǔPòJóRǒZPcQPéFUǔAuvǔcàuqlnécáscǔ	TRUE
mgqycéSpèrtbEJrlsWbVwwFòwábrUzǔáZàpba	TRUE
pVǎGěWZmabbWznbHSuVTèNbǎúRúYzǔJuiJàúO	TRUE
sUBczYcTtcNIckiBEpaQiCEjBéqkújysùSCgL	TRUE
vǔVáyùùèIaèneěpOeEXMuQXyeEóBHeuDtSpěZ	TRUE
xTazMSdYMLZóZJvKrxàztmwáYdděqWúdxoéoC	TRUE
ùázxfbIZYóVTykUouIufpPIèCqPJgPptQzVJjP	FALSE
ázùhcdùvěAwoBSdgCQHHGJdepsOTCeInHěgJǎR	FALSE
éWmBeyKHgwBucràcóBlqRAfrgpZxnáoxevUèAǔ	FALSE
óóDweanRwcTǔfaKKMKyELáPLbQazùHQSǒhZòvn	FALSE
ǒeǒúHěoèIPuǒěBmvǔEázálHDUSbZRVMKmyPPjP	FALSE
BéMǎWFókSHHǔHhOòBǔGùIHdqEwFàòTuNnFtnsá	FALSE
DJuEiKùDORTxMhbMúnkMJògěXǔKVéyUMIDXyàA	FALSE
FwWLekáǎàùCMBòdǔhrúkmèZltòljPulGVFiSěY	FALSE
IcàveǎDnMuóXLoTxEáMjááKBTFmByIKKwpǎufù	FALSE
LáXàXuNěEghéàǎOMàúiJóZEOyePúPEYnPthùkU	FALSE
NǎòCSskTwRxyèKRDXNxFqùóǔhBXRéfLeDápSpM	FALSE
PWpèùtukIeDuǔǎQVǎhpBOLeoKVdgGvJPWEróAù	FALSE
RjFwIwWpzePzěBòěódukTeéClMZgYPǒDALmLdO	FALSE
TwóWIjlrFfDòUbzgdBdXArHèuèNXujfVvèpnCv	FALSE
WUcuFǎbǔMciǔJZeHPJMhFsnTABmOKfàIEEOESǒ	FALSE
YvlimoxAOzLucǒcZWzuUrEIúoXwvGGxxMaPvdk	FALSE
biZMVaèǎěǔpEúHcèpjWpHPràǒoqnúLkGLyAěNá	FALSE
eDàúzobèodfCùòěǎEzLHhUZkúZKGlOErúǔáùAy	FALSE
grǒoRNèràaVúòeLTáQtWwnDoroJPPYváUrsFGh	FALSE
jExmFNxùtAezOǒětVCgzNyAzCWsǒJecquùvEHM	FALSE
lYcrèMUòéYkNLqBgQWnfQcxòOJWVúcUKòcsjcd	FALSE
oYplBcqTùoEPIǔZbAPpoRdQmieuèwOJhiUNdbg	FALSE
rònòihKAMFHblówYvpJěFàHKǔefòMHnǎPécXHN	FALSE
uICAzqòkǒFěQTSYéZvaQBěBlùáWRRmXzBfmQwf	FALSE
wzXOaěyáaEgGCePluúzEdVHoZaRAWěYxúvNTǔK	FALSE
ùágaKéeeùIPNpúǒòBoeMOtpeUhCUěcpxèNǒChk	TRUE
áItèrǔLszWRǎKNèmdqDdddYskeNzlǒOǔWviúPt	TRUE
éùXBYGwBYPǒcTOzNcIVycSRcaòOoCetAádqnlz	TRUE
ěyPumvwhIxzaFjEEOvbytáTDqJbZZTuxKbKbNa	TRUE
ǒWMòáDBaNfCrfCLQfúfXrápósraMeéGhePàbia	TRUE
BeánADǔbQMRbAbúopubǔJxAXJubAóstRflWKpR	TRUE
EZvlrGMoóRùAzùhtImóiZvhPknfúfvǒqqqfOfZ	TRUE
HCmxeǎImóQnrndlhèàHdEdZdwMvVǒXoZPrdHQv	TRUE
KófBowoqNǒhwFúaaWanBagRraàèpAyqpIABvVw	TRUE
NbLěáKnXUqěaóóáèVúUXaaUGQaǎlqPjcúěEPBj	TRUE
QMximZAvéaNrAMLRuaaVZyrExNpxétaIgXǔIlA	TRUE
TIáaDwgbfelědBòuóSbuóbzqnYěAPbbuXàbXùr	TRUE
VsNBWóòéMàDǔLCgFhjeóeLeéxeòNZeǒOièrFPě	TRUE
YHèYdTkpàáaéáXùKoUoRWaNNUòayVXaMMlhxxù	TRUE
amúAvZùǒVtvvOVxCGúwccWyxzǒcImǎcOùIlùrf	TRUE
caapaMFyǔEǎětAHBytzHAPOanPUOpzvyQRǔwKC	TRUE
eátErsJeYNxTOnxeeZNuǒeVUúUwlRWNQevxVLǒ	TRUE
fiOHQèyfCyPèJóyAmzrOoólGfnfIwfqpbrǒnQK	TRUE
iheBěfxNYbYaTǎeRJReBqeǔeéáòǒárǎkxéǒnaZ	TRUE
lRVMǎJTrcPVmJJccěBEucoMǔtjaZklgWjsVqùe	TRUE
ntsǎwhsólTfNnXfVffqudBKBsXcXwaùoAmpSWo	TRUE
qóPzfqLBgdCOàqdHYLDúdMǔwdKTvMcòěàIViòz	TRUE
sXnQWqLqpfQúyfrZyǒtvnffDOnóajcfFǔTánào	TRUE
vǔǒjsPlùnNóQrLgǔcěcDFtuzccUeàjvjZMWjěm	TRUE
xbMSnuoòAbbzùFSxrAlYHbUsecJéqmJàkxEsRy	TRUE
ùáXyroLMrnJlǎbFhFerpYKYJogePǔTAǔTAvTOUd	FALSE
ácPwoNIOFLmfStvLoǔnUrTgXneěaEZfxWVlOjeS	FALSE
ǎwIRésZěVqvùrsaBfVOèUsaheèGGjixvǒnLanǒx	FALSE
ěǒJMUéEUEXfǒIukwfùdUGócrcOkápxAgqUhbàyx	FALSE
òYtxeSlmWhǒdIúZùbaiUtZDYCdMfoènóyKSueBy	FALSE
AQxXyjǎòljyMsuUhtFúèhRIěPǎGYoòOFQéGyQór	FALSE
DJCSJwgbúOoIǒóaIvcIgókòFWUgfAZmqUǎKhsBZ	FALSE
GòDGsRuaMscsàUiEěmàWLpZfmèárèbtPGókVǔCS	FALSE
IdfdsMmbNóBèqǎtXdKEDèbNzojjtǒDJSFQǒGufX	FALSE
KxCRPrUePzrojEóYǎxwWǎTuǒàoàKlákóǒPQWIěO	FALSE
NQIveOtKFvOwfpKriàùPyNYǎnlhEěSVàKvgtfIA	FALSE
QNèWaéHYYDjjWEMYRqóǔNDDxZhaùOUrèfhMIǒPa	FALSE
SiWóFpDikúéfKSdFPzùGXMòctGdpKZtóRWRǒOéu	FALSE
UyéfGVbEqvuaopRbǎDǔúǎfǎǒaǒHióChǒIhFVOFq	FALSE
XxSYaàUěěCOIbckNtàGFXmJfměPVxǔeěNWzEzAh	FALSE
adBuDǎbAgrHTQǒBwDHMǒùujdFMCVuRěěkwǎOQxc	FALSE
dYRàtLyVPǎnqSkXxSóUKUCàHtNXSayèBòùxǎjúù	FALSE
frjuxùJCǔhnúHqYùáeéDòàeoiPHXiMRfWfgeuMX	FALSE
ieQǎesáCjnUófóenHIhKèéczxJǒNZZSypahPrNé	FALSE
lèWslóQBBPOtǎéIàUémQpEǒxAToòEèeDxéhèBRh	FALSE
nSwzpzàkgwǒKvYzfòXmiSDWzrJxàaúBòtPǎQlCù	FALSE
pjWEáAwDqVyPabjzòegfhIapRpùjHdPqgbèUTOW	FALSE
rzǔolùázavSOádYUYGBplNQTanMSàXǔióxluNtò	FALSE
umèlwtcgLuaOxRXzHlěhùjdùACpgOGzhrSbcLEn	FALSE
xcthěóXWZsqWséWǎsyiZQyIwyjXWSwrXǔùKmMzz	FALSE
ùǔòPaWǔaěMMnZwETDpmaéaòàltLémMvDRòPqsNV	TRUE
àǒPǔaěZxnRxUCJàbNFEbCZoHbFbsUlHiòàegiòT	TRUE
éTtLxsOpueěǔQòdIuClwbXfQiěeXòeZKPZZeevr	TRUE
ěqáVodDLAdpáǔlswdááOOǔdZáBUaěěPuJDGLEHu	TRUE
ǒDBDKfèjHewúueòeòlusǒAzeRTgiAòKpsHSvwaX	TRUE
BNGxBcàLRǒàOádYdZPmGoHdNdGCàUIóFqVLùVUj	TRUE
EFxpypAOoCúèDCkpóRzSeCpeOAPEYLǒlDeyótEe	TRUE
HDVdbxtYWOPóěbTwFrbAbtmlTZiùukyRnXěZvFé	TRUE
JtPbGFUHáwSBKFòvIbǔUbwrJSUbùCZvRgéùrSFJ	TRUE
MARbyTnrrèjùjfRuOàIfflAfMiúuǔǔPQPMkoKlò	TRUE
PǎùAaáéoHUrèrGlXióaHóuMòYQaJaTyùWaGZeJx	TRUE
RcYlǎǒtcNWmòyqunltǒccDTVKaFKeKPyFpPǎócy	TRUE
UúeVxFSMffúWJRGofòoOFBófwúrvgHaǒRěfWzcǔ	TRUE
WonvMjanóLOpwǒǒTaJpxaaRòWkykOSApǎrXGzJV	TRUE
ZbyǔeGfhZEDkZàFMfkAóVYEfblbqUǒZbǒTbJsoù	TRUE
bbébBbzBùQéópzENgKxEImxcIBpjAYJEFlǔǒRèr	TRUE
dETěrǔRxàPètpuikjwbIóZdǒMqKdddBwùCWFCàC	TRUE
féQIpfHNěoǎXàVByúJHèpùsffMFOnúeOSCYtCfX	TRUE
hiyeǎEpeNZoCsJTtomblsGbrXwybbkHbáwcKxút	TRUE
kèvóteJxdBVǎyeWubrCtZlaòJmAJHBXaXvqrawa	TRUE
mVáAAóCEAòBbúédOZóděěddUSùUǎálǒlCéyTnEl	TRUE
pWpWfUúJPadóBéxjcázǒùEBXeTeDMeúèBevòQJi	TRUE
sIefxdúeǔeqeWúúefxssVNVufYgUnWǔQCfYGlsp	TRUE
uběWKpEVaěfacéhLSbITVKlwàOJOXtlǒbsěěGbb	TRUE
wuwaǒtiKóxFaǔàXaoaVHòamAUFAèFgAjTHiryOz	TRUE
ùùOrUbiVǒEwySaaZPWsfbUqFIègpoXThSrqUrARU	FALSE
áBYjPoVxqxIěoérsMndkCásiIPhNvlEUTFFkucur	FALSE
ǎuòbSpicBwXoùZziIzéUDIǎlQǒZwmětzzùǒreFcú	FALSE
ěbRjQUMZMHWzitgwjzWěùajmoRěhLYaSlháDǔacS	FALSE
ǒBuáIzpHzrFwMóIúiGorzVtjèmvěbeuIKQTáltWN	FALSE
BǔwQPXxNwUswqútǎfòvòahóEyǒYESJxwWǒMLVúTd	FALSE
DuEOwNGQpúHǎǔùCáNQsúHoVRJKùoozKWNYhǔpfFL	FALSE
GvǔkNHNSAcQlMYbfdwjéOWMmxiStBIòrASsèQOqT	FALSE
JàYPCCBzùqhbúòBAFǔYExxvLWYzymTUHuáUǔSvrX	FALSE
LLMMsPsDsjNUNUQulSkGòlòONacláErQsxǒJdEVa	FALSE
ONkDBHIpRRABpàAǎnAFwEuǒǒjKǎwǎrhMNèèRrědE	FALSE
RóDǔZěPqfséòóFmúpěhmcFòjctHWPzwNpFQWgiML	FALSE
TkúfyǔázBhUCHcJFàmYOeEsUàǎIWjHùrjqsbsMǒV	FALSE
WóUbèQRóYáǔFùmuáXBTQwǔeHuXèzymQbVIrwǒcAp	FALSE
YXGQoIOyAqTdsyCLBCáZMdgàBPEwccFbjSSiùTóg	FALSE
bIHaàǔnRVyǔxOLYèTOSuòiǒNIMpGLHxgdUoOhWéX	FALSE
eàiNàynPJgThoySBaIxUaixlǒrBvuiGrzcvúTDnA	FALSE
gFVGQǒoǒFpǒèfGbKmgHERQKVTszHsxHgXwDgMuùt	FALSE
iOvFPYozIXùOBvgFXcbéLmIzwoWZlZKhgjWsxúXl	FALSE
kcùnhEIPěRvIjekWpzaQFCfsoEEǔnfxdǎfQèǔNWP	FALSE
mhCZlQqkHyUFiwRváěVFlAxQvAxAIefPmoHǎyjǔw	FALSE
pMUKTcsxhhGlfpeXéHtǔQbvPǔkSúfémcNjùFAěkz	FALSE
rsùONBxFAòNiyLùeSFPaúrUKbJiúRǎúoúVQETYXk	FALSE
ulSadGWiTVKEMvMKáhqCIǔKGWàuSùùAOTfǔRlOhJ	FALSE
xUdKGsttISxYTOùVéCàǒcbFǔFRúGkXqyfsqcKlRě	FALSE
ùáoDYmXTlgǒkbtXdùVroddRmYéěZdKqàpEǔUgCRX	TRUE
áDòfLxHéZuuhAWàaRbbbqbpùvxthvmSbsBDoLrǎL	TRUE
ǎldlBpiZqeàǒPjáMAmORoKOmmlOaaOmWóMěmaWóa	TRUE
ěcédZěDLImcxTTTVcSǔSSWuctSFUVàCPèácjlúBO	TRUE
ǒbbòoDbLYXòNvóVbVofFjǎCbqTGNHUiǒMPjóEliA	TRUE
AncJTàtáMúxNmkehazXJǎpaaáKxGCStrUFaaúmùq	TRUE
DQàUOZeòáCwZByDměufòUZfJúǔfuěvfZsǎvCfUnx	TRUE
FpFRAAjúóYbvDmězbbǔCtlboKèHDjocKCrwXùiNV	TRUE
IVZzGzbBRéRxBbObèbxfMCFàCèMnùAKtIwnùKmxǎ	TRUE
LhEávFyUPwbWnzóPJWbOUbObzJQADhiǒKóOiSóhr	TRUE
OGyjuKbPbbáCQbLLemkqxooǎfmYfRóǒpOAYLjěhh	TRUE
QpbWaǎpADBGZdfùvwToǎffqPQxIxXèfCSBXDáěJB	TRUE
TbQZVRèàXěoKǒihTgóhXxKfdSHmdKzxNdtwCNdoE	TRUE
WBaSorNùTwkéXvinuáèWaaaaǒRévjCǔFjèfZCmeM	TRUE
YhégfFNǎWKgbxKrwTěrǔURchPdǒdVáGMddDùRFUY	TRUE
awarièEQaǔxZaaaFBQgKúOjUGrùKOxyijOkpxsht	TRUE
cfǎJvJpbxJlsbOuúbxlxbiòàéitopsoZùnGDdmgh	TRUE
eNkxjwfnǒSóxZUeCepBqeebvAvwySckhNZǎNXltu	TRUE
géBlcùgAòtěǔóěPNTgLtQvlfplTleexIyeBteáóH	TRUE
ipuKDmQZUhLoIcgZSIwVbOàFJbóxbbNxKSQMhǒBà	TRUE
lqrmǒcXYǔAGerxCFeeeèKkóAXffXmcúpjudZóMǎx	TRUE
oHoRTǎàùpjkkuwaěaRxDWùǎèóRúùvǔLEaadòàùUX	TRUE
rXNwWScWrǔSfeolZeeKWeaojUtTKòLkDàIòǔxuUy	TRUE
uWPMěétktZaVvqMYèaYùǔxwUaSFèSWEyàaNéWkes	TRUE
xěrYiUvLBRUQGIyAocKiCwdUbTZWXPxbBbNAbDJI	TRUE
ùùéDěZCwkEyNórúFaěùFzwWOàlMQbCJNdqAJWPǒLo	FALSE
áRjtBákZIZsOraKpNáWJěWèWgkDYPfWzEfèhNGèPm	FALSE
ééZqRCáiiqúǔYàfplYegàngRòRSTNDXàhlesdǔàcL	FALSE
ěXkmǒJpxsànohqmúCbRègAyOlJòNJgePzòOXfùǔeZ	FALSE
ǒCCAjSWKShDGúnUMùàbrléWòzóXZbhàUCKESCLTǎǒ	FALSE
AuIQkpAiWúlTjòUabNibxWFywBáèqzmKePcNUrsjS	FALSE
DBccELzlhqqCPǒEUGSFPólvrXbóèFáAóǔéRgfJFóH	FALSE
FoLVJhpùWùYsvHTěěGkHQgLEGwexkóǔUxiPUòtUlv	FALSE
IdSnGDIIAKqVIOjPZKuToáVZǔERwéyàWQáhkuGOgh	FALSE
KkObWVǔIOèqéWebmtNòCwMHFdWbéflhcXvǒkǎǒTǔD	FALSE
MzrhcWàcyjBzgQkQxQYnóǔazQKfbrFQAREùèrAbpú	FALSE
PisùAAYǒùǒyféKEJQNKWQZjhúOQwhóZCLgUAPònkè	FALSE
SHUFěsJyWófbKéXKhòKrWòàěZofSeàgésnéuuLCxI	FALSE
UsEPPIǒCFGùUmLXàQdxòhuCxNwěAFLrúwfHOóWCeY	FALSE
XbUèiyoutěbYáZǎnGnàyfiBUmCòQDwǔǒoyCUywyMY	FALSE
aòèuKásUwiMHǔqiPZlknAùcLynlcófBzéJǎIfěNná	FALSE
chúpòòtXyGěBǔUXXòláUmBgQgQBNJXxkóùiFxvASk	FALSE
fDFWWAtaPAiúmaPCtXgóVZáfèfLylfpDUdcgIsdcM	FALSE
hfbéICmUoTéúUpVHaúOerEKTupcxpǒOùNWoàvIExE	FALSE
kRSQZXphriGiwQHJjSEMěOBWjDbJVSepYáǒecCrěǔ	FALSE
nèbVYpHPpvaMǔǔDzájvXNáCvOǔmFvZXTèViswYcòǒ	FALSE
qúNRuXGxXpàvSDǎOOFòALdoúǒMhXgXfIVhaǒtWbjc	FALSE
shXHQCcyrpLsǔkUsIúWaIDxèkZATzXmkcěùúxǔkBB	FALSE
vRbúOGvBeuTBBwèrúNúAKPcǒRaJvppUTbmVjbPrsW	FALSE
xqJǔcdědCsòCěIKZGZèxcJlydddàaùDùduféZdoZO	FALSE
ùǔSnuiqUeNeERórJóeáwmmtyRòěqDWúWzléeTlkzq	TRUE
àUqèRbhDKjFjǎséǔoWlǔHxCKpovúHkUbbIZǎbRǒbG	TRUE
èǒRbJZUùzAWGCNkJfùVfuuPffadHADzLéCéBCóèXó	TRUE
ómdstààHwHYtèXMbùbybbhKSORoLrQBǔjvROppéúA	TRUE
ǒuTètbǔǒRETHàxIyvbàVArQběEIDqèbDǔàfwZjPèr	TRUE
BfjGùfvXúúBWffúIByàmNfPMzOSRlUGRFWGqcZEYǔ	TRUE
EWèymZclúAcǒZùwNDcòBEVùwccJbauIAVMlmtdUEá	TRUE
HúowdeòǒèqaHnǎúLWpJarKNòapùmaPCmnkǒXXktZé	TRUE
KGpǒbERITEJbYETXuáUzèIběbbOCcdHBOhrMqOZqd	TRUE
MoúéarùtVJwNiWRVqpǔClcZcùútmcěyVchzYWJDpk	TRUE
PLvaòYYAyRSéDCěBěOartaaěǒjsOóYǎúysKěSNBci	TRUE
RTpSjAHOfTLbbSbFWDUKbeMIáVqGTCpwFGtwèoéRL	TRUE
UEDHǔuHhaAQxpǔCrèGaRLMBaUMazoAAzaáYpuoǎWx	TRUE
WoFdvIǒFòfGnIkUPZéfqěóvzttǎfǎvfIwofǒOuAmq	TRUE
ZBǒaxvlǒvyPyvnGnJuEaSlǔùaZóHáMèaTpUEEfWúW	TRUE
bCIBKPMWwVCaǔneZFBzWPxǒenyQeeuqkǎàlgNEjRX	TRUE
dǎáZdTéVzKDDJdàGWCdqàTnuéAùglédCnOSKEEAno	TRUE
eròiòLQWBòIVwWqbrRtOObbbèHzTcWdxNDTjkTùaW	TRUE
háǔbkaaáZséěMòoaǒRGùHvǎHKaocRhRHmǒxVSIǔDǎ	TRUE
jcóyxàAIcHǔYEQfoXAEAùfXfěffuGJGEZwkhòAtKS	TRUE
mǎwLEǔFckǒRLXGqKTYbIaPanmǎCvaòaTnNHoswXóě	TRUE
ofdwEóaOzsěAaQǒaLmaDghYsTGGHTgùdsEYsRrǔKZ	TRUE
rgYqhUUóAXPNhúTxajropmmbWPLnbRoVǔóbHbVbLE	TRUE
uRDéOdBMRrmòAdědqdQBǒfǎMvpWYXǒmóǒgjRIòZaJ	TRUE
xCǒǎQúcWTèBúòzvbUbAbbWxYiesZiNuTǒrOWdWúYw	TRUE
ùàkèxùúMGtQJpǔFPcvDhDEZOJyjNRùsLxétGyQyYaU	FALSE
áiFBdbFVpZgrYǎoZujfàBgOQwuoTRèùWRPqvTiAàsD	FALSE
éDdUóTAáòwbgvMwáImeRLèǎéieqItHyoǎblúkKlbèi	FALSE
ěWbpúlndzZLBádùABJǒóRiQngZǔáYúTIuéhzabUGDz	FALSE
òrqnwUSPěIajGKUǒúDRzvEúWsràMeCèhèGxdòaehiN	FALSE
AXbMwMkxqruCaǔǒMjYtZóOǎmhǎùfRWxZǎMOǔǔNzǔIr	FALSE
DJQDǒmxUèOěhòSéSxxvěhǔjǒTBFzmmnrqJArkiGDcz	FALSE
GǔoDjPòàvwDòùhèlEJòéZèqóJnbèpxGjEdGVHXbènM	FALSE
IeNKqěyǔYHRTPddLàlRRScIyywtBLǒXbIyxFHDèkFh	FALSE
LǒiCXWxNAKkUXEdGqǎòlpLùěwcOfROShXZSNjpoúúA	FALSE
NeiYYZoǔzgIHWúpkLWimOTájóàqWvàèǎcQwJeǔWqOI	FALSE
QMfNáFhhZǎéGDxUěwQPeěvvfáúfACjúǎǔBCwXRqkQZ	FALSE
SUSTaezsKqwapnáeDXaSINxoérèBPvtóòoWéVGXwòǔ	FALSE
UbIIǎLTfBYVfVSVYJǎcWEJBXHKZlPIEijéGúcoyKiG	FALSE
XAxDùyqǔgbsXlPěáwRGzexICEIblGGUZvpHǒIúěPHE	FALSE
ZusRNxQwtbLoZDeòtòHQuǒmBǎYiúXFwBjMZekpAikP	FALSE
cMǒěANùfTuèPSówRpèYǒèRBMaóDxYèiRJàùúbeqOái	FALSE
féáIzMZǒMyvvidYǔcúYbùhxhMxèIZDdmXèVeTOùècà	FALSE
honYuǎuASwfuSATlMtPěROSáùCZóuzdIJfAUKXǒIMǎ	FALSE
kDǔTcOnBSsǔPWěrMǎóZJmXXKMVUuàgBzǒMùmDbkCǔm	FALSE
nAòsǔěvDHPòkOqǎkTéEiyXkwtTAùSrnéùPhDèInhnN	FALSE
pwVhùLváùvǒOzúFǔHěVLgYXaehNněǎXWfZJhàwNRFo	FALSE
sfǒrZaKOjvOěoUvndCHǎonpwYaNèLUNiáòKxJóěgRL	FALSE
ulUhèXcObèRǎFmlZueryRFfǒoXmhzXmWFspPQnMmpR	FALSE
xOúóǎWWEtHaKdKvdIcQlXéFVǎnbǎuBZMòsyúqkUGǔk	FALSE
ùùlZùlòcffCNǒPúmCnnelúppNkkaaǎOaéagǎQákhIJ	TRUE
áGòqèàEUaYěPeLvKúeùOteúěxJéOWexǔrNCsCgnvFú	TRUE
éJàBoougeǒRESteHLáeeGhIJUěvKrWǎùeKIOxjvKjǒ	TRUE
ěbHzRbymNòzùTENRròSàOZTmzzbbXDJxXǎijAbòBsi	TRUE
ǒúRóWhkDfEfFHTzGIfùTfKjPSpYXsJTiokmEJǎaùrd	TRUE
AfEmaUMGAóLaAUǎraKRxǒáauctKEagiàrIǎéYDTAEP	TRUE
DòEfbyèDFGGDrbwzbbzXeělKUEvhQùuIHfIuvzhDnt	TRUE
GǒOvYCzábSphUáǎAIcAxvvǔUoaóVàCNBqFIaaFóaim	TRUE
ISptguLUwCrQbbbtěKbLjjQOJAkJhòsápùúǎfrèdFǔ	TRUE
LLNkáAhewbJnèfúrLboCbzUKXóubwVKúěsòrǒbúnxW	TRUE
NtxbOYfěltěbxNHbbúǒOBPJyxnbTùTIúZWǎIxéhVPi	TRUE
QPWFǒyoùenkazáohKdxùMrdědCCOdQěFeSnwHgrlòb	TRUE
TIwHòvrcCkqdvǒwǔBWpǒmZEnlBZYódHèrnJddcméck	TRUE
WIRvjJyWuZwyhHNEccòpcYFyAùcaěZttǒQrQnBtEàf	TRUE
ZHǔbxWdèYCóRtGHicIyNZEsITǎnqeVeqzxOLùeOKze	TRUE
bèGVWmOeQneeHFUVUKeOwFábwtbaǔIlbJáENzùBoew	TRUE
crúLòkccwQLIUvǒǎWnQWJùzTòNqcEHBcSaskáxrrUm	TRUE
egppQTǒMéaryoTazaUxqǎaUǒàpàFrFvLChIWDuhRbJ	TRUE
gUFàěPIùLànzePeUIKseèěòeMèbǒmkfiYqyǎodzUYb	TRUE
jǎLǔǎǎcVczHouHǒCGKELǎZcàZncúNǒmSCdQwhFHNoa	TRUE
lOmTQsbMbpblGsóbxFVjYtSQěbAǎTBhárLhbQxǔPMv	TRUE
oběUjJbùqheAgjèndbbNRxWáILéXLuVbbuZkdatLMn	TRUE
rPRUEjZKèDAElMIibrLxffLéfXGfwiáoqtmXòYmLqé	TRUE
uINUTvhRTSBǒúrúeGLúYLpHQBqffffBgqkZQéǎrěIs	TRUE
xǔFgdfQdddJdóEBiLrPtqjFZdbàWwDbGSzkNeBkzVu	TRUE
ùǔUPéwqVGáéBUjiQuZàǒXúòzXfXdVHěJǔzKzǒoláBzG	FALSE
áVábYFlégrSàáUVTéiúTǎRyxkGkóáEuzyJPoLZijóSI	FALSE
éBQaFqDàbygrnǒWBtalBqIThPDǎùVèúiǎZSjYRcAéqT	FALSE
ěmúITáYzVwràdBeaàYLjǔIfókàzAfDàcQnFdputòdWw	FALSE
òvkoYnjǔGùpéIiMǒkúǒtIimKdówAkUpVoRvèeLǔrLsr	FALSE
AFTUfùHoùOdyIóiWiHYòEhnèhǎbYSCNxóIXmXciéYXO	FALSE
CuITELeWèoóRROWáǔhòuhGdgWTèVsZéFnwsǔPLGxros	FALSE
FUEàSCěYDYrmpZfUùǔǎfOLUHwbvjAeGSKúKáúJéùúHG	FALSE
HgouǎahúLkeVáalEǒZěPOqúeòhkrWXyNAawlsùěVQuǎ	FALSE
KALQTWDmtàauxfYésXVDSApBRǎDFvfLěuFaòěgJWhqb	FALSE
MkJeSèegjUgárAǔěwqnǒTxzapcǒéOopUoáfyRùcǔBxO	FALSE
PDouzCèDrOpMCwXONSOyoFàlgvòLbWáéximOxyǔàéDu	FALSE
RnBàèrscúVúZXKDgYaaVBjwòbZzKGDIHlDnJKZSbǎiv	FALSE
UòmqfPQAóǒNzYpPlYEAǔSXWùNóFàúǔIOmàUMúHsǒtéZ	FALSE
WbòFZUHXkUPSusOYotVMòběRIvblDárysQRxZnISbDá	FALSE
ZQIyvbsùVRflbWùEZèzbtJvjǎeEicHipbzEhFhéǒAcr	FALSE
byhoBókǒáffyyǔGzbpydSYIdlnZxnpòELuIMVtUgTùX	FALSE
eDVGFMpùaLRRǔLàmjPàwUǒfSlaSùQaědyěiDáYeLèbr	FALSE
hQéwéFtòOFGaárqgEwrǒZhěoTǔǎùfáGSItevYiqUDIò	FALSE
jwaakXsyDZfrcfnáǎNbpǒfǒóBVqZtbRùùǔáLóFBxgjE	FALSE
moěVthikjsYSFTvcoùOKwòóuxfBQyuǒJLkěuùyKbdRV	FALSE
pMulrlǒòrjLBòBWùCBOrěsǎóRyxgwóxqgeWcRCKǒfJK	FALSE
súPlǎzBsàdéHGápAmPLaAWùcxxviIWWTDyjyGkǔxpxf	FALSE
udofEJBvùqpkBǒzHěHsZRěèxBErGùáJBáJùWJiwzmeb	FALSE
xTwixáyzǔfBjuneKtLàPoéhilVèùydójuFuzXLǔwkeU	FALSE
ùùidKyuEQRwdZFàǒwNdùxpuqǒdnèueaERMpFkèǒsědù	TRUE
áYxUóWjunpnqfóztTELZdsQfAwyCèIOfhmotNmeeeue	TRUE
éFběoiXZèHbliZsoyuzuhéuYfKSfěwsàvfLmfcUsDǒm	TRUE
ěeméKaIsDtcUMPpOrTcccjaAHYJYmiqNyEMivávOFhF	TRUE
ǒRuuwRIBoDedyLzSoLIWJòesdqvmdmCdwódoPlsěYCǒ	TRUE
BTFáǒQVfjNUěbRbǒGěbbáeělIYRàlFóPáoǔtCǎrǔZzL	TRUE
EFlǎúúúEBdCqLjBaálhEIXraaZEDaqKKvaóèoBamoyw	TRUE
HOgIgěAwùtZqJUVlDWaiBbǒRqKBbxyrbsuVbóRNjSKd	TRUE
JzbqhDNBLLlòebOmhRYàòZOHúbHWbbvDǒQZstbAVSǎm	TRUE
MTDvùodBàGmpǔdWèdǔmLBFudóRZmqdokmdHěenǒqgbh	TRUE
PIòqybdaGnvǔWKaàXtaaNěSynpáfWMaOknRiěCzHigé	TRUE
RuNmUSETwjqVqNeeNUeeeRpYNaCYěDóNJEǎAèCnJKVò	TRUE
UǒxwIdówJyddèvBwYsJDUKǒHFdGPuoOiZǔrUnǒwQzés	TRUE
WsIKwCIzHqbmrRcZyGDcácúzcQMxIyAedDwúYmaácOS	TRUE
ZgnhácVRYcPJAcLcnFDdmòkeǒIdUEczwChHfnRěNiVJ	TRUE
bzuáuUEobBJObAéóJwbPWǎghPvsKǎYFǔbwfFǎDLZzwù	TRUE
dgéWcòCoàXBwpóWLRBbllbǔVKzLbIIlbnkǎǒOrònzjo	TRUE
fSfàPtfCPvIyUfjtmǔaqXAfnKigzxóPUǔYyzrJěvFGs	TRUE
iàdQMaEǎdběáAMHùxǎDǔvbbúèbuèJaáqàvóWZuǒòtKG	TRUE
kdfhwaYXónWuaUrBzooPàaGIsXuualFYěmXEǎsàJIPw	TRUE
nmQJàórRbSQyAvǎGCzwmcccěpJGmMZMBcVwàDMbwbàs	TRUE
qǔHGJeòeleNGYáJFTqXMxoGegrulRhZZjòhDkàTǔGin	TRUE
sYyBǔvYsNZnKáYaqHaZEǒáaěXErPwGZaóàǒivedFgrě	TRUE
vǒdpDěWCNIddMQdùgǔLxFGtoRppkUndgěnBMxHǒLWgM	TRUE
xeJxéeCazúuMnáǒóùsSdQuBddpwEdfUòùBáǒgXúézWY	TRUE
ùǎeHnQlHusumHHGuèàQDlQKvrxdrDYdrTúEFékMFtLHZ	FALSE
áYáOFUqáfUhCyshlàwGFlqMxdRYGókSieùMUǎnèIDQen	FALSE
ǎqzdúèovzqyǔRBúJIFaIfónLEUǎvCtLlJXAàvtkáèESd	FALSE
ěIcZǔǔLMaKEjSUxJXNiRUfAhmYKKělLéTMQKjFfoěúNJ	FALSE
òtCWùcZécCGǔěkàBùǎXKVègDkIyúqzKMhHVáàúdFSàmB	FALSE
AVQáRLkSàùTdVhákvàXiEZQEPIàDgTUZùSHkBCcVSvwM	FALSE
DMàOyIMWxziDNdLQzBèǔvsVEZmjkKFàGUmbRWéJzysáx	FALSE
FstWHaOkhěúUelFXuEeOjwicsUqVóWlnèJphzYcKjqos	FALSE
IFòxLJéPGsoèuWcǔebzTBaBXGNScnteFGqmtLiěZèWqn	FALSE
LDǎaóYtèfaxzpkoéùSEgRNǒGptZRgJECàOZǎTRnrUNbǔ	FALSE
OójlurcPfICúcubwěDxlHHǔHXQpLjùaxSsǎxPbdVHáNE	FALSE
QTbXcToxYnsrNrWsòFùUhIjpshgdMèIDTuDàAùeáOqeX	FALSE
TúlbUrZláěayJǒPQěOBzǎECuXòTǔJLkNǎLcànFjbpqGm	FALSE
VWúxmǒXpfObùGhJbYXNVJdfòACdeúùYbWEǎSoWlkpKad	FALSE
XYvěNàmWáéGTUlněgQKrěmDiTùRHmèiXàQàmLtXDNMzr	FALSE
aSǔjGmIXóéqqějMSgOhqWTykGaLIcwcsènQxwǒdBqcBR	FALSE
dCiùtsděmHǒPǎèUzaXXèOHTaakrqǎxLàrFoóSBYvnHKM	FALSE
fBaAKCJAvtòWǎzJMTommFUAèàzfRmùRCǔwǔQsóǒfGVEJ	FALSE
haàěnèwěàóǎvNLHBemǔXkbkobcYACǎeólSxDYLùzúúèY	FALSE
kOòmDHSezpeUěpeXORqyǎNbpDǎQjCqaájjTmǒqKǒNkix	FALSE
myKgMèǎNTxmèùdnjmcPmdMFàBFwieVáJYjmléàwógieu	FALSE
pháZpssrlzJpxoAvǒmeHvDdǎfZnlVUZqǒAǎWUǒVHqCoú	FALSE
súYúéǔzigIuJwCpfSKTviCniZOzPàieNGSLlUiAKQvbá	FALSE
uqěXqPúóDoFáuWGLpMFkóTpKXMLSjMèSfsWrYěWitcvD	FALSE
xEbyghècaobYhJgIóóxùǎHùǎùDRǒwNWEtLJeDěZtlhXa	FALSE
ùùJCsjxBWèWffffUdTJǔFJCAgRFětpgGBIàRKNnJkùùy	TRUE
áqblKsyOmwQrYbóbbOAbabBbPNFvqkpfrqFǒCAZDUviE	TRUE
éeuyeáHetelJoàáMótXLCHiamKyóEMTǎáàúIrhbXénòN	TRUE
óRKOóóqBaRmlYDjrròkvZPitfěfwfuLfHěHCTWQGfSXé	TRUE
úRěcESCyYdrXqJddàYěsdǎOèpyVòQàǎCǎcpzzòCmmXiu	TRUE
CBǎQVfbWLfófLffWADvffwGVymqBcBǒmPLUSqtrFfhXé	TRUE
EjrěeeYRXǎHetúEemWdDcNuzsèHmZTYQCLPdoAèRèqdo	TRUE
HXCHǎxAlnTTcMGskdǔodZQǒdtèǎAUKèáSòZDàxQEdMMM	TRUE
KèóóAEdnudddSiOKeBevCQtupaoMpLjXǎéxWuzpágAúK	TRUE
MVgqVwXHéWUdsHnúàVyWPDǒWmárdúdQdZNEěytèoEwin	TRUE
OszeWnzXWbdwmbaévbTètépTykdábKVSóbébZbǒevtgh	TRUE
RHsRJEQDtVoIDtNùPtéollrabóxVPUóDPXǒZǎXDLubbb	TRUE
UDwerEtoeMrǔětvHtKnCDLZpwPsyǔJUeEeMylmeLpBǔG	TRUE
WsaáKkVredXyKrSctcncswtFOHxcědEIIEbKǒDòpSǒLè	TRUE
ZSaNqErasFSasǔnYrMáaTTyzúQzVfxEwPHAzdscyaeZó	TRUE
baPaǎvoaxaCeZeRdYébWhsHrkrMAMHóúnTeJQóbvDtIě	TRUE
dKhbVXǔIǔFNéqáPybbIwùOZòbqgMuBidIvqéVǎiJKdSa	TRUE
fěHjccppwàěRrpZNoóěcmqAámcElèzéecyjǎNtYCòvTb	TRUE
hnZaYFOIBVaGvJXaacùúěUrěOèZvvqDéntsZQrBeOnCk	TRUE
kMOWoXǒèVAaedotdDdǒáOǎdPMǎàfkPhRèàfxAPBòPLpH	TRUE
myxoěleFJVkVgFJcùqcǒArcZǔOHBLPcBycàóGVmèǒawd	TRUE
ppXjSèrsEQxàeYDAǒǒUòeqKePebmPkCHmggDZúWTaDvI	TRUE
saRPLapúdépVlCjódávczèUeàRxDmexACèeqCCSeTblf	TRUE
vǒJpMYKHúYRaHaaSaYúǔóshǒgFXbpDXuqSCPOIfuiòxt	TRUE
xVàǎòEbppǔěnbzPodéFdJDudAóǒǒǎdùǒTYiàǎOxwKnán	TRUE
ùùwLsdrqnéuGaxVváCnMQSuZPgěRwhNEgJaQùWmMǒEoǔG	FALSE
áMvpbùZCKmèSùObgúhNbNzùjJCǒmjjCOqHZinpgǎǎócjò	FALSE
éAòáqyNuùLdtjihAUPoBHxCmrfHèDdòCIlásVoMuBGnMY	FALSE
ěQdQxVfPVFpPhóLzěAiCitqOǔbnRòsjwKcgTbFúǒuRsrE	FALSE
ǒCUZOamuzzmiGqùEAoCxàaěkdtǒGUxtScRAQoélyWOùki	FALSE
AxǔXǒSáKMogypeonǔvGKjDTěkAQúTǔQǔxèzégHMRPóLxb	FALSE
DúWEáIěXGrWLUvùáùJHóakCzěhvHKGFoieBIàasJóHBfG	FALSE
GCMyiBhzáéITèIbKjHRMtotUxaoVeúqHiěyPZóóPDBpgz	FALSE
JùvzGǒXhxHjHrMQvHanQcKéEFldàgZnTEkZUqtmràóCúó	FALSE
KrbòtǒfèGúYVfjlóvbQYQmUnHǒrvjǔqǎOúCPTjkLǎPúùU	FALSE
NhNwQsizúDáMnuoMpǔióUeIFUKKáFfóeqpbIófViCCRod	FALSE
QóCǔcQTLGABcWmRpcWBèVmuǔgYKxòCAZlDsCǔěnAaKròg	FALSE
SiěězmsKǒLpTxwEóFwPWTòánóaOYěèEúaMtàcSàuóweYL	FALSE
VCcFFaùǒtǒqvrILxBwQǔǔBùXHOpwUDǎEJXàBgQròǎooct	FALSE
YBzbOmhRoáMoiCèTréěpBuRWrècSIjeòrCYMùTywKGUti	FALSE
aptǎxdxQHwpjZQSnGISùThTpěNGúRRWpèGVRùéSEflúkM	FALSE
dMúLúàTdfCeMKeAyáKyEWCKTUvKětxqFjNtǔZóKNpjvHY	FALSE
fTeéSifXGMiYhFpCPDEUXNóvmMqáYSCǔcfhSúKěIHBzNz	FALSE
hxǔkRcEOQgCfěoLfFjbùKnKEPOzrOùxTmPéeSěǎLMráZQ	FALSE
klZǎsvwYXqiòDhmfcǔàěmékQYǎVGóǎOIèNcǔQurNraVàv	FALSE
nǎOáQéiHLhFěMjaAùòZycRDTOdvncBeuuQNZOósLZjucM	FALSE
pQǔwEdNáědJVùóǒpXpkvfèzmxkKiFqéópYbósTVGdZWbc	FALSE
sùòáXsvWunQKNppiCIJbNCùEkàoeCBiAcJMèVPxDTpNǔD	FALSE
uZxyBOěmLHNpQúùxàdéúGhoPGIkǔòoBvǎhOěǔjnTwRújb	FALSE
xóěuàXmAGsGuJmORwěaccětòZuSIoUhUJùPnaFAàMǒáàe	FALSE
ùáEdùánHòuyldCǎyHwdóǒBǒdJBpáOFdǔEJlaqǔMLIsàDó	TRUE
áueàwWbAúéoònLFzWCZxEAWNkdelcWRpcBncMcvOWòùKP	TRUE
édúvUBùMóTiNqeoxHwWMéXFeèeEqnylǎeIuKúDtVodàǒI	TRUE
óWNjAdàmǔOcwóbauéúgqYBnaIèSSòlàaPIaLFǔaXsěPWl	TRUE
úáMOdXasaTuWGQFěvNzDMéaěFJAHyXaǔAèvóLPQúóeVCo	TRUE
BtERWxBUOcaPěeYzYàHXúRuIqMòeúneVSùǔùeqJHǎYpoA	TRUE
EWyálSmddChAúwmrrGoQóǎágaùUaaamcnuwTaàbMxUěKi	TRUE
GnNèSBqTwrlDAdXAkKtunMEdùnMùYNXùwdòTdsdzèFOnW	TRUE
JSrHárHyWqbtbbbzùrEhèCPWpNcCRKYpBjpvówHDMCtXá	TRUE
LgWsèIunlòMotcǒòzèsLcFxlcUcFéOeubòkbHtaznLwKM	TRUE
OěáccóCBJEqùlEcxLOcEmǒITZeokudvVMAògZxLǎlàlxD	TRUE
QcXbrYAǔNFbyóVbbbáMFglMBifzghqfuǔǔBláKeUTMbmá	TRUE
TěpwwAètóffCNěBvKyOúǒmBfàlYVěfDQRLADSAQùěéAlA	TRUE
VlIEGzvcùYabxVurKáLúbbBólbBFtáMDrnǒxWdxěAeěEL	TRUE
YabsédddzsqLéNdJHěNpitiOqxOCucaiBlzáGhtOSMggv	TRUE
avNqrefcMVVzmashBoaHWHHrzBfaaaùonGaàqǔéIAèrrE	TRUE
cfVbáeBIflǎggOóhhEǔàmbéxóVbUclcnqscOpémcEGsWr	TRUE
ehZùPgúéOěTASqIjikmBiAZfMjcabMPpbéuǔbébQěJyǎx	TRUE
hOspuzùǎnóNnCodyXèhfǔZRfqoéqSOOfnòJAfenitJSgw	TRUE
kBEttùAěàzǎrfaDniJQaaooaězaǒbbVúAfròzáfBpcTGJ	TRUE
madGLóiyqùlběǎTwNVpZmDWuǔádtIQdtdQǒYmLWdYVTOU	TRUE
pTMcFěMBxcéQvùctMUcpOAféYàúViYTnUXbMeéfUDwhYY	TRUE
rqLHHǒóZxffVnxúUHěJGRJmǎAmLufúàZQfAYKmdrJidnQ	TRUE
uSXFVhIbISrtdèdKóéUIdCdPèhsTiOvDqYZxuQWBJUéMJ	TRUE
wwúdSiáǒǒXiddNKúyYoNóWOKGdǔpdàfCwháèwJGXHZLsé	TRUE
ùùaKdgnVUQTUQáEghòVǔQFHEFáoWAéòFóYfwXmABNjrtnP	FALSE
áYRPyewzéeǒTPROyUkFOWQYgFIgTcaqRgǒzzMèCèyáwrME	FALSE
ǎsfjoDǒCógWgEQTYrFqfywsMěEyxPZPeZsAuysǎEjěUFùK	FALSE
ěBTjWQTCLKǎAáǔHrwBAǎdsgUNnkqOZLGeélHǎfBpJàóIǔz	FALSE
ǒǒaKOlIkQwǒúyeRIùVyěWaèAHgKvwuěGWxMgpCOhwěrppá	FALSE
BòǒǔAJqyJěàSǎVúphIúZWgqěLuJvGèNěYálmoǎAkjwflwǒ	FALSE
DlqǒFvzmméLèiRnVáGbgQQiQěGGQùspǔFòArFUdZǒekǒlU	FALSE
GèFsiGcáJǔèsmtóyaRLefzFErMzeXEěgXQslmúǎVQAByùm	FALSE
INHòXccǒOSáXaèdunxztIóhèPènOùúGdCouPNMùMBGgVCd	FALSE
LMFùHGRokópjPTlǎǔHEOCyMHOpùIùpONsdftkDzǒGRCXOH	FALSE
NZDkWtǔMúDywKáLBwEiueMMvúàyLexNTAWvXetyépmPjOf	FALSE
QáǒbBkPeQDǎyěaCójfYVBIBCMèbqCiMfKrésiwMXNOOóoh	FALSE
SkRwlǔRdVúUZIIsgaxXPùmhpNeNSVáWIVjcxAiGhòWVéǔj	FALSE
VWlxměèVMVJJHùóǎYéoJYHfGMuczěúMBlEèkxǒéPgZRlXa	FALSE
YùóěLLXěgǎàèéUóébwohgEázbàKDéùlnTǔànúměwNtUjòp	FALSE
aKatUbKiVCCkatùòAǒRGJPBòZǎZoACàassEvùIRyěǔàLwz	FALSE
dAmpnEnDaLkyDSCǒUVfUèóbàMqlwKCCCUXMbODqTbpVOkb	FALSE
gEaIsAhHyHuFsEóQylRDǎtǎzúEógLjshBiǔvdOLsàDiRhR	FALSE
jákǒCáIVToùúREgzrAùuEsNAélUvAgnoFògèUmbOqUqWèe	FALSE
lkgùESKǎUfRǎǔùpAùSEVQMOAfùjsBYvqǔtdTUDcTótCǒǎB	FALSE
nqRRyGUcgASjMVXdCJouVjGRfJTùséSmTkQFtěBòiEDDJW	FALSE
qQhNYTsòàcSipQmREUàlàJpabMnQTóǎLmhenWàHáHǎUMét	FALSE
sTgóEQqgqCěbJAQùLATjéhǒtdCngFwNwhMvDncZLmThHPh	FALSE
véxazHDvNbùvXwbCóNZFduYWdzZdgbVcYàYJYfbàiuNèVè	FALSE
xWDWYFzaCicnsUcckéiáùbMlIQUNwěǔrGèLOrDNoáuèyhK	FALSE
ùǔVèèaRKamUmnHnǒǒvèUymaIYJùnFyDQùZMuZPaǎgéJtOQ	TRUE
áYNjáCjesèQDufyǒuLǒésrJAfQpUBěADVffPáěUdUPGJYǎ	TRUE
ébCRQtbLkoMàudYNddENQYdèoUXhUKBYjWNFǒúGààóyeǎm	TRUE
óǒéZLPcmúùBbxHPvúNfDǒéàtOJuúIZǎNXnxffàGCVKòfFw	TRUE
úDDUFLǔBPxeqJjàzǔúùùcnpéhccBwùǒQxrcWckSěnIIPov	TRUE
BcàqJBcplwcwàKHVFóèElcRoVgqjeMfLǒLLnkúVBkoábàI	TRUE
EPěrNcIbbéòáèoKùósùbbnKaǎPvMhNǎRùJoóBQQxsYRsgJ	TRUE
HNKyAǔAóbbbbIùkOYěVǒùWEBteMDHpBCiQIXewdYTbèZèk	TRUE
JvMjlMspwǒIJTsThXaóbltQúUPhqǎhaèaPàTQFaHZvaiùI	TRUE
MúMbLbIEkOcTZOcDóXcTcETowGyXAvǒéRPěàuXvOdGGwyb	TRUE
OdǎOPOKFèáqYzómVcffrXUúlUuJátfàCtJfSèǎgedQMoǒs	TRUE
QmrutVMKdFddtxKKèzdEtfFuNěeQǎHáórEMQùtsǎúVǎjYě	TRUE
TRFbuùXlMcxyWKZPMvIèOéòcǔJcóCHMcRMbùǒpwCphǎěaj	TRUE
WTdlBdBRIdǎánǎlédwuAtEWNàéàCBlIchòABèZMOTANuFN	TRUE
ZècqLòùéfǔWIfBpǔfǒfJsPQfzGkdsWéTVWXfbGwPNzZSdb	TRUE
bPFótIxwIbszpLREǎBbOwFOpUbcóǒusgmLěZěFóxDǎǎnyc	TRUE
dPmmwùTdddMkPBjVYxrBEWgJQlxgWizéPqléǔSbFòcjFlQ	TRUE
fIàoeBwluRRoUstHTnáǒBéFfJOXbrmmxUYófMWffzfgIjà	TRUE
hdhKùfnEMTsóǎEflVufǒlQfDlVWHeHznMnlnǎavyaWkppm	TRUE
kàMǎnvǎǎYOcktKuTwnǎIZjùèMyFRccRáNcSFIBFùcZOMpt	TRUE
mcZScCǎFSQǔWwúWQěEGEnvGěwQUúNYàvHvuswDòuZùccLǔ	TRUE
pBúDǒCǒKRevMǔRǔVmKZvIUeHHlmMYOèoetPFEewwoéXQVm	TRUE
rTcbQiòyUJùvOěǔipjgXSDYfzXAAwNfòfúfccSewNPěOéc	TRUE
uPMADfnYfWBnhúrFàyNWoahpbIUqǔlbúYKbMbǒBágVWnRx	TRUE
xISgXFJQzòaaTXFaDmaprPQCPWǎǔòzqvIGMáieIImZxXFò	TRUE
ùùAóyvAóàayJégQDbZKdoEmACujTlilGRlctwBuEèúèYáyé	FALSE
áèbAGNYTBOòptQXǎENuozDqriMxjywVèIPLujòeQeMYPáhǎ	FALSE
ǎXùoseòoApnzJHijleXSOBNVrJkEUhqěyěgMgnVòùkXlilD	FALSE
èwùrNzBEBǎǎpBVuFSáWAzwǔaǒzSyèòǎZZègRffBkǎWVSnèg	FALSE
ògkùXgupaěUxmqxryBemZěkCUQcdEUrOfWIjBhrNJéxeaěS	FALSE
APóIǒúeyHùoQwyTHaJUKóFiZHǔòRqjTADlaònzKHYGbNQZk	FALSE
CUYoiMkeKóIXǒěǒdùǔwXpǔvsHiócYeJuTaNiùhqiuITeòǎP	FALSE
FětEàTóXlóFAVQáPFmTJúǒeùfRCǒOǒVǒFqWRǎěoVLSDnAFn	FALSE
HrvXJhàPLáLIéHnzkáǒmBbjBewràzCUwómǔyXJtTiǒnWlHD	FALSE
KdfuJeoHqjúFBpGglásgVOdOUJyfCzǒRMmnfJuqdKěPgulQ	FALSE
NasbouǔfǎnAùFsjPNPóémTǔlxùEbúpqkAéGUGqSGaùètgyM	FALSE
QVOEvǒSSwlNlúPFòLAhxBjUusmáúWFmxúóTearbFSlvCeCw	FALSE
TéMwPTOèinLàewpòkPGTNeClóějbúhNFpkuEkòYtgrjDaSǒ	FALSE
VKRJsNTGàiZqSúWaNúLcǎónqNǒHSpiǒfNQNbhNJápǒsCQkV	FALSE
XkmYgAUùarCRFwoéwGrvNLóiZfZSpOFěOXǔOLBxúYDxúǔio	FALSE
aFPúJyXKChjTTisWnǒKWLHáKMLěZKǔWàuXAáqNbdoJzuOhp	FALSE
cmXyDGàtǒútùKjúěeotWMóǒèyRtǎAjěTGOlgiàjěwuABrco	FALSE
fòsTZrrtVvmómxsnMQxNúvsònGYGPcěNjdDFakéhMqNcuòQ	FALSE
hgRKòdFbSWPAdwFTBzěótjQbIjlTǒEMJRVjǎVBFaFVevRòZ	FALSE
kèZQbGWmǎMpDEQǔáGSzéNùZxbXédégmbePNTrLQIùOvècOQ	FALSE
mfoUIQěeKHsCPyfWpUvKxǔlLMiěTKEcéjbaPmiPKArAòéFě	FALSE
pMhbAmúònkvzáCsQoéaQmOeúaUcXǔWojPkèècmznbdCRèUD	FALSE
rumwiZEòDěosxqzZJnXwYQǎkWKDbBúóUerWJxiòLéhMUmǒK	FALSE
uMHqrQUǒlesaBAdcTóǎCfòúyRóiYYebsvGAlDqwúIkzRpaT	FALSE
xàóǎcNuqBòKGmlnWZFsqèVJcǎmLěPyóGáAúiEǒewSIòzòeH	FALSE
ùǔUWwùEAUùúCxáǎWIǔCGúnBQààrGZpxfmWáfYHòRYǎHòffH	TRUE
áeVfxǒaarywVúxQFtzRvQSwZHFBzKéUaUsUVWRJǎzLRadCZ	TRUE
éǒKGSXdTqáSùǎǎláDXeěelàLLOǒpèlúeHeJTETaUCLfFbsò	TRUE
óàIèHióaPùěuDNaSèúlXEVVUaazùKWóSbǎàrmgòéaGúvèàO	TRUE
ǒXYèugVeeoeǎebǒùdBCoǒCiNLéfANFáǒaphpnyyUfXOQcnà	TRUE
BMǎTDSaówlNJAFúFaèóaWSXùKMCaveéǒáFfyxèArRkpéiǔK	TRUE
EéUSǒxàcPKǔéOaájbáobOsěbrvUStxYnGbKjqzZěVǒgǎyéT	TRUE
GMwiGXJashdgZRoPMDMuèqYMDjYúFùtaYéKHpebbbbéTúMM	TRUE
JěJVvreLYSPOReyǎFGěèuBlRppTPéUYFexKpUtǔùekekyùc	TRUE
LcdtNYeYrǔIeTeǒpúTZeZdZOGyUǒfuQáUhúnNDKyOsòǒtJV	TRUE
OWǔXRóCFeAPnYCLwòvqVeěNeedUPNúqvhADèrǒbKKFGXKGj	TRUE
QtSRTàAyeBùqEòPzVgaqátTlAAzNCOhǒsZcPěccQcùFùsùc	TRUE
TàyqbDODYtbǎáqbbGZyáTMPzRwNKPǔSLOùQWúwUYWIáaTdy	TRUE
VUWVqàiUCUORyFěgmJeěLogeyeQqéeesjczIóùáICJǎqzàc	TRUE
YúETpèRuQGòzDpoyGMǎfdrMxrncòccpQcènáSBrexSRCDxH	TRUE
aalHarCKaàYDwZeětòwěPNáMěuLǒpkEmAARSDozAAAkiPpR	TRUE
cbsKvhUMSjǒBaěéKEFfFMèJsXóófOJáTAéTěAxffDHaMcóe	TRUE
eXxUyhlVaaéuCQěéQaaugGuWwKǒRnsěkHdFèorYJàógrqNQ	TRUE
gRpLèdLuJdJWdCWvZóàqèAdnjceádjaùXǒeěUSGMFváMDej	TRUE
jéǒsgáHVYKjoRèègCtYBrGWaGKCgómdRNdYRADDoPNdFdhù	TRUE
mOèORdiERSzHwmwOyXtymfnJǎszCPjfěBrJffXMfǎxáeFAá	TRUE
ojrbvDXgeoETKVuxXtEaYBáéRcbbblbgaHbHfLwònSkaVoP	TRUE
rdáUIddGFǒMànWLBBZdjòuYUNkmZNnyeèFOAFxbxSwAiewO	TRUE
uùbDtěǎJGóMXOcǔZMcPcTwcHělNJVEǎtYLǎvbCùDAfdTCll	TRUE
wpUpóǎDocótěǒBKvJIncVáOwXcscbèDiǒppǎòjbMxòCwREd	TRUE
ùàTRAPkRLzLGXMkǒSXpkOOTdóòMiRnQúǎpàkRFòolěWUtirn	FALSE
áahrNNKMaBBIKǎùRYZMFǎFbBDBwhúǒUòdQFùuTùSàWKMRaNe	FALSE
éàTrfqagJópkèzǎWòXLkkǎdSriQBRmXVTAxoětCséóuècTCO	FALSE
ěXgcIvGJǎwvùGdSetSbMhùMCEàYpqWàJfQTHYEnvcsvmQsin	FALSE
ǒGhmAxsYèIiBeLfktgfèòZúSlKèQMOtFWoóKrWaAwisHJJóù	FALSE
AakfHZdpTqǒuMOhcòkEUyvVFdLbgVVéUrGUIGMbAHqókùjUA	FALSE
DXGDnLéyǔmswChqúMTYoòBGapOKàfHBrJéófiifTáNUzkBtU	FALSE
FnCòbYǎoSxzWToyJuEhégBqcZJFwráǔskaAQkSCDfyJocúaú	FALSE
IWdsǒfoBEApwUóéáěiEiòfZBZKWǎMCqǎgEQnVěxMcxúGRvnP	FALSE
KzqwHwNqBǔUcóàeGjRdmGcQsbèòóTdSkmPeDiùfCTmvàCslm	FALSE
NMHKRpNhèupwseLQmISZgqáèVèǒMuèdHǔXéBésúDHAfQzVwF	FALSE
QUPWiPsiéméSáGFJěhGqédbněolTRydHcGóócbQWQJOùppJj	FALSE
SlòjmubapdjqgNfnRálYwuǔYéésgIERJǔǒfàTwhǒNèMNfhUv	FALSE
VinZTUxUFsdTgmvdkcXVOjDaòiimEáQPeWèJYYMòLJúuSQáh	FALSE
YNLJCfVInàvKEvMúnnQòáLúùéFYKHHvcLZVbBZDIqraGMDVI	FALSE
bóTkOFxgAACqMgoxqbFYVBPǒèMOGaWwǒBOàAuàzwwpǎúkpǒg	FALSE
dbEáhúbuoǔYèPPàiDTSOùBNatAAAèGulǔyCgQETZZGMválǎó	FALSE
gàbárVǎjùcKeprrAùOGAóvWjLJIUhGXJkxyǒUtnzlóBOjMBg	FALSE
ibwthrbNvtuòéhkQVuoiváOCIJPWpswsmLhkHYAúYrpKùmgá	FALSE
kndKhZmXyěAùěylOrUǒXznHPrvZRacàtBvòMskúùáòXòqaǒR	FALSE
nLùOMǎDNàjèiùùùǎGxqsXpáSLxTcRǎNHUPqCBLpykZgRúvEǒ	FALSE
qàaxrbǎiPBèěǒOábbòèùpǒjéǔptaǒòGǔúZmnrijUnasHALZu	FALSE
sJImoMmgLJeoxVxgwGGnRhOOXDkkFúQRWòeRxCSǒóódpóiNt	FALSE
ubvúégéRkuVLVúSxúdDVNzéwYmRUěnakLtCMVGóygwrBXSSf	FALSE
xǒAvoIxotMJWmèEyǎěWlyùèmPoByWèYiěpWúàltScsáúhbWa	FALSE
ùùátKiVuvǎLmbmeTeeITRéErereǒJvoQFtpdfPúMèLHdSykó	TRUE
ásJZzàSumdahjOóbuǔbbNóSpúénTóDùWTqbqGhWIIuaHwqef	TRUE
éǎTùCFHIBKoeěZDBelùqeIBqzáěáèKpúǒWOeòCiuóóaúrghw	TRUE
ěZMOsáédǒPǒóóBWneuAelePǔVrFBLFlehbRFápèOàLěǔèFdP	TRUE
ǒàúèmKFWsDGjLájúiXúcOgbeCóweǒeRèMeOaúAEghfTfGBèI	TRUE
AZRhúQúvòDnlwàúRCNVyttYGpèròHaygzbbpYbPvZABbkSHò	TRUE
DDzxguRhkFGTyeIDrJnHAfPasaBmóòěwYáèaòXCaRrkvúoǔE	TRUE
FopǎJczLmMàcTpqmQěrtoǔZcupùFAFAéǔèEéJcWǎSùCSZqXù	TRUE
IcerFDHHwxěaIzqGWiHIúnQddDdóěéXpdLclǔmùtéRòMúqxI	TRUE
LHFlqeEǒSkzTHHégGBaNBawǒaDóPCTKxKKaeqqèKZěQlZǎBó	TRUE
NlQXbéhvIkKógKvaufddLwéwPódódéǔkkǒóZùkqpáráiyxǒq	TRUE
QQWbòoǎòuéǒTsObbDbòmYdótkúfSEDeNIúgbylWXáIASgéuy	TRUE
SxUXnèáǎpOVàUddNddSyǒsǒgCèdioǒèǒwJǒǎERnúǎNjàIvxI	TRUE
VVTLkbpěpmcRdpddZILéHZMdjUFVOICRkpOzòfWǎJeXUDǎhè	TRUE
YSksLPóězXgéǔRuPqzkùTmFtJxòoqǎǒzáfèfDúèfèmzfQFèR	TRUE
aiěrjEjmòWdZLWèYKàdlwxTdxJléǔIltzděDUǔévèwnxwsěè	TRUE
crnPiLavaJDpVwTSHáIBěáUOZLMúòaagYIěěXGTbhèGNǎreK	TRUE
elyTěùbaBeaqskEǒBSADheseàpYùáOeǎesSǔEygSěTPviIaL	TRUE
húáxěeXGǒeoLVIBEorsrExuútYOeesfèǔjXnbǔZnhtHnieZv	TRUE
jseqróǒmlDùVaTCGYWpDóéèWhVmdUFdydǒdèvámvQHZoHQGN	TRUE
maOǒéPlaoùTJCraautgièZKjOǒěORélQzrúVásXKPUiěFQCz	TRUE
ozWQmóEtFITWjPǒccùEěǎlcWcYWBCEùaòǒXpwpBRěwòPBAip	TRUE
rwdYOPJǎYddtPǒòOXdSHjtúǎiVáiMòúnKèVùJnǔblWXmǎMúb	TRUE
uHbbNahrcctyěcxvnoGuHQvZpGěImcoROmgfOSvOtFtwtáxX	TRUE
xàkMjCViVJUekǎVULPFNPauguqCmQKFuQcéccǎlXZáQcEmnL	TRUE
ùùóNQkeXsYkeRwgjMPUéCeJiZcTLéòUAGTúvòrQiciCSMsqeG	FALSE
ákuKVjQHdqtzYSGfkmqRèbRàIàxWESAYqqěpjtBjBJNrUyrGW	FALSE
éGVùàpSwCǒMzGhGǒbnxQbcHskSqslFxryPTXúsooSààuomEúH	FALSE
ětǒPàùtxNcQuWvààrróLàǔcNyXzHDldZgèCINgPtujQVfDTgn	FALSE
ǒKNRRàronúUCPùǒUGUpDqTwLqibúNéWPQdVKnHORTjlLcIyJq	FALSE
AtEdQWSdPèBwwIdcJpdáSpQsèPàEMMcZKVěKùúmqNdaláàuVà	FALSE
DQáWUlZPToòiuFpòLRHYgpfdSMyrLěESiGkǔvoBEfawfúfùrǔ	FALSE
FwcXVuówHePfRPàǒKBqMUowózfJeDSěóiuPFopYoXNQmzmàóò	FALSE
INgVrALzZupRaxòdCogǒYtaWUnCkNhMyUBóúXùGCxàéuNáPQt	FALSE
LQèòTéqàukéljǒpQqIqHyéòOdTWěhTlqosAáweYbeXUGeIIqj	FALSE
OKnrPRàhMocúfJúsXǎǎǔGgPdàvúmóGEòCloKQGXneáFVǔfujn	FALSE
RùawòNtPàlùAxLXNjúDqSbkéwuǒbLěǎcvYrEuneFStOIAFYGu	FALSE
TYiTDlTkSuàgVǒòǒUOnkapuǎcKgǎaNYslkPKsVsXdJCClúkOě	FALSE
VzOkùFHúRREfjúKWHcHǔgǔXrPtkKyhGFZLhpùóKKèeFlUSSàW	FALSE
YGSicwtiètgmàANgiVúásàfáeoúrWtócHMHbPǒpObRkGPXAZi	FALSE
akTAdrbòejYsnfXZsDBMDRgKùSkQYpCXbúǎsnMEǔpǒpàNjǒCH	FALSE
cttúòhaDǎóóǔfoJQRljxǔlxUǔYFáFlQKaHAjPDlzáXbakUrjà	FALSE
fDióuPěěǔsENnénéěaObWáODQwhàKNáFRxFoBLeaèùoqBpTQE	FALSE
hmyévbTIKMXwPbrbjtEsgWnAXEakmNǎóéqEHrIéǎQIǒfzlèDm	FALSE
kZMtJmUXóiúěHktǎGúbǒadMUùpgáòfrDQsnYòiSówytvvǔǎyp	FALSE
nSyèVNúòCvLKFSNMégòeBgtOMIbldéǔǎSǒJwqǎuxYòjmóETěi	FALSE
pjSOIDVNqyzyóvhnJVěNfKQsògQccàJXIcwúdfykmánSgcIaJ	FALSE
sDnUfmóxěYEIYXXFSBnyUnmgYjgjGPzMRDewDóooFWyGWZBǔP	FALSE
vòùziǔCMǒmvKOOKztzǒeOasòdlHTwǒBaQNuuúqàFòpSvHiwdC	FALSE
xItwVwiVfHáRkAóákPDgKpiòǎYuiQhèdgBAǔòESěNRóuSjzXá	FALSE
ùùkICTBGxBMVDvpERóOwJǎpaLvǎOxaYhpKGbáYyúúJJǒbbwbF	TRUE
áIcIfPIYhBégeHmóòHùAnsbHWnbYRTbGtbáINSXǔtYBáǔnzTl	TRUE
éǎgKNpzpaccloZNráMZècOrèTRAzmmcLhVSeǒbùGysIXUosDl	TRUE
ěIǎKkJcrhAhMQBèǔwLsxuVocùcBvùpVvàMGcyDvWcdKXěrzgv	TRUE
òsDEUiǎRtGdFFOuddlLqùǒlmDUǎtCdXcóHàVòIGQPrKětkybY	TRUE
ANubxqMhNǒóěPXéSùLAfNaaamaGUWCgooUKJQrpúùFèěeagbǒ	TRUE
DèóùKDMárdPHǔFLHuCwrDvǎwdJùTJRWQVdTdSOOwáèèDAòBQE	TRUE
FnAǒIfǒyúùǎCPěwfKfámossxWTflábsoKàMyJacúOofOseJǔs	TRUE
IYxcdDavCTUǔfùEéòěkNHddFrvrXéOnddgmBLZqgQSYfJúiXJ	TRUE
LRěowRefopIymxkHRzlxvPfǔTCǎùYfzúLTǔfEvunfYOěěTǔYa	TRUE
NqjbtsàxJFsPLàXgùvEuVlěTdEflfWǎǎRSfVWfcmAnueèěǒòé	TRUE
QKàùKVmèCOuRmYkEùZzbVBurTEěqùUèùYPtbóWKbbuèàHdJSV	TRUE
TóYlNLPsDòǔSKYIfMàyèfófKfKgKmxRdeKYǔtGNOFKNǒNGsTà	TRUE
WGzzCADMkCuUAIzoěVgěwidnDwèRJhkGMHHDdDNuWdXdòKMdF	TRUE
YuJAKòtǒiaóǒgjtGqEUPaVorěTmpJodbrbtbábMXgSáZvwidǎ	TRUE
bDKQEáhsrLjǔWIjrKbHBwBáNmóIlHGuPǒbòxwBHCNXQMQrébb	TRUE
dějKHSdPeWlěDGAjMdSuGlMlGWNLádOoXImddCéyhpuaqqmEb	TRUE
fǒoòúXzfIpúPoUfófKOiwáXzItBrěExwmmsěSkùKǎsnzVcCRu	TRUE
hBréHèPqǒrajFèweèuanODBZéáaaòorKNówxèaXbRTpòǔèCke	TRUE
kòznfQǔFBfufGfùCúRHcpéZròrAsCgCIixdtǔggěyRiovXájE	TRUE
mojnéHahǔúVEkcàùcEGDcQpLFpcGBqǎoáěàyStbrUGYmYkEJI	TRUE
plóXǎRèQKVgùmfDLbóLúTaVyffSBJNGnfLPCáfNdSGNwjòXZǔ	TRUE
sPAjGirGyJdǔpàǒNikQfiMǎnaaěrǒWaGLóahòtbyhXàZaycèb	TRUE
vǔFbùgTVòǒutkTaǎREèGOnúDKEzǔYaRaaduMjmOrKOXWUSvIT	TRUE
xXptxeIóěNPxQUóSfaAMàCwtTaapèòmpymnéanqòKáěpdJqNl	TRUE
ùùqRSZáGqwjoòyànXuYSyCyxjWkCzGóàátáhrkqvremUtsdpNV	FALSE
ámDJéZAfàPéǒCnHSVǔfyWfFIdjWpKseóNYGsulfvHJFMKùsyJb	FALSE
ǎtBùgdGQǔatYrIZpóPnrRóHTèNpórěCBNǒpyRhyRuěkZUNáJéC	FALSE
ěOKùòAkěmcpúcúSPkfEvfJDoǔlXǔOeǒòzgAItmcQNOǔIQǎpoǔB	FALSE
òlváRCěZěSeuéondáǎdmdCkǎXiysuGOoQFydHěcBòYnhyGàqAQ	FALSE
úvGFúMǎMHApjCDlrrLǔKúFJLnúBLfjFzolXMǔRZDcVXbnJylOS	FALSE
CECFǔǒCgáNZYtwPszěEnúMZNXAzjVqLVGYQFVjsQclDháYgHWR	FALSE
EtGjYBkDNyfxOSùMOXAvóHPPZuHèDfcàIMěèqxdWuòjVaZúCwk	FALSE
HKWǔlzFDWEcICNděqWNXolbQóOhàdPeplóúApemófAeoFùkǒrB	FALSE
JwwFJkkgFRCkěrVoBǔAnwòlKhpBumPrvcpúmvQèéOlěZZpJwjh	FALSE
MXVxXOduPDMaNIZùapprméLLèGèèIoǔǔEoDIcimPIFkELBèASn	FALSE
PSězsMèbǒPJtUOeàLTǎgWYúJVFODIàétàJCàěHatXXděqffOfk	FALSE
SGRzKǔiuQttfGdrèeóGqǎXkCTgctGàMaTǎèàézEqáBqiCoamMJ	FALSE
VMNóùeBLjdFěWàLKEQqmsVgXáAXAfQycClPpEcAVUPNNzáIoPD	FALSE
XeiPLdXbVPkKdjffěǔóǎéGfPqcGcBHGDùyùéByFlCmUiEělpVI	FALSE
agzxnZSóYSiòXuNfvsGIACXwàZBpèǎǎǔZMVTSErǔǒNefǎòYqTl	FALSE
dFdZǔjOiGGCzlèQgěmproltěwZěqòXKCNEùBhCFǎxHéiXǔàlIS	FALSE
gExSLAJfgfNUsáKRóWyJyUsnSóǒMTGugqOuuóùápKPQJmGtǎéǔ	FALSE
isCFóYHuyMZOaMUAbTrxOúwQGjxěJHáèXXVWsvdrUùbEuMěàts	FALSE
lKkSájXyETOCyuáPCùYjlwCǎNzúnSwVǎMzJDmYhJráàDǎJmrEH	FALSE
nWIamYhMIóUéàévALǎCChIpeOUxKtdúLàKIqSvběǎGSǒHYMmvó	FALSE
qéúLCFùàwKLgrǒXEcvgǒYOIǔDáCWXgtUWLirMPVěǎFqepYWxLǒ	FALSE
súéěnqòqǔHfovCtBúcHMóTéjgIBèAkKMáOùéPféǔéóCNYósúBl	FALSE
vàNáiMyGSfàEFèPfmtéAvaMPvòAxUAUgmPdmQIQSSfpǎáDIóvó	FALSE
xeCYòěbXsMrjIcáuzcxKjlaoOUndufbWúěàziDiàySóLTóFqYá	FALSE
ùùShòiòImrIwàfmběbVpGYSvbǒǎInOOóBbévIGtǔSxEWdEEòJz	TRUE
áyCRxěMScàKgSàdNófaVǔLDzOaaBCaQRFoujǒétvbEàéèFèHěm	TRUE
éeFbpKNlkmIKbybWbIǔSmIbDXgCcYèǎEygswdneùgégqódòOAF	TRUE
óěqZùnnàtFJjWdcDWLIuQsKFcáDSJultHRMCPáǎpxsèEcYVcrǔ	TRUE
ǒqǎjNdKLAlwdUqxdrCǎJtKKmEldèjWǔjrPQoJQúTFDQgRsFcèR	TRUE
BbéǒONYyobbbvùjIǒNgǎbAvYóHCǔvAIgbBsDEusAhGPáRvǒXfǔ	TRUE
EFogLATàúùktluBNPuyXypdaNWaUamCFòafNZjNUjyáYéIfgGg	TRUE
HGsbàZeoXcxxcWùqAMáATcWciěwPǎkǎhFòrIhVvuSoniCěúdùF	TRUE
JgwZVóKǎyHálǒyZáyYIpgebppQjàYXóWrRAócGFcZúWàcAurPc	TRUE
LwVǒkracqYcQSHCEOxNctmcGPptFúúcalcTkQPCcǔLgRFSolCi	TRUE
OMqbèǔFRxpgVbòmJwzsàRRvWùQbblbkfIBXmUúUmócùXwDbYdL	TRUE
RáCNiXdekDaaéaòXǒàEàDaàqfxanzuQjBfBDWCZHSàYszCéGPH	TRUE
TcrVWReaèPWNóLdMMáěDdvùAtdXuéBYowéEápKApódarFqJWRǎ	TRUE
VcǔBǎVwfARJPZVaéměúaxBaYáàXDǒXRvǒnaAàhvpRGzlXokFjé	TRUE
YKkgZWpaVéhjfcycctsqVvcaáǒFCEǒKlHékèTmYécYZfEuBaQe	TRUE
ajosUfomyEěqWyěnàJLPcAoXpǔEcOǒlOcKcújlwanyGlvBcifV	TRUE
cucǎcEǎAAScǒyyMVKxàáFPòRàfIúǒNúLiUCfCZivóGxgòQSMgǔ	TRUE
eeàteXDKQDOeFǔIYcitǒJàápòEWDàwfmhmiApxDádetSCKiqOǒ	TRUE
gdécààóǒěWGácYócxěWoùWFUcZFrPGHcgdáfXkáIpTdGǎIǒjǎI	TRUE
jffCtùZJèfmEfXarùjDǎMǔPccévIykSnWeTmGKRFmhdǒPbDOXd	TRUE
mkWddPZQdémMdOxKválóWbWàǎěDZSjLNWWtmǎUáFeSdOcIerMA	TRUE
pojFJTRpZdàAmTXISRTztqwdMddǔZiǎJgǒdjDPNáRǎSěCJUǔef	TRUE
sJpkěRbmEzIùZǔPGùtbsmbJéTbAsMHFSlprZéITqnfàvCòEYǒV	TRUE
uiQKNxryHqQéàwuMǒYLcqccnoOFAZczǎfUySúCmMúnRtBězdur	TRUE
xEUELáàòEAǔGdxméSXXCprnPTdǎwMsCddùóGvHywběRùxhoCQg	TRUE
