ùùQKldLèNǎmkHvúVxóbè	FALSE
ǔWpAfEKIǎcùnnGRWWicǎ	FALSE
álWtJòrYòkbjaRIáicKM	FALSE
ǎABérwáezIkMCfCàáNdg	FALSE
éWúǎdvbgǒměxkEbOxOmO	FALSE
ènrGqěòxNXfMǒúbděEǎt	FALSE
óúdmUòvhlEExglmKjòNV	FALSE
òaIOYùúTmAJToúFEfEúD	FALSE
úǔUjLCdPJjGùTkTzMisT	FALSE
AIoBdkwUpHèYkMIPxotz	FALSE
BpjzGWmGbbQDdkhSYgUS	FALSE
DHWGXgInGZqùdGIaBKOT	FALSE
EcqueònóCpmOphRéXlnv	FALSE
FvIGLLEtMSkvaHIàwdAj	FALSE
HEéágiaěJmvESyèZómBP	FALSE
IZajwCqhhHRenceǔèúfò	FALSE
JnLSnàjzqHIAǎBWpydhě	FALSE
KvaHlQNPRólDtáJQiGsH	FALSE
MúDěpowQZsrOVàsMciún	FALSE
NWǔevOàèFxxDzdJWuXóS	FALSE
PǔvOóoěLNǒXcyOqghCáA	FALSE
QǒAYdUbémYbǔfòGqǔsóù	FALSE
RWaòBawuOmǎOáaiOáOgD	FALSE
ScWUnKVzDHSKeOvLfLdb	FALSE
TlǔCcráorpVèrHiEVuEA	FALSE
UtYAdxgTFǔnqǎAxBFǒnG	FALSE
WòDBHfaùgcMjgScYefùr	FALSE
XXǎkDgcWkMóVxoóǔyBcg	FALSE
YeqfNJVmsGAyMcjùǎyKv	FALSE
ZsCdPpUKWNrSiDnKFPQe	FALSE
arHzczědAFxKKIǒInEmS	FALSE
cěúFRjhSwONWàIkgmOLP	FALSE
dèaWUyWvOFRfvfEvoOWQ	FALSE
eùWKGsoltETQSCǒxDǒúa	FALSE
fǎzùcèVCěliòcucuGSPE	FALSE
gaTOwèàuBVdvèqsěkrLv	FALSE
hlcDUcjRQsyàǔxályJòF	FALSE
jCsXǒJeqpXyPQVwóscnP	FALSE
kTèAspkStméwNqoRǎwDb	FALSE
lnZgEèPLěWxǎfNQdéúfn	FALSE
nǔJéSdǔǎémsfyúVyǒóKé	FALSE
oLNmùHTMkozLùxWmtècY	FALSE
pVxfAmúHjzcwTǒYǒxpAV	FALSE
qqbQvEYEyGJzvééKPǎyJ	FALSE
súvcùtyGěIJxuIfúdgRǔ	FALSE
tLhfAFDěóǒDXcáRXMGCú	FALSE
uYAxHoǎbaPéLǎqòoqáaT	FALSE
vuámedúǒCxHaǔHnIuWxv	FALSE
xDxDAKndwoéDkaugiiOp	FALSE
ydqóeQUàGNfěàBHùjneA	FALSE
ùùQKldLèNǎmkcvúVxóbè	TRUE
ǔWpAfEKIǎcùnnaGRWWicǎ	TRUE
álWtJòrYòkbcaRIáicKM	TRUE
ǎABérwáezIkMCfCàáNdc	TRUE
éWúǎdvdgǒměxkEbOxOmO	TRUE
ènrGděòxNXfMǒúbděEǎt	TRUE
óúdmcòvhlEExglmKjòNV	TRUE
còaIOYùúTmAJToúFEfEúD	TRUE
úǔUjLCdPJjGdùTkTzMisT	TRUE
AIoBdkwUpHèYdMIPxotz	TRUE
BpjzdWmGbbQDdkhSYgUS	TRUE
DHWGXgInGZqùdGIaBKOdT	TRUE
EcqueònóCpmOphRaXlnv	TRUE
FvIGLLEtMSkvaHIàwbAj	TRUE
HEéágiaěJmvESyèbómBP	TRUE
dIZajwCqhhHRenceǔèúfò	TRUE
JnLSnàjzdqHIAǎBWpydhě	TRUE
KvaHlQNPRólDtáJQiGsHb	TRUE
MúDěpowQdsrOVàsMciún	TRUE
NWǔevOdàèFxxDzdJWuXóS	TRUE
PǔvOóoěLNǒXdcyOqghCáA	TRUE
QǒAYddbémYbǔfòGqǔsóù	TRUE
RWaòBbwuOmǎOáaiOáOgD	TRUE
ScdUnKVzDHSKeOvLfLdb	TRUE
TlǔCcráorpVèrHiEauEA	TRUE
UtYddxgTFǔnqǎAxBFǒnG	TRUE
WòDBHfaùgcMjgbScYefùr	TRUE
XXǎkDgcWkMdóVxoóǔyBcg	TRUE
YeqfNJVdmsGAyMcjùǎyKv	TRUE
ZsCdPpUKWdNrSiDnKFPQe	TRUE
abHzczědAFxKKIǒInEmS	TRUE
cěúFRjhSwONWàIkgmOLa	TRUE
dèaWUyWvOFRfvcfEvoOWQ	TRUE
ceùWKGsoltETQSCǒxDǒúa	TRUE
fǎzùcèaCěliòcucuGSPE	TRUE
gaTOwèàuBVdcèqsěkrLv	TRUE
hlcDUcjRQsaàǔxályJòF	TRUE
jCsXǒdJeqpXyPQVwóscnP	TRUE
kTèaAspkStméwNqoRǎwDb	TRUE
lnZgEèPLěWxǎfNQddúfn	TRUE
nǔJéSdǔǎémsfyúVyǒdóKé	TRUE
oLNmùdTMkozLùxWmtècY	TRUE
pVxfAmúHdzcwTǒYǒxpAV	TRUE
qabQvEYEyGJzvééKPǎyJ	TRUE
súvcùtyGěIJaxuIfúdgRǔ	TRUE
tLhfAdFDěóǒDXcáRXMGCú	TRUE
uYAxHoǎbaPéLǎqcoqáaT	TRUE
vuámedúǒCxHaǔcHnIuWxv	TRUE
xDxDAKndwoéDkaugidiOp	TRUE
ydqóeQUàGNfěcàBHùjneA	TRUE
ùùUuKLǔhypnNtiNigHiǎb	FALSE
ǔèwcgDèFQsJéYcrnBXppE	FALSE
áNsZRbYJeErypRicédIeX	FALSE
àoPlMòybpútóUJúsgájaw	FALSE
éáàrCházyOǔOfiGSǔhaCS	FALSE
èAǔmòLèpǒIyééhsibóoff	FALSE
ěQTWólJctfHZiáǔdàKúnH	FALSE
ókItgApGòLoCǎibRóěsNr	FALSE
òzYasǎEsǎxRXSIACóúdBZ	FALSE
úOidHhòVLesHHaPròZogù	FALSE
AfèbǎJPhdeQkgěòXléSZp	FALSE
BmgúudohkBgPuIeYjùATP	FALSE
DǒxAénJYYzhpácùècNJgs	FALSE
EdCNnGSZKRkéPWDNfyáǔY	FALSE
GèIGáFDWCéWvkawaONVùs	FALSE
HQùáViPzbǒNUmiFzùixUA	FALSE
IsEòMwupVBUskGvúéuǔcz	FALSE
KKUjdALMěěkjiDVGeXzYy	FALSE
LOUǒvièsMvWúpDdebráhm	FALSE
MpLZkZéPCmPeúCfbZéúúF	FALSE
NtBòOAgKFPhráTPaTúzpò	FALSE
OzyǔgQèynvDIrUěǎcxmAL	FALSE
QRAiUxkzEeHjSqidIRtbC	FALSE
RccèKfLòkǔILEKàdXKǎKo	FALSE
SmgeIJCJYFǔiáBLzYtdiS	FALSE
UáKcSeADúǎoáLèǔNHyOùě	FALSE
VéézrNWVRVǎesUbògJúbú	FALSE
WKùZTLdIKvKàóXánjfLiY	FALSE
XgHúaVTpZóupeKPOPáǔia	FALSE
YrEǔwBIWXEévqJòGDèKzc	FALSE
aójRzfYhóESCéǔeRLCyJw	FALSE
bánkjZnéWayhnJUBKfHfu	FALSE
cHùkxPVxHǔwNHUhRDLbǒú	FALSE
dCnqAétlHiFxǎsàǒUyKeN	FALSE
eEnWdwNlzpoáCCYieXGwr	FALSE
fhrXǎLbWáaqmvdFLǔTKKG	FALSE
hògòVZCCfJeUúùwltbikR	FALSE
iUákdézQYǔěFUGjGHàXéò	FALSE
jeéDǎǒDVnmjwiámIFcmZB	FALSE
lètbTCLsyEkRCMgèdYGsé	FALSE
mMdpDWuèABVùǔKXyKgBLO	FALSE
noXjzKvcvTbbWóEwVrvtr	FALSE
póYpEúmPtjAcǔestWQmYA	FALSE
qQtzgFGRéeMKbPqBGsxvd	FALSE
rkdBààHéYBymajmMálúHg	FALSE
téaPDOéǒvúWGLvNPhèsùú	FALSE
uFXEeEèQlnkòùúàajDJtn	FALSE
vTqJQBdPvZuèZTsAgixqè	FALSE
wwàóYǒèǔqbytCúTzolVcé	FALSE
yLQhatxMnBqOGCoéóZRJY	FALSE
ùùUuKLǔhapnNtiNigHiǎb	TRUE
ǔèwcgDèFQsJéYcarnBXppE	TRUE
áNsaZRbYJeErypRicédIeX	TRUE
àoPlMòybpútóUJcsgájaw	TRUE
éáàrCházycOǔOfiGSǔhaCS	TRUE
èAǔmòLèpǒIyééhasibóoff	TRUE
ěQTWólJctdfHZiáǔdàKúnH	TRUE
ókatgApGòLoCǎibRóěsNr	TRUE
òzYasdEsǎxRXSIACóúdBZ	TRUE
úOicdHhòVLesHHaPròZogù	TRUE
AfèbǎJPhddeQkgěòXléSZp	TRUE
BmgúudohckBgPuIeYjùATP	TRUE
DǒxAénJYYdzhpácùècNJgs	TRUE
EdCNnGSZKRkdéPWDNfyáǔY	TRUE
GèIGáFDWCcWvkawaONVùs	TRUE
HQùáVaiPzbǒNUmiFzùixUA	TRUE
IsEòMwupVBUskGvúduǔcz	TRUE
KKUjdALMěěkjiDVGeczYy	TRUE
LdOUǒvièsMvWúpDdebráhm	TRUE
MpLZkZéPCmPaeúCfbZéúúF	TRUE
ctBòOAgKFPhráTPaTúzpò	TRUE
OzyǔgdQèynvDIrUěǎcxmAL	TRUE
QRAiUxkzEeHdSqidIRtbC	TRUE
RccèKfLòkǔILEKàdXKǎcKo	TRUE
SmgeIJCJYFǔiáBLzYtdciS	TRUE
UáKcSeaDúǎoáLèǔNHyOùě	TRUE
VéézarNWVRVǎesUbògJúbú	TRUE
WKùZTLdIKvcàóXánjfLiY	TRUE
XgHúaVTpZóupceKPOPáǔia	TRUE
YrEǔwBIWXEévqJòdGDèKzc	TRUE
aójRzfYhóESCéǔeRLCbyJw	TRUE
bánkjZcéWayhnJUBKfHfu	TRUE
cHùkxPVxHǔwNHaUhRDLbǒú	TRUE
dCdnqAétlHiFxǎsàǒUyKeN	TRUE
eEnWdwNlzpoáCCYdieXGwr	TRUE
fhrXǎLbWáaqmvdFLǔTKKd	TRUE
ahògòVZCCfJeUúùwltbikR	TRUE
iUákdézQYǔěFUGjGHàXdò	TRUE
jeéDǎǒDdVnmjwiámIFcmZB	TRUE
latbTCLsyEkRCMgèdYGsé	TRUE
mMdpDWucABVùǔKXyKgBLO	TRUE
noXjzKvcvTbbWaóEwVrvtr	TRUE
póYpEúmPtjAcǔestWamYA	TRUE
qQtazgFGRéeMKbPqBGsxvd	TRUE
rkdBààHéYBymabmMálúHg	TRUE
téaPDOéǒvúWGLvNPhèsbú	TRUE
uFXEeEèQlnkòùúàajDJtbn	TRUE
vTqJQBdPvZuèZTsAcixqè	TRUE
wwàaYǒèǔqbytCúTzolVcé	TRUE
yLQhatxMnBqOGCoéóZbJY	TRUE
ùǔTuCcMAHxfnUtqJJǎYAVt	FALSE
ǔVadrhXhǒRRZZlIXòyCNjá	FALSE
ánVijLòqzJocàECuèBSFǎF	FALSE
ǎóǒatnrQFMFftNytSùlóFD	FALSE
éSáIKjhàǔRtbkVùIǔZpevj	FALSE
ècúJixrMáUUWfcěrNDèàph	FALSE
ěvfmssDéATBdDxTYFamáPv	FALSE
òSǒPQEclbòyúIHbòǔDXtYF	FALSE
ǒuáióNdCMIFéúùAGiYxgaC	FALSE
AèolěuěVWHCBnccóuúVáné	FALSE
BMěHTPǒyáòcJkSIneJdOèO	FALSE
CYéjVAvaIFCKptǒfaùEòko	FALSE
DriEMlIgfùnQsdUFhipIZp	FALSE
FáCjDǒjEFWNKèGTǔúDyRóa	FALSE
GJcKceJùnZeèKlGZuúuyFH	FALSE
HUǔEuBFóctùèwWikNòdiǎE	FALSE
InkJpOǎúEMjKxwiáXcIsRá	FALSE
KúdhEJGsqǎyòqEUKnvihěJ	FALSE
LRCFaévgwFlpXMPedúlgàǒ	FALSE
MiNniéIěZmóEváVHcuOǒkO	FALSE
OùQbQdbWFmQBSEáublzMxK	FALSE
PLKsigkěbBUtFKVaQvsZZl	FALSE
QcAbVCKdǎQHǒTèxgOmLlYR	FALSE
RbóéTPaǎsDXukcázěnèuǎU	FALSE
TěQAiofhǔlsùydiméQKèUn	FALSE
UOèfaaoecKOùéàQǒQUevMU	FALSE
VXiǎkTbàǎǔKxFbPlJIGjpà	FALSE
WqàrùScHxlhcbOtLoInDMò	FALSE
YPpěWDuLǒuokWDiBMrwěcN	FALSE
ZalIdkFZàrFAmóòggmúsjr	FALSE
aUtOdèYPnHioXIuZoáutúz	FALSE
bTzasYZWRtlOéfMHgFOǎvP	FALSE
cZZfOyDhVYóBEsNPKǒmzéI	FALSE
dUaNzliǒFqPIOmSuQFqLfG	FALSE
ecYǒpPexmqXòúUXèHNPUqv	FALSE
fpkPoduPlǎsNòaólkLòLMv	FALSE
hòEFòARwáshfzAdǎhKoYim	FALSE
iRéGEMóbsǒTLzgàsùoGGsb	FALSE
jjGbkOJǒǎWLZweUMaeúrIZ	FALSE
lǒuvkóMPKSYpmkpzèsburC	FALSE
mNOàéóàNmyYiTjJNbMZjXu	FALSE
nZzJéOyzWVCapkPIxèiLǔa	FALSE
ověvffNXwmSrZRXBùAPcoc	FALSE
qéDUlecvùwYigATroVSzvé	FALSE
rcLmLgNǔXjENvóDrekTnqs	FALSE
tCFXvégǔǔbSèNxcShCxǔxd	FALSE
udǔáPòpQòúAfCfTPnmóIDk	FALSE
vzfJWVZúébsEùZCRuùrùóM	FALSE
xPhaAtězJBfáDúTéFgZnwà	FALSE
ykdWǒkCPkNTIǔkhǒbJǒJHJ	FALSE
ùǔTuCcMAHxfnUtqJJǎYAVta	TRUE
ǔVadrhXhǒRRZZlIbòyCNjá	TRUE
ádnVijLòqzJocàECuèBSFǎF	TRUE
ǎóǒatnrQFMFftNytSblóFD	TRUE
éSáIKjhàaRtbkVùIǔZpevj	TRUE
ècúJixrMáUUafcěrNDèàph	TRUE
cěvfmssDéATBdDxTYFamáPv	TRUE
òSǒaPQEclbòyúIHbòǔDXtYF	TRUE
ǒuáióNdCMIFcéúùAGiYxgaC	TRUE
AèolěuěVWHCBnccóuúVaáné	TRUE
BMěHTPdyáòcJkSIneJdOèO	TRUE
CYéjVAvaIFCKptǒfaùEòkob	TRUE
DriEMlIgfùnQsdUFhipIcp	TRUE
FáCjDǒjEFWNKèGTcǔúDyRóa	TRUE
GJcKceJùnaZeèKlGZuúuyFH	TRUE
HUǔEuBFóctùèwWikNòdiǎaE	TRUE
InkJpOǎúEMjKxwdáXcIsRá	TRUE
KúdhEJGsqdyòqEUKnvihěJ	TRUE
LRCFaévgwFlpXMPbedúlgàǒ	TRUE
MiNniéIěZmóEváVdcuOǒkO	TRUE
OùQbQdbWFmQBSEáublzdMxK	TRUE
PLKsigkcbBUtFKVaQvsZZl	TRUE
QcAbVCKdǎQHǒTèxaOmLlYR	TRUE
RbóéTPaǎdsDXukcázěnèuǎU	TRUE
TěQAiofhǔdlsùydiméQKèUn	TRUE
UOècfaaoecKOùéàQǒQUevMU	TRUE
VXiǎkTbàǎaKxFbPlJIGjpà	TRUE
WqàrùScHxlhcbOtLoInDaò	TRUE
YPpěWDuLǒuokWDiBMrwěcaN	TRUE
ZalIdkFZàrFAmóòbgmúsjr	TRUE
aUtOdèYPnHdioXIuZoáutúz	TRUE
bTzasYZWRtlOéfMHgFOǎvbP	TRUE
cZZfayDhVYóBEsNPKǒmzéI	TRUE
ddaNzliǒFqPIOmSuQFqLfG	TRUE
ecYǒpPexmaXòúUXèHNPUqv	TRUE
fpkPoduPlǎsNòaólbkLòLMv	TRUE
hòEFòAdRwáshfzAdǎhKoYim	TRUE
iRéGEMaóbsǒTLzgàsùoGGsb	TRUE
jjGbkOJǒǎWLZweUMaeúrIZb	TRUE
lǒuvkóMPKSYpmkpzaèsburC	TRUE
mNOàéóàNmyYiTajJNbMZjXu	TRUE
nZzJéOyzWVCapkPIxèiLǔca	TRUE
ověvffNXwmSrZRXBùAPcodc	TRUE
qéDUlecvùwYigAaroVSzvé	TRUE
rcLmLgNǔXjENvóDrekTnas	TRUE
tCFXvégǔabSèNxcShCxǔxd	TRUE
udǔáPòpQcúAfCfTPnmóIDk	TRUE
avzfJWVZúébsEùZCRuùrùóM	TRUE
xPhaAtěbzJBfáDúTéFgZnwà	TRUE
ykdWǒkcPkNTIǔkhǒbJǒJHJ	TRUE
ùǔIRèùlúmrioWèSnSCbgZOO	FALSE
ǔCxTKNiKfeqCécNǒxdNDàEP	FALSE
áSnFZdekFLtěòQIQluJLYAě	FALSE
àpzUèXIMRRǒùDYzMSǎwaZNL	FALSE
ǎzFCQAǎhpGEYtajuLmǎèthc	FALSE
èJDdvněnsxGàěOHCALPLéMG	FALSE
ěpcCVpZùúnvsMhIqiàògUúx	FALSE
òùSegnEǎQQxEfUóàATZKkcU	FALSE
ǒòMWGPTCcGBMnòOhuèǎyWòǎ	FALSE
úEccjCZiǔmHùáziKNYqGlvl	FALSE
ATúBcBZkàpnbVvGxuWcúzBN	FALSE
BhUOàBsQNúkIaLnzQOatCáP	FALSE
DǎtvlděXxézjHèrOfuúòvǔi	FALSE
ErtasòZúAMkcIftFYhòòFúI	FALSE
GálěpaaBTXvyAFǒgLOCóaòV	FALSE
HěOáèBcDuRSeùGnFRhCfbsG	FALSE
IMEOQIFfdKTjWhgaRNLffjC	FALSE
KàeJtóéádVùuǔOZexéuefTA	FALSE
LVVóebTqqyjmMiqdFfNtDAv	FALSE
MipuyrǒPKcDoGQfFDzáQlnk	FALSE
NyògóFtfaùKtuYRqqeCoXqI	FALSE
PQàfUáSVqgYbVěrytòaDYHQ	FALSE
QgfkFNFVikXquByaDlkweKù	FALSE
RuCbévgOLDdCDbEwYàfXNJH	FALSE
TǒqqzébphAKALdgVtIǎǒJHR	FALSE
UKKeàSqFJBNJqJLLǔdxékǒo	FALSE
VlfISKGGetáèqhěcFDuòPBz	FALSE
XBVrvsúBkcTpEZMDsqréQiK	FALSE
YOMebǒxdCrQaBIDfNDòòooù	FALSE
ZuWbhbNuSXlTCOúǒcrRGòsG	FALSE
aspuOvqxwUóHDRcéOViEhhQ	FALSE
cóOMuBLGkMBNKrDBxéùRCQA	FALSE
dǒlùúXoèùZféúsQUmóEskúb	FALSE
eǒBQeLKXCdCeMgǔèPkóoRoé	FALSE
fHUKsOlgQóRexjaménCBDyA	FALSE
gcWfyCQIRrKNgtyCdCǒzbmR	FALSE
hnvmHhEBsCCrǎdUMSjRxrCm	FALSE
jBMYvtczmFMvpcspsJdlnAO	FALSE
kOàivTirrpTwavǒcUfUAiFf	FALSE
lvyJIèFGùWxdùypòeBVúyCW	FALSE
nFaǔùnZuTEYxVróKhPùéXOp	FALSE
oPpévǒaDZhQmpcǔzèlKXáDC	FALSE
posǎNǔqǒXEiwoWcúùpáYázL	FALSE
ròMLoEEúkǔiázdLlROGVxoB	FALSE
sRàSèyéPxcSAfUbGphClǔSW	FALSE
tgárMaèhrǎpǒpeAwáAVTZǒA	FALSE
urfTPuWgǒEnUǒrUNbaTivIě	FALSE
wDZanywCNsVBlcfvvsZfnǎr	FALSE
xaaXAIlHaPmvtWRúdGVMflC	FALSE
yxPDaYOthNVxAěuòLClgrUN	FALSE
ùǔIRèùlúamrioWèSnSCbgZOO	TRUE
ǔCxTKNiKfeqCécNǒxdNDaàEP	TRUE
áSnFZdekFLtěòQdQluJLYAě	TRUE
àpzUèXIMRRcǒùDYzMSǎwaZNL	TRUE
ǎzFCQAǎhpGcYtajuLmǎèthc	TRUE
èJDdvděnsxGàěOHCALPLéMG	TRUE
ěpcCVpZùúnvsMahIqiàògUúx	TRUE
òùdegnEǎQQxEfUóàATZKkcU	TRUE
ǒòMWGPTCcGBMnòOhuèǎyWaòǎ	TRUE
úEccjCZiǔmHùázaiKNYqGlvl	TRUE
ATúBcBZkàpnbVvGxuWcúzaN	TRUE
BhUOàBsQNúkIaLbzQOatCáP	TRUE
DǎtvlděXxézjHèrOfuúòcǔi	TRUE
ErtasòZúAMkcIftFYhòòFbI	TRUE
GálěpaaBTXvyAFǒgLOcóaòV	TRUE
HěOáèBcDuRSeùGnFRaCfbsG	TRUE
IMEOQIFfdKTjWcgaRNLffjC	TRUE
KàeJtóéddVùuǔOZexéuefTA	TRUE
LVVóebTqqyjmMiqdFfNtDAd	TRUE
MipuyrǒPKdcDoGQfFDzáQlnk	TRUE
NyògóFcfaùKtuYRqqeCoXqI	TRUE
PQàfUáSVqgYbVcěrytòaDYHQ	TRUE
QgfkFNFVikXqucyaDlkweKù	TRUE
RudCbévgOLDdCDbEwYàfXNJH	TRUE
aǒqqzébphAKALdgVtIǎǒJHR	TRUE
UKKeàSqFJBNJqJLLǔdxéckǒo	TRUE
VlfISKGGetáèqhěcFDuaPBz	TRUE
XBVrvsúBkcTpEZMaDsqréQiK	TRUE
YOMebǒxdCrcaBIDfNDòòooù	TRUE
ZdWbhbNuSXlTCOúǒcrRGòsG	TRUE
aspuOvqxbUóHDRcéOViEhhQ	TRUE
cóaMuBLGkMBNKrDBxéùRCQA	TRUE
dǒlùúXoèùZféúsaQUmóEskúb	TRUE
eǒBQeLKXCdCdeMgǔèPkóoRoé	TRUE
fHUKsOlgQcóRexjaménCBDyA	TRUE
gdcWfyCQIRrKNgtyCdCǒzbmR	TRUE
hnvmHhEBsCCrǎdUMSjRxrCcm	TRUE
jBMYvtczmFMvpcsasJdlnAO	TRUE
kOàivTirrpTwavǒcUfUbiFf	TRUE
lvyJIèFGùWxdùypòeBdVúyCW	TRUE
nFaǔùnZuTEbxVróKhPùéXOp	TRUE
oPpévǒaDZhQmpbǔzèlKXáDC	TRUE
posǎNǔqǒXEdwoWcúùpáYázL	TRUE
ròMLoEEúkǔiázddLlROGVxoB	TRUE
dRàSèyéPxcSAfUbGphClǔSW	TRUE
tgárMaèhrbpǒpeAwáAVTZǒA	TRUE
urfTPuagǒEnUǒrUNbaTivIě	TRUE
dDZanywCNsVBlcfvvsZfnǎr	TRUE
xaaXAIlHabPmvtWRúdGVMflC	TRUE
yxPDabYOthNVxAěuòLClgrUN	TRUE
ùùvMòUXwqúiRcPǒqbFreǎǒyA	FALSE
ǔJNaldWyMNUNótZǒKòMúeyèS	FALSE
áTóZEkuLòHuYqRaàHzWpVkOS	FALSE
àdPJSèjNetsAǔtCepZěJxVZǔ	FALSE
éǒLRmPcIvooèEYhòòIxtUdàm	FALSE
èkijSLXúNEjyawèghNdjǎsKf	FALSE
ěyRrAFJsZFZqDuaùgBFdYHDl	FALSE
òJukHImIjdeTàJwǎèWOFXhqS	FALSE
ǒkhZKWèKfqnkBiNsùàKzcZAw	FALSE
úpěucúcǔuvDeúDhutIoYóVYf	FALSE
BǎnúTǔObéjWútGkèxaáqXǒZM	FALSE
CDVwqNáVXwOésPhykYhónbth	FALSE
DprgbQUMrǔáKTYduNjgǎNWjW	FALSE
FáàCCóXXcvòOàǔùòIqMàěVSt	FALSE
GCiVbjbKWǎyěbYfwmVhTaMXǔ	FALSE
HhBWòiNúASUǒuYUáJoGTbNdǔ	FALSE
JàiEùàóGhHiòMbKNYpEtùUyǎ	FALSE
KAHwMZaǒkOKòIcAKemYfwges	FALSE
LVuDkòeEZeHGvbòzǎBaùGhóf	FALSE
MidáCévYOqBáktYvnvókviǒP	FALSE
OAgkgGàTrYyUěTtaABdvAòam	FALSE
PPmFěrKkuVúùòSRJzTcYǔLèz	FALSE
QiwsáFrǒDázèBVzGwuTCdIóx	FALSE
SémaYiǎkèáIòQáùáuéèEKFem	FALSE
TOxIGIoyMMorHdnàVeHúzTDz	FALSE
UZWPǒOwsxzhWdòrYkINòBTTY	FALSE
VsoàiFfěGèwcDvúkchsóClrg	FALSE
XèHupWaàdyòumnKvJèlLóòkm	FALSE
YPimXéOYǎOVsOOGhSVgIùLdG	FALSE
ZXxsùrfWYqHchǔHxqmWèRcfK	FALSE
aféBhtQqeáKWùfòreHùMOpPù	FALSE
bhepsǎsgáúòPáoeùVHáOCano	FALSE
dǎTiRyYgWenáIóKXIQfIǔBNo	FALSE
eàWJtbohZAOoRCěxzCézgcvp	FALSE
fVǔUXóBóvydnZóLěèPCzaLTW	FALSE
gvUwNZvsuúrLDóZyUájHDùUa	FALSE
iMIWvDkaJǒsVsZYcěNBLRyHH	FALSE
jlǔòZOhwgùPTIEDdajqoyézN	FALSE
lóRpfdMlàěqBaZáLDAaUúIBz	FALSE
mOVQgMědéèzvlNHCzébCYòKy	FALSE
nYxOǒmlQsóyěálùHféxùjLao	FALSE
oiWRqàTTMvVùTmnfXUXcSDHH	FALSE
pyWróéyvǎǒuLépxLPBbUEctE	FALSE
rFǎjWúRyqZnézcPiAUpjlkxm	FALSE
saKpnGNiwYoTeXIǎMòAAùlak	FALSE
tgOLGVJbrEFATmAccèdowWWv	FALSE
unDSzeuZóèADèjYoeòrǔVdrk	FALSE
wòzwFxěfoàéúáGǒHICRRLqUd	FALSE
xVkzOróqzaěrújgNFFwAnòúG	FALSE
yhǎGúòmHWOóùgawWǔfáQmǎèL	FALSE
ùùvMòUXwqúiRcPǒqbFreaǒyA	TRUE
ǔJNaldWyMNUNótZǒKòMúebyèS	TRUE
áTóZEkuLòHcuYqRaàHzWpVkOS	TRUE
àdPJSèjNetsAǔtCepZěJxVcǔ	TRUE
éǒLRmPcIvaoèEYhòòIxtUdàm	TRUE
èkijSLXúNEjyawèghNdjǎcsKf	TRUE
ěyRrAFJsZFZqDuaùgBFdYHbDl	TRUE
òJukHImIjdeTàJwǎcWOFXhqS	TRUE
ǒkhZKWèKfqnkdBiNsùàKzcZAw	TRUE
úpěucúcǔuvDeúDhatIoYóVYf	TRUE
BǎnúTǔObéjWctGkèxaáqXǒZM	TRUE
CDVwqNáVXwOésPhykYaónbth	TRUE
DprgbQUMrǔáKTYduNdgǎNWjW	TRUE
FáàCCóXXcvòOàǔùòIqaMàěVSt	TRUE
GCiVabjbKWǎyěbYfwmVhTaMXǔ	TRUE
HhBWòiNúASUǒuYdUáJoGTbNdǔ	TRUE
JàiEùàóGhHiòMabKNYpEtùUyǎ	TRUE
KAHwMZaǒkOKòIcAKemYfages	TRUE
cLVuDkòeEZeHGvbòzǎBaùGhóf	TRUE
MidáCcévYOqBáktYvnvókviǒP	TRUE
OAgkgGàTrYyUcěTtaABdvAòam	TRUE
PPmFěrKkuVúùòSRJzTcaYǔLèz	TRUE
QidsáFrǒDázèBVzGwuTCdIóx	TRUE
SémaYiǎkèáIòQbùáuéèEKFem	TRUE
TOxIGIoyMMorHdnàVecúzTDz	TRUE
UZWdPǒOwsxzhWdòrYkINòBTTY	TRUE
VsoàiFfěGèwcDvúkcasóClrg	TRUE
XèHupWaàdyòumnKvdJèlLóòkm	TRUE
YPimXdéOYǎOVsOOGhSVgIùLdG	TRUE
ZXxsùrfWYqHcdǔHxqmWèRcfK	TRUE
abféBhtQqeáKWùfòreHùMOpPù	TRUE
chepsǎsgáúòPáoeùVHáOCano	TRUE
dǎTiRyYgWenácIóKXIQfIǔBNo	TRUE
eàWJabohZAOoRCěxzCézgcvp	TRUE
fVǔUXóBóvydnZóLěèPCzaLTbW	TRUE
gvUwNZvsuúcrLDóZyUájHDùUa	TRUE
iMIWvDkaJǒsVsZYcbNBLRyHH	TRUE
jlǔòZOhwgùPTIcDdajqoyézN	TRUE
lóRpfdMlàědBaZáLDAaUúIBz	TRUE
mOVQgMědéaèzvlNHCzébCYòKy	TRUE
nYxOǒmlQsóyěálùHféxùjcLao	TRUE
oiWRqàTTMvVdTmnfXUXcSDHH	TRUE
pyWróéyvǎǒuLapxLPBbUEctE	TRUE
rFǎjWúRyqZnézcPiAUpjlkam	TRUE
saKpnGNiwYoTecXIǎMòAAùlak	TRUE
tgOLGVJbrEFATmAcacèdowWWv	TRUE
unDSzeuZóèADèjYoedòrǔVdrk	TRUE
wòzwFxěfoàéúáGǒHICRdLqUd	TRUE
xVkzOróqzaěrújgNFFwAnòbúG	TRUE
yhǎGúòmHWOóùgawWǔfáQmǎèbL	TRUE
ùǔEléiRPhwGiǔQHEHcIKúZtFá	FALSE
ǔúáěèóXǔGcFczYǎmEQphqMǔPZ	FALSE
áaagdqǒFvIhIkhuUZPuGSgZMè	FALSE
àlóǔzòkǒEylNJòBCEdrǔPZNJy	FALSE
éàpIfWtVDéyKBxájLaWAěfUUE	FALSE
èRěblǎBZkBnóOyTRělěSdqéCj	FALSE
ěUzJIHZSNSHGQGBDfKYazrěkN	FALSE
òùRàbáùUjafàěJǒUGáGOZVTrN	FALSE
ǒQěfMvMKPHEaépyRWyěAjqkig	FALSE
úngCAZFmqfuiRBbeUIRZnGkEZ	FALSE
BòRbnwWRMpgxcTěěliQAMjòǒp	FALSE
CNǒbljtróhcpàUucEVQzFKzǎH	FALSE
DVóvCsUyCupWoqCàjTvaòRPQF	FALSE
EpBujfúKOgàeHccinOWàPJyib	FALSE
FzWùóeCZQRobzóeVHálvhuěip	FALSE
HǒéǎruǎóKHúáRTZweǎJòBaǎHǒ	FALSE
ITuZònaùIwWUYúǒWzeXoKxImǔ	FALSE
JlrOtVběJDéeJLLùáTLAèaLld	FALSE
LKfwcZEqxhdtGbeWYJMhHJblM	FALSE
MayLHWCPiěùyQoEEàyTIòcXPc	FALSE
NtVVqBǎrXIKúXèZrdàlawYměY	FALSE
PGkvvOlyDPbPǔéǔVěUDKkóRpa	FALSE
QNùQIqǎZcJháiWEOrYQXǒDkrá	FALSE
RdKótùuhGálTCJNQBrIaAáGBy	FALSE
TùhnèFBljòVràaxdiyhMynaàM	FALSE
UDGfyóURLaàNPgmBgrtrPòzúǒ	FALSE
VXOWùèBǔQFVBěDǔǎeHGǔóLcmW	FALSE
WvMBhZlmOlNJqJolkKubǔzYTl	FALSE
YCXdDtMèsRrQàqǔàgQǔúóèDtI	FALSE
ZSZTjxǎqéǒEdxqjXsJmIǔòùIe	FALSE
afǒSàhFPiDHDaaZHócWǔnYTEw	FALSE
bZkiàFIRjEbvsrJèbhNhZlfyǒ	FALSE
chmùiXZeEvàExúEóKécVVbásP	FALSE
daéEakòoYHPWzóKCVfkPWǎDěC	FALSE
epmfWèdvhǔbrVtóCeFDéYMCRV	FALSE
gDfGhèǔoqAlPmévfdǒjSXLMLw	FALSE
hVhCaǒHoKùéǎPBfrxcòIGúljY	FALSE
ilhPlQkbVUWwKxYgUNsCiùgFq	FALSE
kKjaMWǎYnFotkJlǒòèhSKQěùú	FALSE
lXomaVdlZODzxàyfEúàJyCuùg	FALSE
mssefDnCsRiHmIWXXbieKcZiL	FALSE
oórwOIòYéeqpODDeaFsprUOKK	FALSE
pbzJóxxǒbùoUxjànsrǎoIùvJH	FALSE
qlcjmffFUnLUIǔGKiJLcTpMsò	FALSE
sùPǎLòWnKXSaGJPolGoBKùAǔú	FALSE
tSXauomLhcsXtXNzékóǔjOgxW	FALSE
uiPzzcqefnǎdpǒWmtKqQtCFVU	FALSE
vvǎnrWJfrwZěVTtcóbNDBvtxà	FALSE
xJiǔbdbràRmkOpQlòYCktgrǔC	FALSE
yXlufùxeCnDRéOWácQǔèyzYYó	FALSE
ùǔEléiRPhwGiǔQHEHcIKúZtFáa	TRUE
ǔúáěèódXǔGcFczYǎmEQphqMǔPZ	TRUE
áaagdqǒFvIhIkchuUZPuGSgZMè	TRUE
àlóǔzdòkǒEylNJòBCEdrǔPZNJy	TRUE
éàpIfWtVcDéyKBxájLaWAěfUUE	TRUE
èRěbdǎBZkBnóOyTRělěSdqéCj	TRUE
ěUzJIHZSNSHGQGBDfKYabrěkN	TRUE
òùRàbáùUjafběJǒUGáGOZVTrN	TRUE
ǒQěfMcMKPHEaépyRWyěAjqkig	TRUE
úngCAZFmqfaiRBbeUIRZnGkEZ	TRUE
BaRbnwWRMpgxcTěěliQAMjòǒp	TRUE
CNǒbljtróhcpàUuacEVQzFKzǎH	TRUE
cDVóvCsUyCupWoqCàjTvaòRPQF	TRUE
EpBujfúKOgàaHccinOWàPJyib	TRUE
FzWùóaeCZQRobzóeVHálvhuěip	TRUE
HǒéǎruǎóKHúáRTZweǎJòBcaǎHǒ	TRUE
ITucònaùIwWUYúǒWzeXoKxImǔ	TRUE
JlrOtVběJDéeJdLùáTLAèaLld	TRUE
LKfwcZEqxhdtGbeWYJMhHdblM	TRUE
MayLHWCPděùyQoEEàyTIòcXPc	TRUE
NtVVqBcǎrXIKúXèZrdàlawYměY	TRUE
PGkvvOlyaDPbPǔéǔVěUDKkóRpa	TRUE
QNùQIqdǎZcJháiWEOrYQXǒDkrá	TRUE
RdKótùuhGdálTCJNQBrIaAáGBy	TRUE
TùdnèFBljòVràaxdiyhMynaàM	TRUE
UDGfyóURLcaàNPgmBgrtrPòzúǒ	TRUE
dVXOWùèBǔQFVBěDǔǎeHGǔóLcmW	TRUE
WvMBhZlmOlNJqJolkKabǔzYTl	TRUE
YCXdDtdèsRrQàqǔàgQǔúóèDtI	TRUE
ZSZTjdǎqéǒEdxqjXsJmIǔòùIe	TRUE
afǒSàhdPiDHDaaZHócWǔnYTEw	TRUE
bZkiàFIRjEbvsrJabhNhZlfyǒ	TRUE
chmùiXZedvàExúEóKécVVbásP	TRUE
daéEakòoYHPWzóKCVfkPWcDěC	TRUE
epmfWèdvhǔbrVtóCeFDéYMCRVc	TRUE
gDfGhèǔoqAlPmévfdǒjcSXLMLw	TRUE
hVhCdǒHoKùéǎPBfrxcòIGúljY	TRUE
ialhPlQkbVUWwKxYgUNsCiùgFq	TRUE
kKjaMWǎYnFotkJlǒòbèhSKQěùú	TRUE
lXomaVdlZODzxàyfEúàbJyCuùg	TRUE
mssefDnCsRiHmIWXXbdieKcZiL	TRUE
oórwOIòYéeqpODDeaFspbUOKK	TRUE
apbzJóxxǒbùoUxjànsrǎoIùvJH	TRUE
qlcjmffFUdLUIǔGKiJLcTpMsò	TRUE
sùPǎLòWnKXSaGJPolGobKùAǔú	TRUE
tSXauomLhdcsXtXNzékóǔjOgxW	TRUE
uiPzzcqefnǎdcǒWmtKqQtCFVU	TRUE
vvǎndrWJfrwZěVTtcóbNDBvtxà	TRUE
xJiǔbdbràRmkdpQlòYCktgrǔC	TRUE
yXlufùxeCnDRédWácQǔèyzYYó	TRUE
ùǔkmQXjCZQMùqbmPòAkělLDIZD	FALSE
ǔúXGLvtǒXLtǒHmRòznXyWcHóLǎ	FALSE
áWehrEKAèAyQfVdwěúQJAqaCèT	FALSE
àjEkRnǒFéòtIVULArQvosùùdze	FALSE
éèbBbLosciyXBfùcqgěùLiuFYè	FALSE
èFKpǔàǔQRXUqúvǎaYzǔkXzhVěá	FALSE
ěMsntODaùèKHěuLùpoòejélBPc	FALSE
ótvQBwùAusVZajJCVAúJSFmsjV	FALSE
ǒLPkbcmdgvVUòúoózCúiùvéPǒx	FALSE
úpùovpUheXMdpLUBbǒgpQùèZQT	FALSE
AvHoQvGOǒXNhàuSskyUcèěcOfC	FALSE
CǔQèvhákzvácéndókmepGěóépv	FALSE
DNEyTéOHywZualuZkJBcQqéàEA	FALSE
ESWdwXJpDòZZkUělDxéYmbúVEǔ	FALSE
FcIòǔwAǒFónòGuyBcáEDeqFpcè	FALSE
GhXZCJèuCoòhPyPaèfòBRocáǎA	FALSE
HmáWRacCowvhlwglXgVyZáfyui	FALSE
JéJUkòsZwsOrhǎǔǔúdubJywDIU	FALSE
KbtéyénHdsDkOxCmàZmVǔnòBka	FALSE
MCèaxǔneékǔhàkgatéZmYáZXHc	FALSE
NUDTùNDLvOLědrúǎbRHKeWOZúi	FALSE
OwáMyPútǒLYrRBiójFvǔeòMjbù	FALSE
QHcoeùǔQxRUmkiDèvFymGWNqxG	FALSE
RuwHoèDHSFtóPgfbhaXxTOdóHá	FALSE
TóHLQgssùǔPǎǔXPGLcrcPTPeuò	FALSE
UNPCJéZǎIcRbwylNcrkxóxgúNJ	FALSE
VXASrMPXQQǒúcWpWdrùwKàmDsu	FALSE
WeHùXgkiceFZYTNfYPDǒQbBCRQ	FALSE
YǔùeLtFoIbGrbhVRdJTLsjoQlO	FALSE
ZFaòlǎQaIAYxQqQLDàějkcXHdi	FALSE
aVtèwpFCmHěòkKèPyDVcokhuPe	FALSE
bsgWJjdóFsyJákjóbbáéroXzsE	FALSE
dàǎkBZFDEROěZFyCAZòHZòYJáD	FALSE
eAoòohDǔEgcTbKáǎrnúUshlXQA	FALSE
fZkmWSoiuJLjnIúiRhjQtthawy	FALSE
glyOAwcéDbdKzǔhLXssówóěVpf	FALSE
iětǔǔjYdkbzqSzNBXztgEJovLO	FALSE
jJYltéYxQBENmiòIfvaCǔkdRPU	FALSE
kZlòYpULHNxyFàǎěLczFwNpěDF	FALSE
ldZMztTDaypyTòIvGhlǔCMJiqf	FALSE
nCozFjFzIztVaZěgjQuGùAǎàAu	FALSE
oaTkùIVqǎPCEǔjCSVrgPheWoJL	FALSE
ptYSjjtěuDoDáLǔèbXxntANxKN	FALSE
rGRàeaJYvWáepITEjuRaùápAqy	FALSE
sZgzsBUěZaBQAqWvěNUdmùFssX	FALSE
tyJJTbppyTǒYHUoNfùǒǒTWméAF	FALSE
vóZpaikǒGCùwzJGyròěuoIgcpw	FALSE
wOúBàRǔfqGKùcǎàUǒSZnDúèHùg	FALSE
xcwAZmlǎmIlkXpIGséXFrúúUdD	FALSE
yfTIáxhuàóTvlBdRǔùbXXVzYrǔ	FALSE
ùakmQXjCZQMùqbmPòAkělLDIZD	TRUE
ǔúXGLvdǒXLtǒHmRòznXyWcHóLǎ	TRUE
áWehrEKAècAyQfVdwěúQJAqaCèT	TRUE
àjEkRnǒFéòtIVULArQvdsùùdze	TRUE
éèbBbLodciyXBfùcqgěùLiuFYè	TRUE
èFKpǔcǔQRXUqúvǎaYzǔkXzhVěá	TRUE
ěMsndtODaùèKHěuLùpoòejélBPc	TRUE
ótvQBwùcAusVZajJCVAúJSFmsjV	TRUE
aLPkbcmdgvVUòúoózCúiùvéPǒx	TRUE
úpùovpUheXMdpLUBbǒgpQùècQT	TRUE
AvHoQvGOǒXNhduSskyUcèěcOfC	TRUE
CǔQèvhákzvácéndókmedGěóépv	TRUE
DNcEyTéOHywZualuZkJBcQqéàEA	TRUE
ESWdwXJpDòZZkUěcDxéYmbúVEǔ	TRUE
FcIòǔwaǒFónòGuyBcáEDeqFpcè	TRUE
GhXZCJèuCoòhPyPaèfòbBRocáǎA	TRUE
HmáWRacCowvhlwglXgVyZáfyai	TRUE
JéJUkòsawsOrhǎǔǔúdubJywDIU	TRUE
KbtéyénHdsDkOxCcàZmVǔnòBka	TRUE
MCèaxǔneékǔhàkgatéZmYáZXHcb	TRUE
NUDTùNDLvOLědrúǎbRHdeWOZúi	TRUE
OwáayPútǒLYrRBiójFvǔeòMjbù	TRUE
dHcoeùǔQxRUmkiDèvFymGWNqxG	TRUE
RuwHoèDHSFtóPgafbhaXxTOdóHá	TRUE
TóHLdQgssùǔPǎǔXPGLcrcPTPeuò	TRUE
UNPCJaZǎIcRbwylNcrkxóxgúNJ	TRUE
VXASrMPXQQǒúcWpWdrcùwKàmDsu	TRUE
WeHùXgkdceFZYTNfYPDǒQbBCRQ	TRUE
YǔùeLtFoaIbGrbhVRdJTLsjoQlO	TRUE
ZFaòlǎQaIAYxQqQLDàějkcXHdbi	TRUE
aVtèwpFCmHěòkKdPyDVcokhuPe	TRUE
bsgWJjdóFsyJákjóbbáéroXcsE	TRUE
dàǎkBdFDEROěZFyCAZòHZòYJáD	TRUE
aeAoòohDǔEgcTbKáǎrnúUshlXQA	TRUE
fZckmWSoiuJLjnIúiRhjQtthawy	TRUE
glyOAwcéDbdKzǔhLXssówóěVcpf	TRUE
iětǔǔjYdkbzqSzNBXztgEJocLO	TRUE
jJYltéYxQBENmiòIfvabCǔkdRPU	TRUE
kZdòYpULHNxyFàǎěLczFwNpěDF	TRUE
ldZMztTDaybyTòIvGhlǔCMJiqf	TRUE
cCozFjFzIztVaZěgjQuGùAǎàAu	TRUE
oaTkùIVqǎPCEǔjCSVrgPheWobJL	TRUE
ptYSjjtěuDoaáLǔèbXxntANxKN	TRUE
cGRàeaJYvWáepITEjuRaùápAqy	TRUE
sZgzsBUěZaBQAqWvěNUdmùFsbsX	TRUE
tyaJJTbppyTǒYHUoNfùǒǒTWméAF	TRUE
vóZpaikǒGCùwzJGyrděuoIgcpw	TRUE
wOúBàRǔfqGKùcaǎàUǒSZnDúèHùg	TRUE
xcdAZmlǎmIlkXpIGséXFrúúUdD	TRUE
yfTIáxhuàdóTvlBdRǔùbXXVzYrǔ	TRUE
ùùwsAcǒxtCcáTyácSTSxbWXRbxR	FALSE
ǔIáGrGOtsCkuqSVVpécQUSnZhyG	FALSE
áYYLUnTBQqéáěéKKYàóBVkcèóCK	FALSE
àdLTejxYRBBǔEIǒYwvóáǒSyvYhǒ	FALSE
ǎkóLhěRéDDúRLtIJDdeQǎǎúaHéǒ	FALSE
èúCbxJNclKdúDǔFzVoùéòěrTáòJ	FALSE
ěHaǒNlǎsǎIóòPtUlQTcvpBMTuhe	FALSE
óhYVAMZhDlǒuóFYBvdUbpHwsRǎZ	FALSE
ǒàCKéoBDDziTUxNarKrcHǒCdiYN	FALSE
úIODEafǔǎěeǎlRWtúùsùwěǔzATV	FALSE
AdbxwGKRKljWkULsáwBòNUbBbJv	FALSE
CǎLPBěTǎXvònàAzuLVàaSJCutQd	FALSE
DLkevCěpyPàǒLJeXèàoJAafmiam	FALSE
ElLGlnSYtZlZDéǎIaLPeoMZrqMw	FALSE
GIJFGKgMaecnoYcǎiúEgUUácùso	FALSE
HanpmhǎOGzàuhKVhdǒGGXkgéKQF	FALSE
IyfgHNRúeYSHmjUFKGROéaTSZǒY	FALSE
KèhSóDSeahǔPtoauǎwBMsǒehcút	FALSE
LTTIdtHǔquqmSiQymúòbzǒCóFEú	FALSE
MWucxTVOyoSRàDhiZBkkHeRQXóh	FALSE
NnuqéSjlRsdLFèwkhkmHmjXéhpX	FALSE
PáPoNmǎòǎRépǔgtóZJǎdbyYuhàV	FALSE
QòXCqYicZEúpyhxPUswttmkPftà	FALSE
REéóǔǎóVOxWěǎWbNANtloSsYuKF	FALSE
SzǔEúBpxKEwTáaIqǎkFaúmǎnLtǎ	FALSE
UUmUǒQúǎǎONlUtqaSIKHZDNtIWc	FALSE
VnoyqBYtnAWgULLQùJlQwkèǎXcr	FALSE
XǒhYǒfVèjDGQvéVfcfúRcpRyUcv	FALSE
YRBHDDlXRHLiyqVǔdlsxtPwYLjH	FALSE
ZZXTaGrěMféǒdKóHqWòórqéCǎaq	FALSE
aXvAèIlóGIrǔaasuáMáfùǎěxivl	FALSE
btjIrǔCSǎSmOXkóOòWvcjòSóUPQ	FALSE
czVòzEBxRQcwVTvNUtUBBEgNDyN	FALSE
eǔévELKùěwwQCZjádPmàaǎiXYKg	FALSE
fòyLQgOXàSaUJmàKFJuOWvǔvulT	FALSE
gXbHáRxTMgpdNwWDrókVàOéòǒéN	FALSE
hrqpExdISàvXJbàGěXbfIFSqLóZ	FALSE
jǒWhOcVDúXRgEpvxDYnádSjJàǎǎ	FALSE
kOBǒpitTéǎhóQùxDgòjáYaSDMcf	FALSE
lléǎQùKrcgxLnbKYwyvzLPòLvgi	FALSE
msfEawUàfǔOQkjezHkZiúàiYfcQ	FALSE
oQPtùycUeBǔSRJzNfpgzsǔKěByr	FALSE
pcPUNáXHsTFTrwYlBúbcsRòjZNl	FALSE
qvVèPltSàSǔzXèěhIjbBòmxFǒsS	FALSE
sǎvNszNHRRaLágPZESrTPóXGLmH	FALSE
tNbòtzbrrùtǒOAPZxwnSybOcǒrP	FALSE
uvqbZKǎuvRpGkOéǎóuòVPáZVVcy	FALSE
wǔZFǔHpTVHEOùPOócgNTqYFiáèT	FALSE
xRkvbBgěHEDTUKIXxoyáSAwgmPd	FALSE
ywaAWEqèúǒéazyVàpJukjéxYgqǔ	FALSE
ùùwsAcǒxtCcáTyacSTSxbWXRbxR	TRUE
ǔIáGrGOtsCkuqSVVpécQUSnZayG	TRUE
áYYLUnTBQqéáěéKKYàóBVkcaèóCK	TRUE
àdLTejxYRBBǔEIǒYwcóáǒSyvYhǒ	TRUE
ǎkóLhěRéDDúRLtIJDdedǎǎúaHéǒ	TRUE
èúCbxJNclKdúDaǔFzVoùéòěrTáòJ	TRUE
ěHaǒNlǎdǎIóòPtUlQTcvpBMTuhe	TRUE
óhYVAMZhalǒuóFYBvdUbpHwsRǎZ	TRUE
ǒàCKéoBDDziTUxNarKrcHǒCdiYaN	TRUE
úIODEafǔǎěbeǎlRWtúùsùwěǔzATV	TRUE
AabxwGKRKljWkULsáwBòNUbBbJv	TRUE
CǎLPBěTǎXvònàAzuLVàaSJCbtQd	TRUE
DLkevCěpyPàǒLJeXèàoJAafmbiam	TRUE
ElLGlnSYtZlZDéǎIaLPeoMbZrqMw	TRUE
GIJFGKgMaebnoYcǎiúEgUUácùso	TRUE
HanpmhǎOGzàuhdKVhdǒGGXkgéKQF	TRUE
IyfgHNRúeYSHmcUFKGROéaTSZǒY	TRUE
KèhSóDSdeahǔPtoauǎwBMsǒehcút	TRUE
dTTIdtHǔquqmSiQymúòbzǒCóFEú	TRUE
MWucxTVOyoSRàDhiZBakkHeRQXóh	TRUE
NnuqéSjlRsdLFèwkhkmHmjXéhpdX	TRUE
dPáPoNmǎòǎRépǔgtóZJǎdbyYuhàV	TRUE
QòXCqYicZEúpyhxPUswttmkPaftà	TRUE
REéóǔǎóVOxaěǎWbNANtloSsYuKF	TRUE
SzǔEúBpxKEwcáaIqǎkFaúmǎnLtǎ	TRUE
UUmUǒQúǎǎONclUtqaSIKHZDNtIWc	TRUE
VnoyqBYdtnAWgULLQùJlQwkèǎXcr	TRUE
XǒhYǒfVèjDGQvédfcfúRcpRyUcv	TRUE
YRBHDDlXRHLiyqVǔdlsxtPwYLdjH	TRUE
cZZXTaGrěMféǒdKóHqWòórqéCǎaq	TRUE
aXvAèIlóGIrǔaasuáMáfùǎěbxivl	TRUE
btjIrǔCSǎSmOXkóOòWvdcjòSóUPQ	TRUE
dzVòzEBxRQcwVTvNUtUBBEgNDyN	TRUE
eǔévELdKùěwwQCZjádPmàaǎiXYKg	TRUE
fòyLQgOXàSaUJmàKFJuOWvǔvulbT	TRUE
gXbHáRxTMgpdNwWDróckVàOéòǒéN	TRUE
hrqpExdISàvXJaàGěXbfIFSqLóZ	TRUE
jǒWhOcVDúXRdgEpvxDYnádSjJàǎǎ	TRUE
kOBǒpitTéǎhóQùxDgòjáYaSDdMcf	TRUE
lléǎQùarcgxLnbKYwyvzLPòLvgi	TRUE
msfEawUbfǔOQkjezHkZiúàiYfcQ	TRUE
oQPtùycUeBǔSRJzNfpgzsaKěByr	TRUE
dpcPUNáXHsTFTrwYlBúbcsRòjZNl	TRUE
qvVèPatSàSǔzXèěhIjbBòmxFǒsS	TRUE
csǎvNszNHRRaLágPZESrTPóXGLmH	TRUE
tNbòtzbrrùtǒOAPZxwnSybOcǒarP	TRUE
uvqbZKǎuvRpGkdéǎóuòVPáZVVcy	TRUE
wǔZFǔHpTVHEOùPOócgNTqYFiaèT	TRUE
xRakvbBgěHEDTUKIXxoyáSAwgmPd	TRUE
ywaAWEqèúǒéazyVàpJukjéxbYgqǔ	TRUE
ùùèSòHlSnsKǎbYnKBxdtbèOCyMjT	FALSE
ǔéUipòANSwóDAEicvJymyHbVòmǎW	FALSE
áJyfQHXèsszOébdòǎǒLmbJLaǒUXè	FALSE
àUldawwyMhòGemóǒHèjVXsqKiòSǎ	FALSE
ǎmúaynǔOùfNCfFKlyJBNùUTSOùCU	FALSE
èǎSkyHěQKfělaúPrqXéMaucMdTǎR	FALSE
ěMnwuǒUeóyǎénDsiqBbMLDehBfap	FALSE
ókwnDledCNOYǎZgahNEDnàǔvlòUy	FALSE
òqngdgěgbúYUIkSMilHěOjazRiBě	FALSE
úěùNMnzxóbMǔhloKBMAugIFVzGDò	FALSE
ANZXyáZawsòjòmxéDxjáSLXPXàpO	FALSE
BjrrátOewpfKkJcEweCAvrWbZicX	FALSE
CzUòǒQcǎPnhGFnháxZRQRùèPLhil	FALSE
EGtBChiSKMNqupéGeògEJwùdjquǔ	FALSE
FHàkóMlxByKzkemKNybèáùaXdxNx	FALSE
GkHPhRJMxaKězxdànBQǎoIúsJefè	FALSE
IòtWǒOéjjJzEWùXděDNgIKvXqhFB	FALSE
JMùqáútaNPUXJǔvóslNiúCAGěǎuu	FALSE
KbTWEKOGUukáéXaHéDtdtǎxPuNJz	FALSE
MùVPLnStYNgFmèbzavwéòAQúcYxú	FALSE
NBaNHkEòDwOhfvXYnǒEpǒdrGkAGl	FALSE
OQáESbTDpqèieHǒTrKmPuczTxqts	FALSE
PdǒDéRnóujPigiǔGyhTǔbyZMrzǎN	FALSE
QvyfBóifkzQkZǔXxkZtqdIQbskǔU	FALSE
SKRXèNWXrDǒvfTIàZúuCWAèkcSLb	FALSE
TtěwHoDtSbqVòntevZgYxlWjéWcb	FALSE
VěskpdrèwlCfkXúiYWCògzCaJiéó	FALSE
WiDGǎOSyEcyjMEQMnlhDGtcsYxfh	FALSE
YádqPWéxǎkjLEysSIOoGmSPálfOI	FALSE
ZHyuundoCMóqbuilCpéQHXróCMyb	FALSE
aZǎǎMRpQpamcUJPeVRéBYlmDyQpp	FALSE
brPcVACDXLPóòǒPQógǎǔxúRrbIpǒ	FALSE
dééZRAGpXhbùPièǔPBjóHWǔǎOeWu	FALSE
eMoYpGWwiBYmkójCdvRpèFqǔkěNp	FALSE
fjWóyyWǒLTMvOdUǔtDváóěTvmGtZ	FALSE
hǎEpRdZKúzòvemtVXěáúaVéǎmlQT	FALSE
iNqcLOIFmOCùtLwpjzQPùfMXxzAl	FALSE
jYqYeEwhòéVrIKǒrMèdAYzALaqvS	FALSE
kyECSvǔMRùMWáùPjuxkzXQáuRǒdà	FALSE
měNTGiTTrbXsǔòkFéBèǔsbVTldǎN	FALSE
nKLeǔǎzWPvAPgXvLEcQǒEǒUXCpǒW	FALSE
oiTobdJěUěmǎróYospoaùuiòaáaL	FALSE
qùTHOQCIxtBWǔrúdDCàKàAVrǔqéw	FALSE
rHcLàPzXǎKwbbRoǎáBǎMwCVhdzZV	FALSE
sleèTaelùyPINIOóěTjJléDòFLóD	FALSE
txUkrǎFtbrlnzogytBvFojcLgǔKW	FALSE
vèVEAòEOimDVoòMiiUVksyyNSaúX	FALSE
wLANIǎDpkǒdTCèFTaróTQkNxEǒhD	FALSE
xcHcúJetnHóSiPIbǒIAèLùPOZlǔm	FALSE
zùGǔécKúQkKXfgSQndoxUyjwxYOF	FALSE
ùùèSòHlSnsKǎbYnKdBxdtbèOCyMjT	TRUE
ǔéUipòANSwóDAEicvJymayHbVòmǎW	TRUE
áJyfQHXèsszcOébdòǎǒLmbJLaǒUXè	TRUE
àUldawwybhòGemóǒHèjVXsqKiòSǎ	TRUE
ǎmúaynǔOùfNCfFKlyJBNùbTSOùCU	TRUE
èǎSkyHěcKfělaúPrqXéMaucMdTǎR	TRUE
ěMnwuǒUeóyǎénasiqBbMLDehBfap	TRUE
ókwnDledCNOYǎZgahNEDnàǔvlòby	TRUE
òqngdgěgbúYUIkSMilHěOdazRiBě	TRUE
úěùNMnzaxóbMǔhloKBMAugIFVzGDò	TRUE
ANZXcáZawsòjòmxéDxjáSLXPXàpO	TRUE
BjrrátOewpfKkJcEweCAvraWbZicX	TRUE
CzUòǒdQcǎPnhGFnháxZRQRùèPLhil	TRUE
EGtBChiSKMNqupéGeògEdJwùdjquǔ	TRUE
FHàkóMlxByKzkemKNdybèáùaXdxNx	TRUE
GkHPhRJMxaKězxdànBQǎoIúbJefè	TRUE
IòtWǒOdéjjJzEWùXděDNgIKvXqhFB	TRUE
JMùqáútaNPUXJǔvbóslNiúCAGěǎuu	TRUE
KbTWEKOGUukáéXaHéDtdbǎxPuNJz	TRUE
MùVPLnScYNgFmèbzavwéòAQúcYxú	TRUE
NBaNHkEòDwOhfvXYnǒEpǒbdrGkAGl	TRUE
OQáESbTDpqdieHǒTrKmPuczTxqts	TRUE
PdǒDéRnóujPigiǔGayhTǔbyZMrzǎN	TRUE
QvyfBóifkzQkZǔXxkZtqdIQbsdǔU	TRUE
SaRXèNWXrDǒvfTIàZúuCWAèkcSLb	TRUE
TtěwHdoDtSbqVòntevZgYxlWjéWcb	TRUE
VěskpdrèwlCdfkXúiYWCògzCaJiéó	TRUE
WiDGǎOSyEcyjMEQMnlhDdtcsYxfh	TRUE
YádqPWéxǎkjLEysSIdOoGmSPálfOI	TRUE
ZHyuunadoCMóqbuilCpéQHXróCMyb	TRUE
aZǎǎMRpQpamcUJPeVRéBYlmayQpp	TRUE
baPcVACDXLPóòǒPQógǎǔxúRrbIpǒ	TRUE
dééZRAGpXhbùPièǔPBjóHWǔǎOedWu	TRUE
eMoYpGWwiBYmkójCddvRpèFqǔkěNp	TRUE
fjWóyyWǒLTMvOdUǔtDváóěTvmcGtZ	TRUE
hǎEpRdZKúzòvemtVXěáúaVéǎmclQT	TRUE
iNqcLOIFmOCùtLwpjzQaùfMXxzAl	TRUE
jYqYeEwhòéVrIKǒrMèdAYzALdqvS	TRUE
kyECSvǔMRdMWáùPjuxkzXQáuRǒdà	TRUE
měNTGiTTrbXsǔòkFéBèǔsbVdldǎN	TRUE
nKLeǔǎzWPvAPgXvLEcQǒEǒUXCpǒa	TRUE
oiTobdJědUěmǎróYospoaùuiòaáaL	TRUE
qùTHOQCIxtBWǔrúdDCàKàAVrǔqdw	TRUE
rHcLàPzXǎKwbbRoǎáBǎMdwCVhdzZV	TRUE
sleèTaelùyPINIOóěTjJlbéDòFLóD	TRUE
txUkrǎFtbrlnzogytBvFojcagǔKW	TRUE
vèVEAòEOimDVoòMiiUVksyyNSabúX	TRUE
wLANIǎDpkǒcdTCèFTaróTQkNxEǒhD	TRUE
xcHcúJetnHóSaPIbǒIAèLùPOZlǔm	TRUE
dzùGǔécKúQkKXfgSQndoxUyjwxYOF	TRUE
ùáúNáqééFóèǔijáeatXùtHǒcJlucE	FALSE
ùzFGgUBikKǎěLhùMihXhFJóIYvbiR	FALSE
áNùZUPRsnhUAdqSRBYǎhóXbeGWPoS	FALSE
àbhǎktJLǎPwǔBQHáOYsFkJLRèIrěd	FALSE
ǎrgsbǒskAElieZiTNBVVǒUZAcJCwě	FALSE
èéIihàCbGSIJxvhqáYoGQǒUdWátlS	FALSE
ěSùcPǒèúǎfjPclbyàUóGpiOGFwJNǔ	FALSE
ófVXpǒquòsǔàExSboòQbYKGSKAoYp	FALSE
ǒùJSWMRlEAdmTWbNfotǔShBVáRNèl	FALSE
úKUVIKtǒLvKBaéjAgǒhwétHlLucOL	FALSE
AqǔvIékJAèLzáuóFuLeXBLfkdúDxB	FALSE
BrGóueCksèsSySEǎzFlóVènlHHTdM	FALSE
CwgǔǎzFZAyLwCěùlVeZDacUmGvTwm	FALSE
EAmgdrFeakǎXzrzuXDoMjzTàIzàHj	FALSE
FVocùróKPBQMOrǔěMZduQVùTSSDáP	FALSE
GkmeFbóLSzcwuHǔIrQsWerHKúESWZ	FALSE
IěǎAǎéMàgOqújóFgfdèYhúRrUuuuj	FALSE
JEGépTòáaàKátApséyVtZhOǎǎdáPY	FALSE
KlbLlmLxoézzdjELEmjèkPéyyYNyD	FALSE
MěòlerPtèHbdTzMLXWpèKRBàEkbrB	FALSE
NTRAvèmzdqlǒewéiěǒènJasZpjKqt	FALSE
OesQKUSpWSlsGcùùtZùóQcXǒVPgbM	FALSE
PuvòWffSǔsdPǔpóJLbpkssLKWLRyW	FALSE
RǔpsóEMXWWpòǎOTvmFcTóIEǒUéfVo	FALSE
SNOwHIǔndòCLQójàYUgěZbpgvRgXU	FALSE
TTevshlGezmaiwnKtsWCjécLlúùMǎ	FALSE
UiàmEHZkpEYbaNvTAlxAnhOùAkxim	FALSE
VzmǎYTǔxghSǒaòoEHùádàQfeTùxXé	FALSE
XOXupéěMEFpevgVqǔVǒCtFtaIKvPk	FALSE
YkEIóQBdQěnéYjIESbsOjFbqǒJAbB	FALSE
aèzèIRǎjùlWXéorfaùRmǒEhnsǎèBc	FALSE
bGTYVivHéLKLxilkLrLHPLbFwUdzk	FALSE
cXTKTáqCEfhRupNiBcgzZéLIXeǎěY	FALSE
deGoEBMǒorIaWMòyùàheéwáTòxIèF	FALSE
fèmdxweújmDUóioGóQòDnBévDxDkě	FALSE
gWwLbFDěRjaGffUMRCkcǒzNlyréEx	FALSE
hhZIFKaàhBJiéGqsaoBFhǎavCgàCp	FALSE
isFSyMyeEpoháàxIfBǒNagNuPàùXG	FALSE
kUFYEYiúxOáIHTYcOekǒgáYGDǔFIP	FALSE
lwHBFhdjeèmzfTDjWNZǒMgiiQIměz	FALSE
néEhèǔOxVtGgtnAàéFigDdkpMwWhr	FALSE
oQDuefgQAPcgYAzkxZsMóyXárWzLQ	FALSE
pgrèDúLǔGbpUgEzaúZùhtKkzvuáèg	FALSE
qqXklàqKsOgFFvtmRYiSOVDbòzpRA	FALSE
sǔfùàoKIePwxBZPdfjLLEZDaYFgóé	FALSE
tQqxcDKIǔéUwKózVáuyQwhCFxcuop	FALSE
uocuvǎiWNpzèrtYòGèxàZsAoùmshǎ	FALSE
wFbphàódòywViFsvMYFqáJWaěooAM	FALSE
xOywtCtzIhǒEǎLudǒěoALAIUUJqRx	FALSE
ymàJPJxsěafIxwvǔaqKOáLEàKcoés	FALSE
ùáúNáqééFóèǔijáeatXùtHǒcJlucEb	TRUE
ùzFGgaUBikKǎěLhùMihXhFJóIYvbiR	TRUE
áNùZUPRsnhUAdaSRBYǎhóXbeGWPoS	TRUE
àdhǎktJLǎPwǔBQHáOYsFkJLRèIrěd	TRUE
ǎrgsbǒskAElieZiTNBdVVǒUZAcJCwě	TRUE
èéIihàCbGSIJxvhqáYoGQdǒUdWátlS	TRUE
ěSùcPǒèúǎfjPclbyàUóGpiOGaFwJNǔ	TRUE
ófVXpaquòsǔàExSboòQbYKGSKAoYp	TRUE
ǒùJSWMRlEAdmTWbNfotǔShBVdáRNèl	TRUE
úKUVIKtǒcLvKBaéjAgǒhwétHlLucOL	TRUE
AqǔvdékJAèLzáuóFuLeXBLfkdúDxB	TRUE
BrGóueCksèsSySEǎzFlóVènlHHTdd	TRUE
CwgǔǎzFZAyLwCěùlVeZDacUmGvTawm	TRUE
EAmgdrFeakǎXzrzuXDoMjzbTàIzàHj	TRUE
FVocùródKPBQMOrǔěMZduQVùTSSDáP	TRUE
GkmeFbóLSzcwuHaǔIrQsWerHKúESWZ	TRUE
IěǎAdéMàgOqújóFgfdèYhúRrUuuuj	TRUE
JEGépTòáabàKátApséyVtZhOǎǎdáPY	TRUE
KlbLldmLxoézzdjELEmjèkPéyyYNyD	TRUE
MěòlerPtèHbddTzMLXWpèKRBàEkbrB	TRUE
NTRAvèmzddqlǒewéiěǒènJasZpjKqt	TRUE
OaesQKUSpWSlsGcùùtZùóQcXǒVPgbM	TRUE
PuvòWffSǔsdPǔpóJLbpkssLKcLRyW	TRUE
RǔpsóEMXWWpòǎOTvmFcTóIEǒUafVo	TRUE
SNOwHIǔndòCLQdjàYUgěZbpgvRgXU	TRUE
TTevshlGezmaiwdKtsWCjécLlúùMǎ	TRUE
cUiàmEHZkpEYbaNvTAlxAnhOùAkxim	TRUE
VzmǎYTǔxgdSǒaòoEHùádàQfeTùxXé	TRUE
XOXupéěMcEFpevgVqǔVǒCtFtaIKvPk	TRUE
YkEIóQBdQěnéYjIESbsOjFbqǒcJAbB	TRUE
aèzèIRǎjùlWXéorfaùRmǒEhnsdǎèBc	TRUE
bGTYVivHdéLKLxilkLrLHPLbFwUdzk	TRUE
cXTKTáqCEfhRupaiBcgzZéLIXeǎěY	TRUE
dcGoEBMǒorIaWMòyùàheéwáTòxIèF	TRUE
fèmdxweújmDUóioGóQòDnBévdxDkě	TRUE
gWwabFDěRjaGffUMRCkcǒzNlyréEx	TRUE
hhZIFKaàhBbJiéGqsaoBFhǎavCgàCp	TRUE
isFSycMyeEpoháàxIfBǒNagNuPàùXG	TRUE
kUFYEYiúxOáIHTYcOeaǒgáYGDǔFIP	TRUE
lwHBFhdjeèmzfTDjWNZǒMgiiQIměd	TRUE
ndEhèǔOxVtGgtnAàéFigDdkpMwWhr	TRUE
oQDuefgdAPcgYAzkxZsMóyXárWzLQ	TRUE
pgrèDúLǔGbpUgEzaúZùbtKkzvuáèg	TRUE
qqXklàqKsOgFFvtmRYiSOVDabòzpRA	TRUE
sǔfùàoKIePwxBZPdfdjLLEZDaYFgóé	TRUE
tQqxcDKIǔéUwKózVáauyQwhCFxcuop	TRUE
uocuvǎiWNpzèrtYaGèxàZsAoùmshǎ	TRUE
wFbphàódòywViFsdvMYFqáJWaěooAM	TRUE
xOywtCtzIhǒEǎLudǒěoALAIUUdqRx	TRUE
ymàJPJxsěafIxbwvǔaqKOáLEàKcoés	TRUE
