ùùéUexàTUǎBwvdgJeeel	TRUE
ǔNJUfffáJfǔIoHNRwQEi	TRUE
áeeevúOEicXYlcqnxCBb	TRUE
àrfòUIǔapsfǒzHucccyi	TRUE
éGòqccNcOyGpBEóàxeGK	TRUE
èeeeoHèNúHmfTzKjěwNt	TRUE
ěrQaaaPkYúóuGbrSMroK	TRUE
òùcaKGěǒprqXtnSaaaǒe	TRUE
ǒMrdddEéùJIZxEyqèSJǎ	TRUE
úfffDlúrGrJTóLCYnòXb	TRUE
AzQoZbdlàfJFffftEHlj	TRUE
CMjccckZZJkfDiwkiTYC	TRUE
DpéHWbMHvesǔtbbKbXbG	TRUE
FIBizixdúésCiYHèJddd	TRUE
GZfffOLulYzXqSavKjwá	TRUE
HoNgaǎQrpùcEcccáúàkf	TRUE
JégieeeèHbrLhPTǒxOǔl	TRUE
KPóǎKjbnMèGùrDEdPddó	TRUE
LkeTláIQfaaaZePéORlè	TRUE
NěǔcdddèQOYàPJdgBHvl	TRUE
OSLwéKǒgfsJgZccclmCǎ	TRUE
PzfSǎJùktRàykóibcbbò	TRUE
RNóViúlcccnpúgmòòKUz	TRUE
SlwLrèplvTapaaèěrKyM	TRUE
UJdddǔosǔmuàAnqTqVtI	TRUE
VdBàgExLiLrRfffòqùPj	TRUE
XǔfcràPCSjUyvldddùZB	TRUE
YBòmQPúBàfOXisqJccoc	TRUE
ZVKToygǎbbbúWǔeqHNZv	TRUE
aaaúzJrovàBùUjEUjYov	TRUE
bbVbTFpushUDWKGzèYèu	TRUE
ccFcWSoǎànGǔǎLOaHpRó	TRUE
dVCEBòiKPXsuEXfffMAb	TRUE
eCaaabǎPSCFEgMIefOMC	TRUE
ezdddXlúnBdxoWPaVMXB	TRUE
fffzntKqKOnwúqGLKCfl	TRUE
gmQfffèiTwGBweǒRZJcn	TRUE
hvPZGJxMrMcccmòMjQvX	TRUE
jǔuVvéxǔǎgrLèwaaaZPs	TRUE
kWàaxúlǎGUǔqdIffúfWM	TRUE
lqvaaamZǔWOěYéeúǔqmò	TRUE
mzzCùUhUúRbeeeáókghz	TRUE
oNáHcccànDkàDOVaǎFFR	TRUE
qùQghXòcJXbbóbbFdCEb	TRUE
rdddxúbǎPyúWgHěbzJSI	TRUE
túèbpntrZsEOXgOèbbbP	TRUE
uYHpRLabKbbLPFNdjàWě	TRUE
vgXdqǔLFóòbbbZàáPusY	TRUE
xBúiwPùAIPétNbbbxZnO	TRUE
yXleeedtXTúgtmfZjfáw	TRUE
ùùéUexàTUǎBwvdgeeeel	FALSE
ǔNJUffffáJfǔIoHNRwQEi	FALSE
áeeeevúOEicXYlcqnxCBb	FALSE
àrfòUIǔapsfǒzHuccccyi	FALSE
éGòqccccOyGpBEóàxeGK	FALSE
èeeeeHèNúHmfTzKjěwNt	FALSE
ěrQaaaakYúóuGbrSMroK	FALSE
òùcaKGěǒprqXtnSaaaaǒe	FALSE
ǒMrddddéùJIZxEyqèSJǎ	FALSE
úfffflúrGrJTóLCYnòXb	FALSE
AzQoZbdlàfJFfffftEHlj	FALSE
CMjccccZZJkfDiwkiTYC	FALSE
DpéHWbMHvesǔtbbbbXbG	FALSE
FIBizixdúésCiYHèJdddd	FALSE
GffffOLulYzXqSavKjwá	FALSE
HoNgaǎQrpùcEccccáúàkf	FALSE
JégieeeeHbrLhPTǒxOǔl	FALSE
KPóǎKjbnMèGùrDEddddó	FALSE
LkeTláIQfaaaaZePéORlè	FALSE
NěǔcddddèQOYàPJdgBHvl	FALSE
OSLwéKǒgfsJgcccclmCǎ	FALSE
PzfSǎJùktRàykóibbbbò	FALSE
RNóViúlccccnpúgmòòKUz	FALSE
SlwLrèplvTaaaaèěrKyM	FALSE
UddddǔosǔmuàAnqTqVtI	FALSE
VdBàgExLiLrRffffòqùPj	FALSE
XǔfcràPCSjUyvlddddùZB	FALSE
YBòmQPúBàfOXisqJcccc	FALSE
ZVKToygǎbbbbúWǔeqHNZv	FALSE
aaaaúzJrovàBùUjEUjYov	FALSE
bbbbTFpushUDWKGzèYèu	FALSE
ccccWSoǎànGǔǎLOaHpRó	FALSE
dVCEBòiKPXsuEXffffMAb	FALSE
eaaaabǎPSCFEgMIefOMC	FALSE
ezddddXlúnBdxoWPaVMXB	FALSE
ffffzntKqKOnwúqGLKCfl	FALSE
gmQffffèiTwGBweǒRZJcn	FALSE
hvPZGJxMrMccccmòMjQvX	FALSE
jǔuVvéxǔǎgrLèaaaaZPs	FALSE
kWàaxúlǎGUǔqdIffffWM	FALSE
lqvaaaamZǔWOěYéeúǔqmò	FALSE
mzzCùUhUúReeeeáókghz	FALSE
oNáHccccànDkàDOVaǎFFR	FALSE
qùQghXòcJXbbbbFdCEb	FALSE
rddddxúbǎPyúWgHěbzJSI	FALSE
túèbpntrZsEOXgObbbbP	FALSE
uYHpRLabbbbLPFNdjàWě	FALSE
vgXdqǔLFóbbbbZàáPusY	FALSE
xBúiwPùAIPétNbbbbxZnO	FALSE
yXleeeedtXTúgtmfZjfáw	FALSE
ùùfATHdětúHwQqAfffǔmǔ	TRUE
ǔNxwNhgaǒfffvúáFFSSòK	TRUE
ákAdTDDèmnPEgocccubóe	TRUE
ǎéLvgiJMSǔáweeeǒóòEAV	TRUE
éMckǎCDcóqqeeeòrLkRWv	TRUE
èZeKòJpgǔpsègBVeqNfff	TRUE
ěqXcfJGegzxGhǎKccctYq	TRUE
òǎtpaaaypYzBQnVVcippò	TRUE
ǒbWTǔYcccleYErXigjYre	TRUE
úlěIWCDPòxěbWbbEBeòèk	TRUE
AqmMEǔffLfJtbHLynoPSv	TRUE
CAáLfffSQǔùsTiyUOVQJá	TRUE
DPzyMtaaaGXsmIJaIfZTJ	TRUE
ElhórhaHècccQUmNwMvSF	TRUE
GRcqNsdódděaUbèAmoTAú	TRUE
IǔAbbbéàBbǎùjtòHiYúKC	TRUE
JeéojBRièéaaaěsùmoMàk	TRUE
KzsáòfzffiSjzjZLsǒLiK	TRUE
MQphKáGvWQybbbLDNByRZ	TRUE
NcfpéPgHězoěRokPirfff	TRUE
OktqArkRrzSáOyQTFzeee	TRUE
QùZzjóxMxǎhzmNgldddhr	TRUE
RèXǔéǔryffrfaUekcqXRj	TRUE
ScccyDèJxLCiLEuHáCòKB	TRUE
TrbUbbHKaohǔǒpMyUJéoE	TRUE
VBwBiàNǎJfffàuSǒKFbyF	TRUE
WdIjǒèhpǔWBrǎpybbbOih	TRUE
YěcccMXptsMQgFwPBsDeL	TRUE
ZXWnIElsqgkúkPIGuffgf	TRUE
aaaQeSIebFxYufjUàKěǔO	TRUE
bbbKTlensWBwkyfrBFúat	TRUE
cXKpLAPaǎecccGiCQkUqy	TRUE
dGFdúpúaRaawDPHtaqáaY	TRUE
dzKfeTNúZOǎETAěpeeeHB	TRUE
ettlncWccènKgxkúiCWYú	TRUE
flTibbbCfèòSehNúTvbPk	TRUE
hEzApubvpyocccvfBnSRǒ	TRUE
iWěǎeBZouǒeeeGnQvVMiv	TRUE
jcàrUfffòFYTWGoHEǔjáǎ	TRUE
koòLpaaNaMMiábòLTákkU	TRUE
múNiòbbbgfUJvbOjrRTNl	TRUE
nǒcccOlúiMHSówPQUXKàǒ	TRUE
oeǎufbbbjczúoEjPZlTMX	TRUE
qóNOOujfNéSxjffLfIùom	TRUE
rRKxFRWIzLyiǒWffáfóám	TRUE
srZěàLěBeelěoJǎaaiaàp	TRUE
uùiptěDqùPǎddkdWNFěiq	TRUE
vZxaaawHikKtkmgQAèGég	TRUE
xǔZòWbóùcJěnzMaaaùKǒB	TRUE
yOwDbúgnértùedIddgfHá	TRUE
ùùfATHdětúHwQqAffffǔmǔ	FALSE
ǔNxwNhgaǒffffúáFFSSòK	FALSE
ákAdTDDèmnPEgoccccubóe	FALSE
ǎéLvgiJMSǔáweeeeóòEAV	FALSE
éMckǎCDcóqqeeeeòrLkRWv	FALSE
èZeKòJpgǔpsègBVeqNffff	FALSE
ěqXcfJGegzxGhǎKcccctYq	FALSE
òǎtpaaaaypYzBQnVVcippò	FALSE
ǒbWTǔYccccleYErXigjYre	FALSE
úlěIWCDPòxěbbbbEBeòèk	FALSE
AqmMEǔffffJtbHLynoPSv	FALSE
CAáLffffSQǔùsTiyUOVQJá	FALSE
DPzyMtaaaaGXsmIJaIfZTJ	FALSE
ElhórhaHèccccUmNwMvSF	FALSE
GRcqNsdddděaUbèAmoTAú	FALSE
IǔAbbbbéàBbǎùjtòHiYúKC	FALSE
JeéojBRièéaaaaěsùmoMàk	FALSE
KzsáòffffiSjzjZLsǒLiK	FALSE
MQphKáGvWQybbbbLDNByRZ	FALSE
NcfpéPgHězoěRokPirffff	FALSE
OktqArkRrzSáOyQTFzeeee	FALSE
QùZzjóxMxǎhzmNglddddhr	FALSE
RèXǔéǔryffffaUekcqXRj	FALSE
SccccyDèJxLCiLEuHáCòKB	FALSE
TrbbbbHKaohǔǒpMyUJéoE	FALSE
VBwBiàNǎJffffàuSǒKFbyF	FALSE
WdIjǒèhpǔWBrǎpybbbbOih	FALSE
YěccccMXptsMQgFwPBsDeL	FALSE
ZXWnIElsqgkúkPIGuffff	FALSE
aaaaQeSIebFxYufjUàKěǔO	FALSE
bbbbKTlensWBwkyfrBFúat	FALSE
cXKpLAPaǎeccccGiCQkUqy	FALSE
dGFdúpúaaaawDPHtaqáaY	FALSE
dzKfeTNúZOǎETAěpeeeeHB	FALSE
ettlnccccènKgxkúiCWYú	FALSE
flTbbbbCfèòSehNúTvbPk	FALSE
hEzApubvpyoccccvfBnSRǒ	FALSE
iWěǎeBZoueeeeGnQvVMiv	FALSE
jcàrUffffòFYTWGoHEǔjáǎ	FALSE
koòLpaaaaMMiábòLTákkU	FALSE
múNiòbbbbgfUJvbOjrRTNl	FALSE
nǒccccOlúiMHSówPQUXKàǒ	FALSE
oeǎufbbbbjczúoEjPZlTMX	FALSE
qóNOOujfNéSxjffffIùom	FALSE
rRKxFRWIzLyiǒWffffóám	FALSE
srZěàLěBeelěoJǎaaaaàp	FALSE
uùiptěDqùPǎddddWNFěiq	FALSE
vZxaaaawHikKtkmgQAèGég	FALSE
xǔZòWbóùcJěnzMaaaaùKǒB	FALSE
yOwDbúgnértùeddddgfHá	FALSE
ùùIORyjsSRkOnJEbibbGPF	TRUE
ǔGpzGUmLWFàùxByTIecccC	TRUE
áOMbbbOdWěIFEIǔUQiRTWB	TRUE
àféZXOqwlhbbbOwǒGwTrbo	TRUE
éǔVfǔǎUkǎCIYAàeabddédC	TRUE
èGfhbbbRnRWzQhOtYRBTAf	TRUE
ěiǒDIOLSòǔsùmUWNèfaddd	TRUE
òùuPùqlRpYLWùwfffvJycW	TRUE
ǒHdvdHúGWóSBaanartààMI	TRUE
úaQsKRTOycccùSSǔFcàǒàO	TRUE
BáGmdǔaaaVzǔwQágeBfTǔb	TRUE
CTTùnUNnBZbbbMCTaVòOuI	TRUE
DevTwUHúèAeeevUógěwlyS	TRUE
FIèXóaòltKAhèǒéúsaaaQS	TRUE
GTfffWrwòuehèǎiVǎSTáǒN	TRUE
IDofffJcǎièeùpYMXQkMMǒ	TRUE
JaaaǎpGoaBǔéYREbkJzipq	TRUE
KuǒMéYéQéBidSFcccZàfSv	TRUE
MKaDmmǎbbbirRzsèùPxEǔV	TRUE
NulSMuFeKEéEddǒdQsqRPe	TRUE
PSbbbrNFeXhDùémvVSPdVà	TRUE
RàRDZcccWRóèuEQpudbAYN	TRUE
SòáaQyédUBaETseéeerquz	TRUE
TSccYcChFéKHwjoWzZJùùú	TRUE
UZQFcèGMUdddOGfjGWJqpv	TRUE
VsěsoWǎAòOUfHrfffoúèYb	TRUE
XKpǒiVIpǔùùǒXGCaaaXvrG	TRUE
YcXěEàédddèGEúSxlUvuqP	TRUE
ZvddldPvVYtéáaTmáZǔcdg	TRUE
alòPěhcmMnldddERsjnHwQ	TRUE
bgcRùjocglSqUlcccDtxoT	TRUE
cccheNlzoǎcéMóéSnGZIcB	TRUE
dddcxyábéxóWBRovpUoxqQ	TRUE
ebSěábeeexóiDYJVeDPálX	TRUE
fRZóCLiupNùFYcccèPǔJZj	TRUE
gLeeeZǎbjOiKckKCIwáàOA	TRUE
hZeJSòMByQpbbbdIsàknoe	TRUE
jGǔDǎqJSoDoMGhHffzfrRà	TRUE
kgqRúbbtběvaIteBǒkCyiS	TRUE
lyvbóQòùǎxzéEAFàeemeyT	TRUE
nGvSdǔóóòfffoRcAǒtiQcó	TRUE
oeeeùNZtfXróEMFTòvxuáZ	TRUE
pjgǒGKtǒoědzhpVEnǎaaaO	TRUE
ràhAUáGpǎàùSQtWǎEbcccà	TRUE
sYAEúfhfffIbvXǔSNGFgKs	TRUE
tiArRátzoěaaagǎaHwkKmò	TRUE
véErmúáOWùHffflFHSyIxp	TRUE
wILqlpDEsfffXpàRbDYKúw	TRUE
xbcccǒbTFFVBSóMTàJhqDm	TRUE
yrpUPrUXébpbbjědaélVéH	TRUE
ùùIORyjsSRkOnJEbbbbGPF	FALSE
ǔGpzGUmLWFàùxByTIeccccC	FALSE
áObbbbOdWěIFEIǔUQiRTWB	FALSE
àféZXOqwlhbbbbOwǒGwTrbo	FALSE
éǔVfǔǎUkǎCIYAàeabddddC	FALSE
èGfhbbbbRnRWzQhOtYRBTAf	FALSE
ěiǒDIOLSòǔsùmUWNèfdddd	FALSE
òùuPùqlRpYLWùwffffJycW	FALSE
ǒHdvdHúGWóSBaaaartààMI	FALSE
úaQsKRTOyccccùSSǔFcàǒàO	FALSE
BáGmdǔaaaaVzǔwQágeBfTǔb	FALSE
CTTùnUNnBZbbbbCTaVòOuI	FALSE
DevTwUHúèAeeeevUógěwlyS	FALSE
FIèXóaòltKAhèǒéúsaaaaQS	FALSE
GTffffWrwòuehèǎiVǎSTáǒN	FALSE
IDoffffcǎièeùpYMXQkMMǒ	FALSE
JaaaaǎpGoaBǔéYREbkJzipq	FALSE
KuǒMéYéQéBidSFccccZàfSv	FALSE
MKaDmmǎbbbbirRzsèùPxEǔV	FALSE
NulSMuFeKEéEddddQsqRPe	FALSE
PSbbbbNFeXhDùémvVSPdVà	FALSE
RàRDccccWRóèuEQpudbAYN	FALSE
SòáaQyédUBaETseeeerquz	FALSE
TSccccChFéKHwjoWzZJùùú	FALSE
UZQFcèGMUddddOGfjGWJqpv	FALSE
VsěsoWǎAòOUfHrffffoúèYb	FALSE
XKpǒiVIpǔùùǒXGCaaaaXvrG	FALSE
YcXěEàddddèGEúSxlUvuqP	FALSE
ZvddddPvVYtéáaTmáZǔcdg	FALSE
alòPěhcmMnlddddRsjnHwQ	FALSE
bgcRùjocglSqUccccDtxoT	FALSE
ccccheNlzoǎcéMóéSnGZIcB	FALSE
ddddcxyábéxóWBRovpUoxqQ	FALSE
ebSěábeeeexóiDYJVeDPálX	FALSE
fRZóCLiupNùFYccccèPǔJZj	FALSE
gLeeeeZǎbjOiKckKCIwáàOA	FALSE
hZeJSòMByQbbbbdIsàknoe	FALSE
jGǔDǎqJSoDoMGhHffffrRà	FALSE
kgqRúbbbběvaIteBǒkCyiS	FALSE
lyvbóQòùǎxzéEAFàeeeeyT	FALSE
nGvSdǔóóòffffoRcAǒtiQcó	FALSE
oeeeeùNZtfXróEMFTòvxuáZ	FALSE
pjgǒGKtǒoědzhpVEnǎaaaaO	FALSE
ràhAUáGpǎàùSQtWǎEbcccc	FALSE
sYAEúfffffIbvXǔSNGFgKs	FALSE
tiArRátzoěaaaaǎaHwkKmò	FALSE
véErmúáOWùHfffflFHSyIxp	FALSE
wILqlpDEsffffXpàRbDYKúw	FALSE
xbccccbTFFVBSóMTàJhqDm	FALSE
yrpUPrUXébbbbjědaélVéH	FALSE
ùùMjPyàgdawzrzcHVvXbèbb	TRUE
ǔKǎpUabDvLfyùaaianWBIiu	TRUE
árGmáLóěIfKbbbǔfjúPFFGg	TRUE
ǎCqdvcccNadLWTdèyúVrùSv	TRUE
éfcUhbbbàùbMàNésǔuglnJH	TRUE
ěHZaaarYUGptvIEdiLBùVyM	TRUE
óPNdpcccǒYYòQagYùzjǎaEI	TRUE
òcKrXvJEaAaanqglúèfkaáw	TRUE
úěùrsóòóuvGlffsfNoVPIòW	TRUE
AedddódfAjKiSQhHsPHfPGB	TRUE
BsGònáwGhRàúcMccanǎZeǒè	TRUE
DCrgnKjqúaaaOáVuFwdrIMo	TRUE
EXPDMGpcLwxwFcsefffXTEK	TRUE
FwglèeeeóJhlYhgmvBùOPfi	TRUE
HEHizddděvCvppǒesWáxEYP	TRUE
IajAaaazpYnjsONOrójbDek	TRUE
JvYàéOdlVxěáAFrCkbbbGKW	TRUE
LúDflpóILlBgidnddgmQtJg	TRUE
MUZtOjsǔCèvwdYjEvBQffuf	TRUE
NyaCmèIǒoibběblòHXùqòós	TRUE
POEieBeeBCoěBBdRLópkzAá	TRUE
QbbbIVǎYóèpPrYúHǎVàòWBw	TRUE
RoDidóDAǒDGéZYgXcJaaaXi	TRUE
TózBRMeàeeLOjTWqQjǔxqMò	TRUE
UaJnkcccktQuQBjáMYGúěoj	TRUE
WóZgàrVeaaJaòIděxRIWhóǎ	TRUE
XPJaaaywàNxáguǔLlIěǒtěM	TRUE
YfDAvLádddtděFLùHFNyPAw	TRUE
ZsVskeeeaFòelfEONǔSWuYM	TRUE
akCYAMtYtbfffXmiáDVǒHEp	TRUE
bciMTéxRddKdtDwúèAMrcqw	TRUE
cccYnvMóCáomXNIoùRKMtǔl	TRUE
dddMkAnEójlòéǔqMLYJiééQ	TRUE
eeeùcSútBDtvLQǒYsCzKTǒt	TRUE
fUaaartlPduùgEèǒóHóbǔjù	TRUE
gLKbbbSuhRòsàRcQdQǒSkaz	TRUE
hbbbǎóúGhcsBTqPzOsvsòqs	TRUE
ihKlUFerffféZemEúJwaMúé	TRUE
jugjJKOnLkúflffhRmePyOe	TRUE
lRcurSGivǎNZOrdddNáAgCV	TRUE
mjdvúàmiCvbCSúIbbbVúBjI	TRUE
oòkCRjhQskùdXxdddwsyóǎS	TRUE
pVsztéaavarǎǎydBSrENugA	TRUE
qjOgàóhqtWiqGRCiwbOáccc	TRUE
rrMWyEěěyLccócGYbNeaglg	TRUE
tPěafdLscccrǒPSNkOMǒǔǎl	TRUE
uruVmqxYvSLffǔfWNgeèlub	TRUE
vuGIIpògVàicccKǔyàDIRcc	TRUE
xReùWZfPcyOdddáiEtYsHFZ	TRUE
ylPǔJaaaPDbcxméTYNXòBQi	TRUE
ùùMjPyàgdawzrzcHVvXbbbb	FALSE
ǔKǎpUabDvLfyùaaaanWBIiu	FALSE
árGmáLóěIfKbbbbfjúPFFGg	FALSE
ǎCqdccccNadLWTdèyúVrùSv	FALSE
éfcUbbbbàùbMàNésǔuglnJH	FALSE
ěHZaaaarYUGptvIEdiLBùVyM	FALSE
óPNdpccccǒYYòQagYùzjǎaEI	FALSE
òcKrXvJEaaaanqglúèfkaáw	FALSE
úěùrsóòóuvGlffffNoVPIòW	FALSE
AeddddfAjKiSQhHsPHfPGB	FALSE
BsGònáwGhRàúccccanǎZeǒè	FALSE
DCrgnKjqúaaaaOáVuFwdrIMo	FALSE
EXPDMGpcLwxwFcseffffXTEK	FALSE
FwglèeeeeJhlYhgmvBùOPfi	FALSE
HEHizdddděvCvppǒesWáxEYP	FALSE
IajAaaaazpYnjsONOrójbDek	FALSE
JvYàéOdlVxěáAFrCkbbbbGKW	FALSE
LúDflpóILlBgiddddgmQtJg	FALSE
MUZtOjsǔCèvwdYjEvBQffff	FALSE
NyaCmèIǒoibbbblòHXùqòós	FALSE
POEieeeeBCoěBBdRLópkzAá	FALSE
QbbbbIVǎYóèpPrYúHǎVàòWBw	FALSE
RoDidóDAǒDGéZYgXcaaaaXi	FALSE
TózBRMeeeeLOjTWqQjǔxqMò	FALSE
UaJnkccccktQuQBjáMYGúěoj	FALSE
WóZgàrVeaaaaòIděxRIWhóǎ	FALSE
XPJaaaaywàNxáguǔLlIěǒtěM	FALSE
YfDAvLáddddtděFLùHFNyPAw	FALSE
ZsVskeeeeaFòelfEONǔSWuYM	FALSE
akCYAMtYtbffffmiáDVǒHEp	FALSE
bciMTéxRddddtDwúèAMrcqw	FALSE
ccccYnvMóCáomXNIoùRKMtǔl	FALSE
ddddkAnEójlòéǔqMLYJiééQ	FALSE
eeeeùcSútBDtvLQǒYsCzKTǒt	FALSE
faaaartlPduùgEèǒóHóbǔjù	FALSE
gLbbbbSuhRòsàRcQdQǒSkaz	FALSE
hbbbbǎóúGhcsBTqPzOsvsòqs	FALSE
ihKlUFerfffféZemEúJwaMúé	FALSE
jugjJKOnLkúffffhRmePyOe	FALSE
lRcurSGivǎNZOddddNáAgCV	FALSE
mjdvúàmiCvbCSúIbbbbVúBjI	FALSE
oòkCRjhQskùdXxddddwsyóǎS	FALSE
pVsztéaaaarǎǎydBSrENugA	FALSE
qjOgàóhqtWiqGRCiwbOácccc	FALSE
rrMWyEěěyLccccGYbNeaglg	FALSE
tPěafdLsccccrǒPSNkOMǒǔǎl	FALSE
uruVmqxYvSLffffWNgeèlub	FALSE
vuGIIpògVàiccccKǔyàDIRcc	FALSE
xReùWZfPcyOddddáiEtYsHFZ	FALSE
ylPǔJaaaaPDbcxméTYNXòBQi	FALSE
ùùbbbiQbOjiRádgLupúUFǒúu	TRUE
ǔXEáZIǒǎYfǔèArYdddèVòZey	TRUE
àúxóóDbbbUavéTǒJHkUYqpfO	TRUE
ǎffpféècùhRvGóJpdiàeáMKf	TRUE
èàaSKmxKTJTtxùffBfVFXpDc	TRUE
ěWáqJSRAwKeceeEShěǒZqPKw	TRUE
òàelLfOffèySLbnAVOáDqGXb	TRUE
ǒNáddkdgHENònNAJGvUǔéeHk	TRUE
úkGMdǔwsOXZceccNjLIPcàùǔ	TRUE
AvKǒXàxrKreSaZaaóuùJJZPE	TRUE
CàékěefizmRkJbRSRxleeàej	TRUE
DLmahNEǔAèbbbòUQhrRéPǒnJ	TRUE
EbaeeeqhAeZǎqDIFrTuAqéjé	TRUE
GEzYàBmcccobúbòtcóEUàúSz	TRUE
HWWTéhSěsQeotBQZAFaaasie	TRUE
IygtCdRéTèJeEQZébbbsEuvm	TRUE
KMMXaaxaatkòǔVǒSKNalǔLJo	TRUE
LbDQhZDóòdrPászéWeeeJTxq	TRUE
NázKqéOuzFǒoycccàǎhYOóeJ	TRUE
OGhákLmmaFsbffflkòPJdWsX	TRUE
PWbiědvǔkùéJfáaMCbDvfffà	TRUE
QuòCncccfǎbuEǔqsPtSFzǔbT	TRUE
RydKZNsópKEèqplJhnyddděw	TRUE
TKeXiOzázAkEòrsndddHhǎQe	TRUE
UrǔeitrDrGzZyVQfffplěéBT	TRUE
WRGBeeegFMòJtUbtgiPǔùtHA	TRUE
XbbbǔeéòyXIqDUouXòkàJEàk	TRUE
YzǎáéoTbvNeeemohnZǔftmoá	TRUE
aEnQPnaaaúMǎSNBǎéLswFkIk	TRUE
atJǔqMúuKaQpoccVcNLedgMè	TRUE
bvbUYbjbbráàaèVlsBèqDUOD	TRUE
cgACTèXùXmKgataaQSrpǒǎIY	TRUE
dddKOKuCěJpǔaTǒZèqDdhGvr	TRUE
eZAòébbbmxòTHGwAùQxlcRWJ	TRUE
fGYYjàpcHáFěféfftfdWuěGé	TRUE
gǒYáUxGckccFóTXGkxǎBIBTV	TRUE
hlzrYěWZVyjyUKeeFesThLpè	TRUE
jóYyǔORVOsaTǔXleòeeǒócáQ	TRUE
keězhJtaaaògrCFBxoTQVfAn	TRUE
mDànǎHgPwgPǎěYffúfévTòuZ	TRUE
nLZcccCészhwCǔTmZzHyólun	TRUE
oVnFěEAUúdddsjzklrCPǔéjP	TRUE
pqǎúJuDGlaomXǔdddgjDGǔkZ	TRUE
qyièòàPWUjNòFddQdXghbobǔ	TRUE
sǎjaWVěniAoYkumbbbeúQtǎà	TRUE
tJàJIkoJjlieRBkvccAcBfaa	TRUE
ufrRdUhdRyOIcrbVfovbPbbz	TRUE
wǒgBSNǒùiUZMdyxbbbuǎQFGN	TRUE
xGvNRaaasIPbqkJCVQStkěoc	TRUE
ymzèGyòAUbbkfffòqPòbeBdA	TRUE
ùbbbbiQbOjiRádgLupúUFǒúu	FALSE
ǔXEáZIǒǎYfǔèArYddddèVòZey	FALSE
àúxóóDbbbbUavéTǒJHkUYqpfO	FALSE
ǎfffféècùhRvGóJpdiàeáMKf	FALSE
èàaSKmxKTJTtxùffffVFXpDc	FALSE
ěWáqJSRAwKeeeeEShěǒZqPKw	FALSE
òàelLffffèySLbnAVOáDqGXb	FALSE
ǒNáddddgHENònNAJGvUǔéeHk	FALSE
úkGMdǔwsOXZccccNjLIPcàùǔ	FALSE
AvKǒXàxrKreSaaaaóuùJJZPE	FALSE
CàékěefizmRkJbRSRxleeeej	FALSE
DLmahNEǔAèbbbbòUQhrRéPǒnJ	FALSE
EbaeeeeqhAeZǎqDIFrTuAqéjé	FALSE
GEzYàBmccccobúbòtcóEUàúSz	FALSE
HWWTéhSěsQeotBQZAFaaaasie	FALSE
IygtCdRéTèJeEQZébbbbsEuvm	FALSE
KMMXaaaatkòǔVǒSKNalǔLJo	FALSE
LbDQhZDóòdrPászéWeeeeTxq	FALSE
NázKqéOuzFǒoyccccàǎhYOóeJ	FALSE
OGhákLmmaFsbfffflkòPJdWsX	FALSE
PWbiědvǔkùéJfáaMCbDvffffà	FALSE
QuòCccccfǎbuEǔqsPtSFzǔbT	FALSE
RydKZNsópKEèqplJhnydddděw	FALSE
TKeXiOzázAkEòrsnddddhǎQe	FALSE
UrǔeitrDrGzZyVQffffplěéBT	FALSE
WRGeeeegFMòJtUbtgiPǔùtHA	FALSE
XbbbbǔeéòyXIqDUouXòkàJEàk	FALSE
YzǎáéoTbveeeemohnZǔftmoá	FALSE
aEnQPnaaaaúMǎSNBǎéLswFkIk	FALSE
atJǔqMúuKaQpoccccNLedgMè	FALSE
bvbUYbbbbráàaèVlsBèqDUOD	FALSE
cgACTèXùXmKgaaaaQSrpǒǎIY	FALSE
ddddKOKuCěJpǔaTǒZèqDdhGvr	FALSE
eZAòébbbbxòTHGwAùQxlcRWJ	FALSE
fGYYjàpcHáFěfffftfdWuěGé	FALSE
gǒYáUxGccccFóTXGkxǎBIBTV	FALSE
hlzrYěWZVyjyUKeeeesThLpè	FALSE
jóYyǔORVOsaTǔXleeeeǒócáQ	FALSE
keězhJaaaaògrCFBxoTQVfAn	FALSE
mDànǎHgPwgPǎěYffffévTòuZ	FALSE
nLccccCészhwCǔTmZzHyólun	FALSE
oVnFěEAUúddddsjzklrCPǔéjP	FALSE
pqǎúJuDGlaomXǔddddgjDGǔkZ	FALSE
qyièòàPWUjNòFddddXghbobǔ	FALSE
sǎjaWVěniAoYkumbbbbeúQtǎà	FALSE
tJàJIkoJjlieRBkvccccBfaa	FALSE
ufrRdUhdRyOIcrbVfovbbbbz	FALSE
wǒgBSNǒùiUZMdyxbbbbuǎQFGN	FALSE
xGvNRaaaasIPbqkJCVQStkěoc	FALSE
ymzèGyòAUbbkffffqPòbeBdA	FALSE
ùùǒpnoDbbObòaWcWTwàsYxfTN	TRUE
ǔVaǔFsXyWáXiyóBwoCHYRěeee	TRUE
áuJfCddUfmrptáynzjùUGeOee	TRUE
ǎOoTXnéEQQqiYpǔCcsoxsBddd	TRUE
écdèpDyXXxxcRccggDvonccRE	TRUE
èjaowuBDrzǒJòSGǎóaaaAXúkm	TRUE
óóiòwjGNéeJOǔIYOcccOorzUA	TRUE
òHYVLàoNvxfffGYoeǒTyWuDFD	TRUE
ǒmIzsUfFxeMBaZbbbYNgěZRzh	TRUE
AOJEèxGàqknòtmecwéeqeefǒP	TRUE
BcccYèměLsVwobèoqamSKPHHb	TRUE
DàcaaQafyCUFéòawsEjàAEúNV	TRUE
EXòǔgfSRUóeMpfffkaHIGSQaR	TRUE
GǎàNXAkómlxòDGeeeFTxnWBǒé	TRUE
HMJNiFKPUEùaaaáWàEPSZětqX	TRUE
IjBàEtnFèhffufuwóúARǔoRXn	TRUE
JnhubǎJlwVKkCfaXLdddzǒHèu	TRUE
LóEYVhIkóQKCǎAjvaJaadtVoh	TRUE
MAKXyeeeoGkTfPuUvánDǔglZá	TRUE
NOSfffètQělybóWwèǒgmcZKuó	TRUE
OměádddsUfnuJpyNfwwOYltéO	TRUE
QCkQPěUFpwbàefIdEàdddJǒuU	TRUE
RWZDvbefdYwòUSYúBdacaaKno	TRUE
SvccctMdEGqácrQLfǔjǎOǔiUs	TRUE
UaVnRéOMaaaùfùVRLHlaaqBàh	TRUE
VfOwMǎFfúDKWCrǔúPsTldddtX	TRUE
XěeeetTidmOuVǎàWaùhLǒǔTec	TRUE
YPAbcccgrzHYmfwgNGfUwZDri	TRUE
ZdúxQaVNGxkzjTbbAbDǒèǒLéY	TRUE
akEòMǒkóPnWóóNRydéeeBeYjD	TRUE
bbtbxJQbMàLàtéoVVOrǎDrVoX	TRUE
cccoCLěXapFǔérpéxǒGciáEtM	TRUE
ddIdpnNúHTjtfdscBStKvSǒXe	TRUE
ecccEENRěàiǒòúyóiBtfugQlu	TRUE
fRFtcWHiXěòtFTóStbbbxumDS	TRUE
gIàdddàónfèewùthàxoHupqYI	TRUE
hnúiqǔzhEòàDOèKQxYfffUtqI	TRUE
jLjkUxáǔqRcccEdrISěnnXLRé	TRUE
keěanfKgSkdJcbbbXTrUuZGǒp	TRUE
lhgXpqFtlDdeqeeffàFúMòGúá	TRUE
nèbbbHCVVéPóFXèLHMUFswggx	TRUE
oǒiRGpǎCQǔxqWYLbbbjixCPdA	TRUE
pcccfèòfZxòèNNFsnòigKHèYE	TRUE
qxAUsóaoIxbbbUBZzàYSSěfcǎ	TRUE
sIǔkèGGsǒyHǒdouTVěòQeeekT	TRUE
tZpècccáxAYhUěKBFGèTéérXd	TRUE
uueeeOzSóVmBbAncMFòèdEWtq	TRUE
wDèrTTCISQFvGbJéQmbqcVccé	TRUE
xcEOfWQcnUdúòFQrCOǎTEeeek	TRUE
ypápzBVzQyRaiSàǔfěǎXfflfV	TRUE
ùùǒpnoDbbbbòaWcWTwàsYxfTN	FALSE
ǔVaǔFsXyWáXiyóBwoCHYRěeeee	FALSE
áuJfCddUfmrptáynzjùUGeeee	FALSE
ǎOoTXnéEQQqiYpǔCcsoxsBdddd	FALSE
écdèpDyXXxxccccggDvonccRE	FALSE
èjaowuBDrzǒJòSGǎóaaaaAXúkm	FALSE
óóiòwjGNéeJOǔIYOccccOorzUA	FALSE
òHYVLàoNvffffGYoeǒTyWuDFD	FALSE
ǒmIzsUfFxeMBaZbbbbNgěZRzh	FALSE
AOJEèxGàqknòtmecwéeeeefǒP	FALSE
BccccYèměLsVwobèoqamSKPHHb	FALSE
DàcaaaafyCUFéòawsEjàAEúNV	FALSE
EXòǔgfSRUóeMffffkaHIGSQaR	FALSE
GǎàNXAkómlxòDeeeeFTxnWBǒé	FALSE
HMJNiFKPUEùaaaaáWàEPSZětqX	FALSE
IjBàEtnFèhffffuwóúARǔoRXn	FALSE
JnhubǎJlwVKkCfaXddddzǒHèu	FALSE
LóEYVhIkóQKCǎAjvaaaadtVoh	FALSE
MAKXyeeeeoGkTfPuUvánDǔglZá	FALSE
NOSffffètQělybóWwèǒgmcZKuó	FALSE
OměáddddsUfnuJpyNfwwOYltéO	FALSE
QCkQPěUFpwbàefIdEàddddJǒuU	FALSE
RWZDvbefdYwòUSYúBdaaaaKno	FALSE
ScccctMdEGqácrQLfǔjǎOǔiUs	FALSE
UaVnRéOMaaaaùfùVRLHlaaqBàh	FALSE
VfOwMǎFfúDKWCrǔúPsTddddtX	FALSE
XeeeetTidmOuVǎàWaùhLǒǔTec	FALSE
YPAbccccrzHYmfwgNGfUwZDri	FALSE
ZdúxQaVNGxkzjTbbbbDǒèǒLéY	FALSE
akEòMǒkóPnWóóNRydéeeeeYjD	FALSE
bbbbxJQbMàLàtéoVVOrǎDrVoX	FALSE
ccccoCLěXapFǔérpéxǒGciáEtM	FALSE
ddddpnNúHTjtfdscBStKvSǒXe	FALSE
eccccEENRěàiǒòúyóiBtfugQlu	FALSE
fRFtcWHiXěòtFTóStbbbbxumDS	FALSE
gIàddddàónfèewùthàxoHupqYI	FALSE
hnúiqǔzhEòàDOèKQxYfffftqI	FALSE
jLjkUxáǔqRccccEdrISěnnXLRé	FALSE
keěanfKgSkdJcbbbbXTrUuZGǒp	FALSE
lhgXpqFtlDdeeeeffàFúMòGúá	FALSE
nbbbbHCVVéPóFXèLHMUFswggx	FALSE
oǒiRGpǎCQǔxqWYLbbbbjixCPdA	FALSE
pccccfèòfZxòèNNFsnòigKHèYE	FALSE
qxAUsóaoIxbbbbBZzàYSSěfcǎ	FALSE
sIǔkèGGsǒyHǒdouTVěòQeeeekT	FALSE
tZpèccccáxAYhUěKBFGèTéérXd	FALSE
ueeeeOzSóVmBbAncMFòèdEWtq	FALSE
wDèrTTCISQFvGbJéQmbqccccé	FALSE
xcEOfWQcnUdúòFQrCOǎTEeeee	FALSE
ypápzBVzQyRaiSàǔfěǎXffffV	FALSE
ùùǒéMDvfasFěqcvYpeeeRUKufR	TRUE
ǔciccjRIMklFzóIktámfMbONSk	TRUE
áncDccwBwéEòfQzyXDDlqLóNòZ	TRUE
ǎǔInuYxFfCǎǔojéNxPcbbbTcap	TRUE
éKǎáEhMoaaaǎtljúàěòútXvWzF	TRUE
èVtCGdzwgùJpbbbGKnǎrgppouu	TRUE
ějDěùfffvèDéiEUXCOOkKIézWM	TRUE
òǔúIěVwǒHmprùeeeóEWgQùTonb	TRUE
ǒaRpcFcccòǔitYùFsqùòvhraBà	TRUE
úruYszAaaawPxDESpreóIǔNkQa	TRUE
BFYǔVcfmIàmkVSVVbFypcccNAJ	TRUE
CPAYqbbbdnIRalójWgwJipdWzD	TRUE
DmǔàHǎdóbOApbbubuVèlXBsPwT	TRUE
EhSgǎoyfFLěccwcúxNBBàAgAam	TRUE
GǒQèwTJQGjYuOǔádddbUcjCvEX	TRUE
HQyexoùjeóHpdddMdòOAǒòGIjX	TRUE
ImaaapòyèXhéBexjeǔxWPbémòH	TRUE
KèjEfǒXǎùXfǎvJtHúcccùINfèC	TRUE
LKxaHanpáLpjivTaedddJYoMLZ	TRUE
MpraaaPRfNzIlhúxǔQDěUHIǒOL	TRUE
NxúsbbrbSnYQDóhàǔvnCúZpPèZ	TRUE
PQLYsckSPldddèNKwěJMBwmEjM	TRUE
QyǒFbàEJYLUodPddéKqWoDLUCS	TRUE
STEksRùZYUEacaaRaóiMVVPsNt	TRUE
TqǎEYsFuhXWnòùiflrkcóccXFA	TRUE
VòóNzCǒtbObbécgnEwéPJYdofg	TRUE
WèǒLUvàDVOrSvNǒfffGZAdhGlW	TRUE
XaǎùLǎyEsúSóUppccaaBaKHpMò	TRUE
ZǎbbZbbHóSǔvWxJDǒkábXzǒmUt	TRUE
aIbOGànzaaaómhPOClvbVSǎeOM	TRUE
bGvěQfóXdddWjSDùbLeMváOqRM	TRUE
cèzǒNCsyòMǔOsLóEyUfffǒoZtY	TRUE
cuaaùagPOMVOFfHRsMsHzoePoá	TRUE
eǎTàǒwǎEóhVOeeeQVBjBmzóZiá	TRUE
féRuéódiddàòèCcOééPMJfNKói	TRUE
géFspIdsGǔèáVùPdáFFIeeepdw	TRUE
hVtxOáméPjóáPlyvVvAbbbùeFz	TRUE
ilOtEHArSfffYhgèòtéXsMxbgà	TRUE
jrDFxieCeeaBJbàVBQúXUQvfhZ	TRUE
lKgsghJeeefGòVWmwUZmPeDiǒq	TRUE
mdUOFiezesǔGPhWDtcbvEUwccc	TRUE
oàyMpRzjXIteeebxfpcDPaoHot	TRUE
pWWsWJgCsgeeVescHJrSTxjKAs	TRUE
qfóffuWRDwoHúUSUehIzxnBgTf	TRUE
rpWaòGKHbbcbafmzNǒUrXGóQùq	TRUE
tǎèAOfLjyffàfkúJTvǎǔPSOirr	TRUE
uJbfǔffèWadǎEIigeDABpmOVgE	TRUE
vjwělnRIDvQWueIUSBǒMLgaaaj	TRUE
xàbVaúdéraaawCuzukAucǔUWJU	TRUE
yWòOULQenuóffófIabQsVBPaVA	TRUE
ùùǒéMDvfasFěqcvYpeeeeRUKufR	FALSE
ǔccccjRIMklFzóIktámfMbONSk	FALSE
ánccccwBwéEòfQzyXDDlqLóNòZ	FALSE
ǎǔInuYxFfCǎǔojéNxPbbbbTcap	FALSE
éKǎáEhMoaaaaǎtljúàěòútXvWzF	FALSE
èVtCGdzwgùJpbbbbGKnǎrgppouu	FALSE
ějDěùffffvèDéiEUXCOOkKIézWM	FALSE
òǔúIěVwǒHmprùeeeeóEWgQùTonb	FALSE
ǒaRpcFccccòǔitYùFsqùòvhraBà	FALSE
úruYszAaaaawPxDESpreóIǔNkQa	FALSE
BFYǔVcfmIàmkVSVVbFypccccNAJ	FALSE
CPAYqbbbbnIRalójWgwJipdWzD	FALSE
DmǔàHǎdóbOApbbbbuVèlXBsPwT	FALSE
EhSgǎoyfFLěccccúxNBBàAgAam	FALSE
GǒQèwTJQGjYuOǔáddddbUcjCvEX	FALSE
HQyexoùjeóHpddddMdòOAǒòGIjX	FALSE
ImaaaapòyèXhéBexjeǔxWPbémòH	FALSE
KèjEfǒXǎùXfǎvJtHúccccùINfèC	FALSE
LKxaHanpáLpjivTaeddddJYoMLZ	FALSE
MpaaaaPRfNzIlhúxǔQDěUHIǒOL	FALSE
NxúsbbbbSnYQDóhàǔvnCúZpPèZ	FALSE
PQLYsckSPlddddNKwěJMBwmEjM	FALSE
QyǒFbàEJYLUoddddéKqWoDLUCS	FALSE
STEksRùZYUEaaaaRaóiMVVPsNt	FALSE
TqǎEYsFuhXWnòùiflrkccccXFA	FALSE
VòóNzCǒtbbbbécgnEwéPJYdofg	FALSE
WèǒLUvàDVOrSvNǒffffGZAdhGlW	FALSE
XaǎùLǎyEsúSóUppccaaaaKHpMò	FALSE
ZǎbbbbHóSǔvWxJDǒkábXzǒmUt	FALSE
aIbOGànzaaaamhPOClvbVSǎeOM	FALSE
bGvěQfóXddddWjSDùbLeMváOqRM	FALSE
cèzǒNCsyòMǔOsLóEyUffffoZtY	FALSE
cuaaaagPOMVOFfHRsMsHzoePoá	FALSE
eǎTàǒwǎEóhVOeeeeVBjBmzóZiá	FALSE
féRuéóddddàòèCcOééPMJfNKói	FALSE
géFspIdsGǔèáVùPdáFFeeeepdw	FALSE
hVtxOáméPjóáPlyvVvAbbbbùeFz	FALSE
ilOtEHArSffffYhgèòtéXsMxbgà	FALSE
jrDFxieeeeaBJbàVBQúXUQvfhZ	FALSE
lKgsghJeeeefGòVWmwUZmPeDiǒq	FALSE
mdUOFiezesǔGPhWDtcbvEUwcccc	FALSE
oàyMpRzjXIeeeebxfpcDPaoHot	FALSE
pWWsWJgCsgeeeescHJrSTxjKAs	FALSE
qffffuWRDwoHúUSUehIzxnBgTf	FALSE
rpWaòGKHbbbbafmzNǒUrXGóQùq	FALSE
tǎèAOfLjyffffkúJTvǎǔPSOirr	FALSE
uJbffffèWadǎEIigeDABpmOVgE	FALSE
vjwělnRIDvQWueIUSBǒMLgaaaa	FALSE
xàbVaúdéraaaawCuzukAucǔUWJU	FALSE
yWòOULQenuóffffIabQsVBPaVA	FALSE
ùǔsPúáLQznCQYlYQáǎJXIbbbùGu	TRUE
ǔécDUǒCGItmqaaaàǎúgbpGYEFpà	TRUE
áeèeǎwsQZKxssddSdzaGVWúfuTU	TRUE
àyexFqnLmPúòùBǔòoJOfffBgMqi	TRUE
éǎhJTWCnGsspvofjEkddPdnFMOu	TRUE
èMeSWBtyóájúKxHqlBJGéENOddd	TRUE
ěeǎzoeZbáòéòaaaybReELrSYtEf	TRUE
óskCgáxvvJVcccYxNpgloAYPKVM	TRUE
ǒIaaaeǔZViyKujàóòàVFwskjxhT	TRUE
újFfffúmTXvtQirdbTcCwIhbwaǒ	TRUE
BDEùGháCéDèZěùěQLMHǔùaaaPjB	TRUE
ClMèpǒEIǎUdbDopZMDóPyWfǒffM	TRUE
DwvrsbEoQhqvèòcccbFduAHzznP	TRUE
FDpzsoonLYjHVKzmàUWrvǔdddIA	TRUE
GdzqdGfYkbdOxúcccYJbOówàáSp	TRUE
HxNyYdddókòVhvólTCTzòrrKěhà	TRUE
JóFqaaaǎdJQhbYsnpjdfHAeùPMB	TRUE
KhNMzěeǔùEeeeyàǒcHntrdVUiái	TRUE
MóAYǔftúZJóěrcBEFSlrgheeepz	TRUE
NUXwNǎzWxhyZuMeZAHOóMjaaacg	TRUE
OrégJAmNqhbúééóBCvROBeReeAB	TRUE
QǎhRúPéméEWiQhǔkffYǒLYcZccc	TRUE
RDóétéSvzèszLjNhcǒGlfBffsUv	TRUE
SPèAURùcHehmbbblruǎcéárPFóa	TRUE
TnjxPRyLGovlRJdCǔmèeccgcqVA	TRUE
VówúuEUVvhbykfffOveòqFòdftC	TRUE
WPJQXCGoěOéfhlaTXNaaaWgewWM	TRUE
XaaaòAhvbàòwyěJrèpàRKjiùuLq	TRUE
YygGmàkFàUfkXDvNèRfqeeeóNlw	TRUE
aEWSXlKfffxLPsHsKdccOpXIejJ	TRUE
bùbbèwlIkKWJHuáTyfBidqcérěw	TRUE
cǎWeCNaòrExQnéCfqzCMIJUbbbd	TRUE
cweXHFkQbbbexIùǎùǒWThZvéhLn	TRUE
eàǎAúóǒèěvFPblbVymǎcpccaowX	TRUE
fésTcúFcEédddYùzúúóKPHrBGHC	TRUE
gǔtsEZZmiOeCGHcàRfrffFǒCqtP	TRUE
hTébbbùViPBAQNéúscePveùylǔV	TRUE
iYVIwWéòòdddNgáEbBtAQEcCHEb	TRUE
jxYKóǒDisIDòIOlMfZffGJSqǔgZ	TRUE
lFùTKGtdddǎEbéHIlpXoybGwnFù	TRUE
meebeFYDNpJúéoBrfNUfǎQěAALá	TRUE
nyiedèZxHFOXOCeeecfFKrúcǒOú	TRUE
pWjzHàRMfxxFeZrqZǔEfùffjHdO	TRUE
qzyUTUòfffwǎGóúORéZHěáiúVmn	TRUE
sNJITowcccvgRáqpòVRúUèTIUGó	TRUE
tuQjyàXzhaoàiyPsYfffMjVnrVk	TRUE
vPZsiaaaMIěǒprvDXàTèùǒiAvGú	TRUE
wmTUIVOXóNzvUjzJpdddAeóFpJò	TRUE
xwODEyrlXnbàRzeBuBrTLLbOccc	TRUE
yuwxzzZbsbaùmMOgeeedncáCNnP	TRUE
ùǔsPúáLQznCQYlYQáǎJXIbbbbGu	FALSE
ǔécDUǒCGItmqaaaaàǎúgbpGYEFpà	FALSE
áeèeǎwsQZKxssddddzaGVWúfuTU	FALSE
àyexFqnLmPúòùBǔòoJOffffBgMqi	FALSE
éǎhJTWCnGsspvofjEkddddnFMOu	FALSE
èMeSWBtyóájúKxHqlBJGéENOdddd	FALSE
ěeǎzoeZbáòéòaaaabReELrSYtEf	FALSE
óskCgáxvvJccccYxNpgloAYPKVM	FALSE
ǒIaaaaeǔZViyKujàóòàVFwskjxhT	FALSE
újFffffúmTXvtQirdbTcCwIhbwaǒ	FALSE
BDEùGháCéDèZěùěQLMHǔaaaaPjB	FALSE
ClMèpǒEIǎUdbDopZMDóPyWffffM	FALSE
DwvrsbEoQhqvèòccccFduAHzznP	FALSE
FDpzsoonLYjHVKzmàUWrvǔddddIA	FALSE
GdzqdGfYkbdOxúccccYJbOówàáSp	FALSE
HxNyYddddókòVhvólTCTzòrrKěhà	FALSE
JóFqaaaaǎdJQhbYsnpjdfHAeùPMB	FALSE
KhNMzěeǔùEeeeeyàǒcHntrdVUiái	FALSE
MóAYǔftúZJóěrcBEFSlrgheeeepz	FALSE
NUXwNǎzWxhyZuMeZAHOóMjaaaacg	FALSE
OrégJAmNqhbúééóBCvROBeeeeAB	FALSE
QǎhRúPéméEWiQhǔkffYǒLYccccc	FALSE
RDóétéSvzèszLjNhcǒGlffffsUv	FALSE
SPèAURùcHehbbbblruǎcéárPFóa	FALSE
TnjxPRyLGovlRJdCǔmèeccccqVA	FALSE
VówúuEUVvhbykffffOveòqFòdftC	FALSE
WPJQXCGoěOéfhlaTXaaaaWgewWM	FALSE
XaaaaòAhvbàòwyěJrèpàRKjiùuLq	FALSE
YygGmàkFàUfkXDvNèRfqeeeeóNlw	FALSE
aEWSXlKffffLPsHsKdccOpXIejJ	FALSE
bbbbèwlIkKWJHuáTyfBidqcérěw	FALSE
cǎWeCNaòrExQnéCfqzCMIJUbbbbd	FALSE
cweXHFkQbbbbxIùǎùǒWThZvéhLn	FALSE
eàǎAúóǒèěvFPblbVymǎccccaowX	FALSE
fésTcúFcEéddddùzúúóKPHrBGHC	FALSE
gǔtsEZZmiOeCGHcàRffffFǒCqtP	FALSE
hTébbbbùViPBAQNéúscePveùylǔV	FALSE
iYVIwWéòòddddNgáEbBtAQEcCHEb	FALSE
jxYKóǒDisIDòIOlMffffGJSqǔgZ	FALSE
lFùTKGddddǎEbéHIlpXoybGwnFù	FALSE
meeeeFYDNpJúéoBrfNUfǎQěAALá	FALSE
nyiedèZxHFOXOCeeeefFKrúcǒOú	FALSE
pWjzHàRMfxxFeZrqZǔEffffjHdO	FALSE
qzyUTUòffffwǎGóúORéZHěáiúVmn	FALSE
sNJITowccccvgRáqpòVRúUèTIUGó	FALSE
tuQjyàXzhaoàiyPsffffMjVnrVk	FALSE
vPZsiaaaaMIěǒprvDXàTèùǒiAvGú	FALSE
wmTUIVOXóNzvUjzJpddddAeóFpJò	FALSE
xwODEyrlXnbàRzeBuBrTLLbOcccc	FALSE
yuwxzzZbsbaùmMOgeeeedncáCNnP	FALSE
ùùǎJQTJJidGZKxbáWAèǒpDVuAbbb	TRUE
ǔPCOUyEtóǔùqptCEúteXeesózsHv	TRUE
áiWRèWzěoGlkPkfffQKánSPOyLMB	TRUE
àvonCzHáfffhhYótvkaOFúěKqěmR	TRUE
éòGQùPkNdqiàAEdòddJvéthFvsCV	TRUE
èXPùfffèGmpRVMBtJrFmvDaasBBR	TRUE
ěiGXkcccgèTzúFAGjujǎdrJMmFUx	TRUE
òáóoúqFveeWegEòOvPHXPQRCwVSǎ	TRUE
ǒQeeeTsěxqgfZbvaúYùwwáFqFLYv	TRUE
úaXZNgdPgeeeUsòéUVàEòdtòKǎnJ	TRUE
AtmyóúuCYNVYòhbUgùdcccǎjFeKq	TRUE
CCVTIaWnFèùYZBkXhmLúuiLěcccI	TRUE
DWcccòJHàyesaqhǎkgyZkTQBvdCó	TRUE
EhùvéhSIFàèYPEIjcccwGěBUioqb	TRUE
GùQGLèBXáilùúSHZbrwTnǒfffRSR	TRUE
HJaZVéqéDdJjzqyeeeYkùaZsUtjd	TRUE
IkǎdcccUYWPlTkCngSàóCáJwqnFI	TRUE
JyedáNbOǔùmǔLàeeeàHàEOlèjlEǒ	TRUE
LMSúvBáùónNKéGfffyWmTmRCgcúk	TRUE
MwQcFNbmtpBLěǎùTNOàrpébbbAci	TRUE
OHIyěópbbbòLYjRhixtěXzyCcIJJ	TRUE
PjùjPXùègeěSIeiòhKicfffGědtè	TRUE
RAWhKóǒcJccokèZèETZnSTàCpVzù	TRUE
SeKIpHqéHècccXewDitǎglpbCBZǒ	TRUE
UùpàIDhààrLánaKsvǎǔNDEbGeeek	TRUE
VóZvfòefffóěuGmXǔhtdbxyèQQAO	TRUE
WPjělddèdpgéóciwúèEGMBMpǒQqp	TRUE
XgdMSǎCVéèddMYsóXǔzRMQIZccùc	TRUE
ZéNgstheeepDJcJyAUUǔAQNFěDEè	TRUE
aEmLkHDqYjWàPjVRBRaNvXtcccDy	TRUE
bCgNXhkzFthBròYáoEiawaaXAmóú	TRUE
cělOònPHóúǎTfffEaǎòǔpwfwYJZú	TRUE
cvpMuRPVWúeDúBsrjkynóúUvobbb	TRUE
duclzwòuPLrOhzZSoDdddRFBěhAj	TRUE
ejpCHxXDwFLaHaaùodXcPVLjIlPL	TRUE
fntUcqdóccZcEyèYLyNNAéKDóHǔu	TRUE
hòulóAěSǎTLLPBǒáeeeCQEVUHóIó	TRUE
iUXnzPTccOcǒsǒónèEùWènǔPMFyC	TRUE
jlGUysAdiUyFóQRhjáGMèágcccQC	TRUE
lAxCzǒnnOMIměaaǒaqROèlCZbKRb	TRUE
mQSǎěòPndddhQzYHlYdùAZfPRNàx	TRUE
nkMFaHYuLvIYMRFHisCBáaaaXǒdo	TRUE
pHJoEjòrelzJěózbbbYhmXzmarIé	TRUE
qelTǎTbVoEzoyJUfffGùMJtHLuSn	TRUE
rtPHyzèDǎmGKPWUáeófaaaCCqmZe	TRUE
tKBbbbMXJBNcaZkQOEzáPXsOuELJ	TRUE
ubbbmvxdqOyPOojoèGDIsàUvùǎOx	TRUE
wábbbyqPùaYúbǒNCdàFgòǒwdKǎǒn	TRUE
xèáccceúDqYpěrUrhMGojàByFgtM	TRUE
yVJpǎòJèdZùsnDHTzfǎffGxkcbuT	TRUE
ùùǎJQTJJidGZKxbáWAèǒpDVuAbbbb	FALSE
ǔPCOUyEtóǔùqptCEúteeeesózsHv	FALSE
áiWRèWzěoGlkPkffffQKánSPOyLMB	FALSE
àvonCzHáffffhhYótvkaOFúěKqěmR	FALSE
éòGQùPkNdqiàAEddddJvéthFvsCV	FALSE
èXPùffffèGmpRVMBtJrFmvDaasBBR	FALSE
ěiGXkccccgèTzúFAGjujǎdrJMmFUx	FALSE
òáóoúqFveeeegEòOvPHXPQRCwVSǎ	FALSE
ǒQeeeeTsěxqgfZbvaúYùwwáFqFLYv	FALSE
úaXZNgdPgeeeeUsòéUVàEòdtòKǎnJ	FALSE
AtmyóúuCYNVYòhbUgùccccǎjFeKq	FALSE
CCVTIaWnFèùYZBkXhmLúuiLěccccI	FALSE
DccccòJHàyesaqhǎkgyZkTQBvdCó	FALSE
EhùvéhSIFàèYPEIjccccwGěBUioqb	FALSE
GùQGLèBXáilùúSHZbrwTnǒffffSR	FALSE
HJaZVéqéDdJjzqeeeeYkùaZsUtjd	FALSE
IkǎdccccUYWPlTkCngSàóCáJwqnFI	FALSE
JyedáNbOǔùmǔLàeeeeHàEOlèjlEǒ	FALSE
LMSúvBáùónNKéGffffyWmTmRCgcúk	FALSE
MwQcFNbmtpBLěǎùTNOàrpébbbbAci	FALSE
OHIyěóbbbbòLYjRhixtěXzyCcIJJ	FALSE
PjùjPXùègeěSIeiòhKiffffGědtè	FALSE
RAWhKóǒccccokèZèETZnSTàCpVzù	FALSE
SeKIpHqéHccccXewDitǎglpbCBZǒ	FALSE
UùpàIDhààrLánaKsvǎǔNDEbeeeek	FALSE
VóZvfòeffffóěuGmXǔhtdbxyèQQAO	FALSE
WPjělddddpgéóciwúèEGMBMpǒQqp	FALSE
XgdMSǎCVéèddMYsóXǔzRMQIZcccc	FALSE
ZéNgstheeeepDJcJyAUUǔAQNFěDEè	FALSE
aEmLkHDqYjWàPjVRBRaNvXtccccDy	FALSE
bCgNXhkzFthBròYáoEiaaaaXAmóú	FALSE
cělOònPHóúǎTffffaǎòǔpwfwYJZú	FALSE
cvpMuRPVWúeDúBsrjkynóúUvobbbb	FALSE
duclzwòuPLrOhzZSoDddddRFBěhAj	FALSE
ejpCHxXDwFLaaaaùodXcPVLjIlPL	FALSE
fntUcqdóccccEyèYLyNNAéKDóHǔu	FALSE
hòulóAěSǎTLLPBǒáeeeeQEVUHóIó	FALSE
iUXnzPTccccǒsǒónèEùWènǔPMFyC	FALSE
jlGUysAdiUyFóQRhjáGMèágccccQC	FALSE
lAxCzǒnnOMIměaaaaqROèlCZbKRb	FALSE
mQSǎěòPddddhQzYHlYdùAZfPRNàx	FALSE
nkMFaHYuLvIYMRFHisCBáaaaaXǒdo	FALSE
pHJoEjòrelzJěózbbbbYhmXzmarIé	FALSE
qelTǎTbVoEzoyJUffffGùMJtHLuSn	FALSE
rtPHyzèDǎmGKPWUáeófaaaaCCqmZe	FALSE
tKBbbbbMXJBNcaZkQOEzáPXsOuELJ	FALSE
bbbbmvxdqOyPOojoèGDIsàUvùǎOx	FALSE
wábbbbyqPùaYúbǒNCdàFgòǒwdKǎǒn	FALSE
xèácccceúDqYpěrUrhMGojàByFgtM	FALSE
yVJpǎòJèdZùsnDHTzffffGxkcbuT	FALSE
ùùOaawatyvjVqubUdWFAǒQVCyòPkO	TRUE
ǔNAaaayǔùfHǎséWOeWǎCtuǎoòéTGǔ	TRUE
áuXeǒáHNLWHaaabjTǔqEàtěùybézK	TRUE
ǎDPoknkǎDcUnXYèuyKttsèeěàaaac	TRUE
écccFàJGhSǔIXbǎǎDhòVfǔLRoRmZǒ	TRUE
ètúSLǔNbtzrDàmRqxeqeelWKDBǎsZ	TRUE
óúsJewEeeekéxpyltaqkfbJPFrěyX	TRUE
òbbnòQàfffǔměèIMǔpkèzfGzvèoBJ	TRUE
úùCaéGwfwffápxaúkkHhWrOQúhlBQ	TRUE
AEoQKrdXtǒòvjtpXHTbbbOrTácbpj	TRUE
BQabfGViàMéWRQZdstUvbsfPRcccC	TRUE
CgVèùYpúxdddǒZwcxDlYfLYCǒvWǒU	TRUE
EǔaqKEvcltòaRaootTuhcdddMmǎsp	TRUE
FXcOxùtDvójuHaaaroFGǎZóbMégpd	TRUE
GiǒeeeòqzǒjKhùózrPpjnúOqèDVAS	TRUE
IùǎTxPLúEdddYDkCkTnTnTrqhàPmP	TRUE
JLAáKJiAěUǒUóócyccUmaéRCèóQió	TRUE
KhoKvQgbbbmgJEExVHNUmnaǎRLJpM	TRUE
LyNNmircQpeeewPgftúyèuQmàtPYv	TRUE
NǎIBLOcccdXdhjxǔIVEéyjjjǔaSXú	TRUE
OèǎqoáòaaaUdFiKUlOWJQGMGOùrǔa	TRUE
PNVDZziVúUǎrJybMbbórcWNfqcHwf	TRUE
QflWǒhqLúěfJkIhcUèǔUJVKSàPeee	TRUE
SéávKliJNPògccclèIlnǔUàzrQòpě	TRUE
TOCwKJeAzBUǎáěsJMXXfAffabgpsó	TRUE
UjLDtIwutcésvTàtaútbbberEIWnV	TRUE
VxcYxrdVmWRKAáǔDàúxLaLmúPbbbh	TRUE
XQFZaKòǔkElPneeeěèFAèóùòBěGKq	TRUE
YdhcwkRydoyNVkITptúOdRaaaWxta	TRUE
ZwèClmVIlnoKeTaaafgEPéwóèùǒùL	TRUE
arNoEmLHjXùptkcccáòtHvmkEǒVyx	TRUE
bgLLIǔleeeOéHyjBǎáWJdeěINfHmv	TRUE
ccjcùcrYrIORmUpHRnBPRèVFárMXJ	TRUE
dddYoXqHJtVOeHAgzpfómwuèówefI	TRUE
eeeèmóxkǒHjǔěàIlyucyvòSuóàtFT	TRUE
fffIvNBòGnKnYefyvyjàqBgótéuDP	TRUE
gjCdàmcpèYQwHjSWWcSàarVòEieee	TRUE
iǎUdRROvtjzxLoRWǎPàorbbbjtkXc	TRUE
jWNrivYSàWaaaNIéLcBKqDDCJǎIǔr	TRUE
kxèááMòwccZcMěùRZaòǔTPéIùhzKi	TRUE
mPsSmúvGTWWszDdddWúEneIcjQANR	TRUE
ncccDuyacfjXǔzkurkǒETwèlFoqná	TRUE
owǔTEEiǒHbuVkqTxUlgPǔYeeePúvf	TRUE
qúCVQFcohèàěMpJaWaaáCxfvákTtp	TRUE
rcccOGRzélěhpǔbReVicSwcVfVOBS	TRUE
sxsEQURdddQXàiOiòtQXLKGǒYwoUx	TRUE
uQNEzěvkOlpWeAYqxóKAgzúbbbFxM	TRUE
vtZóIǒZùěáeUuójǒudddpMiěgEHYh	TRUE
xǒiRQafffSCrùǒkébxqtSFěByubip	TRUE
yhèǎhhròcòcctiOiBcVnǒSuXKwIEN	TRUE
ùùOaaaatyvjVqubUdWFAǒQVCyòPkO	FALSE
ǔNAaaaayǔùfHǎséWOeWǎCtuǎoòéTGǔ	FALSE
áuXeǒáHNLWHaaaabjTǔqEàtěùybézK	FALSE
ǎDPoknkǎDcUnXYèuyKttsèeěàaaaac	FALSE
éccccFàJGhSǔIXbǎǎDhòVfǔLRoRmZǒ	FALSE
ètúSLǔNbtzrDàmRqxeeeelWKDBǎsZ	FALSE
óúsJewEeeeekéxpyltaqkfbJPFrěyX	FALSE
òbbnòQàffffǔměèIMǔpkèzfGzvèoBJ	FALSE
úùCaéGwffffápxaúkkHhWrOQúhlBQ	FALSE
AEoQKrdXtǒòvjtpXHTbbbbOrTácbpj	FALSE
BQabfGViàMéWRQZdstUvbsfPRccccC	FALSE
CgVèùYpúxddddǒZwcxDlYfLYCǒvWǒU	FALSE
EǔaqKEvcltòaRaootTuhddddMmǎsp	FALSE
FXcOxùtDvójuHaaaaroFGǎZóbMégpd	FALSE
GiǒeeeeòqzǒjKhùózrPpjnúOqèDVAS	FALSE
IùǎTxPLúEddddYDkCkTnTnTrqhàPmP	FALSE
JLAáKJiAěUǒUóóccccUmaéRCèóQió	FALSE
KhoKvQbbbbmgJEExVHNUmnaǎRLJpM	FALSE
LyNNmircQpeeeewPgftúyèuQmàtPYv	FALSE
NǎIBLOccccdXdhjxǔIVEéyjjjǔaSXú	FALSE
OèǎqoáòaaaaUdFiKUlOWJQGMGOùrǔa	FALSE
PNVDZziVúUǎrJybbbbórcWNfqcHwf	FALSE
QflWǒhqLúěfJkIhcUèǔUJVKSàPeeee	FALSE
SéávKliJNPògccccèIlnǔUàzrQòpě	FALSE
TOCwKJeAzBUǎáěsJMXXffffabgpsó	FALSE
UjLDtIwutcésvTàtaútbbbberEIWnV	FALSE
VxcYxrdVmWRKAáǔDàúxLaLmúbbbbh	FALSE
XQFZaKòǔkElPneeeeèFAèóùòBěGKq	FALSE
YdhcwkRydoyNVkITptúOdRaaaaWxta	FALSE
ZwèClmVIlnoKeaaaafgEPéwóèùǒùL	FALSE
arNoEmLHjXùptkccccáòtHvmkEǒVyx	FALSE
bgLLIǔleeeeOéHyjBǎáWJdeěINfHmv	FALSE
ccccùcrYrIORmUpHRnBPRèVFárMXJ	FALSE
ddddoXqHJtVOeHAgzpfómwuèówefI	FALSE
eeeeèmóxkǒHjǔěàIlyucyvòSuóàtFT	FALSE
ffffIvNBòGnKnYefyvyjàqBgótéuDP	FALSE
gjCdàmcpèYQwHjSWWcSàarVòEieeee	FALSE
iǎUdRROvtjzxLoRWǎPàorbbbbjtkXc	FALSE
jWNrivYSàWaaaaIéLcBKqDDCJǎIǔr	FALSE
kxèááMòwccccMěùRZaòǔTPéIùhzKi	FALSE
mPsSmúvGTWWszDddddWúEneIcjQANR	FALSE
nccccDuyacfjXǔzkurkǒETwèlFoqná	FALSE
owǔTEEiǒHbuVkqTxUlgPǔYeeeePúvf	FALSE
qúCVQFcohèàěMpJaaaaáCxfvákTtp	FALSE
rccccOGRzélěhpǔbReVicSwcVfVOBS	FALSE
sxsEQURddddQXàiOiòtQXLKGǒYwoUx	FALSE
uQNEzěvkOlpWeAYqxóKAgzúbbbbFxM	FALSE
vtZóIǒZùěáeUuójǒddddpMiěgEHYh	FALSE
xǒiRQffffSCrùǒkébxqtSFěByubip	FALSE
yhèǎhhròcccctiOiBcVnǒSuXKwIEN	FALSE
