aaaówGoGtOBCoNelcéqc	TRUE
aaaySsógábXàDcNsNCyY	TRUE
aaazBrvpZǔáJǒDǎpxtUX	TRUE
aaaaómbgWFghEéHJèhgA	TRUE
aaaóMeécfpéftùùlIúbS	TRUE
aaaéwoáTǒeTGEWěRzafL	TRUE
aaafgpkshKrxáoWeoekZ	TRUE
aaaAàtòfygqMlpcUfpjI	TRUE
aaamrcxpLzzWǎFzAmeiǎ	TRUE
aaaòyáqHBǎBVvlòNókYá	TRUE
aaagVbeeǔHtuárjiyNDM	TRUE
aaamOGScCMYùàfùfǔBOD	TRUE
aaaòmlmǎTóPóIYèòiLFM	TRUE
aaaruTwěkRnffcnuróZR	TRUE
aaaFpúMHaelǎjáIǎiwRP	TRUE
aaatPihwCnDoxgxpfiEN	TRUE
aaaóHPLSMúMjàEFiilWN	TRUE
aaaZéxRJléciiMvVWZPH	TRUE
aaaBàoǒǎáCaYJàcUjPǎB	TRUE
aaaDǎQfxèGqědPSQUnLc	TRUE
aaaXqéèlzrRoǔpKúěozP	TRUE
aaahwěPXLlTéEZvjCUsL	TRUE
aaaǎnbdcvAdSTǔwyKútV	TRUE
aaaěcovEQYYǎKúNXvIeó	TRUE
aaagMCmvcwNEuóèxǒkiW	TRUE
aaaGǔKbólPèVsQéSRěLA	TRUE
aaakyViMQEQJwnWDNYcǔ	TRUE
aaarnsRYsxNòhDyKUsyP	TRUE
aaayPwRhóǒáǔjXpàYCQn	TRUE
aaaFZǒǔhJDOùtúAXdbhó	TRUE
aaaJzFpabqjCGèWUahpv	TRUE
aaacJilthMQccyuùFèhI	TRUE
aaaBwtbmhSòvúiPntaee	TRUE
aaaNXóúěRSGBpóbxshrY	TRUE
aaaDòFsJGkTDFlmDGTrZ	TRUE
aaanpVoEiZUMéSgoMWSá	TRUE
aaaáCKEpYIoLjQlǔaCgY	TRUE
aaashwqtZcjYWArǔJSvR	TRUE
aaaSqVxRrhàbBrpèWdSi	TRUE
aaazlmBUéqvǒsJVàóBpH	TRUE
aaaàLImEVRJjámjsTévq	TRUE
aaayFaMnWNqtúáklFkEc	TRUE
aaaAWwYfFgWVqUYtiEùù	TRUE
aaaeZeùRyGisVqaòHàeo	TRUE
aaawóFTmHaaJRoxǒYLàd	TRUE
aaakjDVgfǒRpaáfCzEzZ	TRUE
aaaúXCkHarAfRAaReYQC	TRUE
aaaDbwAZBQVgzǒàPNfDI	TRUE
aaasAERcsěDhoCJwhkJX	TRUE
aaajkǎJóúFBKixQǒlàev	TRUE
ùaaaówGoGtOBCoNelcéqc	FALSE
ěaaaySsógábXàDcNsNCyY	FALSE
DaaazBrvpZǔáJǒDǎpxtUX	FALSE
LaaaaómbgWFghEéHJèhgA	FALSE
SaaaóMeécfpéftùùlIúbS	FALSE
baaaéwoáTǒeTGEWěRzafL	FALSE
jaaafgpkshKrxáoWeoekZ	FALSE
raaaAàtòfygqMlpcUfpjI	FALSE
yaaamrcxpLzzWǎFzAmeiǎ	FALSE
éaaòyáqHBǎBVvlòNókYá	FALSE
AaagVbeeǔHtuárjiyNDM	FALSE
HaamOGScCMYùàfùfǔBOD	FALSE
OaaòmlmǎTóPóIYèòiLFM	FALSE
VaaruTwěkRnffcnuróZR	FALSE
aǎaaFpúMHaelǎjáIǎiwRP	FALSE
aAaatPihwCnDoxgxpfiEN	FALSE
aJaaóHPLSMúMjàEFiilWN	FALSE
aOaaZéxRJléciiMvVWZPH	FALSE
aVaaBàoǒǎáCaYJàcUjPǎB	FALSE
aeaaDǎQfxèGqědPSQUnLc	FALSE
alaaXqéèlzrRoǔpKúěozP	FALSE
asaahwěPXLlTéEZvjCUsL	FALSE
aaǎnbdcvAdSTǔwyKútV	FALSE
aěaěcovEQYYǎKúNXvIeó	FALSE
aEagMCmvcwNEuóèxǒkiW	FALSE
aNaGǔKbólPèVsQéSRěLA	FALSE
aTakyViMQEQJwnWDNYcǔ	FALSE
aaǔarnsRYsxNòhDyKUsyP	FALSE
aaǒayPwRhóǒáǔjXpàYCQn	FALSE
aaFaFZǒǔhJDOùtúAXdbhó	FALSE
aaPaJzFpabqjCGèWUahpv	FALSE
aaWacJilthMQccyuùFèhI	FALSE
aaeaBwtbmhSòvúiPntaee	FALSE
aamaNXóúěRSGBpóbxshrY	FALSE
aasaDòFsJGkTDFlmDGTrZ	FALSE
aanpVoEiZUMéSgoMWSá	FALSE
aaěáCKEpYIoLjQlǔaCgY	FALSE
aaCshwqtZcjYWArǔJSvR	FALSE
aaJSqVxRrhàbBrpèWdSi	FALSE
aaQzlmBUéqvǒsJVàóBpH	FALSE
aaYàLImEVRJjámjsTévq	FALSE
aafyFaMnWNqtúáklFkEc	FALSE
aamAWwYfFgWVqUYtiEùù	FALSE
aaveZeùRyGisVqaòHàeo	FALSE
aeawóFTmHaaJRoxǒYLàd	FALSE
alakjDVgfǒRpaáfCzEzZ	FALSE
asaúXCkHarAfRAaReYQC	FALSE
caaDbwAZBQVgzǒàPNfDI	FALSE
jaasAERcsěDhoCJwhkJX	FALSE
raajkǎJóúFBKixQǒlàev	FALSE
aaaIEPGapOAsáqHsEEEmG	TRUE
aaaKǒúàuUaZOAbTODQDkn	TRUE
aaapJfZOǔǒxawPiQmTaùv	TRUE
aaaéfsfVUǒIFexhrtvpyě	TRUE
aaaFKWXpxFWZàMtèPvPQt	TRUE
aaaPJǎGeYRěHyMóZTRIéW	TRUE
aaaEslNJQǎpsYvKLQIpsf	TRUE
aaaQóGǔzGPTcjkWLfTvRh	TRUE
aaaMPVBZzùsǒIzLNyèeáb	TRUE
aaaJtàóiQhgTójKǎrCUdF	TRUE
aaaumkPauépfěLgIXQeCc	TRUE
aaaǎaóétDǒǔóèvXbYzoSú	TRUE
aaavYWáOiDRChiwxbzàsb	TRUE
aaamqPaUóvcXwbDǒxlSòb	TRUE
aaaUVoLqmIwrEuDPXjjvǒ	TRUE
aaaxrbniIòvHREétjHfNǒ	TRUE
aaaǔzpAwBSlCgUiNpnnùx	TRUE
aaaóiiafNúRvMNQHǒXWsX	TRUE
aaaSHWPDchilbùUnaèTxB	TRUE
aaaGDqIàǔZaxdmMUYquǎG	TRUE
aaamàǎaWmwDúdOtoùgOxù	TRUE
aaaNnZJàUcWSpúsOzysxP	TRUE
aaaáǎóqqwtXuDdǒǒgDQiě	TRUE
aaalcMǔénáhleZUěwdqZl	TRUE
aaaIGaWUpXRLùéVNǎTOǔt	TRUE
aaaPRǎmeWSEliNVtòpueò	TRUE
aaaqTcyrWtHrGòǔfSLgqn	TRUE
aaaséjWrRojlohvèěZzǎN	TRUE
aaaéWBbúeXdhloXYaóFMJ	TRUE
aaaHpèáogóGSIQxàúxrqb	TRUE
aaaǔnMǒQNUOéfAKskkàSG	TRUE
aaaRQhgYòxZUkěǒèRKhlà	TRUE
aaaězepàcMSvRAùègǎuDǒ	TRUE
aaacfBRqNúnZwiulělwYE	TRUE
aaaviDcHùèvqksǔYhJèNA	TRUE
aaaòěRáèOdczkópZhGhWz	TRUE
aaaèhwéitcHpàBEWZZrIp	TRUE
aaayoNjNiRwklNHBJǎOpu	TRUE
aaamUPmGBLvMòwtZfAitI	TRUE
aaafKDBlcZèonUrSVYLOr	TRUE
aaaQeRAUHDqxfèibaDGǒP	TRUE
aaaLQHSIkòJOǔǔówUbǎǎy	TRUE
aaaěèBIhsǎáWajáuKNVhe	TRUE
aaaùfáfvxWéàyXrWXnùmǔ	TRUE
aaaDDwLbǎmúámvèajCjaG	TRUE
aaaWJPoǒáxniBiPDYLEùp	TRUE
aaaSCǔJfáHlòABóaouAóé	TRUE
aaaoRnvBJǎéaásescVasb	TRUE
aaaBdwnáQeQrfFnyVXóNv	TRUE
aaayJRYǎbsQǒáuàzmCSNt	TRUE
ùaaaIEPGapOAsáqHsEEEmG	FALSE
ěaaaKǒúàuUaZOAbTODQDkn	FALSE
DaaapJfZOǔǒxawPiQmTaùv	FALSE
KaaaéfsfVUǒIFexhrtvpyě	FALSE
TaaaFKWXpxFWZàMtèPvPQt	FALSE
caaaPJǎGeYRěHyMóZTRIéW	FALSE
jaaaEslNJQǎpsYvKLQIpsf	FALSE
raaaQóGǔzGPTcjkWLfTvRh	FALSE
yaaaMPVBZzùsǒIzLNyèeáb	FALSE
éaaJtàóiQhgTójKǎrCUdF	FALSE
CaaumkPauépfěLgIXQeCc	FALSE
LaaǎaóétDǒǔóèvXbYzoSú	FALSE
SaavYWáOiDRChiwxbzàsb	FALSE
aǔaamqPaUóvcXwbDǒxlSòb	FALSE
aóaaUVoLqmIwrEuDPXjjvǒ	FALSE
aEaaxrbniIòvHREétjHfNǒ	FALSE
aMaaǔzpAwBSlCgUiNpnnùx	FALSE
aTaaóiiafNúRvMNQHǒXWsX	FALSE
adaaSHWPDchilbùUnaèTxB	FALSE
akaaGDqIàǔZaxdmMUYquǎG	FALSE
asaamàǎaWmwDúdOtoùgOxù	FALSE
azaaNnZJàUcWSpúsOzysxP	FALSE
aǎaáǎóqqwtXuDdǒǒgDQiě	FALSE
aúalcMǔénáhleZUěwdqZl	FALSE
aGaIGaWUpXRLùéVNǎTOǔt	FALSE
aOaPRǎmeWSEliNVtòpueò	FALSE
aVaqTcyrWtHrGòǔfSLgqn	FALSE
aaàaséjWrRojlohvèěZzǎN	FALSE
aaAaéWBbúeXdhloXYaóFMJ	FALSE
aaJaHpèáogóGSIQxàúxrqb	FALSE
aaPaǔnMǒQNUOéfAKskkàSG	FALSE
aaWaRQhgYòxZUkěǒèRKhlà	FALSE
aagaězepàcMSvRAùègǎuDǒ	FALSE
aamacfBRqNúnZwiulělwYE	FALSE
aasaviDcHùèvqksǔYhJèNA	FALSE
aaǔòěRáèOdczkópZhGhWz	FALSE
aaóèhwéitcHpàBEWZZrIp	FALSE
aaDyoNjNiRwklNHBJǎOpu	FALSE
aaMmUPmGBLvMòwtZfAitI	FALSE
aaTfKDBlcZèonUrSVYLOr	FALSE
aabQeRAUHDqxfèibaDGǒP	FALSE
aajLQHSIkòJOǔǔówUbǎǎy	FALSE
aarěèBIhsǎáWajáuKNVhe	FALSE
aayùfáfvxWéàyXrWXnùmǔ	FALSE
ahaDDwLbǎmúámvèajCjaG	FALSE
apaWJPoǒáxniBiPDYLEùp	FALSE
awaSCǔJfáHlòABóaouAóé	FALSE
eaaoRnvBJǎéaásescVasb	FALSE
laaBdwnáQeQrfFnyVXóNv	FALSE
saayJRYǎbsQǒáuàzmCSNt	FALSE
aaaHiiǎwGNRlàVUNòjQlnI	TRUE
aaaqCcvVǔmdozKhǎKOLùvK	TRUE
aaaavZoTMSoJXlSqCvjéAè	TRUE
aaattOpmjájuJANvzGLPùM	TRUE
aaanXHmmnyreqgópOǒějòk	TRUE
aaaSCèTTvUkpjfǒdeinIěL	TRUE
aaaùFkreVnaPRNǎFojYǔLr	TRUE
aaadúHúwstDzTREupèkYnp	TRUE
aaaDraYqéEvaojxyàyJdzm	TRUE
aaaQqyǔkvmEIeòǎvzoZhTI	TRUE
aaafZwóòocHNùcRgJeQVqS	TRUE
aaaěWdIsèǎaáIBdòWBùòFA	TRUE
aaavIwEzSYIysTiHèéfHTn	TRUE
aaayoTnPAaqEǎóòstHǔDpv	TRUE
aaaafyezaLXqàSRněJIToò	TRUE
aaawMMràDYǎnWWJwHKùùxD	TRUE
aaavdúěDhcǒWKBKgWHTAěó	TRUE
aaaǔVCgJàáLeyMAǔěǎrTùR	TRUE
aaaQSPEmokepeóJSyHcDaǔ	TRUE
aaafgùfVQúúGěhKuiKoǎKǎ	TRUE
aaaóOCczhMOéGpZcèiKmmC	TRUE
aaaLVYtBxIwoèǔWsmxZǔǔP	TRUE
aaaétayorVǎHNùzěWséXòP	TRUE
aaaiwJóVSRIúládjBèoùNb	TRUE
aaaMVlKOgèOiAuwzǔTUiSS	TRUE
aaaùfFIxCNiàpZùǒdnkHpá	TRUE
aaaInFEewfNUUàUsMǔTBAh	TRUE
aaalkùpZbMkayǒFbùoCvWH	TRUE
aaaóAzBfalrEAILhùRiTzi	TRUE
aaaMòDákKtkxèMKdGjqǔud	TRUE
aaaúAhzOóHpMrhùbMKEEǔI	TRUE
aaaSZrtDGYiPuZCnrcrOǔò	TRUE
aaaSoAMGxkGKvtrwCùMèòh	TRUE
aaarcNòMmyFabIRRCSgmKě	TRUE
aaaJWQgFZDAQáfǔHQNOOPJ	TRUE
aaaFkjpáWhgYnfUǒSvQLZn	TRUE
aaadvXUǔXNKxcyKfVQHlPr	TRUE
aaasBóvoSMBLfHUflKqsNl	TRUE
aaawwfúnóěGdVámShǒwmRi	TRUE
aaaóGHpPTRDéóéOóVkDLěb	TRUE
aaaoHXQQfTeRJkóvOcWrNO	TRUE
aaaSáǒòXrèccXjgsfèpFTè	TRUE
aaacusZòjrucèéxgzoSRXw	TRUE
aaaácúYrHvVǒgIIHZziyiS	TRUE
aaaCZXsoqNjxKDMibětùCò	TRUE
aaaǎvGYCfzbwBqqoǒéevǒA	TRUE
aaaWEVnǒotlMiMpXáóSddù	TRUE
aaabZJkkCRwGWOAgwEBěǒě	TRUE
aaaPtaèneòàETZwqXyIyYM	TRUE
aaaWtéágIgKntbvuTIclUk	TRUE
ùaaaHiiǎwGNRlàVUNòjQlnI	FALSE
óaaaqCcvVǔmdozKhǎKOLùvK	FALSE
CaaaavZoTMSoJXlSqCvjéAè	FALSE
KaaattOpmjájuJANvzGLPùM	FALSE
SaaanXHmmnyreqgópOǒějòk	FALSE
ZaaaSCèTTvUkpjfǒdeinIěL	FALSE
haaaùFkreVnaPRNǎFojYǔLr	FALSE
oaaadúHúwstDzTREupèkYnp	FALSE
xaaaDraYqéEvaojxyàyJdzm	FALSE
ǎaaQqyǔkvmEIeòǎvzoZhTI	FALSE
úaafZwóòocHNùcRgJeQVqS	FALSE
GaaěWdIsèǎaáIBdòWBùòFA	FALSE
QaavIwEzSYIysTiHèéfHTn	FALSE
XaayoTnPAaqEǎóòstHǔDpv	FALSE
aéaaafyezaLXqàSRněJIToò	FALSE
aBaawMMràDYǎnWWJwHKùùxD	FALSE
aHaavdúěDhcǒWKBKgWHTAěó	FALSE
aQaaǔVCgJàáLeyMAǔěǎrTùR	FALSE
aXaaQSPEmokepeóJSyHcDaǔ	FALSE
afaafgùfVQúúGěhKuiKoǎKǎ	FALSE
amaaóOCczhMOéGpZcèiKmmC	FALSE
ataaLVYtBxIwoèǔWsmxZǔǔP	FALSE
aaétayorVǎHNùzěWséXòP	FALSE
aèaiwJóVSRIúládjBèoùNb	FALSE
aCaMVlKOgèOiAuwzǔTUiSS	FALSE
aJaùfFIxCNiàpZùǒdnkHpá	FALSE
aRaInFEewfNUUàUsMǔTBAh	FALSE
aYalkùpZbMkayǒFbùoCvWH	FALSE
aaěaóAzBfalrEAILhùRiTzi	FALSE
aaBaMòDákKtkxèMKdGjqǔud	FALSE
aaKaúAhzOóHpMrhùbMKEEǔI	FALSE
aaRaSZrtDGYiPuZCnrcrOǔò	FALSE
aaYaSoAMGxkGKvtrwCùMèòh	FALSE
aagarcNòMmyFabIRRCSgmKě	FALSE
aanaJWQgFZDAQáfǔHQNOOPJ	FALSE
aavaFkjpáWhgYnfUǒSvQLZn	FALSE
aaádvXUǔXNKxcyKfVQHlPr	FALSE
aaǒsBóvoSMBLfHUflKqsNl	FALSE
aaFwwfúnóěGdVámShǒwmRi	FALSE
aaNóGHpPTRDéóéOóVkDLěb	FALSE
aaToHXQQfTeRJkóvOcWrNO	FALSE
aadSáǒòXrèccXjgsfèpFTè	FALSE
aancusZòjrucèéxgzoSRXw	FALSE
aavácúYrHvVǒgIIHZziyiS	FALSE
afaCZXsoqNjxKDMibětùCò	FALSE
amaǎvGYCfzbwBqqoǒéevǒA	FALSE
auaWEVnǒotlMiMpXáóSddù	FALSE
baabZJkkCRwGWOAgwEBěǒě	FALSE
jaaPtaèneòàETZwqXyIyYM	FALSE
saaWtéágIgKntbvuTIclUk	FALSE
aaaǔBPSàDAZxPQUVRvZegEV	TRUE
aaaoTáAUmvyxTmúljěDùhNz	TRUE
aaaEáOQǒzKbmùvMvlùCáOkf	TRUE
aaaqLzOigbbǔàcagVàúKxPj	TRUE
aaaqTàWaètKáGiěBVTtàJiu	TRUE
aaahjIùohWZXTúEGáPioQiE	TRUE
aaaufgOěBBMCJorMEǔOLUeú	TRUE
aaaYàZfrlIKPàèhàFOWfQAP	TRUE
aaaGeAóǔbVTKhǎótnkliySf	TRUE
aaaGXǒMǔJFMxpzlIěǔXzCnn	TRUE
aaaAuáèVMslùǔěRPcQYDxgh	TRUE
aaaBTTVLnVpnRZùbáxuIvàj	TRUE
aaazzǔiwbMCcjuLUwsFpǎYD	TRUE
aaavoLǔBYwrtkpMéjooONcq	TRUE
aaapnczAóóùnùwyMTWIjNYǔ	TRUE
aaaSdúylqeWTmQùaGPKuZhC	TRUE
aaaLóUtAěphàMNxryBUXPVp	TRUE
aaajccóGGàǔLfCYIcIlxlYG	TRUE
aaaǎWXLèURuMDOméRanrztF	TRUE
aaaVNPnaEEwlbRqJPoVfonL	TRUE
aaayǎhPXXVZIxXjPqYaKkAE	TRUE
aaaBJpánMXdSVòǎlgvEvkvn	TRUE
aaaHBóùaRAOpbtklIpviWěL	TRUE
aaafqAoHxóàVèXóùnòJkàLa	TRUE
aaaNbRUGàNBcěscJLOwzjQm	TRUE
aaakóRGQaMgcDHáéfǔòVxYu	TRUE
aaaòǒMàyoJnZtWzionIVYUG	TRUE
aaaěIrténZLNORaCjkQsTss	TRUE
aaaméòaYIWOCAzwVàtIiǎXA	TRUE
aaaVQTMuEKhCLErbkJbáFtq	TRUE
aaaxPGjóPmáxQcfnvphpyAi	TRUE
aaaéntxAceNJwuóCwwTPFvé	TRUE
aaaqcěCczěSZyaxRryIaCòt	TRUE
aaaLùqáTCkǒSǎKHcZELHfWD	TRUE
aaaywaLkǔmXIJQCymóàtOJB	TRUE
aaawóRibùDFkxIùoIùlǔCěW	TRUE
aaaSzcuSVBBǒBéCcùedéCdò	TRUE
aaaILEJCámàPEǔIvxwěkqLw	TRUE
aaaGLsSjsgcLeRIwhqrhǎvè	TRUE
aaacnIǔskWIWlwǎuQCoqqRu	TRUE
aaaDkDwFvmEmYSawxrEfNBn	TRUE
aaaùòaiúǎěǔITóQǔumFDXcò	TRUE
aaaAMǎaúèPěqMolWImmTGZR	TRUE
aaaxrfǎnWàqHUZDmBaRTljn	TRUE
aaarPAhǒbhQǔEChHàcùOEǎà	TRUE
aaaerCǔEèLdmEYǎozFkKZOá	TRUE
aaaNayXúmuxlGhjnbpàZyúǔ	TRUE
aaahUCwMCjNmIǔizIFáBAEu	TRUE
aaaójVZXùyihrQdpVngIvhL	TRUE
aaaIiéqkEQKMwLéoWzXhwor	TRUE
ùaaaǔBPSàDAZxPQUVRvZegEV	FALSE
èaaaoTáAUmvyxTmúljěDùhNz	FALSE
BaaaEáOQǒzKbmùvMvlùCáOkf	FALSE
IaaaqLzOigbbǔàcagVàúKxPj	FALSE
PaaaqTàWaètKáGiěBVTtàJiu	FALSE
WaaahjIùohWZXTúEGáPioQiE	FALSE
faaaufgOěBBMCJorMEǔOLUeú	FALSE
maaaYàZfrlIKPàèhàFOWfQAP	FALSE
uaaaGeAóǔbVTKhǎótnkliySf	FALSE
ùaaGXǒMǔJFMxpzlIěǔXzCnn	FALSE
óaaAuáèVMslùǔěRPcQYDxgh	FALSE
DaaBTTVLnVpnRZùbáxuIvàj	FALSE
JaazzǔiwbMCcjuLUwsFpǎYD	FALSE
RaavoLǔBYwrtkpMéjooONcq	FALSE
XaapnczAóóùnùwyMTWIjNYǔ	FALSE
aǎaaSdúylqeWTmQùaGPKuZhC	FALSE
aBaaLóUtAěphàMNxryBUXPVp	FALSE
aIaajccóGGàǔLfCYIcIlxlYG	FALSE
aRaaǎWXLèURuMDOméRanrztF	FALSE
aYaaVNPnaEEwlbRqJPoVfonL	FALSE
agaayǎhPXXVZIxXjPqYaKkAE	FALSE
aoaaBJpánMXdSVòǎlgvEvkvn	FALSE
axaaHBóùaRAOpbtklIpviWěL	FALSE
aéafqAoHxóàVèXóùnòJkàLa	FALSE
aCaNbRUGàNBcěscJLOwzjQm	FALSE
aKakóRGQaMgcDHáéfǔòVxYu	FALSE
aRaòǒMàyoJnZtWzionIVYUG	FALSE
aZaěIrténZLNORaCjkQsTss	FALSE
aaóaméòaYIWOCAzwVàtIiǎXA	FALSE
aaFaVQTMuEKhCLErbkJbáFtq	FALSE
aaNaxPGjóPmáxQcfnvphpyAi	FALSE
aaWaéntxAceNJwuóCwwTPFvé	FALSE
aaeaqcěCczěSZyaxRryIaCòt	FALSE
aalaLùqáTCkǒSǎKHcZELHfWD	FALSE
aasaywaLkǔmXIJQCymóàtOJB	FALSE
aazawóRibùDFkxIùoIùlǔCěW	FALSE
aaěSzcuSVBBǒBéCcùedéCdò	FALSE
aaDILEJCámàPEǔIvxwěkqLw	FALSE
aaLGLsSjsgcLeRIwhqrhǎvè	FALSE
aaScnIǔskWIWlwǎuQCoqqRu	FALSE
aabDkDwFvmEmYSawxrEfNBn	FALSE
aaiùòaiúǎěǔITóQǔumFDXcò	FALSE
aaqAMǎaúèPěqMolWImmTGZR	FALSE
aaxxrfǎnWàqHUZDmBaRTljn	FALSE
afarPAhǒbhQǔEChHàcùOEǎà	FALSE
anaerCǔEèLdmEYǎozFkKZOá	FALSE
ataNayXúmuxlGhjnbpàZyúǔ	FALSE
baahUCwMCjNmIǔizIFáBAEu	FALSE
jaaójVZXùyihrQdpVngIvhL	FALSE
saaIiéqkEQKMwLéoWzXhwor	FALSE
aaaEnYtǒCWuALedWkBgǔUcpF	TRUE
aaavraiNnCgPZètěRlmzMlKI	TRUE
aaaòxBDizqávBǔvCDúédlXWl	TRUE
aaaCsúCJLwKuáOODádGùZucJ	TRUE
aaaxbgAoBRzrwQùDátPOóibù	TRUE
aaaǔCqyMoěSǔoICcZNesbèUo	TRUE
aaaKooPSCUrVáǔùRYàOgrWEx	TRUE
aaaYQzpbmwoFPQoèěCEgrpWf	TRUE
aaadpNèúèzuZdCǎYǎPyAXHms	TRUE
aaaaFxXTèqjǔXDZEIqàvKěpt	TRUE
aaaQwàJzRhjéNǔaǒfYeIXúsě	TRUE
aaaHzǎbvrhlFóZFimToxUsee	TRUE
aaaéyǎKBxvUpUgvqlIfqLǒub	TRUE
aaaáJnEiryDàòoxLkXètIOěR	TRUE
aaaqPqǔǎMEQXkXIsjZVWMLkù	TRUE
aaalúùǔYèWbéRVxfEòqxyepó	TRUE
aaaǔǎóUHLrippApjFoTùXKèe	TRUE
aaaRNGnJKPhHvIùěóXeáAEǎm	TRUE
aaakgchàHUoQCgEQJpǎOàgóv	TRUE
aaaRualIděTHUBvlCAYYVerT	TRUE
aaaucbdlRèlGěTágHóAaKRHò	TRUE
aaaccEúáXàséGHàGTógYAJQP	TRUE
aaaQZtFaxhcZFmzfǔJGùHQcH	TRUE
aaaFerxǒUGyáFUAilomPxtOà	TRUE
aaajlufSùKwòFSvMmEoubGhU	TRUE
aaaOfLAYǒǒyFpgàgòòúxlóWl	TRUE
aaaěXVVǔbaéaòhyQéógwěSNk	TRUE
aaapOvuIpskEfmqDJupNpsàq	TRUE
aaazDCéNwFùèSeúqQQùtèqbc	TRUE
aaaLZérSZxQwǎHcPoWWxrhGW	TRUE
aaaOOlcěSmxjdZEoTQuuNǔné	TRUE
aaaNáàsqoxǒIRcJGMahrxRlm	TRUE
aaayóYsRoHdAVpEMFPTjmXNm	TRUE
aaarbúdkjCSBnLXRnDvlBàfA	TRUE
aaavjnMthFMCnNěǔóEzJòbgǒ	TRUE
aaaxazSePùBrHzwèpènJwPcR	TRUE
aaadbGJèmjAuúǎXJpSTQjIiS	TRUE
aaaNsgcNIcfPEPYǔwrXEǔyúh	TRUE
aaaáXǔHdàEòěltxCòGxBscCj	TRUE
aaamhiBWUBYCRzBJúwRhfTto	TRUE
aaaaQgOólHrqsHaMXGdgMěǎd	TRUE
aaaǎzsvéNNcDpJLUàěyppKàZ	TRUE
aaaXèZZZbXNGuQáhLYěANpoN	TRUE
aaaoCnJBzxztTngTgMqkTxcn	TRUE
aaafZRSXdGHSeBóCWWPpnMST	TRUE
aaawáGHFcZPDiPADàhstěMhW	TRUE
aaaKójUeRGYǒFvNuéòVKFKsó	TRUE
aaaJhákdtgqhěàKOsVxuqOFá	TRUE
aaaBcqQtoxqcééBsYóHJGjQt	TRUE
aaaQvZDwjAYaqNqxcyòFúsaě	TRUE
ùaaaEnYtǒCWuALedWkBgǔUcpF	FALSE
èaaavraiNnCgPZètěRlmzMlKI	FALSE
BaaaòxBDizqávBǔvCDúédlXWl	FALSE
IaaaCsúCJLwKuáOODádGùZucJ	FALSE
QaaaxbgAoBRzrwQùDátPOóibù	FALSE
XaaaǔCqyMoěSǔoICcZNesbèUo	FALSE
faaaKooPSCUrVáǔùRYàOgrWEx	FALSE
naaaYQzpbmwoFPQoèěCEgrpWf	FALSE
vaaadpNèúèzuZdCǎYǎPyAXHms	FALSE
áaaaFxXTèqjǔXDZEIqàvKěpt	FALSE
óaaQwàJzRhjéNǔaǒfYeIXúsě	FALSE
DaaHzǎbvrhlFóZFimToxUsee	FALSE
LaaéyǎKBxvUpUgvqlIfqLǒub	FALSE
UaaáJnEiryDàòoxLkXètIOěR	FALSE
aáaaqPqǔǎMEQXkXIsjZVWMLkù	FALSE
aòaalúùǔYèWbéRVxfEòqxyepó	FALSE
aEaaǔǎóUHLrippApjFoTùXKèe	FALSE
aMaaRNGnJKPhHvIùěóXeáAEǎm	FALSE
aUaakgchàHUoQCgEQJpǎOàgóv	FALSE
acaaRualIděTHUBvlCAYYVerT	FALSE
ajaaucbdlRèlGěTágHóAaKRHò	FALSE
araaccEúáXàséGHàGTógYAJQP	FALSE
ayaaQZtFaxhcZFmzfǔJGùHQcH	FALSE
aéaFerxǒUGyáFUAilomPxtOà	FALSE
aAajlufSùKwòFSvMmEoubGhU	FALSE
aHaOfLAYǒǒyFpgàgòòúxlóWl	FALSE
aQaěXVVǔbaéaòhyQéógwěSNk	FALSE
aWapOvuIpskEfmqDJupNpsàq	FALSE
aaǎazDCéNwFùèSeúqQQùtèqbc	FALSE
aaAaLZérSZxQwǎHcPoWWxrhGW	FALSE
aaIaOOlcěSmxjdZEoTQuuNǔné	FALSE
aaQaNáàsqoxǒIRcJGMahrxRlm	FALSE
aaYayóYsRoHdAVpEMFPTjmXNm	FALSE
aaiarbúdkjCSBnLXRnDvlBàfA	FALSE
aaoavjnMthFMCnNěǔóEzJòbgǒ	FALSE
aawaxazSePùBrHzwèpènJwPcR	FALSE
aaádbGJèmjAuúǎXJpSTQjIiS	FALSE
aaǒNsgcNIcfPEPYǔwrXEǔyúh	FALSE
aaGáXǔHdàEòěltxCòGxBscCj	FALSE
aaNmhiBWUBYCRzBJúwRhfTto	FALSE
aaVaQgOólHrqsHaMXGdgMěǎd	FALSE
aaeǎzsvéNNcDpJLUàěyppKàZ	FALSE
aamXèZZZbXNGuQáhLYěANpoN	FALSE
aatoCnJBzxztTngTgMqkTxcn	FALSE
aazfZRSXdGHSeBóCWWPpnMST	FALSE
ajawáGHFcZPDiPADàhstěMhW	FALSE
araKójUeRGYǒFvNuéòVKFKsó	FALSE
azaJhákdtgqhěàKOsVxuqOFá	FALSE
jaaBcqQtoxqcééBsYóHJGjQt	FALSE
qaaQvZDwjAYaqNqxcyòFúsaě	FALSE
aaaǔúmǎCbmdvòcZUkeLéǒéoRR	TRUE
aaaeBSfùúòuyBéWFòCrQwpóTH	TRUE
aaaCSYTZiiheHTPwpymjǔgkXw	TRUE
aaayXpúqgaUáEèLVǒQǎèKUǔgi	TRUE
aaaYPNwukkAxLiBkPAywikjUQ	TRUE
aaaNxInrlKKúXLghVAKétǒuěM	TRUE
aaaJnǔàYWázjFZncVVEěaXnóN	TRUE
aaaxèjSAadhóKmxpFJAZknKEl	TRUE
aaaUxkRùěZBXklàMmAIXToèHX	TRUE
aaaòǎbuénWIKZèǎIBAEOmhywO	TRUE
aaaMBnóhGéeFNLLWiCějGGSLp	TRUE
aaaTCtAOzǒgYtlRjViJfaVtaB	TRUE
aaaǒqPTǔFyáHJoRfORQXWsdRn	TRUE
aaaymZELéáMTIxRáǔqzéWTóǎK	TRUE
aaaFókiVuGgěSTKsAPuàHéréR	TRUE
aaamokkòoǔàzZZngjòCpcJàUP	TRUE
aaaHsKTndgyǒǔǎrwLzMRnPBup	TRUE
aaaèXrěěùúfhxvtUubqcUòeWM	TRUE
aaaáǒpNáippQGkàEfRZqIXáBJ	TRUE
aaaXxbútúNEwNVoHfAvNiuSdF	TRUE
aaaxSYDUAJIòonKǔCHèzNwddó	TRUE
aaaeéEǔǔywěmleHKspDrSTpuǒ	TRUE
aaaǒCěùIǒPNYiaSEFNyLmNAóa	TRUE
aaaIhgúúxGóugLábWèZBurFúp	TRUE
aaaùHAHèjBBóSZmǒrǎKěTWqAB	TRUE
aaaovtOEMMPDRTyKyèjDdinjF	TRUE
aaadkTjyúdEODaLEǒQLmTHxeW	TRUE
aaaqrJKRhyzebTKeFǎAMNeěuu	TRUE
aaabhhROpVXúHpkyěKòDrALPú	TRUE
aaafjZOWBPldDVsěijsyuěǔjg	TRUE
aaaàNǒjdXVoGtEYslTCDjépeX	TRUE
aaaPiàzZMlcQOfóKiBqAkUGfx	TRUE
aaagrKMzvIjáPLIecRIòTkPLU	TRUE
aaaǒMǎlǎlOùdQjrèVROkǎvvǒY	TRUE
aaarQGfyGHnaBDLSKkhdmúVgo	TRUE
aaaáqdmyCJUVzrFéZárjBgnci	TRUE
aaaGsnèBùnYwFBUtFjTěwùffX	TRUE
aaaNtarrbghTcúpsMLéDdǔhǎs	TRUE
aaaCUelFkiiEdjPzTsHCtjxsB	TRUE
aaapnOmèfmcoxCkFqJJXaáláv	TRUE
aaaEèXùǎszXDGdQáxadúPiIeX	TRUE
aaaòRhNCùnaTpòuJDǒMUhZsùù	TRUE
aaauFWfòSCuòUěECjdEFCDTsz	TRUE
aaajFjǎEjRómlkgAéfBEnBkfY	TRUE
aaaYuDoqlxixQqsJnaPzvEǔèH	TRUE
aaamvěahpvNSMóùVòOguBirOB	TRUE
aaaVeNJQGxWxùRzKjkGzgzaǒy	TRUE
aaaǔUYàúqáSùOqàtábmVyòtdM	TRUE
aaakzǎDIuzAnvIFucálwTwXqè	TRUE
aaaěhFCzCvǎSLòǎèSpXVǒOèKJ	TRUE
ùaaaǔúmǎCbmdvòcZUkeLéǒéoRR	FALSE
ěaaaeBSfùúòuyBéWFòCrQwpóTH	FALSE
CaaaCSYTZiiheHTPwpymjǔgkXw	FALSE
IaaayXpúqgaUáEèLVǒQǎèKUǔgi	FALSE
QaaaYPNwukkAxLiBkPAywikjUQ	FALSE
ZaaaNxInrlKKúXLghVAKétǒuěM	FALSE
iaaaJnǔàYWázjFZncVVEěaXnóN	FALSE
paaaxèjSAadhóKmxpFJAZknKEl	FALSE
yaaaUxkRùěZBXklàMmAIXToèHX	FALSE
éaaòǎbuénWIKZèǎIBAEOmhywO	FALSE
AaaMBnóhGéeFNLLWiCějGGSLp	FALSE
IaaTCtAOzǒgYtlRjViJfaVtaB	FALSE
PaaǒqPTǔFyáHJoRfORQXWsdRn	FALSE
XaaymZELéáMTIxRáǔqzéWTóǎK	FALSE
aǎaaFókiVuGgěSTKsAPuàHéréR	FALSE
aBaamokkòoǔàzZZngjòCpcJàUP	FALSE
aJaaHsKTndgyǒǔǎrwLzMRnPBup	FALSE
aPaaèXrěěùúfhxvtUubqcUòeWM	FALSE
aWaaáǒpNáippQGkàEfRZqIXáBJ	FALSE
afaaXxbútúNEwNVoHfAvNiuSdF	FALSE
amaaxSYDUAJIòonKǔCHèzNwddó	FALSE
asaaeéEǔǔywěmleHKspDrSTpuǒ	FALSE
aaǒCěùIǒPNYiaSEFNyLmNAóa	FALSE
aéaIhgúúxGóugLábWèZBurFúp	FALSE
aCaùHAHèjBBóSZmǒrǎKěTWqAB	FALSE
aKaovtOEMMPDRTyKyèjDdinjF	FALSE
aSadkTjyúdEODaLEǒQLmTHxeW	FALSE
aYaqrJKRhyzebTKeFǎAMNeěuu	FALSE
aaěabhhROpVXúHpkyěKòDrALPú	FALSE
aaCafjZOWBPldDVsěijsyuěǔjg	FALSE
aaKaàNǒjdXVoGtEYslTCDjépeX	FALSE
aaRaPiàzZMlcQOfóKiBqAkUGfx	FALSE
aaYagrKMzvIjáPLIecRIòTkPLU	FALSE
aajaǒMǎlǎlOùdQjrèVROkǎvvǒY	FALSE
aaqarQGfyGHnaBDLSKkhdmúVgo	FALSE
aayaáqdmyCJUVzrFéZárjBgnci	FALSE
aaèGsnèBùnYwFBUtFjTěwùffX	FALSE
aaCNtarrbghTcúpsMLéDdǔhǎs	FALSE
aaKCUelFkiiEdjPzTsHCtjxsB	FALSE
aaRpnOmèfmcoxCkFqJJXaáláv	FALSE
aabEèXùǎszXDGdQáxadúPiIeX	FALSE
aajòRhNCùnaTpòuJDǒMUhZsùù	FALSE
aaquFWfòSCuòUěECjdEFCDTsz	FALSE
aayjFjǎEjRómlkgAéfBEnBkfY	FALSE
agaYuDoqlxixQqsJnaPzvEǔèH	FALSE
aoamvěahpvNSMóùVòOguBirOB	FALSE
avaVeNJQGxWxùRzKjkGzgzaǒy	FALSE
eaaǔUYàúqáSùOqàtábmVyòtdM	FALSE
laakzǎDIuzAnvIFucálwTwXqè	FALSE
taaěhFCzCvǎSLòǎèSpXVǒOèKJ	FALSE
aaamMJtàdWlsYtéYVzCpùWaáPI	TRUE
aaaDoǒcJuYGiEoEPdTSSǔTěicó	TRUE
aaaBPtEZNPszjNWewqRànHZGǔc	TRUE
aaalWGǒYeéOěěsyRmrWUsǒoVNà	TRUE
aaaǔbgàEBúeyjgwlyEAZTqFǎMù	TRUE
aaaùbiàǒOyWpWqJcǒxIhgùiòGq	TRUE
aaabSwjědsToxEJéfEzěòZkNIE	TRUE
aaawǔèArSZFarScǎZTòQHwKlEN	TRUE
aaalUwwrrVòVvǔóDgAótěǒgdTo	TRUE
aaaogècisYcLLnMueYéěwàúhbá	TRUE
aaaboRTIjàIzǒeúòcùldéjaòCF	TRUE
aaatUhNXèiRDcSèNpkQToXǒóvc	TRUE
aaahPJàXfráràúèLykYDúSpdqu	TRUE
aaaàPEQNIéWOfúèèrHvwIsXHvR	TRUE
aaaòZijGmùXáCmbxubgZdQTfOU	TRUE
aaaRosMskCùNbBqLDOYyoNgěěǔ	TRUE
aaaOliUhrWPHěbóqJTsgPyXǔfB	TRUE
aaasOòCèNáúzXUNnIUKlmóùtMt	TRUE
aaaùLCVQéLhbSEjiIǎáǔVvtGcà	TRUE
aaaóhMMKǔEMVzWòRjIǎAwpXDǎT	TRUE
aaasGIǔnhtzBvWbNBJoéwwCQwa	TRUE
aaaéWàIpPúpCèeFtRxbhoNxJJò	TRUE
aaaàòKuLwùkèráwKsSJWáykeWL	TRUE
aaaéyèJkrdImGěBfáYuYhjffXv	TRUE
aaaxvzWiRbxǒófěbqKúèěǔgEVX	TRUE
aaaagaOhQcAhUMkzIdJsQZQTHM	TRUE
aaacgmNsyYWCcónsvMǒǔnDAgxI	TRUE
aaaǒtqAZYiáHcDXGkàóùQgVWWé	TRUE
aaaòVóhxEdXnéAXGfTèEJFKNHR	TRUE
aaazǎjǔlqwóúòlCquWgMTNǔAdt	TRUE
aaaGpjjNXkNvKnHvBAóaEeSéWF	TRUE
aaacJayhvNGóGAuAájVmEùOnùr	TRUE
aaaóElóuFǔWiáogYvFfSOsYXnX	TRUE
aaaǔKwPvezyzRěQrTaHuěcěàNy	TRUE
aaayRslFyUgqKéúKěúǎAfúKwBú	TRUE
aaaijbóǒjqWTrsmùóǔKěoYéǔVf	TRUE
aaahyHěòxCQPònAChgRMkùlXav	TRUE
aaakcSmòúZWKoVZùEǔlRPAgcwi	TRUE
aaaflLdFBrxHWVVFxwùǎèéúòYǔ	TRUE
aaaranvlcOlqRZEsóZuEòzTXúx	TRUE
aaaUXimiòEUèCǔnxuáiàHǔIpèw	TRUE
aaaCuěéXùQjvCǔPKǎfùVévSxǒo	TRUE
aaaAPuzàěaWAQǒEKǒPeeluAmlù	TRUE
aaaYehHàMrmkPuvZǔvéCǎLèáJE	TRUE
aaaLKiOSPMOIQoOGSǎFMzmDvJV	TRUE
aaaAIáúLPzeèǔSTrmòGgóaààkù	TRUE
aaaAszKkprqsCèiUénXftVWVhl	TRUE
aaanPKěàtTXycLpmǎúQMǒDGáúr	TRUE
aaaaAyǔThuibQBlFIANffqneYB	TRUE
aaaáJuWóCǔòngaaoFlAjzuúNfC	TRUE
ùaaamMJtàdWlsYtéYVzCpùWaáPI	FALSE
óaaaDoǒcJuYGiEoEPdTSSǔTěicó	FALSE
EaaaBPtEZNPszjNWewqRànHZGǔc	FALSE
LaaalWGǒYeéOěěsyRmrWUsǒoVNà	FALSE
SaaaǔbgàEBúeyjgwlyEAZTqFǎMù	FALSE
ZaaaùbiàǒOyWpWqJcǒxIhgùiòGq	FALSE
iaaabSwjědsToxEJéfEzěòZkNIE	FALSE
qaaawǔèArSZFarScǎZTòQHwKlEN	FALSE
yaaalUwwrrVòVvǔóDgAótěǒgdTo	FALSE
ǎaaogècisYcLLnMueYéěwàúhbá	FALSE
AaaboRTIjàIzǒeúòcùldéjaòCF	FALSE
HaatUhNXèiRDcSèNpkQToXǒóvc	FALSE
PaahPJàXfráràúèLykYDúSpdqu	FALSE
VaaàPEQNIéWOfúèèrHvwIsXHvR	FALSE
aǎaaòZijGmùXáCmbxubgZdQTfOU	FALSE
aAaaRosMskCùNbBqLDOYyoNgěěǔ	FALSE
aIaaOliUhrWPHěbóqJTsgPyXǔfB	FALSE
aPaasOòCèNáúzXUNnIUKlmóùtMt	FALSE
aYaaùLCVQéLhbSEjiIǎáǔVvtGcà	FALSE
agaaóhMMKǔEMVzWòRjIǎAwpXDǎT	FALSE
anaasGIǔnhtzBvWbNBJoéwwCQwa	FALSE
auaaéWàIpPúpCèeFtRxbhoNxJJò	FALSE
aaàòKuLwùkèráwKsSJWáykeWL	FALSE
aòaéyèJkrdImGěBfáYuYhjffXv	FALSE
aEaxvzWiRbxǒófěbqKúèěǔgEVX	FALSE
aMaagaOhQcAhUMkzIdJsQZQTHM	FALSE
aSacgmNsyYWCcónsvMǒǔnDAgxI	FALSE
aaáaǒtqAZYiáHcDXGkàóùQgVWWé	FALSE
aaǒaòVóhxEdXnéAXGfTèEJFKNHR	FALSE
aaEazǎjǔlqwóúòlCquWgMTNǔAdt	FALSE
aaMaGpjjNXkNvKnHvBAóaEeSéWF	FALSE
aaUacJayhvNGóGAuAájVmEùOnùr	FALSE
aadaóElóuFǔWiáogYvFfSOsYXnX	FALSE
aalaǔKwPvezyzRěQrTaHuěcěàNy	FALSE
aasayRslFyUgqKéúKěúǎAfúKwBú	FALSE
aaijbóǒjqWTrsmùóǔKěoYéǔVf	FALSE
aaóhyHěòxCQPònAChgRMkùlXav	FALSE
aaDkcSmòúZWKoVZùEǔlRPAgcwi	FALSE
aaKflLdFBrxHWVVFxwùǎèéúòYǔ	FALSE
aaRranvlcOlqRZEsóZuEòzTXúx	FALSE
aaYUXimiòEUèCǔnxuáiàHǔIpèw	FALSE
aagCuěéXùQjvCǔPKǎfùVévSxǒo	FALSE
aanAPuzàěaWAQǒEKǒPeeluAmlù	FALSE
aavYehHàMrmkPuvZǔvéCǎLèáJE	FALSE
afaLKiOSPMOIQoOGSǎFMzmDvJV	FALSE
aoaAIáúLPzeèǔSTrmòGgóaààkù	FALSE
auaAszKkprqsCèiUénXftVWVhl	FALSE
daanPKěàtTXycLpmǎúQMǒDGáúr	FALSE
kaaaAyǔThuibQBlFIANffqneYB	FALSE
raaáJuWóCǔòngaaoFlAjzuúNfC	FALSE
aaaeVàmdBMaòsInrMcdáTxnfWVǎ	TRUE
aaajXǒáaAFnaEWctcáQqHǎUaQEà	TRUE
aaaTòKèjǎjmwzQmacměuLhAúvǒU	TRUE
aaaHèjSTCǒqUhhHqDděoAqePQxě	TRUE
aaamòRùZǒgZZHtAézwVrànrIVèó	TRUE
aaaEVǒǔvUAiYXùMTùǎjámmbábfQ	TRUE
aaaWpvǎtQYAZlkNlKFPfdzáěáfS	TRUE
aaaEGǒQǎYdWidTěUPákFOlèbàNh	TRUE
aaaOoheLéVZSorǔAèoWkmzCFCwe	TRUE
aaaJDZaahGwuHYùZQREǔLkùKplg	TRUE
aaaFqICuKsRKQworFEFOxoNBǔUú	TRUE
aaaKnMZmbqSOféUevYTǔùZnpkró	TRUE
aaaQPKeuNPzúvRkKXáXuprówdTS	TRUE
aaahzzWtgvKuTBxQgQbPydfDDdà	TRUE
aaaKcQylEsTyeNùSIGǒǒnKQItnU	TRUE
aaaaùàèlmsuúetbAgKQùKHkQmàP	TRUE
aaajJbcěèJèaèAWoICXjojtpfóq	TRUE
aaaǔòVyehUIDrWkórchVǒhBOWPq	TRUE
aaavIVzHéLNgQòviJVXhǔiEQlùj	TRUE
aaaòQVVkWònéUiZpYXěWZeǔáSoà	TRUE
aaaùJSLUfLHòvàTáMQiosVělikG	TRUE
aaaǒVWZsòěXGzúgStàopHěpéázǔ	TRUE
aaaǒvsQIXuWsQwwkěpqOKàpMěyR	TRUE
aaabJGcITUXǒéhxhidhVXDISjJU	TRUE
aaaùWqWXǔUoHèaTěrNaEóvmǎnZP	TRUE
aaagQfRDyRcIXwwěGcctGSYCQZT	TRUE
aaaZYHSzgjOFHqBǎfopwKOèéǎèT	TRUE
aaaǔǎzYWyxeqVFvUJBCsǎàmoèjé	TRUE
aaavDáYPèeLUfèOvRRcLbRúVpKx	TRUE
aaaRqággZǔéumaòwPioǎcPmaKèj	TRUE
aaaWgBqGádVGfkrwTezǒsiOimHè	TRUE
aaaáoǎRxnóatvOEsBFVeAùwjEjt	TRUE
aaajpHéYènHYMRiCAElBVgtUVPǔ	TRUE
aaagedaééoDěsRàuxMtèOcpsiVy	TRUE
aaaóUauZòFěGxJáMqTUoFǒaGǔǒl	TRUE
aaazHLégáěxgǒAOrǔqttjèOOaǎz	TRUE
aaayHsMdóYkOPmǎBǎaotRprèPxH	TRUE
aaaSMilCcSwqlxYDvǔjFdthQáML	TRUE
aaaǎaéZMáxúsYèNfPKooúSJějdǒ	TRUE
aaazvhkYRHomuwWèKxzmIǒmWJǎz	TRUE
aaaXVcfAWuZbgIsJZKRèKIrBdǔT	TRUE
aaanBaliPSxTpxàaxNIxgxùIIěc	TRUE
aaajǒFlèBJtvCzgCgDJòclfpóNm	TRUE
aaabóùIwCpBEQǒqcmQwzèjUNfúà	TRUE
aaaèoèáǔjrxbLBvDǔRbùPUQOòùB	TRUE
aaaětmJóKQtFTvDújǒXOáexqlLù	TRUE
aaaúbgJǒZZvzòcJáWàQǒzwvèscP	TRUE
aaaTàóTàóHMjOàZLtJhTVxaáósù	TRUE
aaaOOǔdNZztkpBsYuEVquKNStBY	TRUE
aaalLnYmuóàavYmotHOadsAYwLy	TRUE
ùaaaeVàmdBMaòsInrMcdáTxnfWVǎ	FALSE
óaaajXǒáaAFnaEWctcáQqHǎUaQEà	FALSE
EaaaTòKèjǎjmwzQmacměuLhAúvǒU	FALSE
NaaaHèjSTCǒqUhhHqDděoAqePQxě	FALSE
VaaamòRùZǒgZZHtAézwVrànrIVèó	FALSE
daaaEVǒǔvUAiYXùMTùǎjámmbábfQ	FALSE
laaaWpvǎtQYAZlkNlKFPfdzáěáfS	FALSE
saaaEGǒQǎYdWidTěUPákFOlèbàNh	FALSE
aaOoheLéVZSorǔAèoWkmzCFCwe	FALSE
ěaaJDZaahGwuHYùZQREǔLkùKplg	FALSE
CaaFqICuKsRKQworFEFOxoNBǔUú	FALSE
JaaKnMZmbqSOféUevYTǔùZnpkró	FALSE
RaaQPKeuNPzúvRkKXáXuprówdTS	FALSE
ZaahzzWtgvKuTBxQgQbPydfDDdà	FALSE
aèaaKcQylEsTyeNùSIGǒǒnKQItnU	FALSE
aCaaaùàèlmsuúetbAgKQùKHkQmàP	FALSE
aLaajJbcěèJèaèAWoICXjojtpfóq	FALSE
aTaaǔòVyehUIDrWkórchVǒhBOWPq	FALSE
adaavIVzHéLNgQòviJVXhǔiEQlùj	FALSE
akaaòQVVkWònéUiZpYXěWZeǔáSoà	FALSE
asaaùJSLUfLHòvàTáMQiosVělikG	FALSE
azaaǒVWZsòěXGzúgStàopHěpéázǔ	FALSE
aěaǒvsQIXuWsQwwkěpqOKàpMěyR	FALSE
aCabJGcITUXǒéhxhidhVXDISjJU	FALSE
aIaùWqWXǔUoHèaTěrNaEóvmǎnZP	FALSE
aRagQfRDyRcIXwwěGcctGSYCQZT	FALSE
aZaZYHSzgjOFHqBǎfopwKOèéǎèT	FALSE
aaèaǔǎzYWyxeqVFvUJBCsǎàmoèjé	FALSE
aaCavDáYPèeLUfèOvRRcLbRúVpKx	FALSE
aaKaRqággZǔéumaòwPioǎcPmaKèj	FALSE
aaRaWgBqGádVGfkrwTezǒsiOimHè	FALSE
aaYaáoǎRxnóatvOEsBFVeAùwjEjt	FALSE
aahajpHéYènHYMRiCAElBVgtUVPǔ	FALSE
aaoagedaééoDěsRàuxMtèOcpsiVy	FALSE
aawaóUauZòFěGxJáMqTUoFǒaGǔǒl	FALSE
aaǔzHLégáěxgǒAOrǔqttjèOOaǎz	FALSE
aaòyHsMdóYkOPmǎBǎaotRprèPxH	FALSE
aaGSMilCcSwqlxYDvǔjFdthQáML	FALSE
aaOǎaéZMáxúsYèNfPKooúSJějdǒ	FALSE
aaVzvhkYRHomuwWèKxzmIǒmWJǎz	FALSE
aadXVcfAWuZbgIsJZKRèKIrBdǔT	FALSE
aaknBaliPSxTpxàaxNIxgxùIIěc	FALSE
aasjǒFlèBJtvCzgCgDJòclfpóNm	FALSE
aaybóùIwCpBEQǒqcmQwzèjUNfúà	FALSE
afaèoèáǔjrxbLBvDǔRbùPUQOòùB	FALSE
amaětmJóKQtFTvDújǒXOáexqlLù	FALSE
auaúbgJǒZZvzòcJáWàQǒzwvèscP	FALSE
baaTàóTàóHMjOàZLtJhTVxaáósù	FALSE
kaaOOǔdNZztkpBsYuEVquKNStBY	FALSE
saalLnYmuóàavYmotHOadsAYwLy	FALSE
aaaèiMaDOtjLCàmDwéXèKCUXhàFv	TRUE
aaaPnHhOZaKVccbuCúYYcDáǔèBěY	TRUE
aaaSěmúFPoéuMLMxefnIóKreuGOs	TRUE
aaasmTgábDALǎàglWOKmòfYZnsOK	TRUE
aaaJéKkqqóòPFBqxèCsBǎfòoòǒǒL	TRUE
aaaèFExYSauuǔfFoòenévZqMLcYe	TRUE
aaauùúNòLHSUwszTkhkǔtbFúǒLve	TRUE
aaarQEfiéSidxzawOBPǒòjàYeAua	TRUE
aaaKLGvXáhMPESafdCRUákOgqViL	TRUE
aaaqèlúuèàUǎrǒúòwMcRmyBoaúóá	TRUE
aaaěDQèNdSAStróZUAyNHyWbOpxc	TRUE
aaagTyoYPmLRàúvúzUoaZWXdPUbR	TRUE
aaatXUuSgfiùkTWPǎběúVXúLKòUO	TRUE
aaaTóKáǔwáKěruNjměSqsúZRsIaú	TRUE
aaahěwAúmlùkFykvLusabédUsveD	TRUE
aaaxéWèCEkǒgbkjjhwQěWPEDAYkò	TRUE
aaaSFPHOCGqjeIévéBéúFǒsBbGTs	TRUE
aaagSVMYsrěLZzStèRiYòJqEYnHù	TRUE
aaaulKGéxmhDXèEneLzIòǎKúcOóT	TRUE
aaaYtùYpDOúoLeqwrXqzěxJIhwja	TRUE
aaaqatZzkRkáyiodáHqeVknmerxe	TRUE
aaaFRádwèàXòLHbHBAXáXMHDiCsc	TRUE
aaaǔCNǎJxiùsFTItiUltéAUejUEK	TRUE
aaaxsùěMDbyDpùJOGěXLLǒLckIEǒ	TRUE
aaaLRsqkáCUfBPeétpjKJiqNOCzW	TRUE
aaafǔkéBUfBxèKanurBcLmpTFMzk	TRUE
aaaqgàeéSqbNLJǒPakǔǔUtyyIané	TRUE
aaaedgděnPRXcǒTeQVmtMDURǔJsC	TRUE
aaaFózPrúzXetCWuJCjàUwsCIòND	TRUE
aaaěufeBYCèáasIàgomPxěCyqxCX	TRUE
aaaMSàoRxùLǒHLùHéYDmNTàbùHYZ	TRUE
aaaVéIkóuNǒWqPgsplòSěěúDijeB	TRUE
aaaiúlbLMàTxfFQMUVǒùBàwóègVt	TRUE
aaaEóMkcmmspNmxùRufeEqKQYQǎn	TRUE
aaaKNǒLsǔKOmLQuèùcEGldwlvySW	TRUE
aaaùqahóXǔoqAvzlzyhqaIréXtǒR	TRUE
aaaǔKKWkPdoSKjVGWwùCyòòbLlFj	TRUE
aaaySNéněPhOOUtgMzúHqytPyucW	TRUE
aaaùPúéEgNTǎiWrsVqNeMfǔEkéQJ	TRUE
aaaNDǎóoCDzLqxaOmúnBpèónǒěqc	TRUE
aaaOdZùHOojjQzeBùǎuULXmúPáuU	TRUE
aaajFQKGèpbùLjArinlgǔUqběǔKG	TRUE
aaaùAqéùáǔsǎCScjàmpFCeYDěXBI	TRUE
aaatTSéSkUBEUsěgXOWǎàNiLWhRǎ	TRUE
aaaááǎnNwlèFóXsyóayGèVrCGEéO	TRUE
aaarYynAzésúDáBhkVdOWEzLpXQi	TRUE
aaaYDlfliúKbNVFǒSXRfGiMEèqàN	TRUE
aaaydkaqěPèvBloSwtCUTKGiDNǒv	TRUE
aaaiGOWXyKYǔEKàǎyàREZvopTeMǔ	TRUE
aaaMzuLgéUvtPuIfsoùCóJlEEzqR	TRUE
ùaaaèiMaDOtjLCàmDwéXèKCUXhàFv	FALSE
ěaaaPnHhOZaKVccbuCúYYcDáǔèBěY	FALSE
CaaaSěmúFPoéuMLMxefnIóKreuGOs	FALSE
LaaasmTgábDALǎàglWOKmòfYZnsOK	FALSE
SaaaJéKkqqóòPFBqxèCsBǎfòoòǒǒL	FALSE
baaaèFExYSauuǔfFoòenévZqMLcYe	FALSE
iaaauùúNòLHSUwszTkhkǔtbFúǒLve	FALSE
qaaarQEfiéSidxzawOBPǒòjàYeAua	FALSE
xaaaKLGvXáhMPESafdCRUákOgqViL	FALSE
ǎaaqèlúuèàUǎrǒúòwMcRmyBoaúóá	FALSE
úaaěDQèNdSAStróZUAyNHyWbOpxc	FALSE
HaagTyoYPmLRàúvúzUoaZWXdPUbR	FALSE
OaatXUuSgfiùkTWPǎběúVXúLKòUO	FALSE
WaaTóKáǔwáKěruNjměSqsúZRsIaú	FALSE
aàaahěwAúmlùkFykvLusabédUsveD	FALSE
aòaaxéWèCEkǒgbkjjhwQěWPEDAYkò	FALSE
aFaaSFPHOCGqjeIévéBéúFǒsBbGTs	FALSE
aMaagSVMYsrěLZzStèRiYòJqEYnHù	FALSE
aTaaulKGéxmhDXèEneLzIòǎKúcOóT	FALSE
adaaYtùYpDOúoLeqwrXqzěxJIhwja	FALSE
akaaqatZzkRkáyiodáHqeVknmerxe	FALSE
asaaFRádwèàXòLHbHBAXáXMHDiCsc	FALSE
aaǔCNǎJxiùsFTItiUltéAUejUEK	FALSE
aěaxsùěMDbyDpùJOGěXLLǒLckIEǒ	FALSE
aEaLRsqkáCUfBPeétpjKJiqNOCzW	FALSE
aKafǔkéBUfBxèKanurBcLmpTFMzk	FALSE
aSaqgàeéSqbNLJǒPakǔǔUtyyIané	FALSE
aaùaedgděnPRXcǒTeQVmtMDURǔJsC	FALSE
aaóaFózPrúzXetCWuJCjàUwsCIòND	FALSE
aaEaěufeBYCèáasIàgomPxěCyqxCX	FALSE
aaLaMSàoRxùLǒHLùHéYDmNTàbùHYZ	FALSE
aaTaVéIkóuNǒWqPgsplòSěěúDijeB	FALSE
aabaiúlbLMàTxfFQMUVǒùBàwóègVt	FALSE
aaiaEóMkcmmspNmxùRufeEqKQYQǎn	FALSE
aaraKNǒLsǔKOmLQuèùcEGldwlvySW	FALSE
aaùùqahóXǔoqAvzlzyhqaIréXtǒR	FALSE
aaěǔKKWkPdoSKjVGWwùCyòòbLlFj	FALSE
aaDySNéněPhOOUtgMzúHqytPyucW	FALSE
aaKùPúéEgNTǎiWrsVqNeMfǔEkéQJ	FALSE
aaSNDǎóoCDzLqxaOmúnBpèónǒěqc	FALSE
aaZOdZùHOojjQzeBùǎuULXmúPáuU	FALSE
aajjFQKGèpbùLjArinlgǔUqběǔKG	FALSE
aapùAqéùáǔsǎCScjàmpFCeYDěXBI	FALSE
aawtTSéSkUBEUsěgXOWǎàNiLWhRǎ	FALSE
afaááǎnNwlèFóXsyóayGèVrCGEéO	FALSE
amarYynAzésúDáBhkVdOWEzLpXQi	FALSE
auaYDlfliúKbNVFǒSXRfGiMEèqàN	FALSE
caaydkaqěPèvBloSwtCUTKGiDNǒv	FALSE
kaaiGOWXyKYǔEKàǎyàREZvopTeMǔ	FALSE
saaMzuLgéUvtPuIfsoùCóJlEEzqR	FALSE
aaaPòǎdùbOYEBIěnKqúDeWaqDKsrc	TRUE
aaaOeIkCNjavTlpfUǔBchiMcǔRUày	TRUE
aaaFeXZCPánhrHònòpqmàIfOǔjoěE	TRUE
aaaHwgiNRSNXAòwqbvGóygZhqAnWH	TRUE
aaaóúwrHòKTǔǎEdCLanEgtXvTKóFG	TRUE
aaaklMbǒtueùNhúWǒFSeùfǎRWIbXs	TRUE
aaaóuIBDVàuáXěVeCyOnpwèELJbwǒ	TRUE
aaaBtBiiěTFáOǒmǒuZbKdUOnaàkkf	TRUE
aaaIúlǔǎèwcOhzbewJawǎmhsilTǒn	TRUE
aaaulXEozónbKpéDJkùSàMměkThMP	TRUE
aaaEVváPZCuBGnOPòMhUàjlùàIzaC	TRUE
aaarěLèBMvǔVzVwPwúyBAuáfTCIOě	TRUE
aaaSěVáGLBHǒPSOèNVVupqèIQoVFQ	TRUE
aaaDojwúFùuBgRwgMXòNOOOGGyǒCS	TRUE
aaaOUlnèwyódcFWkZcókLXScqkIép	TRUE
aaaFOUěOxsqTLeAOORabsrnQtQPHa	TRUE
aaapStxeotyEJnZWkzfóiàǔSJúnYp	TRUE
aaamEbbCfwòIǔORǒTěvFxáuLORrCs	TRUE
aaaCqnMǎòVfeFhxwtúqmqraùBOǎwQ	TRUE
aaaVcěGjPxyCtzVQROYěeálfEsEùy	TRUE
aaaoùpàǒUHómǔnsǒUxFǔownMjǒNáa	TRUE
aaaàPúhNMKěvrFrwSnmLeTǎǎMlúDI	TRUE
aaanyEKFDKdgsEyUPúIpgYGnIbpxh	TRUE
aaaysCCàFmEuěmkónqrèǎjúeCHVyH	TRUE
aaaǎnMVěpHXJùwIúeDMgxòáǎfǎáàǎ	TRUE
aaaEPRúYsYIuǒǒRúIgyDùGàuFJRǔX	TRUE
aaavèOHXWWqnHcZuoZpnXPMQEtXiv	TRUE
aaaMMZěGneèpǔipXùKqVHdrrOYóǒo	TRUE
aaaAajBláúvoéDónwsADMJQLYInRz	TRUE
aaaoqaTmjUYaBCúGàAAJázBEQZèHz	TRUE
aaaLKwDǒcěǒǒSéZùDèfudcZCUExnJ	TRUE
aaaáKSéèSAaTnWéWTWmǔàXlGéFxcB	TRUE
aaaǒpXQjqCǒMáLTcbddFUBJVǔZCJq	TRUE
aaaMěnHCǒxIiiBUcTGóqfěcCOWJVB	TRUE
aaaááqǎzfjYeǔvvMvhJéLMwQùLcǎo	TRUE
aaaEàójTOVFJNOIcjLKeKusPdVxLF	TRUE
aaaqùágXKXUdsJRIàběwóEnJeLàeT	TRUE
aaabéoXXùNnpIdKhZLqǒDbuúEfVip	TRUE
aaaOSǎPlrHArcDZVxmuvúòòZVEJfě	TRUE
aaafZJóYGázUUnjèSAóNàěèwDǎIpa	TRUE
aaaYrědkaYXikzqzjdòukBIlSIPěá	TRUE
aaaúXsUgzKěXZǔdùàǔUAyMlAKlOGr	TRUE
aaaèeMonBqěBtnàpTpMcmtYěúEúkn	TRUE
aaapwHùfytLézjǔWvgwHCtSVVkZEX	TRUE
aaaivTGkFUPNGèRGòHddIxEtEǎǎTF	TRUE
aaacXnǒRǎMùcgùsbxeuVjAyBzùyvD	TRUE
aaakiyrǎPùkecáexTlèbkyóZogdJO	TRUE
aaajFHZéUěEXěóZěJmóágYòjfFcgd	TRUE
aaaIYdRsǒuZómAèsLàdTcùóLLXTnq	TRUE
aaaFMzqsAsFTjtQǎgGěkěnVmmMOSǔ	TRUE
ùaaaPòǎdùbOYEBIěnKqúDeWaqDKsrc	FALSE
èaaaOeIkCNjavTlpfUǔBchiMcǔRUày	FALSE
CaaaFeXZCPánhrHònòpqmàIfOǔjoěE	FALSE
KaaaHwgiNRSNXAòwqbvGóygZhqAnWH	FALSE
SaaaóúwrHòKTǔǎEdCLanEgtXvTKóFG	FALSE
baaaklMbǒtueùNhúWǒFSeùfǎRWIbXs	FALSE
iaaaóuIBDVàuáXěVeCyOnpwèELJbwǒ	FALSE
qaaaBtBiiěTFáOǒmǒuZbKdUOnaàkkf	FALSE
yaaaIúlǔǎèwcOhzbewJawǎmhsilTǒn	FALSE
àaaulXEozónbKpéDJkùSàMměkThMP	FALSE
ǒaaEVváPZCuBGnOPòMhUàjlùàIzaC	FALSE
GaarěLèBMvǔVzVwPwúyBAuáfTCIOě	FALSE
OaaSěVáGLBHǒPSOèNVVupqèIQoVFQ	FALSE
WaaDojwúFùuBgRwgMXòNOOOGGyǒCS	FALSE
aàaaOUlnèwyódcFWkZcókLXScqkIép	FALSE
aúaaFOUěOxsqTLeAOORabsrnQtQPHa	FALSE
aFaapStxeotyEJnZWkzfóiàǔSJúnYp	FALSE
aMaamEbbCfwòIǔORǒTěvFxáuLORrCs	FALSE
aTaaCqnMǎòVfeFhxwtúqmqraùBOǎwQ	FALSE
abaaVcěGjPxyCtzVQROYěeálfEsEùy	FALSE
aiaaoùpàǒUHómǔnsǒUxFǔownMjǒNáa	FALSE
apaaàPúhNMKěvrFrwSnmLeTǎǎMlúDI	FALSE
awaanyEKFDKdgsEyUPúIpgYGnIbpxh	FALSE
aàaysCCàFmEuěmkónqrèǎjúeCHVyH	FALSE
aúaǎnMVěpHXJùwIúeDMgxòáǎfǎáàǎ	FALSE
aGaEPRúYsYIuǒǒRúIgyDùGàuFJRǔX	FALSE
aOavèOHXWWqnHcZuoZpnXPMQEtXiv	FALSE
aVaMMZěGneèpǔipXùKqVHdrrOYóǒo	FALSE
aaáaAajBláúvoéDónwsADMJQLYInRz	FALSE
aaóaoqaTmjUYaBCúGàAAJázBEQZèHz	FALSE
aaEaLKwDǒcěǒǒSéZùDèfudcZCUExnJ	FALSE
aaLaáKSéèSAaTnWéWTWmǔàXlGéFxcB	FALSE
aaTaǒpXQjqCǒMáLTcbddFUBJVǔZCJq	FALSE
aacaMěnHCǒxIiiBUcTGóqfěcCOWJVB	FALSE
aalaááqǎzfjYeǔvvMvhJéLMwQùLcǎo	FALSE
aataEàójTOVFJNOIcjLKeKusPdVxLF	FALSE
aaùqùágXKXUdsJRIàběwóEnJeLàeT	FALSE
aaǒbéoXXùNnpIdKhZLqǒDbuúEfVip	FALSE
aaGOSǎPlrHArcDZVxmuvúòòZVEJfě	FALSE
aaOfZJóYGázUUnjèSAóNàěèwDǎIpa	FALSE
aaVYrědkaYXikzqzjdòukBIlSIPěá	FALSE
aaeúXsUgzKěXZǔdùàǔUAyMlAKlOGr	FALSE
aanèeMonBqěBtnàpTpMcmtYěúEúkn	FALSE
aavpwHùfytLézjǔWvgwHCtSVVkZEX	FALSE
adaivTGkFUPNGèRGòHddIxEtEǎǎTF	FALSE
amacXnǒRǎMùcgùsbxeuVjAyBzùyvD	FALSE
auakiyrǎPùkecáexTlèbkyóZogdJO	FALSE
eaajFHZéUěEXěóZěJmóágYòjfFcgd	FALSE
maaIYdRsǒuZómAèsLàdTcùóLLXTnq	FALSE
saaFMzqsAsFTjtQǎgGěkěnVmmMOSǔ	FALSE
