ùùCaKcVàKfZaAZQHYhMq	TRUE
ǔFPKAFǔkOYcáwUEsSiób	TRUE
áaókriLxǎBhǒnIQFaKAH	TRUE
àyKgUgPnleRReécèMHFt	TRUE
éFQXhràaèéroNPFFáyFK	TRUE
ècàǒUǔuevzpHròrTTECs	TRUE
óéhBxáPHHèKátrjàbvǒà	TRUE
òTrèbOGOGúǒeWǔféhǒJo	TRUE
ǒjdpAǎóaèěBAutPaǒěòù	TRUE
AIǎrVAmBjlrǒLzdǔcEáh	TRUE
BhVSǒHsjaǔFFMLXèRqDD	TRUE
DàcPfBmúTACVPMǒbàEká	TRUE
EfzIoeFsAiiVàáCwòtbY	TRUE
GǎeěfNppjáèúHpldWfáu	TRUE
HéFNcUvrwTsǔuFkDǎRHc	TRUE
ICThmqaKtǒxQuqPèCDǔl	TRUE
JcPrpvǔtRQHóZazsJSzù	TRUE
LóaWyàmfZWvTQSSDgTwj	TRUE
MDVAXVQiahcvSoLWgèjX	TRUE
NSHùǔYlFEicGQlǔKGIva	TRUE
OoǒticǔOgùèunYúókhCW	TRUE
QèěNAcafUZvyaPYwàlwc	TRUE
RNIuèBYJZyǒlOdóceBég	TRUE
SpFǔpVUilENxBuqmkvbQ	TRUE
TxzSùirǎUkLLTQyhcObA	TRUE
VóHCNQbgYmkjávCpVYpF	TRUE
WTězMéDòùQěbVéHMbuhV	TRUE
XděCglVeTLbXàáúGfBVN	TRUE
YvseJkfXFJàUiKZTAvbL	TRUE
aǎvódOuVaéuéIǒNHmlKE	TRUE
béHwyZJCDfxyQóhAUEGz	TRUE
cáxNgRéJHBcJKiIDFǎǒj	TRUE
cvhtèjkùDkGTtVBBkMUó	TRUE
dxOPmMOFrNnYmDdDqcXR	TRUE
fCJsklPvckDEzxTprcoú	TRUE
gMXuWfCyòVKeZàrOmFwb	TRUE
hawèDxuBxUpxtǔdRtwNv	TRUE
jǔàaóHǔOiGǎkyTZùNOGǔ	TRUE
kQrǎěàzecGoCNDOfIimm	TRUE
lplXRvèWYczěúcCzGEOǔ	TRUE
něèEPáVpfIsfpBIfhǎbu	TRUE
oFǒǔIrbXEIRqfnOPeLeW	TRUE
pMěNzYIjéáaáJRrQkǎFj	TRUE
qgYqRDlǒǔNlFòbDVúUYk	TRUE
rrzbSUNhcVPIinppbAùP	TRUE
tǒàjtIeEòAòBjqbMáèCp	TRUE
uidcǔPoIyatoòzétlAnǒ	TRUE
wèvtáMùDMOdNánHTbJtú	TRUE
xFJFCǒiqGéIdDQǔuforà	TRUE
yhmSDéxjkWǎbTNmiddmt	TRUE
ùùCaKcVàKfbaAZQHYhMq	FALSE
ǔFPKAFǔkOYcáwUEsaSiób	FALSE
áaókriLxǎBhbnIQFaKAH	FALSE
àyKgUgPnleRReécèMHdt	FALSE
éFQbXhràaèéroNPFFáyFK	FALSE
ècàǒUǔudevzpHròrTTECs	FALSE
óéhaBxáPHHèKátrjàbvǒà	FALSE
òTrèbOGOGúǒeWǔféhǒao	FALSE
ǒjdpAǎóaèběBAutPaǒěòù	FALSE
AIǎrVAmBjlrcǒLzdǔcEáh	FALSE
BhVSǒHsjaǔFFMLXèRqDDb	FALSE
DàcPfdmúTACVPMǒbàEká	FALSE
EfzIoaFsAiiVàáCwòtbY	FALSE
GǎeěfNppjáèúHcldWfáu	FALSE
HéFNcdvrwTsǔuFkDǎRHc	FALSE
ICThmqaKtǒxQbuqPèCDǔl	FALSE
JcPrpvǔtRQHóZazsJSzùd	FALSE
LóaWyàbmfZWvTQSSDgTwj	FALSE
MDVAXVQibahcvSoLWgèjX	FALSE
NSHùǔYlbFEicGQlǔKGIva	FALSE
OoǒticǔOdùèunYúókhCW	FALSE
QèěNAcafUZvyaPYdàlwc	FALSE
RNIcèBYJZyǒlOdóceBég	FALSE
SpFǔpVUailENxBuqmkvbQ	FALSE
TxzSairǎUkLLTQyhcObA	FALSE
VóHCNQbgYmkjávCpVapF	FALSE
WTězMéDòùQěbVéHMauhV	FALSE
XděCaglVeTLbXàáúGfBVN	FALSE
YvseJkfXFJaUiKZTAvbL	FALSE
aǎvódOuVaéubIǒNHmlKE	FALSE
béHwyZJCDfxyQóhaUEGz	FALSE
cáxNgdéJHBcJKiIDFǎǒj	FALSE
cvhtèjkùDkGTtVBBkMdó	FALSE
dxcOPmMOFrNnYmDdDqcXR	FALSE
fCJsklPvckDEzxdTprcoú	FALSE
gMXuWfCyaòVKeZàrOmFwb	FALSE
hawèDxuBxUpxtǔbRtwNv	FALSE
jbàaóHǔOiGǎkyTZùNOGǔ	FALSE
kQrǎěàzecGoCNDOfIdimm	FALSE
lplXRvèWYczěúcCdzGEOǔ	FALSE
něaEPáVpfIsfpBIfhǎbu	FALSE
oFǒǔIrbXEIaqfnOPeLeW	FALSE
pMěNzYIjéáaáJRrQkǎFb	FALSE
qgYqRDlǒǔNlaòbDVúUYk	FALSE
rrzbSUNhcVPIinpapbAùP	FALSE
tǒàjtIeEòAòBjqbMáèaCp	FALSE
uidcǔPoIbatoòzétlAnǒ	FALSE
wèvtáMùDaOdNánHTbJtú	FALSE
cFJFCǒiqGéIdDQǔuforà	FALSE
yhmSaéxjkWǎbTNmiddmt	FALSE
ùùhnHbMNWVqzàsfhkNvǔR	TRUE
ǔKGùqODOSTPmtèaydjùèq	TRUE
áVUuzHwIZIpxiOKXxbijè	TRUE
àamaGHoAOWRYésBJaěràm	TRUE
ǎmNKlmǒjǔohOQpjfèZǒbr	TRUE
èědjDpQǔAqqhèXYkóYaoé	TRUE
ěQDZKaFQéùjMàzrúoTrPA	TRUE
óikqCUúwIXèdrTaIthwùz	TRUE
òxXRuqdzYAMDkIǎEǔoaěn	TRUE
úBhiQbUvóDOǔYodwqoJjl	TRUE
AaaUnJaKGWeDdWǒcèyoèà	TRUE
BjgXúMùFDKIěmSmbCsYEl	TRUE
DáààbmzJQANRNùòúHǔTvY	TRUE
EElfgKogYmXoSHSbjBywK	TRUE
FYvjjGàRfOàjMǔVUckWYv	TRUE
GlVěAfǒFYǔèRZGoIbxmsl	TRUE
IéZoDWáhTgèGacWóǒlwXR	TRUE
JèouvXwaWHǔFrùtWáěsàQ	TRUE
KKqTwámtlAěTqjXNbuùǎo	TRUE
LbsUnbYQxsǔěécàftjvǎá	TRUE
NóóSOùétxCqFskeáucgbV	TRUE
OVgSajxéYiMěyBéXdgǔkh	TRUE
PrvbWBúòNGdòháAEUQAǒy	TRUE
RIfibmkLncgxHLGpnáěàb	TRUE
SUKòeòbéóùFAvàwgMjfIX	TRUE
TlLaǎcHUCCiuFPáéBieIà	TRUE
VǔNIáyHáddWNlWsmNǔeOZ	TRUE
WHaóffDRlěiJsKtmspgZQ	TRUE
XlRCdáHUǎsXèdOǒRzmzǒu	TRUE
ZààéuwpDedzftBNàbklèQ	TRUE
aHUQpyLoCtéèIZIspHrKu	TRUE
bAVfùMàUǒOgBégvmcwWUD	TRUE
cèkúCbvZbKfDǔYueHcVYq	TRUE
cxFMǔèVǔrvwSěLSIuNQOr	TRUE
eIèeHUOEcóSXcrRqSrIAu	TRUE
fdGjqnaAhJQàoYǒrkhGFǔ	TRUE
gzJzMPhnòLPhyúlGCǔxaT	TRUE
iKTDeWCyJáAvQwXsǎbQls	TRUE
jYvVvJuMjTNmObkUóóJěě	TRUE
kvvVHǔgsOSòItoěWBYMbǒ	TRUE
mòZǎYcuTzxKhAbphjùhBT	TRUE
nXAwWétinBhOòDBPUoyFd	TRUE
pǒùqtěnYfCjádDiHyéCld	TRUE
qSlJeapsJcYPIEEssǔFJx	TRUE
rfQJjbxádiǔwěwjhjùbzy	TRUE
tùùǒAùaùwzLWnClěǔDGNj	TRUE
uTbMrrqeJEwéFSNǔMpxGe	TRUE
vkOaǎóWùQtKeDjAeèáwiQ	TRUE
wzdwDKZksqwkflRBhQdxo	TRUE
yQbbxuZMFKYrhAvzVǎèIi	TRUE
ùùhnHbMNWVqzàsfhkNvǔaR	FALSE
ǔKGùqODOSTPmtèaycdjùèq	FALSE
áVUuzHwIZIpxiOKXabijè	FALSE
àamaGHoAOWRYésBJaběràm	FALSE
ǎmNKlmǒjǔohaQpjfèZǒbr	FALSE
èědjDpQǔAqqhèXYkbYaoé	FALSE
ěQDZKaFbéùjMàzrúoTrPA	FALSE
óikqCUúwIXèdrTaIthbùz	FALSE
òxXRuqdzYAbMDkIǎEǔoaěn	FALSE
úBhiQbUvóDcOǔYodwqoJjl	FALSE
AaaUnJaKGWeDdWǒcèyboèà	FALSE
BjgXúMùaDKIěmSmbCsYEl	FALSE
DáààbmzJQANRNùòaHǔTvY	FALSE
EaElfgKogYmXoSHSbjBywK	FALSE
FYvjjGàRfOàjMǔVUckdWYv	FALSE
GalVěAfǒFYǔèRZGoIbxmsl	FALSE
IéZoDWáhTgbGacWóǒlwXR	FALSE
JèoubvXwaWHǔFrùtWáěsàQ	FALSE
KKqTwámtlAěTqjXaNbuùǎo	FALSE
LasUnbYQxsǔěécàftjvǎá	FALSE
NóóSOùétxCqFskeáucdbV	FALSE
OVgScjxéYiMěyBéXdgǔkh	FALSE
PrvbWaúòNGdòháAEUQAǒy	FALSE
RIfibmkLncgxHLGpnáěàab	FALSE
SUKòeòbéóaFAvàwgMjfIX	FALSE
TlLaǎcHUCCiuFPáébieIà	FALSE
VǔNIcyHáddWNlWsmNǔeOZ	FALSE
WHaóffDRlěiJsKtmspgZQb	FALSE
XlRcdáHUǎsXèdOǒRzmzǒu	FALSE
aZààéuwpDedzftBNàbklèQ	FALSE
aHUQpyLoCtéèIZIbspHrKu	FALSE
bAVfùMàUǒOgBégvmcwdWUD	FALSE
cèkúCbvZbKfDǔYueHcaVYq	FALSE
cxFMǔèVǔrvwSěLSduNQOr	FALSE
eIèeHUOEcódXcrRqSrIAu	FALSE
fdGjqnaAhJQàboYǒrkhGFǔ	FALSE
gzbzMPhnòLPhyúlGCǔxaT	FALSE
iKTaDeWCyJáAvQwXsǎbQls	FALSE
jYvVaJuMjTNmObkUóóJěě	FALSE
kvvVHǔgsOSòItoaWBYMbǒ	FALSE
mòZǎYcuTzxKhAabphjùhBT	FALSE
nXAwWétinBhOòDBPUcoyFd	FALSE
pǒùcqtěnYfCjádDiHyéCld	FALSE
qSlJeapsJcYPIEEssǔFJd	FALSE
rcQJjbxádiǔwěwjhjùbzy	FALSE
tùùǒAùaùwzLWnClěǔbDGNj	FALSE
uTbMrrqeaJEwéFSNǔMpxGe	FALSE
vkOaǎóWùQtKeDjAbeèáwiQ	FALSE
wzdwDKZksqwkflRBhcdxo	FALSE
yQbbxuZMFKaYrhAvzVǎèIi	FALSE
ùùǒPSbydVúGXKyANQHRmoL	TRUE
ǔOóPAJdbǔDǎmIěoGrSNOAU	TRUE
ábàgKyěGhUGzmSbrrfǔkQx	TRUE
àpLfGAdYarPkpYéJjǔmàLP	TRUE
éèhFètnpXVǒfdsSAesDWbL	TRUE
èPlóAyYbùéǔěhěLyvGzSǔc	TRUE
ělHbOǎábúLwénòsrálAáěy	TRUE
òAswcòlazBzWKáVòěhrGRT	TRUE
ǒJuARTXBcWrtKKWgòbunCe	TRUE
úatǒKUqaIèyiIǎshainóhe	TRUE
AxAùjxqòǔEQàZYééFèIúaM	TRUE
CCjEcoǎUCGlKSVWezABOék	TRUE
DUndRUéǒGMhroddfGJavóZ	TRUE
EsITwKgwáOěRPwNàDèkèZd	TRUE
FtXièRkLèaUhHǔOgxDVGóǎ	TRUE
HǎháMcILGèoHMyweemEGàM	TRUE
IdZòBztdXHQxEǒEaVXGHQò	TRUE
JrgRóXRbJAqDóGqGQtgèTU	TRUE
LèzYěaTLYIDZútǔRAgKnVU	TRUE
MasnYtùzQEsdtKZJzPaòHà	TRUE
NmwYěFxCAWNKOǒOsygXFbW	TRUE
PBSzfQOAóěbBJrnjgèlAFǎ	TRUE
QLPEPMEèCjkBCrdUvfribà	TRUE
RmSUhúrhfùAéajOzěaùUJy	TRUE
TFzSMèMlòrjaeReqSǒrskp	TRUE
UYxNLNuǔcYBxezàáòvbyxZ	TRUE
VwǔeǔDhbNbLdeKzdùXókMh	TRUE
XOuiBxjGLPjinilBqbióqc	TRUE
YcóZYIlqGllAKyhaàGXmko	TRUE
ZrVsPùaàzèěcUóTGAeǔUwG	TRUE
akNǒNqgOBRhoóSvQXANVOh	TRUE
bpdstjòxPófzúVeierzwdE	TRUE
chqkèǒnMESpHQvUkúǎvUáá	TRUE
dfYyeǔAǎàRáJaxxFǒúǔùoI	TRUE
euěòaFyaJFwguqdAǎǔGkul	TRUE
gùnhLAEDbSúOGzdWMbkbSǒ	TRUE
hDaqoǒàFdwcJǔeùJrǎwEià	TRUE
iNǒSqUJrrILRmaùSROóàhq	TRUE
jjézǔFzImdúVIvnNYúXUǔu	TRUE
kzfxuàlEBgagzáIóěiZsLá	TRUE
mDuExjywǔjFTRnUQFUdǔUZ	TRUE
neSViYLwARdcCLxpFqDqEH	TRUE
owiaàsěZQXJǒWTFgZVRǔéG	TRUE
qCOlRXòRǒFèaQějwIěórEH	TRUE
rePcsIèKúWètrcIèUEyqpL	TRUE
svjTABJxvmoerdKRúsSyOz	TRUE
uHmwJrYWKJpmúXǔYdZAběM	TRUE
vvqvhaiffǎURkCteamEtàd	TRUE
xJGàùǎckmtGcqixkAMUǎfǎ	TRUE
ydfèIRTápCèFèhGVbdvkǒS	TRUE
ùùǒcPSbydVúGXKyANQHRmoL	FALSE
ǔOóPAJdbǔDǎmIěoGrSNOAaU	FALSE
áabàgKyěGhUGzmSbrrfǔkQx	FALSE
bpLfGAdYarPkpYéJjǔmàLP	FALSE
éèhFètnpXVǒfdsSAesDaWbL	FALSE
èPlóAyYbùéǔěhěLyaGzSǔc	FALSE
ěalHbOǎábúLwénòsrálAáěy	FALSE
òAswcòlazBzdKáVòěhrGRT	FALSE
ǒJuARTXBcWrtaKWgòbunCe	FALSE
úatǒKUqabIèyiIǎshainóhe	FALSE
AbAùjxqòǔEQàZYééFèIúaM	FALSE
CCjEcoǎUCGlKdSVWezABOék	FALSE
DUndRUéǒGMhroddbGJavóZ	FALSE
EscTwKgwáOěRPwNàDèkèZd	FALSE
FtXièRkLèaUhHǔObgxDVGóǎ	FALSE
HǎháMcILGèoHMyweemEGàdM	FALSE
IdZòBztdXHQbEǒEaVXGHQò	FALSE
JrgRóXRbJAqDóGqaGQtgèTU	FALSE
LèzYěaTLYIDbútǔRAgKnVU	FALSE
basnYtùzQEsdtKZJzPaòHà	FALSE
NmwYěFxCAWNKOǒOsygaFbW	FALSE
PBSzfQOAóěbBJrnjgèlaAFǎ	FALSE
QLPEPMEèCjkBCradUvfribà	FALSE
RmSUhúrhfùAébjOzěaùUJy	FALSE
TFzSMèMlòrjabeReqSǒrskp	FALSE
UYxNLNuacYBxezàáòvbyxZ	FALSE
VwǔeǔDhbNbLdeKzdùXóakMh	FALSE
XOuiBxjGLPjinilBqbióqcd	FALSE
YcóZdYIlqGllAKyhaàGXmko	FALSE
ZrVsPùaàzèěcUóTGAeǔUdwG	FALSE
akNǒNqgOBRboóSvQXANVOh	FALSE
bpdstjòxPófzúVeierzwdEa	FALSE
chqkdèǒnMESpHQvUkúǎvUáá	FALSE
dfYyeǔAǎàRáJaxxFǒúǔùoIb	FALSE
euěòaFyaJFcguqdAǎǔGkul	FALSE
gùnhLAEDbSaúOGzdWMbkbSǒ	FALSE
hDcaqoǒàFdwcJǔeùJrǎwEià	FALSE
iNǒSqUJrrILRmaùSROóbhq	FALSE
jjczǔFzImdúVIvnNYúXUǔu	FALSE
kzbfxuàlEBgagzáIóěiZsLá	FALSE
mDuExjywǔjFTRcUQFUdǔUZ	FALSE
neSViYLwcARdcCLxpFqDqEH	FALSE
owbaàsěZQXJǒWTFgZVRǔéG	FALSE
qCOlRXòRǒFèaQějwIěórEb	FALSE
rePcsIèKúWètrcIèUEyqpdL	FALSE
svjTABJcxvmoerdKRúsSyOz	FALSE
uHmwJrYWKJpmúcXǔYdZAběM	FALSE
vvbqvhaiffǎURkCteamEtàd	FALSE
xJGàùǎckmdtGcqixkAMUǎfǎ	FALSE
ydfèIRTápCèFèhaGVbdvkǒS	FALSE
ùùaULěFvZVSǔYòqmnZBpiOq	TRUE
ǔAáMOEWxIwgKzwAryQdpJxe	TRUE
áWLFóLkMmmRUWúèvbIjáYge	TRUE
ǎéHógǔúFEuykuèeéyDUOàNa	TRUE
éLuSEmAzòcóuàXAáěFCuhay	TRUE
èeJrùLkáGnLzěòWaZfadǎnn	TRUE
ězrIoOcòqóvAHwéeVRrYjJB	TRUE
òPDmyùWwBTkǎXCsùwqějǔBb	TRUE
ǒYJèriXwNóVHIHSǎdHǒéUiǎ	TRUE
úhHfuKAiRáWséóhbffǒàiei	TRUE
AnnDeuZùjsánkwbMěmuuIeg	TRUE
CáHzZyDAóAjVJoàXfEdYéKi	TRUE
DIBgùbLáMQESGkRsJǔZpFRl	TRUE
ERuTemTruòVdTCXuIXǔbèGù	TRUE
FvtDHSúSOcěUùqeRUZVKIKO	TRUE
HúRhljvBcǒNXUPrANAuǒnuO	TRUE
IJStdDyóFWFanzmAwQYòMkT	TRUE
JfàNxgCcuzIkSoFQMǎfxCKL	TRUE
KzKàkzyèXbsoEcyFlǔZTǎwW	TRUE
MQdRcǎwJzúènqSbǒhIVèeXy	TRUE
NsMXbxiSqǎbpèòǎjbqgTdBj	TRUE
PFFǒwZeHcùóójeRóOQaQjaa	TRUE
QLěúOZiSpègjLaEjtNáxwTk	TRUE
RgXPsZRAfLěaXùJWmriLnlp	TRUE
TèmoúxrMbOPehhltDxzóyXX	TRUE
ULolóAèùlepcjtLGipEoùBn	TRUE
VozpéxSLvBàJEBFǔùdBubFJ	TRUE
XùJErBnáShMPeRzràuqeaYr	TRUE
YIERqXGOjàHZjBGděGpYéǒa	TRUE
ZYMBéYanPNZFcùěKvZgKzTI	TRUE
acNUZǒTMǎèmpAMaNeBfǎUat	TRUE
bYùKsQDwQNnDXúhMKóúgExC	TRUE
cPCWǎmQUOCDóclàmPéNèDDq	TRUE
dZPúSgcòKòfcCQatYuéXfFa	TRUE
eiiLbúLVáFiférwúSdEvòcJ	TRUE
fxJPáishEtdnrpáqoGRDjaD	TRUE
hóuYcQPěffqockNaóeǎájMT	TRUE
icǔǎFHAXyphèSEóRqJLóavQ	TRUE
jwótùFwAQguwESGGHymǎaEW	TRUE
lOvyEèàèábFdǔǔNlǒoéWVqá	TRUE
mZOpàSMXhaZSTàPwXUxěǔeU	TRUE
nsǔóhiòcénbAbFvphTeyhěǔ	TRUE
pECaUKFnLXǒBespLGWXUuǒF	TRUE
qbmǎqúúwQùúòzeǔmIúWcsnH	TRUE
rròùpGǔhOlaKSwUúwúANBèT	TRUE
těhRègAběUntetjdpVJKeNA	TRUE
ubQWùKzèqǒúEáqmqùWroEds	TRUE
vqakPdOQómèúwiIIWidxEWQ	TRUE
xCJǔbGTXánhOcKàùfǒpJbpC	TRUE
yayejfsJxYTUCěMqCxQàuCd	TRUE
ùùaULěbvZVSǔYòqmnZBpiOq	FALSE
ǔAáMOEWxIwcKzwAryQdpJxe	FALSE
áWLFóLakMmmRUWúèvbIjáYge	FALSE
ǎéHógǔúFbuykuèeéyDUOàNa	FALSE
éLuSEmAzòcóuàXAáěFCuhayd	FALSE
èeJrùLkáGnLzěòWcaZfadǎnn	FALSE
ězrIoOcòqóvAHwédeVRrYjJB	FALSE
òPDmyùWwBTkǎXCsùwqějǔaBb	FALSE
ǒYJèriXwNóVHIHcǎdHǒéUiǎ	FALSE
úhHfuKAiRaáWséóhbffǒàiei	FALSE
AnnDeuZùjsánkwbMěmuuIega	FALSE
CcHzZyDAóAjVJoàXfEdYéKi	FALSE
DIBgùbLáMQESGkRsJǔZaFRl	FALSE
ERuTemTruòVcdTCXuIXǔbèGù	FALSE
FvtDHSúSOcěUùqeRUdZVKIKO	FALSE
HúRhljvBcǒNXUPdrANAuǒnuO	FALSE
IJStdDyóFWFanzmAbwQYòMkT	FALSE
JfàNxgCcuzIkSoFQMǎfdCKL	FALSE
KzKàkzyèXbsoEcdyFlǔZTǎwW	FALSE
MQdRcǎwJzúèaqSbǒhIVèeXy	FALSE
NsMXbxiSqǎbpèòǎjbqgTdBa	FALSE
PFFǒwZeHcùdóójeRóOQaQjaa	FALSE
QLěúOZbiSpègjLaEjtNáxwTk	FALSE
bgXPsZRAfLěaXùJWmriLnlp	FALSE
TèmoúxrMbOPeahhltDxzóyXX	FALSE
ULolóAèùlepcdjtLGipEoùBn	FALSE
VozpéxSLvcàJEBFǔùdBubFJ	FALSE
XùJErBnáShMPeRzràuqeabYr	FALSE
cIERqXGOjàHZjBGděGpYéǒa	FALSE
ZYMBéYanPNZbFcùěKvZgKzTI	FALSE
acNUZǒTMǎèmpAMbNeBfǎUat	FALSE
bYùKasQDwQNnDXúhMKóúgExC	FALSE
cPCWǎmQUOCdDóclàmPéNèDDq	FALSE
bdZPúSgcòKòfcCQatYuéXfFa	FALSE
eiiLbúLVáFcférwúSdEvòcJ	FALSE
fxJPáishEcdnrpáqoGRDjaD	FALSE
hóuYcQPěffqockNaóeǎájdT	FALSE
icǔǎFHAXdyphèSEóRqJLóavQ	FALSE
jwótùFwbQguwESGGHymǎaEW	FALSE
lOvyEèàèábFdǔaNlǒoéWVqá	FALSE
bmZOpàSMXhaZSTàPwXUxěǔeU	FALSE
nsǔóhiòcénbAbFvphTeyhěa	FALSE
pECaUKbnLXǒBespLGWXUuǒF	FALSE
qbmǎaúúwQùúòzeǔmIúWcsnH	FALSE
rròùpGǔhObaKSwUúwúANBèT	FALSE
těhRègAběUntetjdpaJKeNA	FALSE
ubQWùKzaèqǒúEáqmqùWroEds	FALSE
cqakPdOQómèúwiIIWidxEWQ	FALSE
xCJǔbGTXánaOcKàùfǒpJbpC	FALSE
yayejfsJxYTUCěMqCxQàucCd	FALSE
ùùWQOánGNpAjvBFDèaòCPhFú	TRUE
ǔDMCFbèBàQǒPcrTMJUThlqhG	TRUE
áKǔàJaàǒPTHYùntiSěuPWYLh	TRUE
àYIYZjNháqjUEěqDjClèAama	TRUE
ǎwoRròEòdCgtzYVbPSúlQVYF	TRUE
èúnhYigcmǒRǎlaǎHGOYǒLpPF	TRUE
ěTTǎwèJlVqcblràtPWurBQeg	TRUE
óhvPùBtqTJúvEIdGúaàrxóNx	TRUE
òytgèǎBnpQgzCcòCùKynóěgb	TRUE
úBcVvDPZLùHIHZpDpǔOwgRRK	TRUE
AdòXJSRjGFAFwNdàúěeTùrpx	TRUE
BspYlUnGkrvEfXQgarǒaúylǎ	TRUE
DBúǎhBMóFIPěRoGadMhxQéjG	TRUE
EMSmSBmmHǔcvQKibVcòǎátoC	TRUE
FdKuTóGsgbTyCWeUGiǒdhǒóx	TRUE
GyáǒLIcòyQáBkǎVrDNkMeqqF	TRUE
IJYjèpàSZQqfeMwsSEOItWaR	TRUE
JpbVATHKpkZròcHWEáVweǒUù	TRUE
LópEHcZxZóéYrQxsRhJjubVf	TRUE
MPǎCèYXJHCrRmáètuOpsdvéV	TRUE
NqfkěvàQoFpagNéxàEEMPlln	TRUE
PRǒVwMPAhzmULSYòvJPdRTòc	TRUE
QtajlQaOèKFNwUXrǒBráyǎOě	TRUE
SáydWXkěciqùPǒQějěCmQeèi	TRUE
TKáIiuEbNjVndltLóěZRéYèb	TRUE
UhiPèfnizJuWAóHěOEidbáRF	TRUE
VuucrRHsóqDpFZbéHlèmfKVé	TRUE
XGǎNXófWsIúVNifjSaJIeRzò	TRUE
YXbboǔwUcówkbiQeOàTkuziè	TRUE
ZjWiQIkèRPdtYUúQbNEoUEéT	TRUE
aizJTòaLzsUVUxsldRSfLrúk	TRUE
bmàRCvOSǎróěZyQWóCGMDPGR	TRUE
casoJOIfòVVCàòDqǒòYnjsFù	TRUE
dhCaqxeQFYTWVrfwrfUǔiXdq	TRUE
féztHzTXXúǒoòQQPAOaúLáQD	TRUE
gMdapfeúkYLWYXKPVXgzèGál	TRUE
hfeóǔsYcbgbwKePTàmóùùuáǒ	TRUE
inlUièzcqpPòùOtGojRcǒvUǔ	TRUE
kFgPóYOmibrfvZOFcǒàQXNǔó	TRUE
ladtKMzOtRVEǎcCkǔsGHDǒIe	TRUE
mkàpBKzPHófplFLBZacěnIlù	TRUE
oùmQurNgfǒoHiòYOObDéLjNI	TRUE
pIěFaufTùyplqVǎaLqITFúúu	TRUE
qUOòQKudsIrnmyácqJLvIAvD	TRUE
rniKldxùcjáǔhúeèyfióowyI	TRUE
tKwwGóQtLZiaHoǎùkIAVjpKy	TRUE
ufbtúǔHeèCKRCWhlsscnvflě	TRUE
vtkCZdtLccQLKtlIcaiqxXcA	TRUE
xGObGyJwBiAGdeéxvTAùòhpx	TRUE
yctPZáVsEJǔèRnxǎsMmieujS	TRUE
ùùWQbOánGNpAjvBFDèaòCPhFú	FALSE
ǔDMCFbèBàQǒPcrdMJUThlqhG	FALSE
áKǔàJabǒPTHYùntiSěuPWYLh	FALSE
àYIYZjNháqjUEěqDjCblèAama	FALSE
ǎwoRròEòdCgtzYVbPSúlQVYFa	FALSE
èúnhYigcmǒRǎlaǎHGOYǒdpPF	FALSE
ěTTǎwèJlVqcbdlràtPWurBQeg	FALSE
óhcvPùBtqTJúvEIdGúaàrxóNx	FALSE
òytgèǎBnpQgzCcòCùKdnóěgb	FALSE
úBcVvDPZLùHIHZpDpǔOwgdRK	FALSE
AdòXJSRjGFAFwcNdàúěeTùrpx	FALSE
BspYlUnGkrvEfXQgabǒaúylǎ	FALSE
bDBúǎhBMóFIPěRoGadMhxQéjG	FALSE
EMSmSBmmHǔcvQKdbVcòǎátoC	FALSE
FdKuTóGsgbTyCWeUGiǒdhǒaóx	FALSE
GyáǒLIcòyQáBkǎVrDNkMeqdqF	FALSE
IJYbjèpàSZQqfeMwsSEOItWaR	FALSE
apbVATHKpkZròcHWEáVweǒUù	FALSE
LópaHcZxZóéYrQxsRhJjubVf	FALSE
MPǎCèYXJHCrRcmáètuOpsdvéV	FALSE
NqfkěvàQoFpagNéxàEEMPblln	FALSE
PRǒVwMcPAhzmULSYòvJPdRTòc	FALSE
QbajlQaOèKFNwUXrǒBráyǎOě	FALSE
SáydWXkěcidùPǒQějěCmQeèi	FALSE
TKáIiuEbNjVndltLóěZRéYaèb	FALSE
UhiPèfnizJuWcóHěOEidbáRF	FALSE
VuucrRHdóqDpFZbéHlèmfKVé	FALSE
XGǎNXófWsIúVNifbjSaJIeRzò	FALSE
YXbaoǔwUcówkbiQeOàTkuziè	FALSE
ZjWaiQIkèRPdtYUúQbNEoUEéT	FALSE
aizJTòaLzsUbVUxsldRSfLrúk	FALSE
bmàRCvOaǎróěZyQWóCGMDPGR	FALSE
casobOIfòVVCàòDqǒòYnjsFù	FALSE
dhCaqxeQFbYTWVrfwrfUǔiXdq	FALSE
féztHzTXXúǒobòQQPAOaúLáQD	FALSE
gMdapfeúkYLWYXKbPVXgzèGál	FALSE
hfeóǔsYcbgbwKePTàdóùùuáǒ	FALSE
inlUièzcqpPòùOdtGojRcǒvUǔ	FALSE
kFgPóYOmibrfvZOFcǒàQXNǔóa	FALSE
ladtKMzOtRVEǎcCkǔsGHDǒbe	FALSE
mkàpBKzPHóbfplFLBZacěnIlù	FALSE
oaùmQurNgfǒoHiòYOObDéLjNI	FALSE
pIěFaufTùypbqVǎaLqITFúúu	FALSE
qUcOòQKudsIrnmyácqJLvIAvD	FALSE
rniKldxùcdáǔhúeèyfióowyI	FALSE
tKwwGóQtbZiaHoǎùkIAVjpKy	FALSE
ufbtúǔHeèCKRCahlsscnvflě	FALSE
vckCZdtLccQLKtlIcaiqxXcA	FALSE
xGObGyJwBiAGcdeéxvTAùòhpx	FALSE
ycdPZáVsEJǔèRnxǎsMmieujS	FALSE
ùùBǒǒmqVzǎlàziǎèěIGaépBsU	TRUE
ǔENKùoRctrRjazfIynxěenǔuf	TRUE
áirkTctIozkvFyZfǒaàǔOawwǎ	TRUE
àxéCgtàqfPhǒRòxhbTqzQuCTá	TRUE
éIOàMDAJDàctzuǎeAcVùNgvVh	TRUE
èOǔyKjókfLǒsaeòfnLnCJUVùm	TRUE
ěcǒEgIrqXghyAóNZgèZàgpCWy	TRUE
òCWtgDCEaFogLVkwèpkFeKùSě	TRUE
ǒLgZZMPdrAxsówúǔfbùRwGgGn	TRUE
úaTkeúOOǔNXěǒeCppSrěóZHuW	TRUE
AyenǔdHQaiùtsjeoogQIàácié	TRUE
CDMGàwùOCnMdbtǒXEzmèUnWbD	TRUE
DrZuzúèaWqaehAlsCùcèPièrG	TRUE
FàoLwRCTHWfmzTárEYPéUédwg	TRUE
GXqfǎhqzSDNtOhèdOWoSXSùAE	TRUE
HoDǎIArWzwuàsQbǎNéájeSeUO	TRUE
JúUcmáIiMzayafzǎZùXETEwXq	TRUE
KaGKòQQyDQNOoIiIGǔéKAárKX	TRUE
LhéévUwobZǒzEFóBtPùèhùWdO	TRUE
NúFLGjyYdǒéqwKGEKǔǎGgqdqc	TRUE
OeRDOYOBǎwOQjadǎJcZMneVóo	TRUE
PwMfYZoěnocIwkóEKǔuFHnAVC	TRUE
RFRlwbeAuTMDòWiàkMélyYApd	TRUE
ScjUǒòjOLZsDáěùágNUkHHǔDǔ	TRUE
TsěBwěUdeoěàciRmeTúJvUJkó	TRUE
VúUhyiRBWrzmTehSwdséoaHIn	TRUE
WRaFqǎnmnǒPRQPxZUúqzBIùxy	TRUE
XjCyvifmsBTTúódRdaQnRPózU	TRUE
YoǔKǎOSpBbkǎtnSfHQXAlòòǒá	TRUE
ZvtáMàiètáúAěoshdGbèrqXjN	TRUE
axMPPaóKyFlHùóBóyMóEéòUWú	TRUE
cǎréxaǔáFòeoGáZLYLcǒRYFUz	TRUE
czIeEqǔgarSAěǔElǒYupUOuDv	TRUE
eHóFùyszOZǔPndǒMnLGCUKkvě	TRUE
fdAèMOGcgSHqURùátMglKUPpa	TRUE
gnnNZtgFhǒGaDhAYoTzěvfǔǔK	TRUE
iéèvvNgldUQgzkGDFTtdIPKRs	TRUE
jPiAToJèděěaNUBTLúùQyǔgMQ	TRUE
kyǎKzǔzIavspUdVQEUZóSljGǎ	TRUE
mǎQLWGRJóHAOmFjKMdǔvHcGEl	TRUE
nBlicyBájJeóRNUmjBpwòèSxY	TRUE
oQCyCuEdHllllbOèǔMIèiEFèp	TRUE
pgqVStǎQúBvaàLSTEpnòǎcvaF	TRUE
qzúxuSVYcUCúǒeRFǎhYmbjVoá	TRUE
sMcZqTáMMhjáMEǔEaAxngZYěa	TRUE
tdOròWbmEǒBkoqfoDrópvQùáf	TRUE
uzHanZrǎǎESmkVaayuàDǔdYóT	TRUE
wKsMmrqyzkhgDkbIrUvTlěvLs	TRUE
xXTgmàMEGUezǎbázùáWvéNNCt	TRUE
ygucAfèAxbfGhRwyěúxǔcivBW	TRUE
ùùBǒbǒmqVzǎlàziǎèěIGaépBsU	FALSE
ǔENKùoRctrRjazbIynxěenǔuf	FALSE
áirkTbctIozkvFyZfǒaàǔOawwǎ	FALSE
àxéCgtàaqfPhǒRòxhbTqzQuCTá	FALSE
éIOàMDAJDàctzudeAcVùNgvVh	FALSE
èOǔyKjókfbLǒsaeòfnLnCJUVùm	FALSE
ěcǒEgIrqXghyAóNZgèZdgpCWy	FALSE
òCWtbDCEaFogLVkwèpkFeKùSě	FALSE
ǒcLgZZMPdrAxsówúǔfbùRwGgGn	FALSE
úaTkeúOOǔNXěǒeCppSrběóZHuW	FALSE
byenǔdHQaiùtsjeoogQIàácié	FALSE
CDMGàwùOCnMdbtǒXEzmèUnWbDa	FALSE
DbrZuzúèaWqaehAlsCùcèPièrG	FALSE
FàoLwRcTHWfmzTárEYPéUédwg	FALSE
GXqfǎhqzScDNtOhèdOWoSXSùAE	FALSE
HoDaǎIArWzwuàsQbǎNéájeSeUO	FALSE
JúUcmáIibMzayafzǎZùXETEwXq	FALSE
KaGKòbQQyDQNOoIiIGǔéKAárKX	FALSE
LhaévUwobZǒzEFóBtPùèhùWdO	FALSE
NúFcLGjyYdǒéqwKGEKǔǎGgqdqc	FALSE
OeRDOYOBǎwOQjadǎJcZbMneVóo	FALSE
PwMfYZoěnocIwkóEKǔuFHdnAVC	FALSE
RFRlwbeAcTMDòWiàkMélyYApd	FALSE
ScjUǒòjOLZdsDáěùágNUkHHǔDǔ	FALSE
TscBwěUdeoěàciRmeTúJvUJkó	FALSE
VúUhyiRcWrzmTehSwdséoaHIn	FALSE
WRaFqǎnmnǒPbRQPxZUúqzBIùxy	FALSE
XjCyvbifmsBTTúódRdaQnRPózU	FALSE
YoǔKǎOSpabkǎtnSfHQXAlòòǒá	FALSE
ZvatáMàiètáúAěoshdGbèrqXjN	FALSE
axMPPaóbyFlHùóBóyMóEéòUWú	FALSE
bǎréxaǔáFòeoGáZLYLcǒRYFUz	FALSE
czIeEqdgarSAěǔElǒYupUOuDv	FALSE
eHóFùcszOZǔPndǒMnLGCUKkvě	FALSE
fdAbèMOGcgSHqURùátMglKUPpa	FALSE
gnnNZtgFhǒGaDhAYoTzbvfǔǔK	FALSE
iéèvvNgldUQgzkGDFTtcdIPKRs	FALSE
jPiATbJèděěaNUBTLúùQyǔgMQ	FALSE
kyǎKzǔzIavspUdVQEUbZóSljGǎ	FALSE
mcǎQLWGRJóHAOmFjKMdǔvHcGEl	FALSE
nBlicyBájJdeóRNUmjBpwòèSxY	FALSE
oQCyCuEdHllllbOèaǔMIèiEFèp	FALSE
pgqVStǎQúBvaàLSTEpnòǎbcvaF	FALSE
qzúxuSVYcUCúdeRFǎhYmbjVoá	FALSE
sMcZqTáMMhjáMEǔEaAxdgZYěa	FALSE
tdOròWbmEǒBakoqfoDrópvQùáf	FALSE
uzHanZrǎǎESmkVaayuàDǔdYbT	FALSE
wKsMmrqyzkagDkbIrUvTlěvLs	FALSE
xXTgmàMEGUezǎbázùáWvéaNNCt	FALSE
ygucAfèAxbfGhRwyěúxǔcivBd	FALSE
ùùùPkcPNùnFaUWóYYCéàFYVCvm	TRUE
ǔEgESóúMóAUDiaEòTznveknlǎO	TRUE
ácàpVTǔáYFkCZQSHJcZjMSrVaU	TRUE
ǎàùcWLqcgkéqyYLVRǒfbniNDeI	TRUE
éTòhkhxFQdUkòAQaùěméyúǎáéP	TRUE
èRkTávWLYóNIEaDoFgORǔAYGòU	TRUE
ěkjDNLGRěGeGxóbNPJvǒDóppRZ	TRUE
òúcDvúcNMYYyéàAVóFIMPaFeUa	TRUE
ǒVqbwXdòRQtJbCáUóLOpVùéHéw	TRUE
únJùhKWIJéXIGoJmaiùSugXMZò	TRUE
BěpFYéQeJVloděLnrKSstecbvP	TRUE
CXPdóinǔSdGQLXCǒrADsoQuVcI	TRUE
DwVUòlǎFLloéubelgluóCùZSGò	TRUE
FFLbhTilGYkwdAeóNǎldOPázTh	TRUE
GPǎMOzeBtxsOZDMǒgepeauAPwu	TRUE
HkNcgEqzólMVWCUMGèxnrǔǔFtE	TRUE
IxzBYVǔEIXyQpcVygNLlnhXaHX	TRUE
KGàòkpQmúXXǒMJImwYqmUZaxTú	TRUE
LnrZBKeDúEmèlòolZxWcaǔWáYt	TRUE
MwQFYbǎGOoHBxihfòudnOétsiP	TRUE
OáqxǎbrvsNpssMBLFjmòZZJjuF	TRUE
PPWwLPIJéjgYaǎùUéáCǔèCWèzv	TRUE
QYLóérolǒPyPèwKOyhěpdusKUt	TRUE
RiédQǒzIyBzdzǒáCObéqàwpǔèC	TRUE
SznécKvWZYrhMrvvòwvKCYmKnf	TRUE
UóVfcDǒBNcYLóOrFPQsiióéKóq	TRUE
VOzCǒhvNzvóDuDNFwòuQdvǔKox	TRUE
WdCúáqjěcXGǔǎcùIUaóMaJLBUe	TRUE
YǔclhRBXzHjeOxrSEktWZéCNrò	TRUE
ZǒréwòInYxkmbàtAvHsQgLunmB	TRUE
aEZkòodKdFdeGǒZBQArgSpXǔie	TRUE
bKKùǎspòMqRHSǔcgPyMqěúrEké	TRUE
cQěcuqxLkGQAàznjEbEexWǒWéA	TRUE
dNCáuSgEGAXdMRCHCpfgcWtUfo	TRUE
eQúmyGXvnbBUUèqúKwIyěTéáZr	TRUE
fdoHàyióǎuOréǔYnugbCwáEDgù	TRUE
hóǔLnrewǔGyoFréáMDjLóaTǒBw	TRUE
iódàénzsèòǒlféaRfEèsewcyHG	TRUE
jflzXqIqpLTpùZǒRBiqodRfYOO	TRUE
lúHKCkKcKfuzPVcJéiwFRPiácj	TRUE
mPDGùàéeáǔnááěPlWJQqoIóSVd	TRUE
nnWPxcKCiNNFKppasABZòQiqyg	TRUE
pDòYCOEǎbKibUmGSAmdoycolJi	TRUE
qaáJrHeStǒRVóizVzJQBmdQwRǒ	TRUE
rufVhùfudéIFsJaWPGEoTsPxRN	TRUE
tVwěgfNKjvupOZèMóúúnáhólna	TRUE
uinLhfocswgǔpnfèNNlyPUjsáě	TRUE
wùǔbyrLqvqǔMilèEQBǔJQjJXif	TRUE
xCéYáFuSakàEzéGgFMxFàByRsi	TRUE
ybVěMSàuǔoNěnmpsAdDgIUyhfù	TRUE
ùùùPbcPNùnFaUWóYYCéàFYVCvm	FALSE
ǔEgESóúMóAUDiaEòTznbveknlǎO	FALSE
ácàpVTǔbYFkCZQSHJcZjMSrVaU	FALSE
ǎàùcWLqcgkéqyYLVaǒfbniNDeI	FALSE
éTòhkhxFQdUkòAQaùěméyúǎábP	FALSE
èRkTávWLYóNbEaDoFgORǔAYGòU	FALSE
ěkaDNLGRěGeGxóbNPJvǒDóppRZ	FALSE
òbcDvúcNMYYyéàAVóFIMPaFeUa	FALSE
ǒVqbwXdòRQtJbCáUaLOpVùéHéw	FALSE
únJùhKWIJéXIGoJmaiùSugXMZb	FALSE
BěpFYéQeJVloděLnrKSstecbdP	FALSE
CXPdócnǔSdGQLXCǒrADsoQuVcI	FALSE
DwVUòlǎaFLloéubelgluóCùZSGò	FALSE
FFLbhTialGYkwdAeóNǎldOPázTh	FALSE
GPǎMOzeBtxsOZDMbǒgepeauAPwu	FALSE
HkNcgEqzólMVWCUMGdèxnrǔǔFtE	FALSE
IxzBYVǔEIbXyQpcVygNLlnhXaHX	FALSE
KGàòkpQmúXXǒMJbImwYqmUZaxTú	FALSE
LnrZBKeDúEmèlòolZxWcdaǔWáYt	FALSE
MwcQFYbǎGOoHBxihfòudnOétsiP	FALSE
OáaxǎbrvsNpssMBLFjmòZZJjuF	FALSE
PPWwLPIbJéjgYaǎùUéáCǔèCWèzv	FALSE
QYLóérolǒPyPèwKOcyhěpdusKUt	FALSE
RiédQǒzIyBzdzǒáCObéqàwaǔèC	FALSE
SznécKvWZYrhMrvvòwvKdCYmKnf	FALSE
UóVfcDǒBNcYLóOrFPQsiióéKóqd	FALSE
VOzCǒhvNzvóDuDcNFwòuQdvǔKox	FALSE
WdCúáqjěcXGǔdǎcùIUaóMaJLBUe	FALSE
YǔclhRBXzHjeOxrSEktWZdéCNrò	FALSE
ZǒréwòInYxkmbàtAvHsQgLunma	FALSE
aEZkòodKdFdeGǒZBQArbSpXǔie	FALSE
bKKùǎspòMqRHSǔcgPyMqěúrEkaé	FALSE
cQěcuqxLkGQAàznjEbEedxWǒWéA	FALSE
dNCáuSgEGcXdMRCHCpfgcWtUfo	FALSE
eQúmyGXvnbBUUèqúKwayěTéáZr	FALSE
fdoHàyióǎuOréǔYnugbCwáEDagù	FALSE
hóǔLnrewǔGbyoFréáMDjLóaTǒBw	FALSE
iódàénzsèòǒlféaRfEèsewcdHG	FALSE
jclzXqIqpLTpùZǒRBiqodRfYOO	FALSE
lúHKCkKcKfuzPVcJéiwFRPiácdj	FALSE
cmPDGùàéeáǔnááěPlWJQqoIóSVd	FALSE
nnWPxcKCiNNFbppasABZòQiqyg	FALSE
pDòYCOaEǎbKibUmGSAmdoycolJi	FALSE
qaáJrHeStǒRVóizVzJQBmdQwbǒ	FALSE
rufVhùfudéIFsJaWPGEobsPxRN	FALSE
tVwěgfNKjvubpOZèMóúúnáhólna	FALSE
uinLhfocswgǔpnfèNNlyPUdjsáě	FALSE
wùǔbyraLqvqǔMilèEQBǔJQjJXif	FALSE
xCéYbáFuSakàEzéGgFMxFàByRsi	FALSE
ybVěMSàuǔoNěnmpsadDgIUyhfù	FALSE
ùǔǔLbRèlsrquěPiPQSùXuJsgqFf	TRUE
ǔSúKbwDtElEhbLZlǒOlNvúpFjJP	TRUE
ápúpcFJUIèSXcpyZeòzjgǎUniUZ	TRUE
ǎCHédrXYtYomexjeòosvXTHHhXc	TRUE
éYiFcDINYAVhNcZuOLWAZiǎǒZbf	TRUE
ěáDiGàugeDXpqàTJVeHHdRTDùfo	TRUE
óXáàEBttwTǒeàUjdǔàvùtkKóéSG	TRUE
òaùězǒǔkrmpéinóYgěVMxjNgQCx	TRUE
ǒvZǔyeéQèyóWIeRcHrjpMzǎaMfp	TRUE
ADuugJúmHpAxpIobmóAúúrbFTXG	TRUE
BXzqWveǎWvAùòèNBóǎslantKXUú	TRUE
CwOéSjòmGKosUnbgàOǎzBmóZROS	TRUE
EPkemKMoWnǔWBKjlUcBaFǒsIshK	TRUE
FdmSáVTǎXǔRqbErǎǔIěuiDRófRò	TRUE
GlCLDkaZwLsMlnEFHayúEqóeFOó	TRUE
HvFxHecoDCvzxeltyqǔnJsoúcLa	TRUE
JDòdXRXPtgPbSXùAZOSdxòǎhèbX	TRUE
KRéKomǔzTDahcRwGúLRápǒěVssé	TRUE
LhtgMnlXzAěQlSXbBYdANSDePJA	TRUE
NEápuwàfKiqdxúsayepcWzIaMBò	TRUE
OcáZékěqeǔGQqjYMcIóùEJGúǎéx	TRUE
PwEwǒkcvzLKJqùsǔVMúFpàwaZMM	TRUE
REpCnEekětnlǎásmcóebúuRcQqk	TRUE
SiDbùmévjwóZTJOjISTUmgIoMbT	TRUE
TxtòyIOPbCèpZǒFbYdouoOxěiyP	TRUE
VǎEZxhJǒtUdaWLwOnEóWùùMLvǎH	TRUE
WEZúxDǔsnèùAeFàxwǎhhVlěNbsM	TRUE
XVghwihWMrGéFAdfǒàlvIyOTèRM	TRUE
YzCvLsxájpàxfReFanPIOzvjǎRq	TRUE
aEékiláRáxjCvLnjEFZóJùaIIsW	TRUE
bANzǎDobyǒMeǒVbdPNPvěfǔxPXv	TRUE
cGvIksSWSáRkAǔJWhsqBgTGZnbz	TRUE
dFkqKCěEáIpJoBOvIVZxqHaǔtzA	TRUE
eUJAGěLNUáKfHpeZBzóOvlLPDaz	TRUE
feqmùTsTXLKTbùeěHIǒRQWMzAbp	TRUE
gvbàwRàéùHqBKAúWAobAeyěqùXd	TRUE
iPSǔqXPFCàIqiZJpdǒManMNrLon	TRUE
jeǒanSWghàNJcsYWncòFǔOaUlyc	TRUE
kYqàALAlěQVeHGDVvěvuFQacmKX	TRUE
ljTIóBǒùPxdEHěBǎjěwvLoóbAcě	TRUE
mxNlCLóiBoSrtRjWHaIqNIWKGóó	TRUE
oRoiOoUúkmjZGVfGopRCYóáBFau	TRUE
phǔbnòCPJUjxKùsxWVDFDòlnKGN	TRUE
qrúcúMnóhòqǎQJùraqimàyěwáXě	TRUE
sóazyySAéWABSǒCUXUáǎOYRSjsf	TRUE
tJBmǎWogHNhMzóǒqòzBfdbiòàCs	TRUE
ulpgwRmerQVMùAúóXgIǔLúěFlam	TRUE
wùOhVTesGtziùáyúyúCYqeéfaFǎ	TRUE
xúFlZphiúXcǎwpOWaaQMěvàùTuW	TRUE
yaáOMsOFeKZYvTytmèTSǎKPQòXW	TRUE
ùǔǔaLbRèlsrquěPiPQSùXuJsgqFf	FALSE
ǔSúKbwDtElEhbLZlǒOlNvúaFjJP	FALSE
ápúpcFJUIèSXcpyZeòzjgǎUdiUZ	FALSE
ǎCHédrXYtYomexjeòosvXTHHhXcd	FALSE
éYiFcDIaNYAVhNcZuOLWAZiǎǒZbf	FALSE
cáDiGàugeDXpqàTJVeHHdRTDùfo	FALSE
óXcàEBttwTǒeàUjdǔàvùtkKóéSG	FALSE
òaùězǒǔkrmpéinóYgěVMxjNgbQCx	FALSE
ǒvZǔyeéQèyóWIebcHrjpMzǎaMfp	FALSE
ADuugJúmHpAxpIoabmóAúúrbFTXG	FALSE
BXzqWveǎWvAùbèNBóǎslantKXUú	FALSE
CwOéSjòmGKosUnbgàOǎaBmóZROS	FALSE
bEPkemKMoWnǔWBKjlUcBaFǒsIshK	FALSE
FdmSáVTǎXǔRqbErǎǔIěuiDRófaRò	FALSE
GlCLDbkaZwLsMlnEFHayúEqóeFOó	FALSE
HvFxHecoDCvzbxeltyqǔnJsoúcLa	FALSE
JDòdXRXaPtgPbSXùAZOSdxòǎhèbX	FALSE
KRéKomǔzTDabhcRwGúLRápǒěVssé	FALSE
LhtgMnlXzAěQlSXbBYdANSDeaPJA	FALSE
NEápuwàfKiqdxúsbayepcWzIaMBò	FALSE
OcádZékěqeǔGQqjYMcIóùEJGúǎéx	FALSE
PwEwǒkcvzLKJqùsǔbMúFpàwaZMM	FALSE
REapCnEekětnlǎásmcóebúuRcQqk	FALSE
SiDbùmévjwóZTJOjISTUmgIaMbT	FALSE
TxcòyIOPbCèpZǒFbYdouoOxěiyP	FALSE
bǎEZxhJǒtUdaWLwOnEóWùùMLvǎH	FALSE
WEZúxDǔsnèùAeFàxwǎhhVlěNbsa	FALSE
XcVghwihWMrGéFAdfǒàlvIyOTèRM	FALSE
YzCvLsxájbàxfReFanPIOzvjǎRq	FALSE
aEékiláRáxjCvLnjEFZóJbùaIIsW	FALSE
bANzǎDocbyǒMeǒVbdPNPvěfǔxPXv	FALSE
cGvIksSWSáRkAǔJWhsqdgTGZnbz	FALSE
dFkqKCěEáIpJbBOvIVZxqHaǔtzA	FALSE
eUJAGěLNbáKfHpeZBzóOvlLPDaz	FALSE
feqmùTsTXLaTbùeěHIǒRQWMzAbp	FALSE
gavbàwRàéùHqBKAúWAobAeyěqùXd	FALSE
iPSǔqXPFCàIqibJpdǒManMNrLon	FALSE
jeǒanSWghàNbJcsYWncòFǔOaUlyc	FALSE
kYqàAbAlěQVeHGDVvěvuFQacmKX	FALSE
laTIóBǒùPxdEHěBǎjěwvLoóbAcě	FALSE
mxNlCbóiBoSrtRjWHaIqNIWKGóó	FALSE
oRoiOoUbkmjZGVfGopRCYóáBFau	FALSE
phǔbnòCPJUjxKùsxWVDFDòlnKaN	FALSE
qrúcúMnóhòqǎQJùraqimàydwáXě	FALSE
sóabyySAéWABSǒCUXUáǎOYRSjsf	FALSE
tJBmǎWogHNhMzaǒqòzBfdbiòàCs	FALSE
ulpgwRmerQVMùAúóXgIǔLúěbFlam	FALSE
wùOhVTesGtzibáyúyúCYqeéfaFǎ	FALSE
xúFlZphiúXcǎwpOWaadMěvàùTuW	FALSE
yaáOMsOFeKZYvTybtmèTSǎKPQòXW	FALSE
ùùMOSiShNZbhěòFKúuúéurHxěUdb	TRUE
ǔAJiebycyvMMECfIifehSMěFtěqw	TRUE
áZmCyRǔtǎCóIèOóZwGǔraGIcěwMx	TRUE
ǎùUVMUFfúYhfǎBhfǎzGbóǎNwéwpJ	TRUE
éNdqxYtòùGěǔSwaáéZIàTUednQsp	TRUE
èuSJWhFaqXWZJgpúVBuphLólǎglè	TRUE
óBQulXMWFeMéXelVCétCtéyjxaéz	TRUE
òJǒvésoMKàJfdxGkbWèVAǎXkákwǒ	TRUE
ǒqBdaàpQGDáyFéIohAIUǎrGkPǒjM	TRUE
AéEmúavUcGòxěSTǒNǔyKùàxzZSèG	TRUE
BIiTKuxfcuyRUyJBzjèVPLLóèmVG	TRUE
CbǔHgKTmwiPSjCRRúmsWókvnróáú	TRUE
DuaǒiKǔvFTCèrSaofùcǔǎǎFDQnqe	TRUE
FǎdppsǔáókfkcpǒZWygaJáǔfiéIy	TRUE
GPXVSkXLdNoPauHVwBltIJǔwckèJ	TRUE
HZjTIèàHLFEcilCaqěwYysòjOKVK	TRUE
IoapUSClúèfǒuGVùWSTnXokMyoMn	TRUE
KǎLVáeqPioPnbKOmdLNTròqóvǒIn	TRUE
LGxkQxEAEZoRYOiCZápweEttpZdI	TRUE
MVewpwjàAYáOpnǔtǒTqYǔPHNkbLg	TRUE
NlIlLDHfSfvǒbQQRéYǒósbùópǔLv	TRUE
PórSàùǎzRCJóltǔdkdCaJVvóoGéE	TRUE
QRadEWxKQyeYVólXFBzǒmówspadh	TRUE
RfLtUzViCwRǔDětùèoCBlFHgBǒdó	TRUE
TǔQPǔYWiPypǎQAMdZIEèWéěIvKbC	TRUE
UKòygBBsnRkRLmèelàkYOYamDxJC	TRUE
VQWvqúWUéùwbǔvJIodcpkBBqèqcM	TRUE
WeOGtdùJRgYJJJxpúùrǎcàǒHBKqy	TRUE
YúáuBOOJiQéBúòzWiǔWbàFéUCimL	TRUE
ZqréùùTéSVupHhBxGòEoóCFYóbBW	TRUE
azZxúiemkǔPǒYhqCqWóCBsRěùKùK	TRUE
cGWSěwsFlněNthxYsfhTGTCSGèEé	TRUE
dMnǒòrSohàóKOJLvSúblWlYFHùDf	TRUE
eawàiFàZsoCsTKèTMgBǎpxáKwGgS	TRUE
flKělùǎOěahDòHXUáPnUTqósvIoq	TRUE
gyttnRHǎPPaGòSádJKOùdtHTixVU	TRUE
iPFéJǎòǔqvsQqHdhSOuyòWchgmNN	TRUE
jlVBèSxIwPEYǎaiyGPVáTòfNBDùè	TRUE
koQOnklfcùǔBzUNAXPKGIqoézEyp	TRUE
lvbdOGSěJvKjnàUXjDnbhùDOkúqD	TRUE
nǎLCwJbbsDYDAJqFAzǎWZbULsYGě	TRUE
oFXǒsùnUAGZkhfIDlǔnKdglrúbRZ	TRUE
pcGòěuXǒyúáEtécfèPúwLCàMFòbB	TRUE
qwòrnáunOHIXSàJáPKRifQAaǔcMf	TRUE
sFpcsPǒkVgVwYTeKvùnzIpQKóǒra	TRUE
taOFpeIgǔKvěkáPeJùǎeǔyzqoFúW	TRUE
uvǎZfXoPNnMMyèwRizGyHDdUJyQZ	TRUE
wFOYBǔùBsEaǔyZCóàYèRmUiqàuèU	TRUE
xIJgàògUMEǔKpúsNKTGBòKǒbhSqo	TRUE
yZóogOhxvdbhUmHKchArQulBDxIO	TRUE
ùùMOSiShNZbhěòcKúuúéurHxěUdb	FALSE
ǔAJiebycyvMMECfIifehSMěFtěaqw	FALSE
áZmCyRǔtǎCóIèOóZwGǔraGIcděwMx	FALSE
ǎùUVMUFfúYhfǎBhfǎzGbóǎNwéwpa	FALSE
éNdqxYtcùGěǔSwaáéZIàTUednQsp	FALSE
èuSJWhFaqXWZJgbpúVBuphLólǎglè	FALSE
óBQulXMWFbMéXelVCétCtéyjxaéz	FALSE
òJǒvésoMKàaJfdxGkbWèVAǎXkákwǒ	FALSE
bqBdaàpQGDáyFéIohAIUǎrGkPǒjM	FALSE
AéEmúavUcbòxěSTǒNǔyKùàxzZSèG	FALSE
BIiTKuxfcuyRUyJBzjèVPLLóèmdVG	FALSE
CbaǔHgKTmwiPSjCRRúmsWókvnróáú	FALSE
DuaǒiKǔvFTCèrSaofùcǔǎǎFDbQnqe	FALSE
FǎdppsǔáóbkfkcpǒZWygaJáǔfiéIy	FALSE
cGPXVSkXLdNoPauHVwBltIJǔwckèJ	FALSE
HZjTIèàHLFEcilCbaqěwYysòjOKVK	FALSE
boapUSClúèfǒuGVùWSTnXokMyoMn	FALSE
KǎLVáeqPioPabKOmdLNTròqóvǒIn	FALSE
LGxckQxEAEZoRYOiCZápweEttpZdI	FALSE
MVewpwjàAYáOpnǔtǒTqYaPHNkbLg	FALSE
NlaIlLDHfSfvǒbQQRéYǒósbùópǔLv	FALSE
córSàùǎzRCJóltǔdkdCaJVvóoGéE	FALSE
QRadEWxKQybeYVólXFBzǒmówspadh	FALSE
RfLtUzViCwRǔDětùèoCBlFHcBǒdó	FALSE
TǔQPǔYaiPypǎQAMdZIEèWéěIvKbC	FALSE
UKòygBBsnbRkRLmèelàkYOYamDxJC	FALSE
VQWvqúWUéùwbǔvJIodcpakBBqèqcM	FALSE
WeOGtdùJRgYJJJxpúùrǎcàǒHBKqyd	FALSE
YúáuBOOJiQéBúòzWiǔWbàFaéUCimL	FALSE
ZqréùùTéSVupHhBxGòEoóCFYóbBa	FALSE
azZxúiemkǔPǒYhqCqWbóCBsRěùKùK	FALSE
cGWSěwsFlnědNthxYsfhTGTCSGèEé	FALSE
dMnǒòraohàóKOJLvSúblWlYFHùDf	FALSE
eawàiFàZsoCsTKèTMgBǎpxbáKwGgS	FALSE
flKělùǎOěahDòHXUáPnbTqósvIoq	FALSE
gyttnRHǎPPcGòSádJKOùdtHTixVU	FALSE
iPFéJǎòǔqvsQqHdhSOuyòWchgmNd	FALSE
jlbVBèSxIwPEYǎaiyGPVáTòfNBDùè	FALSE
koQOnklfcùdBzUNAXPKGIqoézEyp	FALSE
lvbdOGSěJvKjnàUXjDnbhùDOkúaD	FALSE
naLCwJbbsDYDAJqFAzǎWZbULsYGě	FALSE
oFXǒsùnUAGaZkhfIDlǔnKdglrúbRZ	FALSE
pcGòěuXǒyúáEtécfèdPúwLCàMFòbB	FALSE
qwòrnáunOHIXSbàJáPKRifQAaǔcMf	FALSE
sFpcsPǒkdVgVwYTeKvùnzIpQKóǒra	FALSE
taOFpeIgǔKvěkábPeJùǎeǔyzqoFúW	FALSE
uvǎZfXoPNnMMcèwRizGyHDdUJyQZ	FALSE
wFOYBbùBsEaǔyZCóàYèRmUiqàuèU	FALSE
xIJgàògUMEǔKpúsNKTGBòKǒbhSqoa	FALSE
yZóogOhxvdbhUmHKchAarQulBDxIO	FALSE
ùùmoyZMúùnjZǔvKkYúǒězqkXitǒbk	TRUE
ǔGěxSIdUyaKěrFhpzěPvXAsEONCmn	TRUE
áTUCjyàmGdmRPkòèTbnRkQéKtèXVM	TRUE
àsyskùǎFjFpvàǒMcWvěúyèroSoCàS	TRUE
éúTsáábmmfùVǒàflvdóOèáéióOěqu	TRUE
èRdóAwoèpKteǒScWjaBaRHMoúNùYǔ	TRUE
ěcPKKrVDaoòCRXyHMweMákXáǔtCiw	TRUE
òàOsdQTPtlGfǔoTgùbfdàdeiKqàǒè	TRUE
ǒSMjvKvibJèfKóEfSùJfVCtCeóQAg	TRUE
úczvtCùoTOnlbVbOuiYoTǔHFFǔSǒě	TRUE
AióvVWZFcNàCǒèxbngGnwjjěPZNnI	TRUE
CǎSǔePGMHùjSxHáěZjyaadyégóAVF	TRUE
DBYyqXlúáóHiePOlqdXYCRiumeaWE	TRUE
EHihqngbBVéLIǔMeVjúéHMàGmǎGzw	TRUE
FdYeKNtàKCKbFǎecPPYjzòfpjjhzG	TRUE
HúydLùèóNDiOgǔfPaEjdHyjkxgJki	TRUE
IXǎXǎéJGsVUQáxpJEwměàiapàvequ	TRUE
JqWózjLRHSBCqHtCànSrGojHHpUdH	TRUE
LǔàYdlěkrxbiúèAXVàùknèPHvoimg	TRUE
MěLXúyKEèwbTFMZBàdǒjTohbúVvYT	TRUE
NEdsTmHùghdiétpwMtlHlěXùqVkàb	TRUE
OhòóqqovudcNúJàXGjvFájXvqèzzE	TRUE
PsraLáInáEzcxNltkàZéEePtYǒLóǎ	TRUE
RFiFUTxrghJYatěRheFyZqáOsIQáY	TRUE
SgrFlmBǔrGkèùKlésqvúFaPdAGmón	TRUE
UùóTvNfwQRWLEfsFágiǒsCdKVJwUp	TRUE
VǒuyhLSǎdáooKěfaóyZIDLcSkuyów	TRUE
WfàǒrFùmQIBlYDSRSéPLFúgPHIbDě	TRUE
XpuóùòáMRmFéǔmǔèegIJòhjǎvKkxb	TRUE
ZǔoJZxwvǒvnLèpmwDNrMnQiblWjTV	TRUE
aDOèrPOWTYsúǎùHRqmmúFCLeIVlǔX	TRUE
bVùásoàNmvcrOhàKQkLèVnHcPiJSk	TRUE
cYscccLQxCwTwEeAehONáépZbǒoóe	TRUE
dfǎEkKulvCSHDgcòrMǎbYFCSPzòEy	TRUE
fáSáùfxfueYeIXbXWFmògBòjckóIX	TRUE
gbfLZQdJuWAOFmBVQBiYwǒEgàqkxi	TRUE
hlvJztptdzFàaFoBhlóáuWVùtREtZ	TRUE
jùWWOYYZvAAdBTlCDFòòVNèXQàcLx	TRUE
kdERDUqpǎuHRulfSOááǒUYTlbVdmF	TRUE
lqgBùcbòCUiótǔYAkWùPJkwEǎDPxO	TRUE
nIOafzXaǔéCIQUwrǎuTJàkCSúVEax	TRUE
oiJpěOqDWuMqOyKaBJóxJvèUxěouV	TRUE
qékèòTǎQSàvMEhKxzdǎpjCrmtFùǒb	TRUE
rKLòèděYWǒkBvqJàtIfDàúRěǎxoTa	TRUE
sfsdZLVVatpRǒIòRHcAHJtsWòéOzk	TRUE
tnknLAfóiFFLOUbpdrǔékFVTkVèEj	TRUE
vákIjùWLqǎQiSibuhfǎAKIàiùTdLà	TRUE
wóLhDǔXǒvJqbIBJyǎnhlJsPǒgUǎPR	TRUE
xKěúyòfoodòtNsòNhFfruryálóSxW	TRUE
ycPoéásǎQúOAtvùHájěEjèlùAètjù	TRUE
ùùmoyZMúùnjZǔvKkYúǒěazqkXitǒbk	FALSE
ǔGěxcSIdUyaKěrFhpzěPvXAsEONCmn	FALSE
áTUCjyàmGadmRPkòèTbnRkQéKtèXVM	FALSE
àsyskùǎFjFpvàǒMcWdvěúyèroSoCàS	FALSE
éúTsáábmmfùVǒàflvadóOèáéióOěqu	FALSE
èRdóAwoèpKteǒScWbjaBaRHMoúNùYǔ	FALSE
ěcPKKrVDaoòCRXyHMweMákbXáǔtCiw	FALSE
òàOsdQTPtlGfǔoTgùbadàdeiKqàǒè	FALSE
ǒSMjvKvibJaèfKóEfSùJfVCtCeóQAg	FALSE
úczvtCùoTOanlbVbOuiYoTǔHFFǔSǒě	FALSE
AióvVWZFcNàCǒèxbngGnwjdjěPZNnI	FALSE
CǎSǔePGMHùjbxHáěZjyaadyégóAVF	FALSE
DBYyqXlúáóHiePOlqdXYCbRiumeaWE	FALSE
EHihqagbBVéLIǔMeVjúéHMàGmǎGzw	FALSE
FdYeKNtàKCKbFǎecPPYjzòfpjajhzG	FALSE
HbydLùèóNDiOgǔfPaEjdHyjkxgJki	FALSE
IXǎbXǎéJGsVUQáxpJEwměàiapàvequ	FALSE
JqWózjLRHSBcCqHtCànSrGojHHpUdH	FALSE
LǔàadlěkrxbiúèAXVàùknèPHvoimg	FALSE
MěLXúyKEèwcbTFMZBàdǒjTohbúVvYT	FALSE
cEdsTmHùghdiétpwMtlHlěXùqVkàb	FALSE
OcòóqqovudcNúJàXGjvFájXvqèzzE	FALSE
PsraLáInáEzcxNltkàZéEePtYǒbóǎ	FALSE
RFiFUTxrgbhJYatěRheFyZqáOsIQáY	FALSE
SgrFlmBǔrGkècùKlésqvúFaPdAGmón	FALSE
UùóTvNfwQcWLEfsFágiǒsCdKVJwUp	FALSE
VǒuyhLSǎdáooKěbfaóyZIDLcSkuyów	FALSE
WfàǒrFùmQIBlYDSRSéaLFúgPHIbDě	FALSE
XpuóùòáMamFéǔmǔèegIJòhjǎvKkxb	FALSE
ZǔoJZxwvǒvnLèpmawDNrMnQiblWjTV	FALSE
aDOèrPOWTYbúǎùHRqmmúFCLeIVlǔX	FALSE
bVùásoàNmvcrOhàKQkLdèVnHcPiJSk	FALSE
cYscccLQxCwTwEeAehONáaépZbǒoóe	FALSE
dfǎEkKulvCSHDgacòrMǎbYFCSPzòEy	FALSE
fáSáùfxfueYeIXbaXWFmògBòjckóIX	FALSE
gbfLZQdJuWAOFmBVQBiawǒEgàqkxi	FALSE
blvJztptdzFàaFoBhlóáuWVùtREtZ	FALSE
jùWWOYYcZvAAdBTlCDFòòVNèXQàcLx	FALSE
kdERDUqpǎuHRulfSOcááǒUYTlbVdmF	FALSE
lqgBùcbòCUaótǔYAkWùPJkwEǎDPxO	FALSE
nIObfzXaǔéCIQUwrǎuTJàkCSúVEax	FALSE
oiJpěOqDWuMqOyKaBJóxJvbUxěouV	FALSE
cqékèòTǎQSàvMEhKxzdǎpjCrmtFùǒb	FALSE
rKLòèděbWǒkBvqJàtIfDàúRěǎxoTa	FALSE
sbsdZLVVatpRǒIòRHcAHJtsWòéOzk	FALSE
tnkncLAfóiFFLOUbpdrǔékFVTkVèEj	FALSE
vákIjùWLqǎQiSibuhfǎAKIàiùcTdLà	FALSE
wóLhDǔXǒvJqbIBJyǎanhlJsPǒgUǎPR	FALSE
xKěúyòfoocdòtNsòNhFfruryálóSxW	FALSE
ycPoéásǎQúOAtvùHájděEjèlùAètjù	FALSE
