ùùěJYymivpVPEkèykúdZHaǔUDLuòkTh	TRUE
ààasxIazhóOàpáwfQtgèòmyuXáěwmCé	TRUE
écǔóoIlěUBTqréWgbbdDFpNTyǎtDIrá	TRUE
ěnVdGKjZúàéùFáecqNwTàkvOéàgimxr	TRUE
ǒoǎTIróUQzScKèéjEeyHéTFkóVbeypl	TRUE
BiHFbGUlgdòfòEǔBpkizgfHVwěsDEmò	TRUE
EHOLCYyULHjojyáIXPqEQPqjEsxBCdT	TRUE
HDkxáWDBtaǎiǎRKXlVwclúrloDúDPxó	TRUE
JkjCòNiNuKXOkYBKgCévěkbLMEktKxO	TRUE
MSRǎGtpvewAHfPKJáBjGOwDǒábdBRqG	TRUE
OsuèTIFsPǒnMJaiMJFfLGdòlGǒaúzéW	TRUE
RrvéúàGfmzsQPpUdRòecbKCaèxsxyVI	TRUE
UǒtDdrYGébEaòpMPPtTtIsUPòpUXRWH	TRUE
WCwǒsIYGòóQHoǎolMěIZkLdwUsbǔcáJ	TRUE
YpólUkctZǒrxeKèAWNOWPHGTbéGrzyě	TRUE
bàGulHlKjpǔáEdhWàofgPVlkOYVypwz	TRUE
dǒǎpDfhǒOKQQvJiTcAQXAlèzhbmlěǔS	TRUE
ekbKmBàmǔtǒfjǔvBCfwobQnLúlXbùNé	TRUE
hNáJkTxPESYBùtbtòLXMfQDrZhWbITE	TRUE
kùFúpbjbětEǔwǒkXmShTtYIVTpbMCùè	TRUE
nǎòùdkzSxxYéyvTàXóòMrIZBXFZlBxù	TRUE
pYrFIǔHEhoIòmUedNMSxbáǔǎLUXyrnP	TRUE
sDeQDDwVThevfàSSYèòUbKěsLwtiqDé	TRUE
uxvccèVúpùoTòidòúéiKOyYéPNfLǔLD	TRUE
xRCgUNcǎWBéjmqzsUNhhPedùRǒUKYtf	TRUE
ùùěJYymivpVPEkèykúdZHaǔUDLuòkThd	FALSE
ààasxIazhóOàpáwfQtgèòmyuXáěwmCb	FALSE
écaǔóoIlěUBTqréWgbbdDFpNTyǎtDIrá	FALSE
ěnVdGKjZúàéùFáecqNwdàkvOéàgimxr	FALSE
ǒoǎTIróUQzScKèéjEeyaHéTFkóVbeypl	FALSE
BiHFbGUlgdòfòEǔBpkizgfHVděsDEmò	FALSE
EHOLCYyULHjojyáIXPqEQdPqjEsxBCdT	FALSE
HDkxáWDBtaǎiǎRKXlVwclbúrloDúDPxó	FALSE
JkjCòNiNuKXOakYBKgCévěkbLMEktKxO	FALSE
MSRǎGtpvewAHfPKdJáBjGOwDǒábdBRqG	FALSE
OsuèTIFsPǒnMJaiMJFfLGdòlGǒdúzéW	FALSE
RrvéúàGfmzsQPpUdRòedcbKCaèxsxyVI	FALSE
UǒdDdrYGébEaòpMPPtTtIsUPòpUXRWH	FALSE
WCwǒsIYGòódHoǎolMěIZkLdwUsbǔcáJ	FALSE
YpóaUkctZǒrxeKèAWNOWPHGTbéGrzyě	FALSE
bàGulHlKjpǔádEdhWàofgPVlkOYVypwz	FALSE
dǒǎpDfhǒOKQQvJiTcAQXAlèzabmlěǔS	FALSE
ekbKmBàmǔtǒfjǔvBCfaobQnLúlXbùNé	FALSE
hNáJkTxPESYBùtbtòLXMfQDrZhaWbITE	FALSE
kùFúpbjbětEǔwǒkXmShTaYIVTpbMCùè	FALSE
dnǎòùdkzSxxYéyvTàXóòMrIZBXFZlBxù	FALSE
pYrFIǔHEhaoIòmUedNMSxbáǔǎLUXyrnP	FALSE
asDeQDDwVThevfàSSYèòUbKěsLwtiqDé	FALSE
uxvccèVdpùoTòidòúéiKOyYéPNfLǔLD	FALSE
xRCgUNcǎdWBéjmqzsUNhhPedùRǒUKYtf	FALSE
ùǔQpòbluNZXeòǎgLmójmbZmàfòCtrzué	TRUE
áMRUwyISiKěézWMǔYboLyofJImoùNlYx	TRUE
éàYHmWVzCaHòvBTǎáyNSqvyMrIlǔósRV	TRUE
ěihtRjhJsLZlLXèzwěǔyOnbPMYQóapòǎ	TRUE
ǒèJuMKúáPúCyúVKAxmVPvClNZrbCmJkR	TRUE
AwgYDhOPGXBhgJóoGXIXcZúbFLAGJpGQ	TRUE
EéezaáBKóuYEǒKPwyáDuvkMoPKǎutYfc	TRUE
GKyhjyORCfZCldCkQkéMáaovuXPyúYrf	TRUE
InfAèXUTujpxpbhvApgAByOoDLVěǒdln	TRUE
KxáfúNVùěóJaOWtZRzneaLlPòmàoěxsB	TRUE
NWǒyryǒZPdBXCéatGepMGóěètWRcivèN	TRUE
QàJYǒyFOQGOAtlTòIùglsRsYdPùRKieT	TRUE
ShZǔjLtGCIoEGPtanFuHkdjvǒVǎoPvDo	TRUE
VàMdTǒáNGǒgSěVmjtmóYyvenMNNySlsQ	TRUE
XpvSóMxbFBGásùgAPòdTOoAwáiGHfzòù	TRUE
aHPàéàlóZxocóBaFZcIqrSvNFLOǎděgǒ	TRUE
cnOáèèRzéálfHgèuBDoùòKjdmǔhAsEuP	TRUE
eaAEáDKnBARówǒenúsHeNSjúpDvdJfóà	TRUE
hHWùòIúěUbaoHrtUTIqHYFGroLsGǒPòǔ	TRUE
jsFAqKKNNrróOópJàeKJàZògPLcnqdòC	TRUE
mǒaXMPBgDeěWtáKJqjǔHXGězJNUpCúAr	TRUE
pàOnǒkiákOGnLgáELdbbFnpRùǔgkRHLK	TRUE
roFyXDcǎǔùVyNbMsKǔjRǎKVgIdxǒEvSé	TRUE
uRqWOúqcaOUàIdòwqPéJAóǒeNyXPNyZo	TRUE
xHMWAxbòXOmǔOYRXOòZJDYgEVpgDzTlt	TRUE
ùǔQpòbluNZXeòǎgaLmójmbZmàfòCtrzué	FALSE
áMaUwyISiKěézWMǔYboLyofJImoùNlYx	FALSE
éàYHmWVzCaHòvBTǎábyNSqvyMrIlǔósRV	FALSE
ěihtRjhJsLZlLXèzwěǔyOanbPMYQóapòǎ	FALSE
ǒèJuMKúaPúCyúVKAxmVPvClNZrbCmJkR	FALSE
AwgYDhOPaGXBhgJóoGXIXcZúbFLAGJpGQ	FALSE
EéezaáBKóuYEǒKPwyáDuvbkMoPKǎutYfc	FALSE
GKyhjyORCfZCldCkQkéMáaovduXPyúYrf	FALSE
InfAèdXUTujpxpbhvApgAByOoDLVěǒdln	FALSE
KxáfúNVùěóJaOWtZRzneaLlbòmàoěxsB	FALSE
NWǒyryǒZPdBXCéatGepMGóěètWRcbvèN	FALSE
QàJYǒyFOdGOAtlTòIùglsRsYdPùRKieT	FALSE
ShZǔjLtGCIoEGPtanFuHkdjvǒVǎoPvDbo	FALSE
VàMdTǒáNGǒgSěVmdtmóYyvenMNNySlsQ	FALSE
XpvaSóMxbFBGásùgAPòdTOoAwáiGHfzòù	FALSE
aHPàéàldóZxocóBaFZcIqrSvNFLOǎděgǒ	FALSE
cnOáèèRzéálfHgèuBDoùòKjdmǔhAsEdP	FALSE
eaAEáDbKnBARówǒenúsHeNSjúpDvdJfóà	FALSE
hHWùòIúěUbaoHrtUTIqHYFbGroLsGǒPòǔ	FALSE
jsFAqKdKNNrróOópJàeKJàZògPLcnqdòC	FALSE
mǒabMPBgDeěWtáKJqjǔHXGězJNUpCúAr	FALSE
pàOnǒkiákOGnLgáELdbabFnpRùǔgkRHLK	FALSE
roFydDcǎǔùVyNbMsKǔjRǎKVgIdxǒEvSé	FALSE
uRqWOúqcaOUàIdòwdqPéJAóǒeNyXPNyZo	FALSE
xHMaWAxbòXOmǔOYRXOòZJDYgEVpgDzTlt	FALSE
ùùYrHHHYǒdAoToèSRéJVàUsPgjTyLWDEě	TRUE
áhydWwgèJùúGguràTajuoXqWnAXeLXěHr	TRUE
éXPBUzJFKěKǎHěofGjedyùaěDPǎǔúéEqG	TRUE
ěeuWCpěCdALWáéFSBXùúùGHèblnLeàsRc	TRUE
ònksáXhaáeàTOfshnórèruáSkmCkfócáM	TRUE
AYXhgǒjPfúedéNFIaspèǎjǒphySHHòtúG	TRUE
DOàéXaxDvLHfǔALqRuzRoZlvPKiVPmgGú	TRUE
GFxèájxtEBJúùoazócHUQlAmQQùdQǔGwv	TRUE
IsJLYkFgǔǒkuEyòCABěZǒdFEQADWLxpkǎ	TRUE
LolXvxaVhuzuhIuòZHftóànmdIZaaàǔrK	TRUE
OòZFiNWVbYCWMJunsCàTgóǔyGécpèObVL	TRUE
QYǎhMoEǔPJMóqCGxfgúemVdXqsWrMqǒuS	TRUE
TMdFáuNjbFmDFvjYntěafJVKgǒvZoLxFT	TRUE
WěogBtéTWèǎrlákdFXUCRePZSěqwXLpBr	TRUE
YbQWQùGLqDǒDjaéUòTczěLvpttNJGWǒVK	TRUE
apGwFeNzAiZJJRtrkHmnàWzCADRrODǎLó	TRUE
dAùMepYèmtùEZOErsoiFAáùéócxzjUbsq	TRUE
fěutèàèvNǎeúSǒCDJtLzéHmúKpbxECLJP	TRUE
hhAǒuBRHàclhnvplbVěSǒGPgòǔàúSǎcFA	TRUE
kfGhòrJAèyóèNrbLujndEòOcUgǔUùFyTc	TRUE
mripplDXéHShdKpfbùxPhǒPeěáégjKYùo	TRUE
pvtBTòDeyLdQvWWrǔZvkóQlfGhvHoèCbg	TRUE
sLdmLfWèFZAlMóǔcepyùEàzKěóGSéHJGf	TRUE
uWXéasǒGulCúàTEéOhWLrǒYwygJkétrJà	TRUE
xPǒeZáòEùHúbeúQcAjKwwaTǔǒNOPUéxgG	TRUE
ùùYrHHHYǒdAoToèSRédVàUsPgjTyLWDEě	FALSE
áhyddWwgèJùúGguràTajuoXqWnAXeLXěHr	FALSE
édXPBUzJFKěKǎHěofGjedyùaěDPǎǔúéEqG	FALSE
ěeuWCpěCdALWáéFSBaXùúùGHèblnLeàsRc	FALSE
ònksáXhaáeàTOfshnórèruáSkmCkfóbcáM	FALSE
AYXhdǒjPfúedéNFIaspèǎjǒphySHHòtúG	FALSE
DOàéXaxDbvLHfǔALqRuzRoZlvPKiVPmgGú	FALSE
GFxèájxtEBJúùoazócHUQlAmQQùbQǔGwv	FALSE
IsJLYkFgǔǒkuEyòCABěZdǒdFEQADWLxpkǎ	FALSE
LolXvxdaVhuzuhIuòZHftóànmdIZaaàǔrK	FALSE
OòZFaiNWVbYCWMJunsCàTgóǔyGécpèObVL	FALSE
QYǎhMoEǔPJMóqCGxfgúemVdXqsWrMdqǒuS	FALSE
TMdFáuNjbFmDFvjYntěafJVbKgǒvZoLxFT	FALSE
WěogBtéTWèǎrdákdFXUCRePZSěqwXLpBr	FALSE
YbQWQùGLqDǒDjaéUbòTczěLvpttNJGWǒVK	FALSE
apGwFeNzAiZJbJRtrkHmnàWzCADRrODǎLó	FALSE
dAùMepYèmtùEZOErsoiFAáùéócxzjdUbsq	FALSE
fěutèàèvNǎeúSaCDJtLzéHmúKpbxECLJP	FALSE
hhAǒuBRHàclhanvplbVěSǒGPgòǔàúSǎcFA	FALSE
kfGhòrJAèyóèNdrbLujndEòOcUgǔUùFyTc	FALSE
mripalDXéHShdKpfbùxPhǒPeěáégjKYùo	FALSE
pavtBTòDeyLdQvWWrǔZvkóQlfGhvHoèCbg	FALSE
sLdmLfWèFZAlMóǔdcepyùEàzKěóGSéHJGf	FALSE
uWXéasǒGulCúbTEéOhWLrǒYwygJkétrJà	FALSE
xaǒeZáòEùHúbeúQcAjKwwaTǔǒNOPUéxgG	FALSE
ùùuaftuJkdaǒǔkǎHkGxHeWlúhEPFuTykóS	TRUE
áTTJrWtIozMvLqHkdgYYgǔnPnǒJIVkMóJǒ	TRUE
éQHDúBqmvòUaYAMRqmklèKòèKàwJàLSǔvG	TRUE
óěXUòpqrMpéárqěTóHAlIaóécQTuBsòTAk	TRUE
ǒWfuádEuUěóGmvIWùcáECLIJkàóǎHjòjgs	TRUE
BaDWXxǔAóoLWànikMèvúsUnMOaéCdTóùyh	TRUE
EǒěpSMKfeáenJHDeRXsLǔeSdUǒRObàrùDǒ	TRUE
GsóXQJlmqěFSeFGfébòNxzóvfzKJLFùSQL	TRUE
JFémidNrXYwJXSiMOǒǒgzVPùZèWzéQolóW	TRUE
LpáàeEPàWLǎXjúbǎRqyEcdquqUáFuBjiBǔ	TRUE
OfIfèncjRàEěéLLBécOacviCkeqNuuéěXm	TRUE
RPSqZYHHàXBDaIwjHéSJUnTGitqvCntGúk	TRUE
TtcóGaAcNNzqgnJxúiEFMLWxòanTdLUUIK	TRUE
WPVKpyJGhEXěWNsBwWqùGGFWyXRRdUMKve	TRUE
ZòuZXóàKúaWCěnjLhVgGwyLhADdéEHáràǒ	TRUE
bǎrsfJqHvXbzyCirVpmxéilúQádxXèFgFǎ	TRUE
dTpALjKGMQfgcuMfpTLLjótScBXpàjZZjN	TRUE
fYeVGIhàzesYQKyǒcTrZmfúKWéOCUJltbi	TRUE
iùGHXéLbdcuWǔxáUèWǎóIuaqJEGyèIòOZK	TRUE
kcúIàùhjàxóLkjrpyIxCdXnúúKocBWbqVb	TRUE
ngYitáXRaYNGdMtKINréPǎoIěǎlisqTvJs	TRUE
qòáGppeJǒmòdǎrtqcUJWoLòDcnǒHHNCPéC	TRUE
sgbNqèáQmNCfhQfDPdBJmwnmaiqXATǔǒBs	TRUE
vJpkprwLtoWEISZǒOCxxArTéNOblúdJoyW	TRUE
xjvyudskěEYRTfèAWxCpoàZaǎzWItèvohr	TRUE
ùùuaftuJkdaǒdǔkǎHkGxHeWlúhEPFuTykóS	FALSE
áTTJrWtIozMvLqHkdgYYgdǔnPnǒJIVkMóJǒ	FALSE
éQHDúBqmvòUaYAMRbqmklèKòèKàwJàLSǔvG	FALSE
óěXUòpqrMpéárqěTóHAlIaóécQTuBsòTbk	FALSE
ǒWfuádEuUěóGmvIWùcáECLIJkàóǎHjòjdgs	FALSE
BaDWXxǔAóoLWbnikMèvúsUnMOaéCdTóùyh	FALSE
EǒěpSMKfdáenJHDeRXsLǔeSdUǒRObàrùDǒ	FALSE
GsóXaJlmqěFSeFGfébòNxzóvfzKJLFùSQL	FALSE
JFémidNdrXYwJXSiMOǒǒgzVPùZèWzéQolóW	FALSE
LpáàdeEPàWLǎXjúbǎRqyEcdquqUáFuBjiBǔ	FALSE
OfIfèncjRàEěéLLBécOabcviCkeqNuuéěXm	FALSE
RPSqZYHHàXBDaIwjHéSJUnTGitqvCbtGúk	FALSE
TtcóGaAcNbNzqgnJxúiEFMLWxòanTdLUUIK	FALSE
WPVdKpyJGhEXěWNsBwWqùGGFWyXRRdUMKve	FALSE
ZòuZXóàKúaWCěnjLhVgGwyLhADdbEHáràǒ	FALSE
bǎrsfJqHvXbzyCirVpmxéilúQádxXèdgFǎ	FALSE
dTpALjKGMQdfgcuMfpTLLjótScBXpàjZZjN	FALSE
fYeVGIhàzesYQKyaǒcTrZmfúKWéOCUJltbi	FALSE
iùGHXéLbdcuWǔxáUèWǎóIuaqdEGyèIòOZK	FALSE
kcúIàùahjàxóLkjrpyIxCdXnúúKocBWbqVb	FALSE
ngYitáXRaYNGdMtKINréPǎoIěǎlisqTvJb	FALSE
qòáGppeJǒmòdǎrtqcUJWoLdòDcnǒHHNCPéC	FALSE
sgbNqdáQmNCfhQfDPdBJmwnmaiqXATǔǒBs	FALSE
vJpkprwLdtoWEISZǒOCxxArTéNOblúdJoyW	FALSE
xjvyudskěEdRTfèAWxCpoàZaǎzWItèvohr	FALSE
ùǎKǔMLódtuMqóPwSBrwóTtjJDVòapZToǎét	TRUE
àèPDaTgGBCòLmuǔvuěBxasǒIJlOmwsVcgùM	TRUE
èěFqóhYrqCjvGAKóbúcSIOwNGsMPaJmOquR	TRUE
óywsǒZbdllzxBVUSǔapKZNBDNjSWEGǎJvIe	TRUE
úArEIOrbáOXǒoBRpIǒxǒéqòǔLMàViIwCXld	TRUE
BejùwfàfrùcǔczáMcCaTnǎxiòGFàWAáIojú	TRUE
EOCWupBmekoeěaMZHcZqSrBVxJwLYQRhWIp	TRUE
GmPHěfQlJǎPDwǒBgvxàOjpTGlwbVoSKqěpJ	TRUE
JFHEDKqYBIneHGkmámZCzZúMgxárázbokLK	TRUE
LoéFPpIePaǔEéDMlINáǔdlàkfcGFkfuPJTS	TRUE
OoiHJeǎPWwYiXUǔKdúViTǎDHhurMGsSCuàD	TRUE
REdòhǔWǒgùQqJilmbswkǎPǒélGzféZMUáGm	TRUE
TkUgLTLKQYvwPórhLdlXlmBxvmPsiXJQVkn	TRUE
WǒZiúǔòǔèhKncWyIBNIqǒálXdéDèAhóxaIú	TRUE
YUrBEkpBáékkcCohCxéTOòáGbPqzIáǎěgiI	TRUE
bHkYǒUoPBaQálxěLltOfcàaLùágYsWysúOA	TRUE
dpqcGhmoYejúéjàéJuMvàYXPbHefmsprZVà	TRUE
gJXRFbXNQjgAgbǎKsázfpdUGjaYiIpMJvfá	TRUE
iTFMFèlùzpLpěBWèèEěblsěnèúyMǒVGjghb	TRUE
láCǎJiXéFMXKrúaLsǔróRoèknkócswCXǒou	TRUE
nOǔzxǒHbJòROnàjzHWvdbǔMiJIòkZUǎRWWǔ	TRUE
povùEǔèqúiNTSOómgKéQSXuYlbxMVYWèpef	TRUE
sójéhvselWùQDáaàykVkaCnBZrsMUùǔcTaE	TRUE
ujVùMgáaǔcTHǎvMcNnlNjKònvdkJfiZǒGòS	TRUE
xExyNqapAèvWXWFvvZójSyxlqhhHcnCAúNè	TRUE
ùǎKǔMdódtuMqóPwSBrwóTtjJDVòapZToǎét	FALSE
àèPDaTgGBCòLmuǔvuěBxasǒIJlOmwsVcbgùM	FALSE
èěFqóhYrqCjvGAKóbúcSIOwNGsMPaJbmOquR	FALSE
ódywsǒZbdllzxBVUSǔapKZNBDNjSWEGǎJvIe	FALSE
úArEIaOrbáOXǒoBRpIǒxǒéqòǔLMàViIwCXld	FALSE
BejùwfàfrùcǔczáMcCaTnǎbiòGFàWAáIojú	FALSE
EOCWupBmekoeěaMZHcZqSrBVxJwLYQRhWbp	FALSE
GmPHěfQlJǎPDwǒBgvxaOjpTGlwbVoSKqěpJ	FALSE
JFHEDKqYBIneHGkmámZCzZúMgaxárázbokLK	FALSE
LoéFPpdePaǔEéDMlINáǔdlàkfcGFkfuPJTS	FALSE
OoiHJeǎPWwYiXUǔKdúViTǎDHhurMdGsSCuàD	FALSE
aREdòhǔWǒgùQqJilmbswkǎPǒélGzféZMUáGm	FALSE
TkUgLTLKQYvwPórhLdlXlmBxvmdsiXJQVkn	FALSE
WdZiúǔòǔèhKncWyIBNIqǒálXdéDèAhóxaIú	FALSE
YUrBEkpBáékkcCohCxéTOòáaGbPqzIáǎěgiI	FALSE
bHkYǒUoPBaQálxěLltOfcàabùágYsWysúOA	FALSE
dpqcGhmoYejúédàéJuMvàYXPbHefmsprZVà	FALSE
gJXRFbXNQjgAgbǎKdsázfpdUGjaYiIpMJvfá	FALSE
iTFMFèlazpLpěBWèèEěblsěnèúyMǒVGjghb	FALSE
láCǎJiXéFMXKrúabsǔróRoèknkócswCXǒou	FALSE
nOǔzxǒHbJòROdnàjzHWvdbǔMiJIòkZUǎRWWǔ	FALSE
povùEǔèqúiNTSOómgKéQaXuYlbxMVYWèpef	FALSE
sójéhvselWùQDáaàykVkaCnBZrsMUùǔcTaEb	FALSE
ujVùMgdaǔcTHǎvMcNnlNjKònvdkJfiZǒGòS	FALSE
xExyNqapAèvWXWFvvZójSyxlqhhbHcnCAúNè	FALSE
ùǔónTókǒúDhoRESjryuǔGOgSJkmALYdLèLWW	TRUE
ádsXtǒZfMbǎEwUàǔYtWNmcrKgxqmWǒQZěèsB	TRUE
éèwQDRVQHFGTauCwuKùXekMéǎDdyaGfǔFyzR	TRUE
óǎxFǔWNsbóFCJReOdjósTsLpyJKCèehùcvòG	TRUE
ǒPuòwùYFǒjdgsUxaKLHAiaXSSǒǒGejgúAaGC	TRUE
BDNCwmùújéHAWkvoDkPIdPLqbháàJMmjkútě	TRUE
DqiJYVKIEQUbùǒUnpDcTějěfěhLěbaògèOlW	TRUE
GSáòHuqKtcměnzDKRShffGFtuǔrBàòZJrhdk	TRUE
IuSbGMVGISWKLEuVdETrCLAèàKzLSjEpDámè	TRUE
LkJApGkgédBoERléǔrěǔNCoJěáZKaxFáRWOj	TRUE
OWǎFBVZQeùdhnyuàféàYvFBáxGòKYDeRSUba	TRUE
RQvbIhYKZFiàáVqxySaéoxCMswAnjUtZWFěf	TRUE
TquioynYǔdqǎCpězàuhyfCyéNCǒpúINǒéYGp	TRUE
VwaGnBkdàEgóHkǎQnǒWvUmúěZPZcPòQLwDOF	TRUE
YKùXKsoealjWádZPHòFCJfHěJYqùTpǔTlSFW	TRUE
axǎXasǔHcBèěxAjYJEgNyPèFtòhikGrvZlFo	TRUE
daEFHtVǒlpqLǎivDQóúèànǔAJMuóTPoYfèǒP	TRUE
fzBǎhQàFbPuMVnAFěsXMLǒGàdwwzǔVKúLoAy	TRUE
iXjěěRziHOKyZNUxPWOùnkpKiLOcypáFsEqb	TRUE
kiKSqúóPcpwáWRkJdUIuóèxVDbiǎZfODCQxz	TRUE
nNAàúPNECaVWPPfáSlǒeěǔjyKWfEùppjeòoU	TRUE
qèEDgòwàXǒbZjvPWětUJUgIWBsoVmdvAàAxT	TRUE
seQFòdRQMIPkZvnzFéIgTLěóTwOóǎQbxRSmG	TRUE
uwEǒuAhúùPDVJeyjyehlěQjvHZGǒUfbgGldQ	TRUE
xBwbxpYùiFngéxMnVBDjǎMAAgkqYdXasyáèu	TRUE
ùǔónTódkǒúDhoRESjryuǔGOgSJkmALYdLèLWW	FALSE
ádaXtǒZfMbǎEwUàǔYtWNmcrKgxqmWǒQZěèsB	FALSE
éèwQDRVQHFGTauCwuKùXekMéǎDbdyaGfǔFyzR	FALSE
óǎxaFǔWNsbóFCJReOdjósTsLpyJKCèehùcvòG	FALSE
ǒPuòwùYFǒjdgsUxaKLHAiaXSSǒǒGejbúAaGC	FALSE
BaDNCwmùújéHAWkvoDkPIdPLqbháàJMmjkútě	FALSE
DqiJYVKIEQUbùǒUnpDcTějěfěhLěbaògèOlWb	FALSE
GSáòHuqKtcměnzDKRShffGFtuǔrBàòZJdrhdk	FALSE
IuSabGMVGISWKLEuVdETrCLAèàKzLSjEpDámè	FALSE
LkJApGkgddBoERléǔrěǔNCoJěáZKaxFáRWOj	FALSE
OWǎFBVZQeùdhdnyuàféàYvFBáxGòKYDeRSUba	FALSE
RQvbIhYKZFiàáVqxySaéoxCMswAnjUtbZWFěf	FALSE
TquioynYǔdqǎCpězàuhyfCyéNCǒpúINǒéYGdp	FALSE
VwaGnBkdàEgóHkbǎQnǒWvUmúěZPZcPòQLwDOF	FALSE
YKùXKsoealjWádZPHòFbJfHěJYqùTpǔTlSFW	FALSE
axǎXasǔHcBèěxAjYJEgNyPèFtòhikGrbZlFo	FALSE
daEFHtVǒlpqLǎivDQóúèànbǔAJMuóTPoYfèǒP	FALSE
fzBǎhaàFbPuMVnAFěsXMLǒGàdwwzǔVKúLoAy	FALSE
iXjěěRziHOKyZNUxPWOùnkpKiLOcyapáFsEqb	FALSE
kiKSqúóPcpwáWRkJdUIuóèxVDbiǎZdfODCQxz	FALSE
nNAàúPNECaVWPPfáSblǒeěǔjyKWfEùppjeòoU	FALSE
qèEDgòwàXǒbZjvPWětUJUgIWBsoVmdvAàdxT	FALSE
sdQFòdRQMIPkZvnzFéIgTLěóTwOóǎQbxRSmG	FALSE
auwEǒuAhúùPDVJeyjyehlěQjvHZGǒUfbgGldQ	FALSE
xBwbxpYùiFngéxMnVBDjǎMAAgkqYdXasdyáèu	FALSE
ùùěrMfsǒàóRctěàEùsHqyaUxEuFsBPHnòóKǔS	TRUE
áIeVsNSaRlYdPóaéróPYPǔxrxFpcYaèPéféEG	TRUE
ǎwISǎvkpOOěsiQoKYdPlááèFmfHKPrNeǒawěu	TRUE
ěéTshoAkNRBRàkSsCfLUPǔJbXdáOcvlbóOáòv	TRUE
òeBuòǔǔAdxúzàúFAnKùISóhfFHoáQAáésyrcN	TRUE
AMAWkààědmǔtQZǔaqMLCscgwTakúwwjmóEiPt	TRUE
DéóǔZTZPǒéCVQaqJfCidúOtHjIcTVWjcTzxpé	TRUE
FXyMaXéèHdLǔTffECtRjèYkCstzVUsmDBUisù	TRUE
IEpbBSLxfglAěhúUPcqDMSaWvJKeyklKvwVMà	TRUE
KoDooèǎěqsHDhvTmTmunJèěqVàùdnKFPǒOHLá	TRUE
NRàétuOXúTúóaNlVfxziRtóYssDdaiyiLXcTy	TRUE
PgyBDWRYDCèSzàvfèrYVǎpDòCdfrjǒPhasUóè	TRUE
SǎùKòóyeSsěcùHKUBaiáǔájVdgoegEoSmCQvh	TRUE
TzsgndbzùseiOFcgxomZbVòǎǎúrkNmuPPMien	TRUE
WoqHěèXJEaáǔǎwAHófCcWVINiěǒvèHTXFcmàO	TRUE
ZUǒǒjFbqLIGWhUMdfsóSPǔNuAǒtzQùvqbàiǒH	TRUE
cFBRAflUròRVàCFHàhfSvdNFiěòoálLjbùsNw	TRUE
eInǒqHPdVUbCǒàǔǎWqJfYfSgEèòDYjhWòICTò	TRUE
hákSúqtcxjSplbMvkdkrLzúzpeCiǒnInóǔWpu	TRUE
kǎFcIáPSCiuǔPIJUǒBǎRdTnèSXúgTHJZàwlLe	TRUE
mdiSuámǎlltEowcnQǒùCMVGǎTápogǎAùhofOs	TRUE
pRKǒatlBděòClYǎYMfAVèùuFFDPmQCTplmkCT	TRUE
rgcyJàJzǒvùǒSpwǔTAmóoyǒKUrěéWQǎǒSbDzv	TRUE
uKSDèdàùMDnbfhZhFáeòWiweDèěItWhùDxhNá	TRUE
wWyTgnUòòxǒlRǔaSnxǎjqdpzPKkǎDqsHiVjBP	TRUE
ùùěrMfsǒàóRctěàEùsHqyaUxEuFsBPHnòóbǔS	FALSE
ádeVsNSaRlYdPóaéróPYPǔxrxFpcYaèPéféEG	FALSE
ǎwISǎvkpOOěsiQoKYdPládèFmfHKPrNeǒawěu	FALSE
ěéTshoAdNRBRàkSsCfLUPǔJbXdáOcvlbóOáòv	FALSE
òeBuòǔǔAdxúzàdFAnKùISóhfFHoáQAáésyrcN	FALSE
AMAWkààědmǔtQZǔaqMdCscgwTakúwwjmóEiPt	FALSE
DéóǔZTZPǒéCVQaqJfCidúOtHjIcTVWjcTzxpéd	FALSE
FXyMaXéèHdLǔTffECtRjèYkCstbzVUsmDBUisù	FALSE
IEpbBSLxfglAěhúUPcqDMSaWvJKebklKvwVMà	FALSE
KoDooèǎěqsHDhvTmTmunJèěqVàùdnKFPǒOHdá	FALSE
NRàétuOXúTúóaNdlVfxziRtóYssDdaiyiLXcTy	FALSE
PgyBDWRYDCèSzàvfèrYVǎpDòCdfdjǒPhasUóè	FALSE
SǎùKòóyeSsěcùHKUBaiáǔájVdgoegbEoSmCQvh	FALSE
TzsgndbzùseiOFcgxomZbVòǎǎúrkNmuPPMdien	FALSE
WoqHěèXJEaábǎwAHófCcWVINiěǒvèHTXFcmàO	FALSE
ZUǒǒjFbqLIGdWhUMdfsóSPǔNuAǒtzQùvqbàiǒH	FALSE
cFBRAflUròRVàdFHàhfSvdNFiěòoálLjbùsNw	FALSE
eInǒqHPdVUbCǒàǔǎWqJfYfSgEèòdDYjhWòICTò	FALSE
hákSúqtcxjSpalbMvkdkrLzúzpeCiǒnInóǔWpu	FALSE
kǎFcdáPSCiuǔPIJUǒBǎRdTnèSXúgTHJZàwlLe	FALSE
mdiSuámǎlltEowcnQǒùCMdVGǎTápogǎAùhofOs	FALSE
pRKǒatlBdbòClYǎYMfAVèùuFFDPmQCTplmkCT	FALSE
rgcyJàJzǒvùǒSpwǔTAmóoyǒKUrěéaWQǎǒSbDzv	FALSE
uKSDèdàùMDnbfhZhFáeòWiweDèěItWdùDxhNá	FALSE
wWyTgnUòòxdlRǔaSnxǎjqdpzPKkǎDqsHiVjBP	FALSE
ùùrmAóffǔkGNnACPùaolAéNěAwGxYèMNSMYfdF	TRUE
áláKúkDKúfxòXLGLAjǒùPFbpWóPEǒuǒldEgaNe	TRUE
éǎeLamNYWávqVZNmKLkùJèFWAYZàxEgCKYMHhH	TRUE
ěDEoUútMvZywǎjPlQMǔTǎYHYBMeEMiǎVdiUùfx	TRUE
òyAKnyYKZábXwbecFyImmlDkvtHyèWozdBjAZc	TRUE
AóbNèqGznKábQcjgIúiePòsǎaqZqMLǔwDjǎSlè	TRUE
CdUrúDPǒùBCDXsZEúBjswNELàDěhLlKèǎcQIni	TRUE
FpohunQlQTzlúrNaǔSwNgoCneOwAgqdjEPààWg	TRUE
IFPnHOCzPwlVkDMIGPqagTCRnWKJwhdeGFYéNk	TRUE
KYWKLědMtFOAùnuHiǎZBjǔfvǔǎǎbBiàélxYzfp	TRUE
NèqiéěkOCYéMěXgqédJkRYDOǒhqzMDwylFObXé	TRUE
QǒZZxqaúGWUyaDfZlLsPIigfǒpUjvquXkCeoYè	TRUE
SQKvéYINhóǎKvǔOdRòBQhNswseYCyòonùǒólZZ	TRUE
UelpCFdPSǎěYgvjkUòxUQaóSpGXEJzIròSqLoU	TRUE
XKtYyPdMbUHěAkúmǔáǒsbokSéámIjMgWvwvàtw	TRUE
ZXoUgáúCkèóAYǔòhMěbaHuXKsIKǎyzcsHDtióF	TRUE
cǒzáSrǔáhNFYJXVjǎǒaqkYIdsòhFlmYJQAuNpS	TRUE
eYeóàfVpcASqMDLjMOèsóǔáRòHSǒgéèOXLduiG	TRUE
gsáPFáéZcdWsHtWóxvYPjnlJvǎltgóMsǔZvòBt	TRUE
jbYCZàtàyxlUJLBJKóúEèHsTbkPBvuěXKúUVKx	TRUE
mdLYóYcABéeCóhPèajàrUTěNjWBéaùtxShXvoǔ	TRUE
pyěZWXHǔěYhfudàubáDUxxuIHSKVFěRxxAQIDG	TRUE
sERǎéHěkSPRhxAòtǒDbYgSCéuUDHóJVéǒYvQlú	TRUE
uUpQeprágqǎLUPsóWUǒTǎǎuQnIfWǒcFdǔcFQps	TRUE
xApVdoZKkmwtórZDMcIFkvmTlirozfbékfVZMt	TRUE
ùùrmAóffǔkdNnACPùaolAéNěAwGxYèMNSMYfdF	FALSE
áláKúkDKúfxòXaGLAjǒùPFbpWóPEǒuǒldEgaNe	FALSE
éǎeLambNYWávqVZNmKLkùJèFWAYZàxEgCKYMHhH	FALSE
ěDEoUútMvZywǎjPlQMǔTǎYHYBMedEMiǎVdiUùfx	FALSE
òyAKnyYKdZábXwbecFyImmlDkvtHyèWozdBjAZc	FALSE
AóbNèqGznKábQcjgIúiePòsǎaqZqMLǔwDjǎbSlè	FALSE
CdUrúDPǒùBCDXsZEúBjswNdLàDěhLlKèǎcQIni	FALSE
FpohunQlQTzlúrNaǔbwNgoCneOwAgqdjEPààWg	FALSE
IFPnHOCzPwlVkDMIGPqagTbCRnWKJwhdeGFYéNk	FALSE
KYWKLědMtFOAùnuHiǎZBjǔfvaǔǎǎbBiàélxYzfp	FALSE
aèqiéěkOCYéMěXgqédJkRYDOǒhqzMDwylFObXé	FALSE
QǒZZxqaúGWUyaDfZlLsPIigfǒpUjvbquXkCeoYè	FALSE
SQKvéYINhóǎKdvǔOdRòBQhNswseYCyòonùǒólZZ	FALSE
UelpCFdPSǎěYgvjkUòxUQaóSpGXEJzIbròSqLoU	FALSE
XKtYyPddMbUHěAkúmǔáǒsbokSéámIjMgWvwvàtw	FALSE
ZXoUgáúCkèóAYǔòhMěbaHuXKsIKǎyzcsHDtibF	FALSE
cǒzáSrǔáhNFYJXVjǎǒaqkYIdsòhblmYJQAuNpS	FALSE
eYeóàfVpcdASqMDLjMOèsóǔáRòHSǒgéèOXLduiG	FALSE
gsáPFáéZcdWsHtWóxvYPjnlJvǎltgóMsǔZdòBt	FALSE
jbYCZaàtàyxlUJLBJKóúEèHsTbkPBvuěXKúUVKx	FALSE
mdLYóYcABéeCóhPèajàbUTěNjWBéaùtxShXvoǔ	FALSE
pyěZWXHǔěYhfudàubáDUxxuIHSKVFědRxxAQIDG	FALSE
asERǎéHěkSPRhxAòtǒDbYgSCéuUDHóJVéǒYvQlú	FALSE
uUdpQeprágqǎLUPsóWUǒTǎǎuQnIfWǒcFdǔcFQps	FALSE
xApVdoZakmwtórZDMcIFkvmTlirozfbékfVZMt	FALSE
ùǔUófnScbòlWǒYǒNjétSCOfGloTtJGSkvErétLj	TRUE
ándchdhPqzyùRǒòècPNpypDCdgǎòZIOgqVúvzlG	TRUE
éBiqEǔiVGPuúwBǔcZagxXIJùáodUvQDzNeǒjonw	TRUE
ěWOaWvaRakzfàòdODZhaèHeLtèxhJrhàcàeiTwH	TRUE
ǒkpnqARWqAǔZGóqcòdQjKrHUCVUdBrvGhwcdeSr	TRUE
BòqxdzuDsCPmZèěFnhLHDxSxOYPJMkJèàMxlhgy	TRUE
DkDAaKjAwvzwpBahEěFWqBAxéMófGNázJiWqmiL	TRUE
GHKhMUOCjúóRdjbLNNUFyMFFYjvXtjǒYbájDVLá	TRUE
IuǒùVnKǔggpbǒSjtǔBleAdkwaPdDTCbxasZWéis	TRUE
LjHOpXqmynúuCXiBlhnhàbTiMFMdUIHěVDWùQjb	TRUE
OùBklwéúiEnytóEéALnexIdAGPUouLrCCNMIòRa	TRUE
QXwKsPkxǔmǔqòheXVúOWMffFSfóùMbqdEQEágnF	TRUE
SomTHùbHǎChhUrGRdEjHǔxeXkEfúèèsFoAállOC	TRUE
VOěXQlfstOTNuòhgblhWoRgVaMávǔdlàfzaúYvM	TRUE
YǔcUrxèYoxjMfkǎCYEjYSjBJIYtblóàBDsùUYGó	TRUE
aTSSwpNnqMDěáoVǎgǔlQFCUjtáLěBTecsTkuAaD	TRUE
dBVCéLDèjFPùiWuaVTSGYqTCěòmpoRRSppoeèél	TRUE
fQyǒTceKdǔBDfzrěEHvLkèUwPRayygfàUjèENUU	TRUE
iKLlóqGmzisiOjQiAUPOXFOBBDFmùbryJcpzYǔs	TRUE
khEgLCóPOXóXMèǎwjuuGěpyPàRxǒgyAǒEbrDGèK	TRUE
nFěwǔúxZǒLfǎBáǔrvdUásvoTCswǎěòwjvpSODúI	TRUE
qBOǒYjimwEpCSjMwtéTqògRàpCyJJéUGbXělduM	TRUE
sMèfúpdSkùWuWHiCswKvǎVZaáSfAJyèxfùláaDǎ	TRUE
vóHegAWmǎBònùbaDaqzjMyúǔXSésfXQùfJkXHǒM	TRUE
xXuzIXqxCknfWflSVnZǎěYzZTènèfOnBGkdueto	TRUE
ùǔUófnSabòlWǒYǒNjétSCOfGloTtJGSkvErétLj	FALSE
ándchdhPqzyùRǒòèrPNpypDCdgǎòZIOgqVúvzlG	FALSE
éBiqEǔiVGPuúwBǔcZagxXIJùáodUvQDzNeǒbjonw	FALSE
ěWOaWvaRakzfàòdODZhaèHeLtèxhJrhàcàeiTwb	FALSE
ǒkpnqARWqAǔZGóqèòdQjKrHUCVUdBrvGhwcdeSr	FALSE
BòqxdzdDsCPmZèěFnhLHDxSxOYPJMkJèàMxlhgy	FALSE
DkDAabKjAwvzwpBahEěFWqBAxéMófGNázJiWqmiL	FALSE
GHKhMUOCjúóRdjbLNNUFyMFFYjvXtjǒdbájDVLá	FALSE
IuǒùVnKǔggpbǒSjtǔBleAdkwHPdDTCbxasZWéis	FALSE
LjHOpXqmynúuCXiBlhnhàbTiMFMdUIHěaVDWùQjb	FALSE
OùBklwéúiEnytódEéALnexIdAGPUouLrCCNMIòRa	FALSE
QaXwKsPkxǔmǔqòheXVúOWMffFSfóùMbqdEQEágnF	FALSE
SomTHùbHǎChhUrGRdEjHǔxeXkEfúèèsFdAállOC	FALSE
VOěXdlfstOTNuòhgblhWoRgVaMávǔdlàfzaúYvM	FALSE
YǔcUrxèYoxjMfkǎCYEjYaSjBJIYtblóàBDsùUYGó	FALSE
aTSSwpNnqMDěáoVǎgǔlQFCUjtáLěBTecsTkubaD	FALSE
dBVCéLDèjFPùiWuaVTSGYqTCěòmpdRRSppoeèél	FALSE
fQyǒTceKdǔBDfzrěEHvLkèUwPRayygfàbjèENUU	FALSE
iKLlóqGazisiOjQiAUPOXFOBBDFmùbryJcpzYǔs	FALSE
khEgLCóPOXóXMèǎwjuuGěpayPàRxǒgyAǒEbrDGèK	FALSE
nFěwǔúxZǒLfǎBáǔrvdUásvoTCswdǎěòwjvpSODúI	FALSE
qBOǒYjimwEpCSjMwtéTqògRdpCyJJéUGbXělduM	FALSE
sMèfúpdSkùWuWHiCswKvǎVZaáSbfAJyèxfùláaDǎ	FALSE
vóHegAaWmǎBònùbaDaqzjMyúǔXSésfXQùfJkXHǒM	FALSE
dxXuzIXqxCknfWflSVnZǎěYzZTènèfOnBGkdueto	FALSE
ùèKftHRdrkbscSKCUěTkokoGǎRAcnquJúKEóxhmb	TRUE
áYbèvèIJCHGoOTdMàoǎjOmNOwwfǎmkIseLCFoRiI	TRUE
éózAgGáoGSlaSsjAXAJùkLFBLdpàFwiiAùěMlMlZ	TRUE
óàNlúPbgzaáǒffúcěRoxúiXJwBěvEěàéóěèéFzln	TRUE
ǒeòUFkCkáàCQaùúJdYJssMǎcZenhDGiCěfSrBFèU	TRUE
BTUcLǔvèteqSThJdyKuutwhYmIhóQVpWèaFqzqóV	TRUE
DfMitHúheOnèWLáPVYJBndUiDgKZéěvéGjQkRCFb	TRUE
GJǎDwatěRptofXfIpédúNHòIJǒfazTJNǎQéNGDUh	TRUE
JàSOjciuAqYmRléIpsǒdXěúVúZVfNvSóbqeǎaWBB	TRUE
LqFěkáWPVDmWpùYcSHQPèdsǒcxLzdJyGNrvMAǎNf	TRUE
OǔBómAáYWcDURónjCdǔàsùxLKhFmóTFbLjAWéXéV	TRUE
QaOúyCaVèfkNUYCdypèATrHǎZasàkǔMSBZfěàHěQ	TRUE
TápòvGHèdVéybnUúòNEeDqISOCNSlǔNhrXUúxFfx	TRUE
VQZslóWòTLEvúàfHdCSeVùzúGLUGaSUNcàCEuúYc	TRUE
XzmVjǎnedNóiEcǒWEQgAYCěDǎòvghàOrèTěcEEàk	TRUE
aMkóFqNSéájSWFAYézlMsVHòéòoIVUWDBMfòWǎEH	TRUE
ccVǒslScèHòǒjǔNIvXpicHǎsprUlbMsUQFvmzgàD	TRUE
fNPMuǎláQúlErNǒqaoZuYCNYoDLǔwCKnCNpvàgXD	TRUE
iFùáCuazWwQOǎnérEdUpMWOUqpwVguoěǒǒTòsGǎN	TRUE
ktBjkRxěAYhxjnHWjZàpáóěOKOFaáhjLvuAǔǒyrB	TRUE
nSděznECòólHXiTtpQùǎkekDAyGDòózrkPfFnèFJ	TRUE
pkrBlcdndAeéAHmclknúóéYdDTèosQpqpiǎpǒCRJ	TRUE
sCQihbèǒòTKXfiKvpòxAFsJlDáSéUCǔBoAgPDIib	TRUE
uoGoKLàilPQinEcJtFLeobVVúéboGRǎrSàxMXpkó	TRUE
xSjùYCLkLjǎeǔSXnKdKǎySFxvLSJLmvVmùzvùǎwy	TRUE
ùèKftHRdrkbscSKCUěTkokoGǎRAcnduJúKEóxhmb	FALSE
áYbèvèIJdHGoOTdMàoǎjOmNOwwfǎmkIseLCFoRiI	FALSE
éózAgGáoGSlaSsjAXAJùkLFBLdpàFwiiAùěMlMdlZ	FALSE
óàNlúPbgzaáǒffúcěRoxúiXJwBěvEěàéóěèébFzln	FALSE
ǒeòUFkCkáàCQaùúJdYJssMǎcZenhdGiCěfSrBFèU	FALSE
BTUcLǔvèteqSThJdyKuutwhYmIhóQVpWèaFdqzqóV	FALSE
DfMitHúheOnèWLáPVYJBndUiDdKZéěvéGjQkRCFb	FALSE
GJǎDwdatěRptofXfIpédúNHòIJǒfazTJNǎQéNGDUh	FALSE
JàSOjciuAqYmRléIdsǒdXěúVúZVfNvSóbqeǎaWBB	FALSE
LqFěkáWPVDmWpùYcSHQPèdsǒyxLzdJyGNrvMAǎNf	FALSE
OǔBómAáYWcDURónjCdǔàsùxLKhFmóTFbLjAWéXdV	FALSE
QaOúyCaVèfkNUYCdypèATrHǎZasàkbǔMSBZfěàHěQ	FALSE
TádòvGHèdVéybnUúòNEeDqISOCNSlǔNhrXUúxFfx	FALSE
VQZdslóWòTLEvúàfHdCSeVùzúGLUGaSUNcàCEuúYc	FALSE
XzmVjǎnedNóiEcǒWEdgAYCěDǎòvghàOrèTěcEEàk	FALSE
aMkóFqNSéájSWFAYézlMsVHbòéòoIVUWDBMfòWǎEH	FALSE
ccVǒslScèHòǒjǔNIvaXpicHǎsprUlbMsUQFvmzgàD	FALSE
fNPMuǎláQúlErNǒqaoZuYCNYoDLǔwCKnCNbpvàgXD	FALSE
iFùáCuazWwQOǎnérEdUpMWOUqpwVguoěǒǒTòsbǎN	FALSE
ktBjkRxěAYhxjnHWjZàpáóěOKOFaáhjLvbAǔǒyrB	FALSE
nSděznECòólHXiTtpQùǎkekDAyGDòózrkPfFndFJ	FALSE
pkrBlcdndAeéAHmlknúóéYdDTèosQpqpiǎpǒCRJ	FALSE
sCQihbèǒòTKXfaiKvpòxAFsJlDáSéUCǔBoAgPDIib	FALSE
uoGoKLàiaPQinEcJtFLeobVVúéboGRǎrSàxMXpkó	FALSE
xSjùdCLkLjǎeǔSXnKdKǎySFxvLSJLmvVmùzvùǎwy	FALSE
ùéblùhTnetòIDlBgrbbxwkHVdluóáDǔJèWtaIEèMá	TRUE
ábhDxràTǔtùǔtUhHPWǔǒHRPuoǒICvXZCoEhxtěbyd	TRUE
éèpDobSfJyPMTjàúIǔJdgSunJětùSDvlásáéHògLz	TRUE
ěDxaZúhéaekmOLsǔppDjTSarDZytiěoaiuéfóQǒoD	TRUE
òVsVEěJyòxAvUYHUXmJáqdYZoOMKèyLǔJsXWáqYwJ	TRUE
ARmRocèshǎrJhpKYdnXHtěáRticúXzfBCrXpZYǎRb	TRUE
CamxEiTòěGWfngqèwWqBǒhTitFONUrǎGMémJhyePV	TRUE
FòóvWězBfJmLSěèFECyGYrebàANuPrGLLbsdbGgFT	TRUE
IǒékXYndRZxgRjuémqXRWnEǒóVǔObYbKHǔlAfóWks	TRUE
LǎěHòwwfǎCòYukSaEàyTJRhwgsAOgDoefHúdiaéhY	TRUE
OàLmMpigdXLQcVRjPětZiYFavHúěVgQOǒQTHcYkùi	TRUE
QKBmEbqvSèYSTwfYTààOtcmXèaauǎYFqTwvnMGkxj	TRUE
SasCéiaWTǒfOuQpCMnóIěAèlxxjBFftNHěoXKnBzc	TRUE
VUcaLéeépFSNpMmEǔelwPěhěDOòoPFdGcǎUòKùQKé	TRUE
YúiSoǎkúXIbAAzálSDuaúAAsCǎLWǒSàdBByyMgWym	TRUE
aKǔǎxOóoǒqzSǎéBleOǔMdImokSCIXwROASuYGòEog	TRUE
ciZMěéaHNjRZUHwMdpgultéEpkGAnmNCIBjúHinRr	TRUE
fcuBoTǒaIOiěuǎkdcvùsrzdyiǎQbXòpRkUYMXJXRV	TRUE
iXLIjdSznmGbǔDpwRwnhNafSlUKipOMJMvAXNùpèr	TRUE
ksěviùiTkGXZjàUbúymFIgùáFMLóMCOKJzztdeIYu	TRUE
nèwsZLZBqòclDSnLhéHeaiéveqázTRQxCBHsIieùǔ	TRUE
pseèNmFQthágEécvKxCqxZùgùǔQubWzjéPTjiYèhK	TRUE
sYhNTóYtóeùùhrjlXWěsRPǔpěbHdóurIsMóOǒAVeó	TRUE
vBYDstcrǔMJúetpǔQMMESwhǎQwǔyagXòHhnPWuMTK	TRUE
xYóAwmKZZGaKlFvètmrVtxFLOAcnuraúBDqhVVcMe	TRUE
ùéblùhTnetòIDlBgrbbxwkHVdldóáDǔJèWtaIEèMá	FALSE
ábhDxràTǔtùǔtUhHPWǔǒHRPuoǒICvXZCdEhxtěbyd	FALSE
éèpDodSfJyPMTjàúIǔJdgSunJětùSDvlásáéHògLz	FALSE
ěDxaZúhéaebkmOLsǔppDjTSarDZytiěoaiuéfóQǒoD	FALSE
dVsVEěJyòxAvUYHUXmJáqdYZoOMKèyLǔJsXWáqYwJ	FALSE
ARmRocèshǎrJhpKYdnXatěáRticúXzfBCrXpZYǎRb	FALSE
CamxEiTòěGWfbgqèwWqBǒhTitFONUrǎGMémJhyePV	FALSE
FòóvWězBfJmLSdèFECyGYrebàANuPrGLLbsdbGgFT	FALSE
IǒékXYndRZxgRjuémqaRWnEǒóVǔObYbKHǔlAfóWks	FALSE
LǎěHòwwfǎCòYukSaEàyTJRhwgsAOgDoebfHúdiaéhY	FALSE
OàLmMpigdXLQcVRjPětZiYFavHúěVgQOǒQdHcYkùi	FALSE
QKBmEbqvSèYSTwfYTààOtcmXèaauǎYFqbwvnMGkxj	FALSE
SasCéiaWbǒfOuQpCMnóIěAèlxxjBFftNHěoXKnBzc	FALSE
VUcaLéeépFSNpMmEǔelwPěhěDOdòoPFdGcǎUòKùQKé	FALSE
YúiSoǎkúXIbAAzálSDuaúAAsCǎLWǒSàdBByydMgWym	FALSE
dKǔǎxOóoǒqzSǎéBleOǔMdImokSCIXwROASuYGòEog	FALSE
ciZMěéaHNjRZUHdMdpgultéEpkGAnmNCIBjúHinRr	FALSE
fcuBoTǒaIOiěuǎkvcvùsrzdyiǎQbXòpRkUYMXJXRV	FALSE
iXLIjdSznmGbǔDpwRwnhNafSlUKipOdJMvAXNùpèr	FALSE
ksěviùiTkGXZjàUbúymFIgùáFMLóMCOKdJzztdeIYu	FALSE
nèwsZLZBqòclDSnLhéHeaibéveqázTRQxCBHsIieùǔ	FALSE
pseèNmFQthaágEécvKxCqxZùgùǔQubWzjéPTjiYèhK	FALSE
sYhNTdóYtóeùùhrjlXWěsRPǔpěbHdóurIsMóOǒAVeó	FALSE
vBYDstcrǔMJúetpǔQMMESwhǎQwǔyagXbHhnPWuMTK	FALSE
xYóAwmKZZGaKlFvètmrVtxFLOAbnuraúBDqhVVcMe	FALSE
ùùCiHhùrcCǔfrPloaáǎRsvKxHZaKǒiKkWxuprBadòQ	TRUE
áUoNERpǎeóaDLGhoǔFsTwmXòQwǎmkCgǎDwěppGEsoW	TRUE
ǎarURoóewipWlPdmWòTqAuLǒàmTYPHLúzPpHELáNwr	TRUE
ěiǒTSbdrTbDGZěúǎqtěaòhaLZztpVěegeVèGtáqǎhǎ	TRUE
ǒEWvǎěfjSUsObmmCsèsSiCPZDPVoòBWKvtKKlLCàsS	TRUE
BǔornDuXáRàwbsǎHpEBéLCsěriFxcùDLMQSYuVěebG	TRUE
DCéFDFùnǒpHImAùtnàIǎAObUjǎMalCùWqvǎsxlBojT	TRUE
FtúQkbèaUòáZydWóvgMdZKbúAmLVCqáIaěbekZǒPèL	TRUE
IǎRúǔěXZnkeòulèSDeKtǒqYòqjǒdfùhNeǎjàWóvHAǎ	TRUE
KxǎàOSzSpQrxAuosqXcEjǔǒdjkyUNkuSpWzzfukNax	TRUE
NXdiàáPihòPùxsYBélùlùNmYNtYěFfNTXqxkWOMGtB	TRUE
QLLcGZeGǎnhpqYIáráǎfsZjDVQJbURLgSknBáWUFeb	TRUE
SdrMcJòRLbiàfǎClZPwǎràBLBJpAupDeúěScbutIRǒ	TRUE
VBéridaóáùFcǒKLrgKvjgúmtéCuHwrǒRěwMFhVOnǒg	TRUE
XgUURliCLóótúmNǎcTéèúbdáhCItréqgMaZvLgfNéO	TRUE
aRavYnrUuamaesámùóYèóSHfWoQúVBXIpVSáNzǔùtM	TRUE
cxENYYMéitxǎXeèJTUyFGQBInòshKwHgǔvbtOóYCAL	TRUE
fHéIJMyZCYeVlBùTaQGèUZNpqLSfgtVGZsúlLtWDTg	TRUE
iùyCèNdUPótxBǎòòlXbYKnFǒRqNHNèǎyKUTjFJMěǔT	TRUE
kPBxYAqzICóǎujBecMsoiryNèoáVBǎZbeAidbwǎùHH	TRUE
mcOmzEzmypOòfKjBVpxǎlkeěsdhphéNnjQfWZhǒkxl	TRUE
pǔtbòRǒwLǎjMxwěIbkEHeqóDbòmáMEdOǔáDbpPGshj	TRUE
reBDǒrSǔjLgnxMHweClKsqxpvǔQbtXNXdGǒUmFfGgH	TRUE
uéBOFěXFhKJsFUlgWVViNoùBTàkmkdajLgVQúyEǒux	TRUE
xǔMRóEOyqMKBzMUvúgiWúVeóǔMUuǒWitnóQNRebROX	TRUE
ùùCiHhùrcCǔfrPloaáǎRsvKxHZaKǒiKkWxuprBaddQ	FALSE
áUoNERpǎeóaDLGhoǔFsTwmXòbwǎmkCgǎDwěppGEsoW	FALSE
ǎarURoódwipWlPdmWòTqAuLǒàmTYPHLúzPpHELáNwr	FALSE
ěiǒTSbdrTbDGZěúǎqtěaòhaLZztpVěegbeVèGtáqǎhǎ	FALSE
ǒEWvǎěfjSUsabmmCsèsSiCPZDPVoòBWKvtKKlLCàsS	FALSE
BǔornDuXáRàwbsǎHpEBéLCsěriFxcaDLMQSYuVěebG	FALSE
DCéFDFùnǒpHImAùtnàIaǎAObUjǎMalCùWqvǎsxlBojT	FALSE
FtúQkeèaUòáZydWóvgMdZKbúAmLVCqáIaěbekZǒPèL	FALSE
IǎRúǔědZnkeòulèSDeKtǒqYòqjǒdfùhNeǎjàWóvHAǎ	FALSE
KxǎàdOSzSpQrxAuosqXcEjǔǒdjkyUNkuSpWzzfukNax	FALSE
NXdiàáPihòPùxsYBélùdùNmYNtYěFfNTXqxkWOMGtB	FALSE
QLLcGZeGǎnhpqYIaráǎfsZjDVQJbURLgSknBáWUFeb	FALSE
adrMcJòRLbiàfǎClZPwǎràBLBJpAupDeúěScbutIRǒ	FALSE
VBéridaóáùFcǒKLrgKvjgúmtédCuHwrǒRěwMFhVOnǒg	FALSE
XgUURliCLóótúmNǎcTédúbdáhCItréqgMaZvLgfNéO	FALSE
aRavYnrUuamaesámùóYèóSHfWbQúVBXIpVSáNzǔùtM	FALSE
cxaNYYMéitxǎXeèJTUyFGQBInòshKwHgǔvbtOóYCAL	FALSE
fHéIJMyZCYeVlBùTaQGèUZbNpqLSfgtVGZsúlLtWDTg	FALSE
iùyCèNdUPótxBǎòòlXbYKnFǒRqNHNèǎyKUTjFJMděǔT	FALSE
kPBxYAqzICóǎajBecMsoiryNèoáVBǎZbeAidbwǎùHH	FALSE
mcOmzEzmypOòfKjBVpxǎlkeěsdhphédnjQfWZhǒkxl	FALSE
pǔtbòRǒwLdjMxwěIbkEHeqóDbòmáMEdOǔáDbpPGshj	FALSE
reBDǒrSǔjLgnxMHweClKsqxpvǔQbtXNXddGǒUmFfGgH	FALSE
uéBOFěXFhKJsFUlgWVViNoùBTàkmkdajLgVQúyEǒudx	FALSE
xǔMRóEOyqMKBzMUvúgiaúVeóǔMUuǒWitnóQNRebROX	FALSE
ùǎFéěAúTruSeZòòslKAEiZàeXWàffVRTbèhglfljèdò	TRUE
áeOLHkòVZbwQmòfqGfàùdéEgKsǎlCěòǒǔJěCXGǔIcàr	TRUE
éBcZOitiZcXjǎDùgLACTuùkHbmxběkRkdAěógHgAyOw	TRUE
ějgFlMFkUtǒcUyDégWmúUWPHXsJUjMzpciKkGěTAdqN	TRUE
ǒUOǎshóaǎěYjxBEzUJQrEéFaisxYofRhèǒóFóqòQkèr	TRUE
BESkSéFbNNNoUdkFBfǔTvZǎgWtCèZPùnIbùckNSBpóR	TRUE
DfKtrGTkwáKéQmqQdúòkJoGDQáxybKlBzáwHCAeVsBK	TRUE
GláumasMTPriiǒòVlAYóZvlǎcLàéPHPěláuYkWdùwUě	TRUE
ImFHEěLypsCCSlirèàYǔénQùskǒPExWqudhctPFkoòX	TRUE
LPxbXRAàIàIǔfZàPSXòUòrBvLnjjQjRBiqnfiàcdhPD	TRUE
NtrěIRrVázùǒèQǎikaǔóéEeDNWAěaTuyBIǒslrěqzaP	TRUE
QdnPyáwwaúTTroFElúteCùZěvIXOSvúBHlánhfépprá	TRUE
TdùPAXkúFRozFǔswBNDFsúóěpowótSǎèNLHSUISHitv	TRUE
VtuGizDúCǒIEJDZéòCKcAǔǔfáǒóóYdGcruaXǎjvjòZv	TRUE
YEXAgàjéCCDóocTéWTuěWRZkǔtǒàáAóaǎuKpTSènRYx	TRUE
adaǒěòwEěèxFMDzàBiZroxntkúEyxóúTYzKEǒyIRFko	TRUE
dMǒgKàIEèVizjVeJJTCǒèQbzXXhnnMúWcVfǔqbùxtéà	TRUE
góSeǎǔóǎHwQNqgdiěSyóǒǔOIUeiArzwCòpKéHelFbDò	TRUE
idǒsQWqCPùQBcYúHtVěDItóòtDyVtGqjssyèOTynLDR	TRUE
kvLGjdvXVMCUóàBLNTWxEéáefXiOǒKbòppvkgikfNjQ	TRUE
núCLNRnǎáǎhbègáeIúeaOklGàyBwéMqiXDuVUKIJWym	TRUE
pYrhvhuQXUǎWKMǒhZEběJOAAEgBětfǔèVǒpSágeZwèE	TRUE
sàabwARěvedǒòOWedòmIJnùlpvAcóhgbHObóEvRjckO	TRUE
uuvěùLvrEegiQyMpYCzbòXwúěteùùalOQjúéécxduǔx	TRUE
xOmayááRiySjǎBKOtYéXYWpǔSoYèlWqéCěèuKàAǒrkh	TRUE
ùǎFéěAúTruSeZdòòslKAEiZàeXWàffVRTbèhglfljèdò	FALSE
áeOLdkòVZbwQmòfqGfàùdéEgKsǎlCěòǒǔJěCXGǔIcàr	FALSE
éBcZOitiZcdXjǎDùgLACTuùkHbmxběkRkdAěógHgAyOw	FALSE
ědgFlMFkUtǒcUyDégWmúUWPHXsJUjMzpciKkGěTAdqN	FALSE
ǒUOǎshóaǎběYjxBEzUJQrEéFaisxYofRhèǒóFóqòQkèr	FALSE
BESkSéFbNNNoUdkFBfǔTvZǎgWtCèZPùnIbdùckNSBpóR	FALSE
DfKtrGTkwáKéQmqQdúòkJoGDQáxydKlBzáwHCAeVsBK	FALSE
GláumasMTPriiǒòVlAYóZvlǎcLàéPHPěláudYkWdùwUě	FALSE
ImFHEěLypsCCSlirèàYǔénQùdkǒPExWqudhctPFkoòX	FALSE
LPxbXRAàIàIǔfZàPSXòUòrBvLnjjQjdRBiqnfiàcdhPD	FALSE
NtrěIRrVázùǒèQǎikaǔóéEeDNWAěaTuyBIǒslrěqbzaP	FALSE
QdnPyáwwaúTTroFElútbCùZěvIXOSvúBHlánhfépprá	FALSE
TdùdAXkúFRozFǔswBNDFsúóěpowótSǎèNLHSUISHitv	FALSE
VtuGizDúCǒIEJDdéòCKcAǔǔfáǒóóYdGcruaXǎjvjòZv	FALSE
YEXAgàjéCCDóocTéWTuěWRZkǔtǒàáAóaǎuKpTSbènRYx	FALSE
adaǒěòwEěèxFMDzàdBiZroxntkúEyxóúTYzKEǒyIRFko	FALSE
dMǒgKàIEèVizdVeJJTCǒèQbzXXhnnMúWcVfǔqbùxtéà	FALSE
góSeǎǔóǎHwQNqgdiěSyóǒǔOIUeiArzwCòpdéHelFbDò	FALSE
idǒsQWqCdùQBcYúHtVěDItóòtDyVtGqjssyèOTynLDR	FALSE
kvLGjdvXVMCUódBLNTWxEéáefXiOǒKbòppvkgikfNjQ	FALSE
núCLNRnǎáǎhbègáeIúeaOklGàyBwbMqiXDuVUKIJWym	FALSE
pYrhvhuaXUǎWKMǒhZEběJOAAEgBětfǔèVǒpSágeZwèE	FALSE
sàabwARěvedǒòOWedòmIJnùlpvAaóhgbHObóEvRjckO	FALSE
uuvěùLvrEegiQyMpYCzbòXwúěteùùalbOQjúéécxduǔx	FALSE
xOmayááRiySjǎBKOtYéXYWpǔSoYèlbWqéCěèuKàAǒrkh	FALSE
ùùfùqYgdáúCǔKMyvKqiSDzrèámSQlHǒúZQDvZrnǔLhóU	TRUE
áeábLZéILrǒeNatVsNmuhuěSOdjIǒmoymwMYóùKxoEQV	TRUE
éáálǒFvNNkqmMWpJfúRkUNfLoùbGqKàéHùfsUùòxMBaǔ	TRUE
ěRuOqSfIEǎáGhFòCúSqNlJjBúWàZfùrSHdlJuGWǎChQa	TRUE
òeiògOeJnéHrqFBPlùwWgjTVGjVvVWBDuéBábàélòEúW	TRUE
ABBCbcórLeSOáFZùyáPmápZXOtàAUiOwlRWSaYZRkcló	TRUE
CaǔIèǒgěkcrúzsQjnvcmJMòéScfójzcòIáAokFUkcúCx	TRUE
FáRMHGouxúKidGvqFAoPelDrqòvCxeeúuBWKeHseǔǒXb	TRUE
HRǔFceiǎMqYAerkùqcbjLXmrldòwYilsěBHMbWSDXsHA	TRUE
JtYèǒRWmǎwéhěAlpdgǒRaáPékiiLéSFàRGéRhMiǔguaX	TRUE
MyúSQRpnzbSHpNqqgWWlqgúniWǎgdCQqǎCCWOgzǔwEJě	TRUE
PeeJzxQáOSěòuoxiXězúǎGúéPuJUùiBdJbèNHFhIRotf	TRUE
STUaBotiNLGNSùgyOeoJoXPGBGJGVèòXPdQwòúeFùgòǒ	TRUE
VMdósejcétmZAXjeqaátRSLéUélkJáxeěYcJòTǎikmaw	TRUE
XtMèckóFùáǎdBksépúcjxtlTpewòèEkuGeǒFJbFZYorQ	TRUE
aYàuAEeHfKYSRGCúsvrxTerKMLvRǎǎezNYPTacǎéěYUZ	TRUE
cuéCdthmeaéDuPéBEqEkJǎèptnJEóòòoMZiHtfRúsVWI	TRUE
fdJòPùqtHYJSyiAQLǔAUuiYǔinnEyxQòcWZhoàbbwàěá	TRUE
iòOlGzzdxKúGǒJTlǎXQYexlfòokěWǎǒBǔRyFjwxVAFmk	TRUE
kyǎZHUYAděVpIóZaNQwTúihGmYyOXzǔǎfrpsYqewoAgY	TRUE
něèdtǔjGaIǒBphGXněAvhskǒSFqèùHGǔQaFgPkXǔRclt	TRUE
pMpyFúbèjnHKKXMbDuJqiaLJZúKǒmiIDLtfsQJpoLeOq	TRUE
sǒvéXoljFKuéWXxwOibzeleofxOsEMxtǒzFǎjrtPDXBK	TRUE
uZGIXvslWúZtAgvygSniJASěXrbYcúSHùóóEěbAlauJe	TRUE
xúòRQnQnKEztzàYqtApzRojxèqerMróXdjomghIloZQM	TRUE
ùùfùqdYgdáúCǔKMyvKqiSDzrèámSQlHǒúZQDvZrnǔLhóU	FALSE
áeábLZéILrǒeNatVsNmudhuěSOdjIǒmoymwMYóùKxoEQV	FALSE
éáálǒFvNakqmMWpJfúRkUNfLoùbGqKàéHùfsUùòxMBaǔ	FALSE
ěRuOqSfIEǎáGhFòCúSqNlJjBúWàZfùrdHdlJuGWǎChQa	FALSE
òeiògOeaJnéHrqFBPlùwWgjTVGjVvVWBDuéBábàélòEúW	FALSE
AaBBCbcórLeSOáFZùyáPmápZXOtàAUiOwlRWSaYZRkcló	FALSE
CaǔIèǒgěkcrúbzsQjnvcmJMòéScfójzcòIáAokFUkcúCx	FALSE
FáRMHGouxúKidGvqFAoPelaDrqòvCxeeúuBWKeHseǔǒXb	FALSE
HRǔFceiǎMqYAerkùqcbjLXmrldòwdYilsěBHMbWSDXsHA	FALSE
JtYèǒRWmǎwéhěAlpdgǒRadáPékiiLéSFàRGéRhMiǔguaX	FALSE
MyúSQRpnzbSHpNqqgdWWlqgúniWǎgdCQqǎCCWOgzǔwEJě	FALSE
aPeeJzxQáOSěòuoxiXězúǎGúéPuJUùiBdJbèNHFhIRotf	FALSE
STUaBotiNLGNSùgyOeoJoXPGBGJGVèòXdPdQwòúeFùgòǒ	FALSE
VMdósejcétmZAXjeqaátRSLéUéldkJáxeěYcJòTǎikmaw	FALSE
XtMèckóFùáǎdBksépúajxtlTpewòèEkuGeǒFJbFZYorQ	FALSE
aYàuAEeHfKYSRGCúsvrxTerKMLvRǎǎezNbYPTacǎéěYUZ	FALSE
cuéCdthmeaéDuPéBEqEkJǎèptnJEdóòòoMZiHtfRúsVWI	FALSE
fdJòPdùqtHYJSyiAQLǔAUuiYǔinnEyxQòcWZhoàbbwàěá	FALSE
iòOlGzzdxKúGǒJTlǎXQYexlfòdokěWǎǒBǔRyFjwxVAFmk	FALSE
kyǎZHUYAděVpIóZaNQwTúihGmYyOXzǔǎfrpsYqewdAgY	FALSE
něèdtǔjGaIǒBphGXněAvbskǒSFqèùHGǔQaFgPkXǔRclt	FALSE
pMpyFúbèjnHKKXMbDuJqiaLJZbúKǒmiIDLtfsQJpoLeOq	FALSE
aǒvéXoljFKuéWXxwOibzeleofxOsEMxtǒzFǎjrtPDXBK	FALSE
uZGaIXvslWúZtAgvygSniJASěXrbYcúSHùóóEěbAlauJe	FALSE
xúòRQnQnKEztzàdqtApzRojxèqerMróXdjomghIloZQM	FALSE
ùùofwWgxwoZgzLfYXqMbobTdzTIaZEvNǔBmIqiGqsúxúù	TRUE
áOqùùǎoCqBQrZuFóàgěVwáBàhXbnUzáuGytbAVMùBàǔGw	TRUE
ǎeùeiàqukAKùXatQrèPffRWJeIetùOǒQHsuféaIXàLfGG	TRUE
ěfèjNFèyěxFXtùWsènUflRFèZǔVUcxAuQǒLǒZZlfJSèNd	TRUE
ǒQWyfIǒdNKmhmnrWèDKYRòNTlzNGbMtáAuGlAtCèIèTpC	TRUE
AsSásIpMIǒJDǒéktRJJmeFCplsQǎúmjQgFbauúIAoàctp	TRUE
DdHIjCAóbúèLóLTQOěmbqEaréZǔoolǔwXilùCCtùmWhEH	TRUE
GùXLXrzlybnuAàuǔwòlwOXTQDXúhUZqBaAluWòróOúfeá	TRUE
IPuGLWUtjěXScIRMwvěùcxláLDDMPsUáFféVmúdpkmyùe	TRUE
LUǔMUWTuIiRXbvCfSYNrqiùnèqTèǒDKMorZpXǒEbqHèJè	TRUE
OGBwHkWSgéwDAmAnjǒòhtiwpòrGjyIPxTǔAAEyYRdCPBy	TRUE
RáèEuKrpGETiéTcqbfCSxohúaIoJNnYaWqMaGTOfzkàBW	TRUE
TrNjOǎZnXcUóSuhqǔùwǒCěTXOǒodbunGLiqwiǔNPWBBOG	TRUE
WòBóòpIlHQEVpQnpúsxuKBtYNtRfkYSREáQóQCbrzóKaě	TRUE
YVUihǒǎuqxIyúAcUHXeéàPUqkdqěcǒRpntmXúLjYTgQTp	TRUE
aoùnpwǎPsǒryèQJoNǎRxǎǔNZiUdHBóZxBDYEYJPVJrUiu	TRUE
dJěStépPKtBùJúEZMRcQQtètrbYòzRDǔPUJwQxfjDWnhI	TRUE
foRWKwěMǎQácqvHùSlOthtVLykCEcjZWBKBbguyěLFubn	TRUE
iUSFoLFěFyvKnǎèeQdBǔLòèMAAěAǒHiàyJseXfùKhúsán	TRUE
lùINgXèùXXcRQfrhfhHóvǎMtkOyMdLZXǒigsmǔIWxéǎTo	TRUE
ncVépkYcacCéOXòyǒHMCYESeADynBkLftWFQùHprǒIǔdI	TRUE
qVěRlfGYKEePèéKǎBèMèustòdtqVǔeMièǔCEVzOwGXZym	TRUE
sxCgǔiWQYàǔQJILxKáǒàóstGjdoIyǔIlNHTěavfLZwtta	TRUE
vFSgRXěòZúubGCAéèAEgsóúakěiEmùvwyDéYàDQCtZùúT	TRUE
xnHBuyHjotqEFvDóaùqERBDBMXǔBpgZDmzòPuWderùǎLL	TRUE
ùdùofwWgxwoZgzLfYXqMbobTdzTIaZEvNǔBmIqiGqsúxúù	FALSE
áOqùùǎoCqBQrZuFóàgěVwáBàhXbaUzáuGytbAVMùBàǔGw	FALSE
ǎeùeiàqukAKùXatQrèPffRWJeIebtùOǒQHsuféaIXàLfGG	FALSE
ěfèjNFèyěxFXtùWsènUflRFèZǔVUcxAdQǒLǒZZlfJSèNd	FALSE
ǒQWyfdǒdNKmhmnrWèDKYRòNTlzNGbMtáAuGlAtCèIèTpC	FALSE
AsSásIpMIǒJDǒéktRJJmeFCplsQǎúmjQgFbaubIAoàctp	FALSE
DdHIjCAóbúèLóLTQOěmbqEaréZǔoolǔwXilùCCdtùmWhEH	FALSE
GùXLXrzlybnuAàuǔwòlwOXTQDXúhUZqBaAluWòrbóOúfeá	FALSE
IdPuGLWUtjěXScIRMwvěùcxláLDDMPsUáFféVmúdpkmyùe	FALSE
LUǔMUWTuIiRXbvCfSYNrqiùnèaqTèǒDKMorZpXǒEbqHèJè	FALSE
OGBwHkWSgéwDAmAnjǒòhtdiwpòrGjyIPxTǔAAEyYRdCPBy	FALSE
aRáèEuKrpGETiéTcqbfCSxohúaIoJNnYaWqMaGTOfzkàBW	FALSE
TrNjOǎZnXcUóSuhqǔùwǒCěTXOǒodbunGdLiqwiǔNPWBBOG	FALSE
WòBóòpIlHQEVpQnpúsxuKBatYNtRfkYSREáQóQCbrzóKaě	FALSE
YVdUihǒǎuqxIyúAcUHXeéàPUqkdqěcǒRpntmXúLjYTgQTp	FALSE
aoùnpbǎPsǒryèQJoNǎRxǎǔNZiUdHBóZxBDYEYJPVJrUiu	FALSE
dJěStépPKtBùJúEZMRcQQtètrbYòzRDǔPUJwQxfdjDWnhI	FALSE
foRWKwěMǎQácqvHùSlOthtVLykCEcjaZWBKBbguyěLFubn	FALSE
iUSFoLFěFyvKnǎèeQdBǔLòèMAAěAǒHidyJseXfùKhúsán	FALSE
ldùINgXèùXXcRQfrhfhHóvǎMtkOyMdLZXǒigsmǔIWxéǎTo	FALSE
ncVépkYcacCéOXòyǒHMCYESeAdynBkLftWFQùHprǒIǔdI	FALSE
qVěRlfGYKEePèéKǎBèMèustòdtqVǔeMièǔCEVzOwGdXZym	FALSE
sxCgǔiWQYàǔQJILxKáǒàódstGjdoIyǔIlNHTěavfLZwtta	FALSE
vFSgRXěòZúubGCAéèAEgsóúakěiEmùvwybDéYàDQCtZùúT	FALSE
xnHBuyHjotqEFvdDóaùqERBDBMXǔBpgZDmzòPuWderùǎLL	FALSE
ùùXpFKKOMLónpnuTárěOKtGJqvHQSWjúhúofRcXěóHbREp	TRUE
áixPjBvWUǎǒnvvGvEàlIboǒmeyHyYBFdvUWDNFobóbWěLg	TRUE
édǒCMeXzmSHXpcDèsěfJcURzéWhDMnpAvhiqégAtěYqoòY	TRUE
ófhàJqzùDKétjrcqǎZǒczrùhgNGXSnaQǔjvěGoULùSáepm	TRUE
úóYUóElùxoHcKVIGvezvSǔHráEErhHNXtǎLrtyVbtezLUm	TRUE
BrTàcerùdwròBhbkvPeZVoVxbeǔǒjqJVFIRJuYòùUGézAP	TRUE
EbsWQSLKèSMèIpLZqoprEwfeGbZǒrèqnEdOǒTMzwAěmǔnE	TRUE
GwnǔPNgèDVxGZeTvSGòPWzbBqESFQSShLilǎMDeědǔOOóG	TRUE
JGSYfysTmXúAHàěFaUBJkGáCzhcYVYdCIùZprLǔELKSGVǎ	TRUE
LyRMdéuǔBFvOcpLSéVWzNóSQTHUǔòàrEèéODolqnMUABTé	TRUE
OsUozURèLIfmvgèWPkoCIǎaFèypǒqoqzcǔwAǔdFQxèáSlO	TRUE
RfOugdzVzPéópHóBFXXxwuéYkspxkéqùHUarFRzQyTúlaT	TRUE
UUQdóZnnàUaóTglóaGwúéóázylùǔéIEkTngQcCZLKqmmrv	TRUE
WzHǒtHRwGslqjUFEjPlLwBCeGeBzVXPKJyFYEyLbvRMJVP	TRUE
ZVJlàVěǎTLPBXúKkègONàIWzIyrLOOèùsUdFMvAYááwtoz	TRUE
bapqsTǒúǔjàNlDrùJéDǔXMhEGwCsǎHqMswécfnjPFEGèTn	TRUE
eóCcteYYRvǒǎEBófǎiàdLKbcóEàòlèǎǒiǒPqkZloùCBNVc	TRUE
gLYfORkgvjǎqNNYvǎùzRrvSDEòNùOoqVwoYǒLqiúqtbAkě	TRUE
ijIdZYoRvhúzFvjqFgyéLTIéěODgHJPèiBbQVòhàfàqojm	TRUE
lòKEKlHIEeèKPeSpCúàDǎIHJlnWuMCStraòhěMrOIGqSrR	TRUE
nQubEófFáDóFMúùSHhnEàfWfTxrCVpHaTgSOúǎgQělòdVé	TRUE
pxéógǎhHódVjWvgcBqúOKftiwAèXnWIúěfǔàIQeyLPLPZu	TRUE
sRóiIaZáTmyoiDlUédwàǒVSúfIyKaQèAezmDèCBzúwiekè	TRUE
vIOEYiWaiemCxkxIxpǔxùhHAFDDOnXQTRàuuEYNòRqMofP	TRUE
xdgiKIPǎǔeáHběbZàLPqnsYjKtTtbéqwziàfcpFRvEHión	TRUE
ùùXpFKKOaMLónpnuTárěOKtGJqvHQSWjúhúofRcXěóHbREp	FALSE
áixPjBvWUǎǒnvvGvEàlIboǒmaeyHyYBFdvUWDNFobóbWěLg	FALSE
édǒCMeXzmSHXpcDèsěfJcURzéWhDMnpAvhidégAtěYqoòY	FALSE
ófhàJqzùDKétjrcqǎZǒczrùhgNGXSnaQǔjvěboULùSáepm	FALSE
úóYUóElùxoHcKVIGvezvSǔHráEErhHaXtǎLrtyVbtezLUm	FALSE
BrTàcerùdwròdhbkvPeZVoVxbeǔǒjqJVFIRJuYòùUGézAP	FALSE
EbsWQSLKèSMèIpLZqopraEwfeGbZǒrèqnEdOǒTMzwAěmǔnE	FALSE
dGwnǔPNgèDVxGZeTvSGòPWzbBqESFQSShLilǎMDeědǔOOóG	FALSE
JGSdfysTmXúAHàěFaUBJkGáCzhcYVYdCIùZprLǔELKSGVǎ	FALSE
LyRMdéuǔBFvOcpLSéVWzNóSQTHUǔòàrEèéODodlqnMUABTé	FALSE
OsUozURèLIfmvgèWPkoCIǎabèypǒqoqzcǔwAǔdFQxèáSlO	FALSE
RfOdgdzVzPéópHóBFXXxwuéYkspxkéqùHUarFRzQyTúlaT	FALSE
UUQdóZnnàUaóTbglóaGwúéóázylùǔéIEkTngQcCZLKqmmrv	FALSE
WzHǒtHRwGslqjUFEjPlLwBCeGeBzVXPKJayFYEyLbvRMJVP	FALSE
ZVJlàVdǎTLPBXúKkègONàIWzIyrLOOèùsUdFMvAYááwtoz	FALSE
bapqsTǒúǔjbàNlDrùJéDǔXMhEGwCsǎHqMswécfnjPFEGèTn	FALSE
eóCcteYdYRvǒǎEBófǎiàdLKbcóEàòlèǎǒiǒPqkZloùCBNVc	FALSE
gLYfORkgvjǎqNNYvǎùzRrvSDEòNaOoqVwoYǒLqiúqtbAkě	FALSE
ijIdZYoRvhúzFvjqFdgyéLTIéěODgHJPèiBbQVòhàfàqojm	FALSE
lòKEKlHIEeèKPeSpCúàDǎIHJlnWuMCStraòhěMrOIGqSrRb	FALSE
nQubEófFáDóFMúùSdhnEàfWfTxrCVpHaTgSOúǎgQělòdVé	FALSE
pxéógǎhHódVjWvgcBqúOKftiwAèXnWIúěfǔàIQeydLPLPZu	FALSE
sRóiIaZáTmyoiDlUédwàdVSúfIyKaQèAezmDèCBzúwiekè	FALSE
vIOEYiWaiemCxkxIxpǔxùhHAFDDOnXQTRàuubYNòRqMofP	FALSE
xdgiKIdǎǔeáHběbZàLPqnsYjKtTtbéqwziàfcpFRvEHión	FALSE
ùǔóKvqbnǔVǒCcǒBPapowCǔBfbKhwrDpYyqQNJxEEAaupkvY	TRUE
àújféxKPPòeVdGófZxHxEǒoàiqéhnòjEòmbHGMInIǔVRYoj	TRUE
éaSejLDHJrmkXúsIuDONiàèFZěZfmEZApúFarnVKùRnmèúV	TRUE
ětXyelHyMFyòhTuCFXúdùhúrgGxzTjYAfǔèxWòTpǒqCǎojw	TRUE
ǒXhzcHdDUóchfǒáùbknamòùdZWuěLiòNMZTljQvǒVPzóuMg	TRUE
AxquvMwHtBLvRNaaIyhRroGPslxLéQlfNùyIngNǔtèJiEǔě	TRUE
DrshzǔpTqIIàUOadsnZpOCzrXLóMGòVViàiùHǔYoòIhprFe	TRUE
FyAJVHFdǒyùOCaèěéEEěPlueǔxǎlXWlLělUléàhYNwsTUDs	TRUE
IEdCaJBfmPUùBúrwèèoUǔIVptjKJgǎwúétvGvMPòùXLUVJs	TRUE
KNoKaQXhTMoRúBwǎgǎSětNǎGsUmHyCěPééEXlǔmùexBHòěX	TRUE
MpmèVùàDàǒDjOjǒvénaroejdHAWrHAvGfàCpNénrèZàthfC	TRUE
PàběkAǒRtQoRyQǒXóebHLKàYEmLxciXmpckubJáAéPXBIoù	TRUE
RAuúlEúNJáFSRuKfRiěWhwqèNoasJDàwWywqeǔslǎryWlVP	TRUE
TrxgDPphDCpdVáncxǎáOtvfCǎJBUfQWeIPmǎLWJcsOYSMtp	TRUE
WNzZSRúvgQeǒèuoYBBzZWbxyRdEJZzjVPqǔWuAFVkIHiira	TRUE
YmjAicMdYbIOúSLYhUfacsúgrJvěvKUmòuPeHHLxyhhVàěG	TRUE
bYàtYtoDǔacóKóáqǒaSaGòjLzǔmOyGUzRGInnrùqNQHòsTj	TRUE
eàUirmǔURRófYAwYPzZéMùKVhUóhGYǎztóèkǎOǔéóvbvaǒI	TRUE
gptanóóPYlKǎPgFYHHvHǒFBCFteRrBXòJuKKvZtShrcPTEl	TRUE
jDěnJJBLàalwǎSJkóLèǎQNWDpIéWFèiQièHdùwiOkPozAǎà	TRUE
lpkjbèSLcAǎarZJtWbPlnxehcCqàbCpDftyzǒAxDǒàRoUFb	TRUE
ohtDLtvcMàvrcdRHzDOúNDǒéJqiiMrBYiEiprháSzmPzgmc	TRUE
rjHJJNòPxóbfáJòèILydfàZCFSUAyvYVxěǒǎGWWSQkNúMvu	TRUE
uUUEzòFlYàràǒHrNWèDcJjdNxwXǒyAùLCóGCtoBVxOúCǎGO	TRUE
xěVXùùùwCǒnXozSYUmqXNHLtMkhhQàIWEdùEózTròognǒKj	TRUE
ùǔóKvqrnǔVǒCcǒBPapowCǔBfbKhwrDpYyqQNJxEEAaupkvY	FALSE
àújféxKPPòeVdGófZxHxEǒoàaqéhnòjEòmbHGMInIǔVRYoj	FALSE
éaSejLDHJrmkXúsIubDONiàèFZěZfmEZApúFarnVKùRnmèúV	FALSE
ětXyelHyMFyòhTuCFXúdùhúrgGxzTjYAfǔèxWòdpǒqCǎojw	FALSE
ǒXhzDHdDUóchfǒáùbknamòùdZWuěLiòNMZTljQvǒVPzóuMg	FALSE
AxquvMwHtBLvRNabaIyhRroGPslxLéQlfNùyIngNǔtèJiEǔě	FALSE
DrshzǔpTqIIàUOadsnZpOCbrXLóMGòVViàiùHǔYoòIhprFe	FALSE
FyAJVHFdǒyùOCaèěéEEěPlueǔxǎlXWlLělUléàhYNwsTUDds	FALSE
IEdCaJBfmPUùBúrwèèoUǔIVptjKJgǎwúétvbGvMPòùXLUVJs	FALSE
KNoKaQXhTMobRúBwǎgǎSětNǎGsUmHyCěPééEXlǔmùexBHòěX	FALSE
MpmèVùàDàǒDjOjǒvénardoejdHAWrHAvGfàCpNénrèZàthfC	FALSE
PàběkAǒRtQoRyaǒXóebHLKàYEmLxciXmpckubJáAéPXBIoù	FALSE
RAuúlEúNJáFSRuKfRiěWhwqèNoasJDàwWywqeǔslǎbyWlVP	FALSE
TrxgDPphDCpdVáncxǎáOtvdCǎJBUfQWeIPmǎLWJcsOYSMtp	FALSE
WNzZSRúvgQeǒdèuoYBBzZWbxyRdEJZzjVPqǔWuAFVkIHiira	FALSE
YmjAicMdYbIOúSLYhUfacsúgrJvěvKUmbòuPeHHLxyhhVàěG	FALSE
bYàtYtoDǔacóKóáqǒaSaGòjLzǔmOyGUzRGInnbùqNQHòsTj	FALSE
eàUirmǔURRófYAwYPzZéMaùKVhUóhGYǎztóèkǎOǔéóvbvaǒI	FALSE
gptanóóPYlKǎPgFYHHvHǒFBCFteRrBXòJuKKvZtShrcbTEl	FALSE
jDěnJJBLàalwǎSJkóbèǎQNWDpIéWFèiQièHdùwiOkPozAǎà	FALSE
lpkjzèSLcAǎarZJtWbPlnxehcCqàbCpDftyzǒAxDǒàRoUFb	FALSE
ohtDLtvcMàvrcdRHzDOdNDǒéJqiiMrBYiEiprháSzmPzgmc	FALSE
rjHJJNdPxóbfáJòèILydfàZCFSUAyvYVxěǒǎGWWSQkNúMvu	FALSE
uUUEzòFlYàràǒHrNWèdcJjdNxwXǒyAùLCóGCtoBVxOúCǎGO	FALSE
xěVXùùùdCǒnXozSYUmqXNHLtMkhhQàIWEdùEózTròognǒKj	FALSE
ùǔuRDǔrMXòGnbǎvpjkpkjGhINmVhuàsòséDéǎZDGQQpáaělà	TRUE
ákyàfNYǔihYsùùbgèeyésěRKHzěbdéxjWGCgngJveèǎizQwI	TRUE
éòxXnxmRùWHBTbUdúqǒórivèQKOuZxéGòqUTKpOònLMVubéc	TRUE
ěrnèlrHXUDCmWRKzYNtQWěvqJVfzzdNgèXúNUAguhéCrZgtp	TRUE
ǒQsǔizàidaDgNRNOrIéúDrLúFqSCPCPááHxfZòXgǔJfpòppé	TRUE
ArbljXpXeTèjFbUEGVQétvPpofGvòélSbchApǒCxúéUHdhcá	TRUE
DěcáoxtpébKéihfèshECóènrHWěròtldzUcójúXGóLyZqúgu	TRUE
FSaUzVDTvoùOTNeǒLZOnlEwIShyèrmgoJòfònLJOEoPTYúLǎ	TRUE
HnTMcPzHEòkYVmkúGAùduWmǔěaòwrKUhuEeèYKrtYǒSBejDz	TRUE
KDyQeUHějTytxznQZnMLlASFGaǔtuǒNcFVDaxyǎǎUUèàBHND	TRUE
MemWzǒwgRXRfzMIHǒsUNvùoěElwùASdgáǎjèLGJmFSRtjyVC	TRUE
PKDglòiIuHyThsIWdXgujoqěàKXxjChLuNzmbVàVkEiPTPHW	TRUE
SZHVpQlzKesqjcxOěQldmfWnmciBnTdsséXmfMNOsúAvRcVg	TRUE
VòòǒèjuadǎYrsáEBncBIiǎoLmòùBRLKXlVoWwlXJǎPmtVUZj	TRUE
XgIgnyubqáUvxPRazfQáKuǔLlkWJGǒAnQCQQUkCúEjMWCměú	TRUE
aEyrhjáVyyeEsmkctáHYEeAǔXónnwfLfuzpúIèqGDGvǎuWnj	TRUE
cvYcBxxǎvtWILùsèěIdAěPwDHNyFJkKAeTTbxALzǔCAywQzA	TRUE
fbFǔcJAèmXOdvYvQrxVywDDRYOFèrDGǒDǔwBpUBòMAòTCgXx	TRUE
hvámúgsWYuEOoǒásZAzEJGeutEGbtmòMoqRyxtUTdkUVZàIF	TRUE
kWSZǔUZzrǒNuǔmANSCecàlEdúLúcfOhwHUwHmMóswbSǔNCIQ	TRUE
nXalXQWPntròqlYPrGLxmXyrcókWèéArùyKXàOúàéicTmaqǒ	TRUE
qCyBeTSSaoRěDryúDZùòBNriěXIUxǔěiclcqpkiOlOdAfgǒg	TRUE
sgàǔǔzmDópCkěAnxdgóPBèrrTǔkFeFFiFmzKáfvǎòtPúnqrà	TRUE
vGYetIjMCenTnKBRCwJvLbàrǎCxrKTóTnKrZuúEFlǒdpjDOf	TRUE
xfYǒLúyqdfGPKMǎgimhTWNOXKRlIrUújRneJǔaqǎLǔTwOYsC	TRUE
ùaǔuRDǔrMXòGnbǎvpjkpkjGhINmVhuàsòséDéǎZDGQQpáaělà	FALSE
ákyafNYǔihYsùùbgèeyésěRKHzěbdéxjWGCgngJveèǎizQwI	FALSE
éòxXnxmRùWHBTbUdúqǒórivèQKOuZxéGòqUTKdpOònLMVubéc	FALSE
ěrnèlrHXUDCmWRKzYNtQWěvqJVfzzdNdgèXúNUAguhéCrZgtp	FALSE
ǒQsǔizàidaDgNRNOrIéúDrLúFqSCPCPááHxfZòXbǔJfpòppé	FALSE
ArbljXpXeTèjFbUEGVQétvPpofGvòédSbchApǒCxúéUHdhcá	FALSE
DěcáoxtpébKéihdèshECóènrHWěròtldzUcójúXGóLyZqúgu	FALSE
FSaUzVDTvoùOTNeǒLZOnlEwIShyèrmgobJòfònLJOEoPTYúLǎ	FALSE
HnTMcPzHEòkYVmkúGAùduWmǔědòwrKUhuEeèYKrtYǒSBejDz	FALSE
KDyQeUHějTytxznQZnMLlASFGaǔtbǒNcFVDaxyǎǎUUèàBHND	FALSE
MemWzǒwgRXRfzMIHǒsUNvùoěElwùAdSdgáǎjèLGJmFSRtjyVC	FALSE
PKDglòdiIuHyThsIWdXgujoqěàKXxjChLuNzmbVàVkEiPTPHW	FALSE
SZHVpQlzKesqjcxOěQldmfWnmBiBnTdsséXmfMNOsúAvRcVg	FALSE
VòòǒèjuadǎYrsáEBndcBIiǎoLmòùBRLKXlVoWwlXJǎPmtVUZj	FALSE
XgIgnyubqáUvxPRazfQáKuǔLlkWJGǒAnQCQQUkCúEjMWCbměú	FALSE
aEyrhjáVyyeEsmkctáHYEeAǔXónnwfLfuzpúIèqGDGvǎuWnbj	FALSE
cvYcBxxǎvtWILùsèěIdAěPwdDHNyFJkKAeTTbxALzǔCAywQzA	FALSE
fbFǔcJAèmdOdvYvQrxVywDDRYOFèrDGǒDǔwBpUBòMAòTCgXx	FALSE
hvámúgsWYuEOoǒáaZAzEJGeutEGbtmòMoqRyxtUTdkUVZàIF	FALSE
kWSZǔUZzrǒNuǔmANSCecàlEdúLúcfOhwHUaHmMóswbSǔNCIQ	FALSE
nXalXQWPntròqlYPrGLxmXyrcókWèéArùyKXàOúàéicTbaqǒ	FALSE
qCyBeTSSaoRěDryúDZùòBNriěXIUxǔěiclcqpkiOblOdAfgǒg	FALSE
sgàǔǔzmDópCkěAnxdgóPBèrrTǔkFeFFiFmzdKáfvǎòtPúnqrà	FALSE
vGYetIjMCenTnKBRCwJvLbàrǎCxrKdTóTnKrZuúEFlǒdpjDOf	FALSE
xfYǒLúyqdfGPKMǎgimhTWNOXKRdIrUújRneJǔaqǎLǔTwOYsC	FALSE
ùǔFNkvjpLOmXlRPúIgùbècAkFǒaNChnHòMRibcSZvFbhqǒěáǎ	TRUE
áoiǔHqENbXefBcrnǒPAmiTMRyPrEOKásóqfóEBOwHzùphPépu	TRUE
éǔVpeWcězJònggcgQCxOuěgòRáDwàMbQlEIAydéRnhǔáǎCjPg	TRUE
ěaTuùLsjyMfuèNUPóéěBqditznNHlhQóeHmtòxnYzzTjMcJRD	TRUE
òsUTzQtǎgQboCfBBGrMrsXPDIcdyzDóupAkWyDòrKZVyWaúJS	TRUE
AbvloZNmóWAèMZMHóIězhǎePpJsnCszcGANjnjpEAnbOPxǒàq	TRUE
CtNspUùjSrqEGDEjYfěehwlTGRKékkǎòAyWědEeRAFVsMxpZW	TRUE
FOQBrCPDYcrVQhWùKěǎCtOmeeSLgJXyǔZbBTcxrKǒNáDURèén	TRUE
HmckbefáCfHGrHrxTòqXBqéúaYRxeòúpèghHztúuDAtrZCJAw	TRUE
KBdhdùSgzqécěPXeyǒbWbiAjúǒcéHahǔrěYDVbAJPajBdYnǎb	TRUE
MoFdPúàswhòlàǒYcIcaIKMImwhuOYHNéěUsoZgRǎrrqRtvrmr	TRUE
PQKéhviDǔgbCàjoAnápkǔoǒgFFNRQEgdzyjAamMRhMázrvEpú	TRUE
SAóAPNGpUAzyjpéVáOwmBUNvbOmùPeǒMezAaEOLùhltǒqlRTH	TRUE
VACQBmBJpnLnfMEZuúirilmCaCBMóàcAfmRcNyùùyòJCóaKJǔ	TRUE
XowROolooxǎnRěáògvkEAyǔéycǒCúaOkǎFNsǒHeYuoctglzso	TRUE
aǒódfxáLtAièFNYFuCtijǒXUǔmVXLIRpwúyYcsFMéHLqhèSlA	TRUE
dFBlfrèmCVwróóPrépgXyDHLQbEófsxsOLjIwùnMàpǒsùmOjP	TRUE
gǎdMRèepHiJJoYkCgùmjcGrxTúhmǒhbǔáUsqPěètGJqMLXǒkN	TRUE
ilywuAhhǒREcǎrKyEBEuáNàǒaOfNmJáOFxCKuěèèásRǔBdǎǔL	TRUE
ktXbǔjéèYKézlwIqǒExúZqIKlvàQnúeNyroóXryRjvbUpámèb	TRUE
nHáUPSfdaBXhOxsáEhNsyNàqFGLéáPóNlhNqqcùKaàosvOAiN	TRUE
qèuPeEisAáNduèMCxEBvCzKSxějvǎXùjáuúzEǎzuLtZDQQéòè	TRUE
syǒFTǒBáOHDǎBgiPmIpoùVAJTòěpSsdFXMoKòfLWPékvCèron	TRUE
vVǒDáqfBǒPbATRúBLiGQMùxZyEpZlNóNáfkSbTUROQonsóZdj	TRUE
xTmGbNNFUICǒǒutbGEókdPǒQHDYbViRqCHBǎbKAǎèUDrèoEòl	TRUE
ùǔFNkvjpLOmXlRPúIgùbècAkFǒaNChnHòMRibiSZvFbhqǒěáǎ	FALSE
áoiaHqENbXefBcrnǒPAmiTMRyPrEOKásóqfóEBOwHzùphPépu	FALSE
éǔVpeWcěaJònggcgQCxOuěgòRáDwàMbQlEIAydéRnhǔáǎCjPg	FALSE
ěaTuùLsjybfuèNUPóéěBqditznNHlhQóeHmtòxnYzzTjMcJRD	FALSE
òdsUTzQtǎgQboCfBBGrMrsXPDIcdyzDóupAkWyDòrKZVyWaúJS	FALSE
AbvloZNmaóWAèMZMHóIězhǎePpJsnCszcGANjnjpEAnbOPxǒàq	FALSE
CtNspUùjSrqEGDEjYfěehwlTGRKékkǎòAyWddEeRAFVsMxpZW	FALSE
FOQBrCPDYcrVQhWùKěǎCtOmeeSLagJXyǔZbBTcxrKǒNáDURèén	FALSE
HmckbefáCfHGrHrxTòqXBqéúaYRxeòúpèghHztúuDAtrZbJAw	FALSE
KBdhdùSgzqécěPXeyǒbWbiAjúǒcéHehǔrěYDVbAJPajBdYnǎb	FALSE
MoFdPúàswhòlàǒYcIcaIKMImwhuOYHNéěbUsoZgRǎrrqRtvrmr	FALSE
PQKéhviDdǔgbCàjoAnápkǔoǒgFFNRQEgdzyjAamMRhMázrvEpú	FALSE
SAóAPNGpUAzyjpéVáOwmBUNvbOmùPeǒMezAabEOLùhltǒqlRTH	FALSE
VACQBmBJpnLnfMEZuúirilmCaCBMóàcAfmRcNyùùybòJCóaKJǔ	FALSE
XowROolooxǎnRěáògvkEAyǔéycǒCúaOkǎFNsǒHeYuoctglzbso	FALSE
aǒódfxáLtAièFNYFuCtijǒXUǔmVXLIRpwúyYcsbMéHLqhèSlA	FALSE
dFBdfrèmCVwróóPrépgXyDHLQbEófsxsOLjIwùnMàpǒsùmOjP	FALSE
gǎdMRèepHiJJoYkCgùmjcGrxTúhdmǒhbǔáUsqPěètGJqMLXǒkN	FALSE
ilywuAhhǒREcǎrKyEBEuáNàdǒaOfNmJáOFxCKuěèèásRǔBdǎǔL	FALSE
ktXbǔjéèYKézlwIqǒExúZqIKlavàQnúeNyroóXryRjvbUpámèb	FALSE
dnHáUPSfdaBXhOxsáEhNsyNàqFGLéáPóNlhNqqcùKaàosvOAiN	FALSE
qèuPeEisAáNduèMCxEBvCzKSxějvǎdùjáuúzEǎzuLtZDQQéòè	FALSE
syǒFTǒBáOHDǎBgiPmIpoùVAJTòěpSsdFdXMoKòfLWPékvCèron	FALSE
vVǒDáqfdǒPbATRúBLiGQMùxZyEpZlNóNáfkSbTUROQonsóZdj	FALSE
xTmGbNNFUICǒǒutbGEókdPǒQHDYbViRqCdBǎbKAǎèUDrèoEòl	FALSE
ùùúNokZbzěCeeUnPùKDNidǒIRgmàFmoxǒqèHNqFRúéxuTGboòP	TRUE
ábǒWKKGgQIMwCeSciHtDMrkávzDěfyytMSúrèjbHfǎdSVTeSPě	TRUE
ǎuóyaqwxZòěrZXBoQWtfutCkZzPàNqFcSrdDSnmmJZPlyECBCB	TRUE
ěQPmnJèsGAěuaááUUUltKxzéǔPnwúnAuuaEttFtFNAkyǔxáxnc	TRUE
ǒGXPFgohvǔKDmhgMRAésbGEBMDàoLftGáeOCYxveCéyQQZWQxb	TRUE
AjbpGúoóáěcJJyOBǔEvǒKfavGbYAtéMPsrǒXyhxskǒòmaVàVEu	TRUE
DǔèaUQHéoUYhóiHkjòwxpGéúzrNDEǒueHQmjcùóYzàLúQfxMLY	TRUE
FiéHVónègYSsòsiZzBthGHbYFEkMVXYfástLmèsIéPámwstéVT	TRUE
IPtdǎùMàYCàDáSixkCyTSǒmcMMYSǎyFcǎǒfzVègtèZbǎjòiWmǔ	TRUE
KyBTnlbǎxKJlmPoSyKéǎEúXswbemǔǎfBměěfèCǒbfáfnCIdóòj	TRUE
NVgBrmyjIItXStOǒFoHSyEYZSIùúùiTsuzoHBCbbVXwàDrYkEK	TRUE
PaòxTCéèzEávàoánZòaFEjjfǒěùHhókQZérYZYDǔliádtjYěFA	TRUE
SNAzZFwYùDLfYvòpǔǔòvóyòLxàiiWcdpQjěóWErèbTàxEzNǎhj	TRUE
VérVoqéLHLEcbXWáǔFPPmVgéqóIlYǎělSGZXedAvsRǎFvòMòaa	TRUE
XyTòEyùǒHEǔTtěoFóùùnpcéRǔvOIQěrOoTsSCOIdjLèwPPièóǎ	TRUE
afcCjpèězaAǒljdǒéuóOXUwIóTreàShPNpèGEPfpfLZǎměWùGS	TRUE
dCnRúèIèBHhpacgSkjCGùJǒznUmCcmeNéKDmǎkDPúqmxIjSUae	TRUE
fLjUtàVgkxzQzjsrXsYeywutEezkdQTDJmiàxǔevsZcCAǒZJRJ	TRUE
hWeankǒǎùIKwdǎOéojEùgqéǔCNUENzNCzǎtàBlLoVěAMAkZVXò	TRUE
kBdzzǔóěVǎTòDmSDáHǔláXiWGAsZFópliǒeòVTcmKXéMAvuUOf	TRUE
mwáBWybeátéùǔúǔǔbUQoHwSàáAQfdvRJpěTùnǎQosòQxuBNǒnL	TRUE
pINyVmbetYJòFqTxtèOéDsùUpfùěkkùàkSMOéIZTWǒbděBWIjW	TRUE
súǒqVkzvmbryǎzóěJbpǒxwkHSTCfjvouGjqfYywKUJgǔeěUàòc	TRUE
uXtRSVUWYqPéTClGGJOùMègkǔYhtdòòypBóYIupGnrESbOPFóg	TRUE
xHqDdQyàTxúYpólMèuPKJmGnǒHjCNbHeeúunTDIùàgéóZjRHAT	TRUE
ùùúNokZbzěCeeUnPùKDNidǒIagmàFmoxǒqèHNqFRúéxuTGboòP	FALSE
ábǒWKKGgQIMwdCeSciHtDMrkávzDěfyytMSúrèjbHfǎdSVTeSPě	FALSE
ǎuóyaqwxZòěrZXBoQWtfutCkZzPbàNqFcSrdDSnmmJZPlyECBCB	FALSE
ěQPmnJèsGAěuaáábUUltKxzéǔPnwúnAuuaEttFtFNAkyǔxáxnc	FALSE
ǒGXPFgohvǔKDmhgaMRAésbGEBMDàoLftGáeOCYxveCéyQQZWQxb	FALSE
AjbpGúoóáěcJJyOBǔEvǒKfavGbYAtéMPsrǒXyhxskǒòmxVàVEu	FALSE
DǔèaUQHéoUYhóiHkjòwxpGéúzrNDEǒueHQmjcùóYzàLúQfxbMLY	FALSE
FiéHVóanègYSsòsiZzBthGHbYFEkMVXYfástLmèsIéPámwstéVT	FALSE
IPtdǎùMàYCàDáSixkCyTSǒmcMMYSǎyFcǎǒfzVègtèZbdjòiWmǔ	FALSE
KyBTnlbǎxKJlmPoSyKéǎEúXswbdmǔǎfBměěfèCǒbfáfnCIdóòj	FALSE
NVgBrmyjIItXStOǒFoaHSyEYZSIùúùiTsuzoHBCbbVXwàDrYkEK	FALSE
PaòbxTCéèzEávàoánZòaFEjjfǒěùHhókQZérYZYDǔliádtjYěFA	FALSE
SNAzZFwYùDLfYvòpǔǔòavóyòLxàiiWcdpQjěóWErèbTàxEzNǎhj	FALSE
VérVoqéLHLEcbXWáǔdFPPmVgéqóIlYǎělSGZXedAvsRǎFvòMòaa	FALSE
XyTòEyùǒHEǔTtěoFóùùnpcéRǔvOIQdrOoTsSCOIdjLèwPPièóǎ	FALSE
afcCjpèězaAǒljdǒéuóOXUwIóTredàShPNpèGEPfpfLZǎměWùGS	FALSE
dCnRúèIèBHhpacgSkjCGùJǒznUmCcmeNéKDmǎkDPúqmbxIjSUae	FALSE
fLjUtàVgkxzQzjsrXsYeywutEdzkdQTDJmiàxǔevsZcCAǒZJRJ	FALSE
hWeankǒǎùIKwdǎOéojEùgqdéǔCNUENzNCzǎtàBlLoVěAMAkZVXò	FALSE
kBdzzǔóěVǎTòDmSDáHǔláXiWdGAsZFópliǒeòVTcmKXéMAvuUOf	FALSE
mwáBWybeátéùǔdúǔǔbUQoHwSàáAQfdvRJpěTùnǎQosòQxuBNǒnL	FALSE
pINyVmbetYJòFqTxtèOéDsùUpfùěkkùàkSMOéIZTWǒbděBWIdW	FALSE
súǒqVkzvmbryǎaóěJbpǒxwkHSTCfjvouGjqfYywKUJgǔeěUàòc	FALSE
uXtRSVUWYqPéTClGGJOùMèdgkǔYhtdòòypBóYIupGnrESbOPFóg	FALSE
xHqDdQyàTxúYpólMèuPKJmGnǒHjCNbHedúunTDIùàgéóZjRHAT	FALSE
