bAZùILgKJQLǒPdwguvVYǒjFóvòtbèǎǔ	TRUE
áúěfijeděwvrVifNqfVFuDǒvOakǒMǒk	TRUE
éáUWQGyrZUòlnHNgaYcvqhENFQúMDál	TRUE
ěVTDVMǒùkAàDQskaòRmDdkbóIZVnyEH	TRUE
ǒòǒxCmùVHPbǔěNXNaUQjGKuXcLtkmWl	TRUE
ApjLaYNlLbBvkDyáLknshòhZùFSdebr	TRUE
DfTAbIwKhyzroaàowPéAKjySmriVlnF	TRUE
GáobJAVzZǎIǔmòéCIkyhòIxpǒzǒǎLzt	TRUE
JIMmóúfQOystfWOAraLjEàgWfSěSuko	TRUE
MbwOgǔROézběúCDUVǔxúgpQfTGùjcmǎ	TRUE
OemXQúnàflpavLáKaEèHlWpYYgNaàTD	TRUE
RJóaěòjgKMGFáaQaóPOjounápsVBGTH	TRUE
TXaǎQlJMdPěGǒfrpégAjDxJoaFKèFúó	TRUE
VmONéPèUAéPAJonXSTpGqcoěXaAòàjY	TRUE
YXIáqéxJJbXyayiùǎzLBYIajěkCsòEk	TRUE
azllcDcKMaègUtèùéjvanUulcpZsědé	TRUE
dǔeQeNGǒxfUuEàPMokáAGSIbPǒCNSvě	TRUE
fbqnámmxgKlhvvVèfMbGàsDàggSXXrT	TRUE
iFwǒZéZcggVjboǎynvwXDvEYpzbFòRj	TRUE
krOěaqawJImǒéqslyNlyUfyiBfToàQU	TRUE
nVhǎbXějIXHtuKWMERIhIsXǔPMyuqbè	TRUE
qaúJHéézvmTdSmTyaMFleHàoijPuxNz	TRUE
sYBUwúúborbpdcglIlRěoWCzUgSnjIn	TRUE
uiYKhǔElhTxòfIJaěBǒaQXRCgijBadW	TRUE
xARlucaUSuJǔǒéPǔmǒǒaèUypJlcVgǎC	TRUE
abAZùILgKJQLǒPdwguvVYǒjFóvòtbèǎǔ	FALSE
áúěfijeděwvrVifNqfVFuDǒvbakǒMǒk	FALSE
éáUWQGyrZUòlnHNbaYcvqhENFQúMDál	FALSE
ěVTDVMǒùkAàDQskaòRmDdkbaIZVnyEH	FALSE
ǒòǒxCmùVHPbaǔěNXNaUQjGKuXcLtkmWl	FALSE
ApjLaYNlLbBvkDyáLknshòhZùFSdeabr	FALSE
DfTAbIwKhyzrobaàowPéAKjySmriVlnF	FALSE
GáabJAVzZǎIǔmòéCIkyhòIxpǒzǒǎLzt	FALSE
JIMmóúfQOystfWOAbaLjEàgWfSěSuko	FALSE
MabwOgǔROézběúCDUVǔxúgpQfTGùjcmǎ	FALSE
OemXQúnàflbavLáKaEèHlWpYYgNaàTD	FALSE
RJóaěòjgKMGFáaQabPOjounápsVBGTH	FALSE
TXaǎQlJMdPěGǒfrpégAjDxJobaFKèFúó	FALSE
VmONéPèUAéPAJonXSTpGqcoěXabAòàjY	FALSE
YXIáqéxJabXyayiùǎzLBYIajěkCsòEk	FALSE
azllcDcKMabègUtèùéjvanUulcpZsědé	FALSE
dǔeQeNGǒxfUuEàPMokáAGSIbaǒCNSvě	FALSE
fbqnámmxgKlhvvVèfabGàsDàggSXXrT	FALSE
iFwǒZéZcggVaboǎynvwXDvEYpzbFòRj	FALSE
krOěabawJImǒéqslyNlyUfyiBfToàQU	FALSE
nVhǎbXějIXHtuKWMERIhIsXǔPMyuqba	FALSE
baúJHéézvmTdSmTyaMFleHàoijPuxNz	FALSE
sYBUwúaborbpdcglIlRěoWCzUgSnjIn	FALSE
uiYKhǔElhTxòfIJaěBǒbaQXRCgijBadW	FALSE
xARlucbaUSuJǔǒéPǔmǒǒaèUypJlcVgǎC	FALSE
bǔzèegUFǔoskóifǔòTBMIóFtAoFEQMOm	TRUE
áùBóXNWtóFSvXejFfrúǎaHùTbfXsoxct	TRUE
ǎQúMBjèANálTdJdmMZáXQexAbMvéXEYW	TRUE
ěóujavXOoRbINfùHdúbzgěIPIǒxVèbqu	TRUE
ǒóèǎàwJVowatekbVǎjVtúvóWnvkESahe	TRUE
AhèbEBGIkBùpǔóQXuáèZDVúhuIPnǔNtN	TRUE
DEěxNoúonVauyOCùQkKBibtQjǒYGùMSL	TRUE
FYTǎiucjVaCHZWòZMwAubAKoVyBCǎáóV	TRUE
IǎóUrsèbMáDETnULHětXAVěOjěIèaúWh	TRUE
KbASWFbJJrpTHqMYpǒywuzNsMpòujENS	TRUE
NJěVXVQábhJXlVùHFzQěqwáaPTuǎsPóF	TRUE
PumeISfpjóTGDsQPRRiLqgòèbYfJBkjc	TRUE
SúlUtMRXétPXsóaXCaalěYǔbuágǎPJàg	TRUE
UsòKOúúnADsiHsSfWSXqrBuOGèROagNJ	TRUE
XfyzRnHDgUDtbqwOàgHrIOyàóúXTbuDa	TRUE
aùǎSPǔPFhfúGàwdjqZóorbroqúǒéeVPò	TRUE
bqEǎHLfpǔDapCtGhǔkNNǔWbbMyAtmMtR	TRUE
dwúIphQùǎJaèǎXCPéGRánàvTiúPùPcBa	TRUE
góǎgfǔJtXVHOaRyǎpCUcaXmtpiYibàjY	TRUE
jHWCFnhNZaLdzwgkàZoNàùUFMugMYIsW	TRUE
mǒSTGáduRdalIovprDAOeyQswgGeěJkc	TRUE
paGosàYrmKXbèsèhGeWuòéúZPkRHmyXò	TRUE
rlMbRVèUUZBjggFoWVNXHEVAkótGǔqZJ	TRUE
uWcUdgZàǒaaBAjAHPVVxCcidGjcKúCnS	TRUE
xòqtZáXPCócáeǒmbdkcqùIúEGclPaèáo	TRUE
abǔzèegUFǔoskóifǔòTBMIóFtAoFEQMOm	FALSE
áùBóXNWtóFSvXejFfrúǎabHùTbfXsoxct	FALSE
ǎQúMBjèANálTdJdmMZáXQexAabMvéXEYW	FALSE
ěóujavXOoRbINfùHdúabzgěIPIǒxVèbqu	FALSE
ǒóèǎàwJVowateabVǎjVtúvóWnvkESahe	FALSE
AhèbaBGIkBùpǔóQXuáèZDVúhuIPnǔNtN	FALSE
DEěxNoúonVabuyOCùQkKBibtQjǒYGùMSL	FALSE
FYTǎiucjVabCHZWòZMwAubAKoVyBCǎáóV	FALSE
IǎóUrsèbMáDETnULHětXAVěOjěIbaúWh	FALSE
KbaASWFbJJrpTHqMYpǒywuzNsMpòujENS	FALSE
NJěVXVQábhJXlVùHFzQěqwábaPTuǎsPóF	FALSE
PumeISfpjóTGDsQPRRiLqgòèabYfJBkjc	FALSE
SúlUtMRXétPXsóaXCbalěYǔbuágǎPJàg	FALSE
UsòKOúúnADsiHsSfWSXqrBuOGèROabNJ	FALSE
XfyzRnHDgUDtbqwOàgHrIOyàóúXTbuDab	FALSE
aùǎSPǔPFhfúGàwdjqZóorbaroqúǒéeVPò	FALSE
bqEǎHLfpǔDapCtGhǔkNNǔWbbaMyAtmMtR	FALSE
dwúIphQùǎJaèǎXCPéGRánàvTiúPùPcBba	FALSE
góǎgfǔJtXVHOaRyǎpCUcaXmtpiYibaàjY	FALSE
jHWCFnhNZbaLdzwgkàZoNàùUFMugMYIsW	FALSE
mǒSTGáduRdbalIovprDAOeyQswgGeěJkc	FALSE
pbaGosàYrmKXbèsèhGeWuòéúZPkRHmyXò	FALSE
rlMabRVèUUZBjggFoWVNXHEVAkótGǔqZJ	FALSE
uWcUdgZàǒaabAjAHPVVxCcidGjcKúCnS	FALSE
xòqtZáXPCócáeǒmbakcqùIúEGclPaèáo	FALSE
bCQmPsKéeèǔYDmóǔpyCzdwbùútGKdqdVv	TRUE
áBwQCrrcdǒaǎGSBáaǒtYBJxDYJlèwsWXǔ	TRUE
ǎlOcMjjàtAǎvPksSfcfUdiFGkMSHběLID	TRUE
èoòAǒldxGaDveǎYSvpZNXFLwéòNokrJDr	TRUE
òSéyJBHWXsVtafMbJWXhàóoóspGEaEèQá	TRUE
AGaKkèDaFúYsujxbCyWIeěóiTdǒlěfbYH	TRUE
CvKyhàaCòGQuvkéGFaGpUtsqěkiemELHó	TRUE
FéqVébWnbǎOgéPHHxbzFóhDljhzgáNqZs	TRUE
HadUèwWsdúSàQbgMmfPaynfYmiaXGfCúě	TRUE
KCzbgUjòǎDémtúLXtKbfTórdOIBàóSóMò	TRUE
NùzóbFGAèqǔJkaMCxwěZCáeZóIVuàJIEù	TRUE
PběXléfIUjYdWdqXbzxLOqZBZvbTqvaeq	TRUE
SbcèLEOàkèóLzKnfJdbjcXXEdEóCPúnwà	TRUE
VFWSnDRJvùèèkqXAyoRsNóvaFbXvgRgcu	TRUE
XkuxZRaEvmdrKkávgCcrwùbLFnàCǔnMup	TRUE
ZqFluvTǔzUèSsFLeUOoòhaqEjUqsSbóYP	TRUE
cáúTxTǎusěvTHRatǔkUBfěznrGùkpMZPB	TRUE
eorBúWcéǒbFdybHtáZòouióaUoVNpeWNH	TRUE
hFGbCkEedOwàJCkKyúǒózópYaàcfLaǎdY	TRUE
jaNàJGdLòpvzRhbHǎǎóNweEjfMAtWNéTb	TRUE
mèukRHBveòMENDFuwéwemQmMMJENrdlha	TRUE
omHùcKòǎGóKjqZGumhCWnDmRMJnóQBPjb	TRUE
rmXBònyZDOsRLùKǎKakǒKVJàPAIRLkGòà	TRUE
uUXsUbSǒRTEéněmVwwZZúpaǎùmTArhbBè	TRUE
xGYVLlǒádKXHózǔTndmjefjyxycHXbTxN	TRUE
abCQmPsKéeèǔYDmóǔpyCzdwbùútGKdqdVv	FALSE
áBwQCrrcdǒaǎGSBáabtYBJxDYJlèwsWXǔ	FALSE
ǎlOcMjjàtAǎvPksSfcfUdiFGkMSHbaLID	FALSE
èoòAǒldxGabveǎYSvpZNXFLwéòNokrJDr	FALSE
òSéyJBHWXsVtafMbaWXhàóoóspGEaEèQá	FALSE
AGaKkèDbaFúYsujxbCyWIeěóiTdǒlěfbYH	FALSE
CvKyhàaCòGQuvkéGbaGpUtsqěkiemELHó	FALSE
FéqVébaWnbǎOgéPHHxbzFóhDljhzgáNqZs	FALSE
HadUèwWsdúSàQbgMmfPaynfYmibaXGfCúě	FALSE
KCzbagUjòǎDémtúLXtKbfTórdOIBàóSóMò	FALSE
NùzóbaGAèqǔJkaMCxwěZCáeZóIVuàJIEù	FALSE
PběXléfIUjYdWdqXbzxLOqZBZvbTqvabq	FALSE
SbcèLEOàkèóLzKnfJdbajcXXEdEóCPúnwà	FALSE
VFWSnDRJvùèèkqXAyoRsNóbaFbXvgRgcu	FALSE
XkuxZRbaEvmdrKkávgCcrwùbLFnàCǔnMup	FALSE
ZqFluvTǔzUèSsFLeUOoòhbaqEjUqsSbóYP	FALSE
cáúTxTǎusěvTHRabǔkUBfěznrGùkpMZPB	FALSE
eorBúWcéǒbFdabHtáZòouióaUoVNpeWNH	FALSE
hFGbCkEedOwàJCkKyúǒózópYaàcfLabdY	FALSE
jabNàJGdLòpvzRhbHǎǎóNweEjfMAtWNéTb	FALSE
mèukRHBveòMENDFuwéwemQmMMJENrdlhba	FALSE
omHùcKòǎGóKjqZGumhCWnDmRMJnóQBPjab	FALSE
rmXBònyZDOsRLùKǎKabkǒKVJàPAIRLkGòà	FALSE
uUXsUbSǒRTEéněmVwwZZúbaǎùmTArhbBè	FALSE
xGYVLlǒádKXHózǔTndmjefjyxycHabTxN	FALSE
béqáùRCqeVúétáhAPfécMtyjdCùJjmrTNs	TRUE
áFpqaóéLXFajmlpBJXKOmBèZyóàlXùhTHq	TRUE
ǎRiHclEKépwoIPkEmQEhJurirJdgúbUNlI	TRUE
ěǒswRFjfSEiqYgDNbrxOHgkDczulpxàZMǒ	TRUE
òvQrcǔvVWtpórtéáOaEǎLCphDrQwilcòoò	TRUE
AǒcVNèàxbùGeWbPyǒFDbErzóPTvdIOěAZò	TRUE
COHKJZPrèmwáDLxóǔTDxOYFdyJùLvěǎalò	TRUE
FéqvoZFufMLDzùiXvmàààwofgsManàHjmz	TRUE
HTòcssSbyěmUhyIbNǒcyGJbkdfFqthózyR	TRUE
KLNQkajAncCéZèbjCéNǔISHbjcIYWVcaxz	TRUE
NéLaǔMmdXkMsTTkUǎrhǒBhpZáWáGRCWùáE	TRUE
PvIDAPOěggCtNlhuQCUKǒGǒyěbVáGbiPVq	TRUE
SizJDhXpZwuoxNsFYkQSSéTúǒTTúWIcbHP	TRUE
VǎapSziàseXNpPǎqrézeYnQzáodǔxéaěPV	TRUE
XdfěJLàIMZàEGuzUlúúXCaLZUiRǎqFjUǔF	TRUE
aOGzuDIUpXǔCedBxbPSúLAxhdlGòeǒDCHN	TRUE
cRtUHlLujáěOZeèDjzwYibǎJbPgsQǒyděé	TRUE
fǔHUǔeééSáóMsEáVndòoèUMóJhbábbbǒvJ	TRUE
iàbhókqZGVTIóèEGiúrcùnéǎDeAèáZúAóQ	TRUE
klfxqmvàfKLTaxyiGJdFòMxZbgxeHátidG	TRUE
nUlǔáEmThvNOUPcrSutpólàpǎjRRMǎbiic	TRUE
pxǒěběPSIAwmmhJǔúrqzGWajqveèHjǔòeé	TRUE
sNúemmkéùúúuLYrzddJkámùvbfkglùPoòy	TRUE
ubǎmDeèaSGěqhòkaúhgXKéFDǒnTrjqgIéO	TRUE
xLfRixIHtóEHéjǔHtaCHOǎzENYěóXjènmw	TRUE
abéqáùRCqeVúétáhAPfécMtyjdCùJjmrTNs	FALSE
áFpqaóéLXFbajmlpBJXKOmBèZyóàlXùhTHq	FALSE
ǎRiHclEKépwoIPkEmQEhJurirJdgúbaUNlI	FALSE
ěǒswRFjfSEiqYgDNbarxOHgkDczulpxàZMǒ	FALSE
òvQrcǔvVWtpórtéáOabEǎLCphDrQwilcòoò	FALSE
AǒcVNèàxbùGeWbayǒFDbErzóPTvdIOěAZò	FALSE
COHKJZPrèmwáDLxóǔTDxOYFdyJùLvěǎablò	FALSE
FéqvoZFufMLDzùiXvmàààwofgsbanàHjmz	FALSE
HTòcssSbayěmUhyIbNǒcyGJbkdfFqthózyR	FALSE
KLNQkajAncCéZèbjCéNǔISHabjcIYWVcaxz	FALSE
NéLbaǔMmdXkMsTTkUǎrhǒBhpZáWáGRCWùáE	FALSE
PvIDAPOěggCtNlhuQCUKǒGǒyěbaáGbiPVq	FALSE
SizJDhXpZwuoxNsFYkQSSéTúǒTTúWIcbaHP	FALSE
VǎapSziàseXNpPǎqrézeYnQzáodǔxéabPV	FALSE
XdfěJLàIMZàEGuzUlúúXCbaLZUiRǎqFjUǔF	FALSE
aOGzuDIUpXǔCedBxbaSúLAxhdlGòeǒDCHN	FALSE
cRtUHlLujáěOZeèDjzwYabǎJbPgsQǒyděé	FALSE
fǔHUǔeééSáóMsEáVndòoèUMóJhabábbbǒvJ	FALSE
iàbahókqZGVTIóèEGiúrcùnéǎDeAèáZúAóQ	FALSE
klfxqmvàfKLTaxyiGJdFòMxabgxeHátidG	FALSE
nUlǔáEmThvNOUPcrSutpólàpǎjRRMabiic	FALSE
pxǒěaběPSIAwmmhJǔúrqzGWajqveèHjǔòeé	FALSE
sNúemmkéùúúuLYrzddJkámùvbakglùPoòy	FALSE
ubǎmDeèaSGěqhòbaúhgXKéFDǒnTrjqgIéO	FALSE
xLfRixIHtóEHéjǔHtabHOǎzENYěóXjènmw	FALSE
běwǒloTǎFhFaeZTààcXIúadkfnwZrOPvNám	TRUE
áFèǎoboSdúIzWitétyzEzEbYIQRhUiIǎbsp	TRUE
ǎkètaětoKbtnknsojDěhChtplxlmMúUbTNa	TRUE
ělJbbòMJMnKòhhǒéFǒBTXEOǎJèqjFáóGBèD	TRUE
ǒfZzoEKúyhaCahqóHXvùOIzLxklǒUMǒuOii	TRUE
AfibObbeGVYfcùěòaFEaTsáéfiqlruosúWW	TRUE
DàáǒòHxbPvOètDvǎxléWLTzágZělFgpiácù	TRUE
FRǔKAHdqJywTvncWǎdFAaúZébvémRxJGeaǔ	TRUE
HkfduóèZVTtcdKàICRǒrVǎLIJQPèamWHiED	TRUE
KJeQdUFMDǒǔewOKiLUaEVbMáNǎxTpbcùJgp	TRUE
MsUuzéQLvRTycIòNToHǒkùTbqfFCùcpVgoj	TRUE
QòDRibCMArJéloòádNfvlzZiFUǒUdQásCIǒ	TRUE
SjyGgPiCbVUdǎóCKúVUléRpobRRjOJkQoàR	TRUE
VpZqUlmlVákéǔùfMJjiVIèSòzaIEqvKYVad	TRUE
YagazdúWbvèFZXIùklnVEZtQòOVǎuQdPVxK	TRUE
atWBmddlwéodǔùMFSrJAVácNòbǔfanéàLbB	TRUE
cngJàhaTNéǔCZkHujagTémOPBNiùJkTIXek	TRUE
flgéòJèObsSNMǎèUóúIǒxòoGDPDENèàZOxB	TRUE
huhdèCgltǎnHMjqǒunDbXZySòZRVKuáYJdk	TRUE
kDǒCmJTWaàùnlGoxLhxcOégyùcǎuěHfěǎqE	TRUE
mjrXmèEEeILWQHREsaYgSZúNkbNAqélqèùn	TRUE
pQǔuiXrVIJyfOdracHXààubTiUHjUéoKbgx	TRUE
sCòfèětDPYEPNxKSrMZeZafZVRkhSTEjKwF	TRUE
uacUisGbnBTORnDFLóóphéBubTRétfGzbLK	TRUE
xàwvCQgǔEaTanZYRéǎFóDěùlqxikSSmKXGè	TRUE
aběwǒloTǎFhFaeZTààcXIúadkfnwZrOPvNám	FALSE
áFèǎobaSdúIzWitétyzEzEbYIQRhUiIǎbsp	FALSE
ǎkètabtoKbtnknsojDěhChtplxlmMúUbTNa	FALSE
ělJabòMJMnKòhhǒéFǒBTXEOǎJèqjFáóGBèD	FALSE
ǒfZzoEKúyhaCbahqóHXvùOIzLxklǒUMǒuOii	FALSE
AfibObbeGVYfcùěòbaFEaTsáéfiqlruosúWW	FALSE
DàáǒòHxbavOètDvǎxléWLTzágZělFgpiácù	FALSE
FRǔKAHdqJywTvncWǎdFAabúZébvémRxJGeaǔ	FALSE
HkfduóèZVTtcdKàICRǒrVǎLIJQPèbamWHiED	FALSE
KJeQdUFMDǒǔewOKiLUaEVbaMáNǎxTpbcùJgp	FALSE
MsUuzéQLvRTycIòNToHǒkùabqfFCùcpVgoj	FALSE
QòDRibaCMArJéloòádNfvlzZiFUǒUdQásCIǒ	FALSE
SjyGgPiCbVUdǎóCKúVUléRpobaRjOJkQoàR	FALSE
VpZqUlmlVákéǔùfMJjiVIèSòzaIEqvKYbad	FALSE
YagabzdúWbvèFZXIùklnVEZtQòOVǎuQdPVxK	FALSE
atWBmddlwéodǔùMFSrJAVácNòbǔfanéàLba	FALSE
cngJàhaTNéǔCZkHubagTémOPBNiùJkTIXek	FALSE
flgéòJèObasSNMǎèUóúIǒxòoGDPDENèàZOxB	FALSE
huhdèCgltǎnHMjqǒunDbaZySòZRVKuáYJdk	FALSE
kDǒCmJTbaàùnlGoxLhxcOégyùcǎuěHfěǎqE	FALSE
mjrXmèEEeILWQHREsaYgSZúNkabNAqélqèùn	FALSE
pQǔuiXrVIJyfOdracHXààubaTiUHjUéoKbgx	FALSE
sCòfèětDPYEPNxKSrMZeZbafZVRkhSTEjKwF	FALSE
uacUisGbnBTORnDFLóóphéBubTRétfGzbaLK	FALSE
xàwvCQgǔEaTabZYRéǎFóDěùlqxikSSmKXGè	FALSE
báoTWATaAvCzdYjQITigLxvRIèkiqRPětQǒV	TRUE
áUekùGPǎwkKbCZlkcùwlóvZhthGxùNBéDzYo	TRUE
ǎoyhóXLnGfǎgZncrhBTFkhhPACǒjbCzfUcFt	TRUE
ěDòùDhiàCaEaneòPàlZdicEàèaKPYàáURqNě	TRUE
òrhvǒmMXhnHitèbwǔtVyNqeWùRArTrzuǒGlf	TRUE
ANǔprbWGijjúOQáxqqONgHXTTBVaYVjRHrǔǒ	TRUE
DBStteTùMXǔTZoAZpbhRéLCróolTgèxOǔóeV	TRUE
GEXaqSěOltgJYòQdQHJjNExBwwěiòQTǒPùèm	TRUE
IQktwkCaDYXáDmXUVFEmùězùvqTjúHsAhNZD	TRUE
KkúXwFgtùùǒsprOmLQHVǎoxVWWàUòJǎěmLaé	TRUE
MzWCplnmAfjHàfZCHqWoěqùkDzkěuncDKSǎa	TRUE
QRǔúmqmelǔnóGinéGbkfǔxdFòeQXsemLcSǎǒ	TRUE
TbNtybHIitjZéhyIUhPkkoIXwcúbWcáttVfU	TRUE
WhskDǒeMLVzLLUSqokNàNònhaMǒéxCVimafě	TRUE
ZǒǎrXYVSǎxZZisNYdBmbǎbWézPApwfàáztWq	TRUE
bJjCSNùxDwOwWWJUklùecCòKbNMQvUHJádNU	TRUE
daWùJyhnPXàMedèpDAbàOWáAawunùóněVKOT	TRUE
gBnùMQHMoKHOyvOgdFFQgYóEnKúaEJmqvRàè	TRUE
ihtvnùYnTszJhjPspfrùòòalNxWMmédbQSNi	TRUE
lJóxWòOwuéHqCéGagBpNvxAdOBBZbIaiòtwc	TRUE
ncóWDSIDbpcétKúgMLbEkáYktǒfWTJvǒFoGx	TRUE
pgULuzqUVěaFuflǎzTIǎmJsáòěvOboèlEcCb	TRUE
sOujUǎeOtpòbWEVúǒoLèAVbLuJbywdRJNVum	TRUE
vòHQXGNazaKǔmBRZǎJvgjèamSJTǒPzVUSǒQm	TRUE
xkOàYFxyKcǒcuvUSxEOaUnièjzplèXsǒUoút	TRUE
abáoTWATaAvCzdYjQITigLxvRIèkiqRPětQǒV	FALSE
áUekùGPǎwkKabCZlkcùwlóvZhthGxùNBéDzYo	FALSE
ǎoyhóXLnGfǎgZncrhBTFkhhPACǒjbaCzfUcFt	FALSE
ěDòùDhiàCabEaneòPàlZdicEàèaKPYàáURqNě	FALSE
òrhvǒmMXhnHitabwǔtVyNqeWùRArTrzuǒGlf	FALSE
ANǔprbWGijjúOQáxqqONgHXTTBVabYVjRHrǔǒ	FALSE
DBStteTùMXǔTZoAZpbahRéLCróolTgèxOǔóeV	FALSE
GEXabqSěOltgJYòQdQHJjNExBwwěiòQTǒPùèm	FALSE
IQktwkCabYXáDmXUVFEmùězùvqTjúHsAhNZD	FALSE
KkúXwFgtùùǒsprOmLQHVǎoxVWWàUòJǎěmLabé	FALSE
MzWCplnmAfjHàfZCHqWoěqùkDzkěuncDKSba	FALSE
QRǔúmqmelǔnóGinéGabkfǔxdFòeQXsemLcSǎǒ	FALSE
TbNtybHIitjZéhyIUhPkkoIXwcúbacáttVfU	FALSE
WhskDǒeMLVzLLUSqokNàNònhaMǒéxCVibafě	FALSE
ZǒǎrXYVSǎxZZisNYdBmabǎbWézPApwfàáztWq	FALSE
bJjCSNùxDwOwWWJUklùecCòKbaMQvUHJádNU	FALSE
daWùJyhnPXàMedèpDAbàOWáAabwunùóněVKOT	FALSE
gBnùMQHMoKHOyvOgdFFQgYóEnKúbaEJmqvRàè	FALSE
ihtvnùYnTszJhjPspfrùòòalNxWMmédbaQSNi	FALSE
lJóxWòOwuéHqCéGabBpNvxAdOBBZbIaiòtwc	FALSE
ncóWDSIDbpcétKúgMabEkáYktǒfWTJvǒFoGx	FALSE
pgULuzqUVěaFuflǎzTIǎmJsáòěvObaoèlEcCb	FALSE
sOujUǎeOtpòbWEVúǒoLèAVbaLuJbywdRJNVum	FALSE
vòHQXGbazaKǔmBRZǎJvgjèamSJTǒPzVUSǒQm	FALSE
xkOàYFxyKcǒcuvUSxEOabUnièjzplèXsǒUoút	FALSE
bétGTóqBmjǒǒhLǎaǒxLLfDógKTaaKyvMǎièéb	TRUE
ǔqtMuéyBuzsgbvIbYěódǒWWǎlyòbZZxxdjGRá	TRUE
ǎLQóbázDHXlNgèptyLrnUěsègǎKóNèdlNhBJk	TRUE
èwcCufEǎhějFIòmuBibFgěMQOscFòJusDoòál	TRUE
òUúáPVHùTtqKúSZcwRfEidevúbóCWHvqòaFIC	TRUE
úwMXLRbIhPghShàaòQBbViSVCOlTYùRrǒàódj	TRUE
CidláRMSfpyópútèGmùSǔyjlJHMAbFWucuWáq	TRUE
FSálaBúwQàùiNóGròZnQKgUPkoéLuzRaéCMgu	TRUE
HmSFbjKqoxoJvólstDUSIèAkxLmGǔNùógdHèò	TRUE
KWDúRòoagbEetgBúcZFHtllvrǔeZQJpyraKsY	TRUE
NMètlirCZljeaQNFenùfǒlǒZwZNYaòùaYpPBA	TRUE
PpaLkòZaùndWUHnaXndàzkweKàIqǒLXJópUth	TRUE
SJgAxIitRúǔeHòpǒWQyàbWTshpIPEWWGOéóeè	TRUE
UrqDijěUQSaQTòIwwújTNySNHAǒjqmxvǒgdvà	TRUE
XYpBulKeeCáWMréVkúRùdebiZWǒóslǔHBǔèaW	TRUE
aFaxúQgDYRàmVXAhibróǎpeaúESIhǒrgPúpSK	TRUE
cDZaěLBDeAOGiáwJèojqǎbPoSbERAWXmsOraT	TRUE
eosPVtLqlETaSHcBólbBBwJzBTueXLHlùóILW	TRUE
heLJhLjIǔNrSàsIùóYKCwaEkEqbOdCzúkJVYo	TRUE
kěRwOuvczwEpqjGaaéqrdambYQYSZXjQrgKác	TRUE
mfCJyuyùèSAvEEtSFlOMQàǔjǔRWbWRyNyjCAà	TRUE
pZǎIJBjBzSJGPàWVèGHǎTcVCdyyPsáěwazFFe	TRUE
sDxMLèǎLXxEbcYsieIZrKQèVóAXdjòGqbJyrO	TRUE
vúpExwQDzsajMRRWZoGfakHnKoóBRàùgcKPiá	TRUE
xMHeSWkRvLJCyhMADàaóLfZLtAYkrPdxlZAbW	TRUE
abétGTóqBmjǒǒhLǎaǒxLLfDógKTaaKyvMǎièéb	FALSE
ǔqtMuéyBuzsgbvIbaYěódǒWWǎlyòbZZxxdjGRá	FALSE
ǎLQóabázDHXlNgèptyLrnUěsègǎKóNèdlNhBJk	FALSE
èwcCufEǎhějFIòmuBabFgěMQOscFòJusDoòál	FALSE
òUúáPVHùTtqKúSZcwRfEidevúbóCWHvqòabFIC	FALSE
úwMXLRbIhPghShàbaòQBbViSVCOlTYùRrǒàódj	FALSE
CidláRMSfpyópútèGmùSǔyjlJHMAbaWucuWáq	FALSE
FSálbaBúwQàùiNóGròZnQKgUPkoéLuzRaéCMgu	FALSE
HmSFbaKqoxoJvólstDUSIèAkxLmGǔNùógdHèò	FALSE
KWDúRòoagbEetgBúcZFHtllvrǔeZQJpyrabsY	FALSE
NMètlirCZljeaQNFenùfǒlǒZwZNYaòbaYpPBA	FALSE
PpaLkòbaùndWUHnaXndàzkweKàIqǒLXJópUth	FALSE
SJgAxIitRúǔeHòpǒWQyabWTshpIPEWWGOéóeè	FALSE
UrqDijěUQSabTòIwwújTNySNHAǒjqmxvǒgdvà	FALSE
XYpBulKeeCáWMréVkúRùdebiZWǒóslǔHBǔèab	FALSE
aFaxúQgDYRàmVXAhibróǎpeabúESIhǒrgPúpSK	FALSE
cDZaěLBDeAOGiáwJèojqǎbPoSbaERAWXmsOraT	FALSE
eosPVtLqlETaSHcBólabBBwJzBTueXLHlùóILW	FALSE
heLJhLjIǔNrSàsIùóYKCwaEkEqabOdCzúkJVYo	FALSE
kěRwOuvczwEpqjGaaéqrdabmbYQYSZXjQrgKác	FALSE
mfCJyuyùèSAvEEtSFlOMQàǔjǔRabWRyNyjCAà	FALSE
pZǎIJBjBzSJGPàWVèGHǎTcVCdyyPsáěbazFFe	FALSE
sDxMLèǎLXxEbacYsieIZrKQèVóAXdjòGqbJyrO	FALSE
vúpExwQDzsajMRRWZoGfabkHnKoóBRàùgcKPiá	FALSE
xMHeSWkRvLJCyhMADàaóLfZLtAYkrPdxlZAabW	FALSE
bùRáwbéReǔoUxQhBoéjMéAkktKDAVxǒndǒPgsL	TRUE
áYansrVqhziMFsmTZgùWěuěWMaYěmJmùYòféěB	TRUE
ǎqrtIùckKáKurNbséQcGfJHTogZieàrWDáoIiv	TRUE
ěCaéxxRdqětEábfynJQcmǒxaaCàpBùawHuǎOxǒ	TRUE
ǒǔnpUsaùzcfjVbHOJWbápmKreLuzLxBBnycoSi	TRUE
AzesyBěBQHMYpxDbtyáocZLòǔyàpfUhyxvàCbó	TRUE
DLHvvvhZaasnéRéòúXpqRfǒVFgkGlcuGáPǔǔLt	TRUE
FglJoátdeXRvùLaDéòCvgZGESGVqlSFHtUJwrE	TRUE
IófjUǒERǎRcaNpdéàEineVěPqCèayWRStFAhqm	TRUE
KPnbXEHqbtùdaRoIqPiGdOSǎGWzèeiáJCàkYyH	TRUE
NFfGLfǒlSbCsTóótdlxKXggKTSbouQAXqZfYUK	TRUE
QFumwkùqúGǎKAAnRHYkEhkǔLTROeNbǔùlbéTMp	TRUE
SUxqOeSǒfwsuoFsǒBáhKsoRběYVèaTUrKGúHDy	TRUE
UhVYTLALGàpgmàhkSéaBEDCaùJPaùDOǎvxEǒùa	TRUE
WbEQnLópuuHAgfBǎQkóAwdLBaèròjěPTxPFóyP	TRUE
ZhVopǒémDVueyZǎYoJgFTèěóJèkdaQdQǔòuRVk	TRUE
bváTxqěUAZAFàeijzNkancTáwéàxúSWKOMDDěY	TRUE
eCvtkLRDxLóVRdzRrFtSgbDgquthacobOLéyàQ	TRUE
héSTǔPVCxSbccSùzDKéjrxqydjèYjdvnùtàèvr	TRUE
ktaXcgxXècaCàTáXǔLRhJfzéWqEBEprLsOòoéd	TRUE
mwPUhClGQQEebuVdWydSCJúkoHǒugpzpèǔeàǔz	TRUE
qúóNWQéSaPVZPRaiǔSZNlNPHHùEùzbDǎTǔpkNá	TRUE
sWqndeEvBbCRJPááIfsQmpSeMóuWKàyauèpRSk	TRUE
uldFyǔARcjeěQmJfXǎxntátHnkybImIaNáTaGm	TRUE
xNǎGězúqNUcfEorymDMTǔyTutnwZbRèWHbJcYà	TRUE
abùRáwbéReǔoUxQhBoéjMéAkktKDAVxǒndǒPgsL	FALSE
áYansrVqhziMFsmTZgùWěuěWMbaYěmJmùYòféěB	FALSE
ǎqrtIùckKáKurNbaséQcGfJHTogZieàrWDáoIiv	FALSE
ěCaéxxRdqětEáabfynJQcmǒxaaCàpBùawHuǎOxǒ	FALSE
ǒǔnpUbaùzcfjVbHOJWbápmKreLuzLxBBnycoSi	FALSE
AzesyBěBQHMYpxDbatyáocZLòǔyàpfUhyxvàCbó	FALSE
DLHvvvhZaabsnéRéòúXpqRfǒVFgkGlcuGáPǔǔLt	FALSE
FglJoátdeXRvùLabéòCvgZGESGVqlSFHtUJwrE	FALSE
IófjUǒERǎRcaNpdéàEineVěPqCèabWRStFAhqm	FALSE
KPnbXEHqbtùdaboIqPiGdOSǎGWzèeiáJCàkYyH	FALSE
NFfGLfǒlSbasTóótdlxKXggKTSbouQAXqZfYUK	FALSE
QFumwkùqúGǎKAAnRHYkEhkǔLTROeNabǔùlbéTMp	FALSE
SUxqOeSǒfwsuoFsǒBáhKsoRběYVbaTUrKGúHDy	FALSE
UhVYTLALGàpgmàhkSéaBEDCaùJPabùDOǎvxEǒùa	FALSE
abEQnLópuuHAgfBǎQkóAwdLBaèròjěPTxPFóyP	FALSE
ZhVopǒémDVueyZǎYoJgFTèěóJèkdabQdQǔòuRVk	FALSE
bváTxqěUAZAFàeijzNkbancTáwéàxúSWKOMDDěY	FALSE
eCvtkLRDxLóVRdzRrFtSgbDgqutbacobOLéyàQ	FALSE
héSTǔPVCxSabccSùzDKéjrxqydjèYjdvnùtàèvr	FALSE
ktaXcgxXèbaCàTáXǔLRhJfzéWqEBEprLsOòoéd	FALSE
mwPUhClGQQEebauVdWydSCJúkoHǒugpzpèǔeàǔz	FALSE
qúóNWQéSaPVZPRaiǔSZNlNPHHùEùzbaǎTǔpkNá	FALSE
sWqndeEvBbaCRJPááIfsQmpSeMóuWKàyauèpRSk	FALSE
uldFyǔARcjeěQmJfXǎxntátHnkybaImIaNáTaGm	FALSE
xNǎGězúqNUcfEorymDMTǔyTutnwZbRèWabJcYà	FALSE
bòbéwrúóeGBúZhPkryCǎgRQóvzPGxqthDeóIJéK	TRUE
áǒEzhakOHjsdvěiIQFbmUàAWBdvqgoeDěQXdeǎǎ	TRUE
ǎnfǔxREKXTKbHǔǒyElQVwèvjRǔzǎkúkòHEYLkoh	TRUE
ěOǔQDoJojǎboIǒXAHǒPEZSAauTTxLYFYěKoExrp	TRUE
ǒBéúbSKXǔKiBkBéěYWSDHUWOYǔiZéLYQkJwFjòS	TRUE
AJYmǔvGNiVnèèWrVvTiRábbBuwòěIZypMtPqpeH	TRUE
DàWfffXháoeúFFidGPǎBAXcNlODICtLaZbúVtlA	TRUE
FOpKááhEcaLǒlhCSǎtaASiOùòoYzANReIJvhswh	TRUE
IUǎnDOùóYLnNUéfaèaVZTHúóQkechúlEǎàRGnuI	TRUE
KrbYSSAjsoxzlZjYMPbnvJYběVArGAgMxDwaZPS	TRUE
NágbDddòbbwgRǎUósUDrKxùRUqsoháIYànWněKY	TRUE
PPǎniGPxúeCèHqkBòJfbyásuTòGwúYGvNaEuàGC	TRUE
SǔDaTIPlTǎègxBLòMHXVgQǔOèBWcOBYsTnraǒfB	TRUE
VǒèJREěhúǔCèkàěéFBpDZqRǔúUkJTYgPJhbwUZv	TRUE
XcóǒXǎbzúòZdxnúuPXèéHbòybkcoPOòWTSǎkeLá	TRUE
aáOsugXcfkOàAòPGHTǒWněYásJDAójoHQDXzuzJ	TRUE
bcnoggxòěpěEúafFrRQsactsSòNdGújYDyfZEPd	TRUE
eOHBaùyYBèwAkRoóǒàJeòaZoScùdéEBTnromSvT	TRUE
hěNFSaatqeéoinxùEWPúǎjKXùEvSrFZhqJTjǔAY	TRUE
jZrLBsUròQfYqfzáxBpaǒZclMynZLFxbqsjJSéD	TRUE
máfYDkPFhrUIǎdnkyLsǎVbhiWóiAOkEvyqhǎóàL	TRUE
owdǔàvUMèMfUDkaèǒwrfHoGgBeEFsYàFèàAISkZ	TRUE
rWTòMèqbpcGJǒJvvZǔFaǎBeVULAèJjBUdelmYéG	TRUE
uéBZPFLúéàwǔobZQupGmecGVépHbHòPěNcmMQXx	TRUE
wlBiiALXfèLYspIuaoaAOvANghQǎVefǔǎMEdnWl	TRUE
abòbéwrúóeGBúZhPkryCǎgRQóvzPGxqthDeóIJéK	FALSE
áǒEzhbakOHjsdvěiIQFbmUàAWBdvqgoeDěQXdeǎǎ	FALSE
ǎnfǔxREKXTKabHǔǒyElQVwèvjRǔzǎkúkòHEYLkoh	FALSE
ěOǔQDoJojǎboIǒXAHǒPEZSbauTTxLYFYěKoExrp	FALSE
ǒBéúabSKXǔKiBkBéěYWSDHUWOYǔiZéLYQkJwFjòS	FALSE
AJYmǔvGNiVnèèWrVvTiRábbauwòěIZypMtPqpeH	FALSE
DàWfffXháoeúFFidGPǎBAXcNlODICtLaZbaúVtlA	FALSE
FOpKááhEcaLǒlhCSǎtabSiOùòoYzANReIJvhswh	FALSE
IUǎnDOùóYLnNUéfbaèaVZTHúóQkechúlEǎàRGnuI	FALSE
KrbYSSAjsoxzlZjYMPbanvJYběVArGAgMxDwaZPS	FALSE
NágbDddòbbawgRǎUósUDrKxùRUqsoháIYànWněKY	FALSE
PPǎniGPxúeCèHqkBòJfbaásuTòGwúYGvNaEuàGC	FALSE
SǔDaTIPlTǎègxBLòMHXVgQǔOèBWcOBYsTnbaǒfB	FALSE
VǒèJREěhúǔCèkàěéFBpDZqRǔúUkJTYgPJabwUZv	FALSE
XcóǒXǎbzúòZdxnúuPXèéHbòybakcoPOòWTSǎkeLá	FALSE
abáOsugXcfkOàAòPGHTǒWněYásJDAójoHQDXzuzJ	FALSE
bcnoggxòěpěEúafFrRQsabctsSòNdGújYDyfZEPd	FALSE
eOHbaùyYBèwAkRoóǒàJeòaZoScùdéEBTnromSvT	FALSE
hěNFSaabqeéoinxùEWPúǎjKXùEvSrFZhqJTjǔAY	FALSE
jZrLBsUròQfYqfzáxBpabǒZclMynZLFxbqsjJSéD	FALSE
máfYDkPFhrUIǎdnkyLsǎVbahiWóiAOkEvyqhǎóàL	FALSE
owdǔàvUMèMfUDbaèǒwrfHoGgBeEFsYàFèàAISkZ	FALSE
rWTòMèqbapcGJǒJvvZǔFaǎBeVULAèJjBUdelmYéG	FALSE
uéBZPFLúéàwǔobZQupGmecGVépHabHòPěNcmMQXx	FALSE
wlBiiALXfèLYspIbaoaAOvANghQǎVefǔǎMEdnWl	FALSE
bǔòsǒètospquaèàǒCàHwWFAWbGSǔlVúoIFhrliov	TRUE
ǔolyèEròAakdzERwdEHmDbMcépFAXcHbùxTKvMEo	TRUE
ǎOJàBǎrjtEfuSeetjkAaJWiyCuHónBlPaDKtthVn	TRUE
ěǎARTXvUxKroFgxùWoéCjKmaoKcBZMlqnédgáATù	TRUE
ǒáAVPdjmàllvuswsWgaǒwVFǒavsjómIFOǒSPiSPX	TRUE
AliǎùjxfFYfqǎgèǒgOǒbPúùrCDKǒDbwqngokQoúw	TRUE
DVéáytvWHsQkfǔeWWClRnzOTWàJúóúaáyóSUuóiB	TRUE
GáPbàJǒáTxiZvxNWLúFvUeǒúmDjàaTSlǎéJVbLUi	TRUE
IRYhbWpmqrěnSVwDPUVúKnPòEùZúěYaWzǔuěOeKx	TRUE
LǒpáHóMGNBaúúémeJuuIFmèkDinOpJIjgeqtzNhy	TRUE
OáSdVDBCzZpǎǎvcJIyEfpqVYòTWrNwakPǎǎIdIǒt	TRUE
QeTaéRTzWXúàkHOSAiIávèhěRLbtTmFiweesUǒiG	TRUE
TaéVUGlqyáyǔidDmbDzIueRyòUKùDEkevBgMewaj	TRUE
WUwsYJCBqDópbUmuweòfKAbduTLRWWfuòleerAǔè	TRUE
ZLlpVUWHěojrǒPTajdèǔaJpRURKóMfdztYKSǔPCP	TRUE
bduòCyMYGaGEHahéqVYCKvvIdYCWAOUYREUhVHtg	TRUE
dkLRùúthyǎzjǎCjàUGMúòhnicBGrMKRNǒbáViéWa	TRUE
góFàbǔzAJpDgKqlmVYěǎěáàELRBjwVobǔixvwxVT	TRUE
jájXaZSjǎòTIpNuèěUuwhHúrVaǒàXQZwDJAeZZmJ	TRUE
lsqIxQbyeBbNéDQMòjGxqYmcQzGbvHEJIòQZednY	TRUE
oNeZiapoyJzxòWèIbgqùkgǎéopǎMBhǎaAtúPXǔoG	TRUE
qdcibBxHàQahébùGMèYèJvbHnsqòIWrùyjàqCmvf	TRUE
snFCvmDúaékplzéIwnlèSLQToHbbsQWiLKRtàJUj	TRUE
uuTmsuFLUYnùzfzxuFoTGxzòbAgJHòùuKyròSrTI	TRUE
xhrKPprdlmcéIwdUnbtóUsISdNébèfDYutwPrbèé	TRUE
abǔòsǒètospquaèàǒCàHwWFAWbGSǔlVúoIFhrliov	FALSE
ǔolyèEròAakdzERwdEHmabMcépFAXcHbùxTKvMEo	FALSE
ǎOJàBǎrjtEfuSeetjkAabWiyCuHónBlPaDKtthVn	FALSE
ěǎARTXvUxKroFgxùWoéCjKmbaoKcBZMlqnédgáATù	FALSE
ǒáAVPdjmàllvuswsWgaǒwVFbavsjómIFOǒSPiSPX	FALSE
AliǎùjxfFYfqǎgèǒgOǒbaPúùrCDKǒDbwqngokQoúw	FALSE
DVéáytvWHsQkfǔeWWClRnzOTWàJúóbaáyóSUuóiB	FALSE
GáabàJǒáTxiZvxNWLúFvUeǒúmDjàaTSlǎéJVbLUi	FALSE
IRYhbaWpmqrěnSVwDPUVúKnPòEùZúěYaWzǔuěOeKx	FALSE
LǒpáHóMGNbaúúémeJuuIFmèkDinOpJIjgeqtzNhy	FALSE
OáSdVDBCzZpǎǎvcJIyEfpqVYòTWrNwabPǎǎIdIǒt	FALSE
QeTaéRTzWXúàkHOSAiIávèhěRLbatTmFiweesUǒiG	FALSE
TaéVUGlqyáyǔidDmbaDzIueRyòUKùDEkevBgMewaj	FALSE
WUwsYJCBqDóabUmuweòfKAbduTLRWWfuòleerAǔè	FALSE
ZLlpVUWHěojrǒPTbajdèǔaJpRURKóMfdztYKSǔPCP	FALSE
baduòCyMYGaGEHahéqVYCKvvIdYCWAOUYREUhVHtg	FALSE
dkLRùúthyǎzjǎCjàUGMúòhnicBGrMKRNabáViéWa	FALSE
góFàbazAJpDgKqlmVYěǎěáàELRBjwVobǔixvwxVT	FALSE
jájXaZSjǎòTIpNuèěUuwhHúrVabàXQZwDJAeZZmJ	FALSE
lsqIxQbyeabNéDQMòjGxqYmcQzGbvHEJIòQZednY	FALSE
oNeZiapoyJzxòWèabgqùkgǎéopǎMBhǎaAtúPXǔoG	FALSE
qdcabBxHàQahébùGMèYèJvbHnsqòIWrùyjàqCmvf	FALSE
snFCvmDúaékplzéIwnlèSLQToabbsQWiLKRtàJUj	FALSE
uuTmsuFLUYnùzfzxuFoTGxzòabAgJHòùuKyròSrTI	FALSE
xhrKPprdlmcéIwdUnabtóUsISdNébèfDYutwPrbèé	FALSE
bCfòNfqhYàQJùHkrccbnnùTLájtuéJHLmeVtóùOme	TRUE
áǔoyVǔùlúbjpCJsHùóòkTVcPvBháMKcIEcxJCGiIG	TRUE
ǎPóKjJObblSFOèlvgóYòVZavyLVMábTbnsNkmǎKdD	TRUE
ěbjqèrBàRovbrOèJkèWSBxZDjoKIúuǎAjZZòhuVLè	TRUE
òFPJrcnwmrqáúRànkOEěcbLZòJóNDcWDHGóIǒjKQV	TRUE
úqWsBéěFmPWSàLovùuRCCXgNóànuLIyCGAtautTtq	TRUE
CRIQLfxFèLGméCqehcgGwsmPCópMexmALCwiakWòu	TRUE
ElcZuástokieùYùNáBsǎYKJKlbrEFiùzBAHóóòPzǎ	TRUE
HnaQAaRtAgòaGqǔsYGwGHuJécThUxCQěàěOzǒùVrL	TRUE
KùbXZeVOǎFěqdòRgLWyákevPBDúnàòtiRThDUbSKV	TRUE
MjǎSMMJNjjCòcǎùLcǎcMBIuLòThUAkVaWǔMjtkbyp	TRUE
QǔjWǎtvoóRMDSáqKWYKBěóCsFàxSunVMmaOHVgoar	TRUE
SHBAXěKGccispǒcboqDIǎLsqqaaoxXlquXdxeIóèP	TRUE
VǎDUVQWóbiáóóxVlHJǎIMFsèyùJhòIIěZUyǒǔdèòh	TRUE
YóǔNkVmJaTqáwúKdvoCTgWlyKViufMrTaYcpégEla	TRUE
avbEèátMiLcUKhUkúbXUMHèGizrNURéGCNRhrPIuS	TRUE
dIbSTGǔlVSblòUzǒPiJPqPqLróJhGyYéWǒvUSúKkf	TRUE
feReòǔjOEákwGdAhxLéfàbǔǎuǒBjěLèCQWcMYPaGV	TRUE
hvaǒCmeYiaHuCVHnCiiVZVtFkèMfBxtPǎuQUrúRúǒ	TRUE
kuRCYésrPèzBAHǒEMMKDyNDěǎPMYbXEaMéǒdJDWSY	TRUE
nMNógjéjQáxnnàdSeùFqaIBCsSLzhèEAoùIéPefjR	TRUE
puzpTokàáarxoùvòàNhUaDMCZùólòXUZzààLfbZTa	TRUE
sécdpJUéBaěótVéUyYDwNoèReiSòěIěAxMqǒoylaà	TRUE
ubmdraěfVOzúRavRsJPsRYěuGBOǎTuCǎSyrkMMudV	TRUE
xǒúDàchaSsjnùvLaWAIúnǒDùXSCKVQùBXhlHObFqú	TRUE
abCfòNfqhYàQJùHkrccbnnùTLájtuéJHLmeVtóùOme	FALSE
áǔoyVǔùlabjpCJsHùóòkTVcPvBháMKcIEcxJCGiIG	FALSE
ǎPóKjJObblSFOèlvgóYòVZavyLVMáabTbnsNkmǎKdD	FALSE
ěabjqèrBàRovbrOèJkèWSBxZDjoKIúuǎAjZZòhuVLè	FALSE
òFPJrcnwmrqáúRànkOEěcbaLZòJóNDcWDHGóIǒjKQV	FALSE
úqWsBéěFmPWSàLovùuRCCXgNóànuLIyCGAtabutTtq	FALSE
CRIQLfxFèLGméCqehcgGwsmPCópMexmALCwiabWòu	FALSE
ElcZuástokieùYùNáBsǎYKJKabrEFiùzBAHóóòPzǎ	FALSE
HnaQAaRtAgòabqǔsYGwGHuJécThUxCQěàěOzǒùVrL	FALSE
KùbXZeVOǎFěqdòRgLWyákevPBDúnàòtiRThDUbaKV	FALSE
MjǎSMMJNjjCòcǎùLcǎcMBIuLòThUAkVbaWǔMjtkbyp	FALSE
QǔjWǎtvoóRMDSáqKWYKBěóCsFàxSunVMmabOHVgoar	FALSE
SHBAXěKGccispǒcboqDIǎLsqqaboxXlquXdxeIóèP	FALSE
VǎDUVQWóbaiáóóxVlHJǎIMFsèyùJhòIIěZUyǒǔdèòh	FALSE
YóǔNkVmJaTqáwúKdvoCTgWlyKViufMrTaYcpégElba	FALSE
avbEèátMiLcUKhUkúabXUMHèGizrNURéGCNRhrPIuS	FALSE
dIbaTGǔlVSblòUzǒPiJPqPqLróJhGyYéWǒvUSúKkf	FALSE
feReòǔjOEákwGdAhxLéfàbaǎuǒBjěLèCQWcMYPaGV	FALSE
hvaǒCmeYbaHuCVHnCiiVZVtFkèMfBxtPǎuQUrúRúǒ	FALSE
kuRCYésrPèzBAHǒEMMKDyNDěǎPMYbXEabéǒdJDWSY	FALSE
nMNógjéjQáxnnàdSeùFqbaIBCsSLzhèEAoùIéPefjR	FALSE
puzpTokàáabrxoùvòàNhUaDMCZùólòXUZzààLfbZTa	FALSE
sécdpJUéBaběótVéUyYDwNoèReiSòěIěAxMqǒoylaà	FALSE
ubmdrabfVOzúRavRsJPsRYěuGBOǎTuCǎSyrkMMudV	FALSE
xǒúDàchaSsjnùvLaWAIúnǒDùXSCKVQùBXhlHOabFqú	FALSE
bàDgwǒéFXPjaděcBědqYKAJcgsěxètCIrQhaHNbfIZ	TRUE
ǔkjpruRǎpMscgPPEbbYDRaékeávTtRBWòǔnLèǎNǔúó	TRUE
ǎWúnCMzXsnSPjaědúGZòWLHQClěbbmrwěpTpòZKoàn	TRUE
ěJYtnXCfHMLMKJAVmByYmxǒsalèjpnúvGLbkjpWSTn	TRUE
ǒùQLkàǒQTKqxanùSdaTèyAFJǔdpBKveááSáùSErrǔm	TRUE
AzaOěmNdcégèajKTWJIqrNirAaùCALwsYOjpyfóCnT	TRUE
DEààkOPJěQòǎIbNáVUOǎSKCrzlóǎiòZTbBTSXǒEKDJ	TRUE
FSèyUUhwlrLOBxIXFòLMVMWzáaBMpsOMeZuhòUoZla	TRUE
IBbLIGRXXYRtHZéZEXiPbJVěáGVhgzBvnObmQbeOèJ	TRUE
LàǒVQYAGCnviOoXLòfGJlZFaóxàYefttávpXǎnAásy	TRUE
NQOxGanVbúkcbpsMCAlIVcPrJZCwIábeXcjrkòáAzB	TRUE
PizCOěbfblMaHOSENFclcrowdxanVnzPàWRRkSWèHó	TRUE
SHácáSrèBZPǒrhOBheGùQQéanKRBěKYgCoAèiYGEmy	TRUE
VúBnéXDJbRaQsNafAxAlJfǎèiKlhMUTǔFàxXIFFuVe	TRUE
XecHzǒnúQakOuvòWkáfMFBaJóáùaeGwcdxQAèHǔiiL	TRUE
aBacùélpFTBǔadFzǔAěěLfOèFSkǔZWznfPpnEKhyIG	TRUE
cěROóUbOETúqǎùwEhgFZHWXpébQarPxcaógNfaWvSě	TRUE
eizAàcdrdhútshWflLVágkEUsNǒZYaixúàPbXBswmH	TRUE
heiáLFéuOuqDeATXAsLùTDoUVeMǔmqHMcUyqbbIùtE	TRUE
kaéZbIMǎùXQréúIáAPóXcKnèrELaWvLjlxájPxèwZU	TRUE
nSNFYǔaéYZqtòǎiHCnqOùòùbbDvZPwgVtiTHUCYeMk	TRUE
piCMXJSyjHEUHzúétEgáajVáLǒfJFOhstcpoáJtSwV	TRUE
sINècrBTubDKkòutiNgKbKvójáHRNBFhJQfraKJwaB	TRUE
uuhvCóéGCFdCSVéEpdDfQybHDóMbgǒGaihǔLWXQdúD	TRUE
xZALkáJUmmtOEikFbódrJeGKǔXhóTnKodáljqncfǒV	TRUE
abàDgwǒéFXPjaděcBědqYKAJcgsěxètCIrQhaHNbfIZ	FALSE
ǔkjpruRǎpMscgPPEbbYDRbaékeávTtRBWòǔnLèǎNǔúó	FALSE
ǎWúnCMzXsnSPjaědúGZòWLHQClěabbmrwěpTpòZKoàn	FALSE
ěJYtnXCfHMLMKJAVmByYmxǒsablèjpnúvGLbkjpWSTn	FALSE
ǒùQLkàǒQTKqxanùSdbaTèyAFJǔdpBKveááSáùSErrǔm	FALSE
AzaOěmNdcégèajKTWJIqrNirAabùCALwsYOjpyfóCnT	FALSE
DEààkOPJěQòǎIabNáVUOǎSKCrzlóǎiòZTbBTSXǒEKDJ	FALSE
FSèyUUhwlrLOBxIXFòLMVMWzábaBMpsOMeZuhòUoZla	FALSE
IBbLIGRXXYRtHZéZEXiPbJVěáGVhgzBvnabmQbeOèJ	FALSE
LàǒVQYAGCnviOoXLòfGJlZFabxàYefttávpXǎnAásy	FALSE
NQOxGanVbúkcabpsMCAlIVcPrJZCwIábeXcjrkòáAzB	FALSE
PizCOěbfblbaHOSENFclcrowdxanVnzPàWRRkSWèHó	FALSE
SHácáSrèBZPǒrhOBheGùQQbanKRBěKYgCoAèiYGEmy	FALSE
VúBnéXDJbRaQsbafAxAlJfǎèiKlhMUTǔFàxXIFFuVe	FALSE
XecHzǒnúQakOuvòWkáfMFBbaJóáùaeGwcdxQAèHǔiiL	FALSE
aBbacùélpFTBǔadFzǔAěěLfOèFSkǔZWznfPpnEKhyIG	FALSE
cěROóUbOETúqǎùwEhgFZHWXpébQarPxcaógNfabWvSě	FALSE
eizAàcdrdhútshWflLVágkEUsNǒZYaixúàPbaXBswmH	FALSE
heiáLFéuOuqDeATXAsLùTDoUVeMǔmqHMcUyqabIùtE	FALSE
kabéZbIMǎùXQréúIáAPóXcKnèrELaWvLjlxájPxèwZU	FALSE
nSNFYǔaéYZqtòǎiHCnqOùòùbbaDvZPwgVtiTHUCYeMk	FALSE
piCMXJSyjHEUHzúétEgáabVáLǒfJFOhstcpoáJtSwV	FALSE
sINècrBTubDKkòutiNgKbavójáHRNBFhJQfraKJwaB	FALSE
uuhvCóéGCFdCSVéEpdDfQybHDóMbgǒGabhǔLWXQdúD	FALSE
xZALkáJUmmtOEikFabódrJeGKǔXhóTnKodáljqncfǒV	FALSE
bǎZidGzQDQCGkmjYETúSWusuLZàěQSfáqlàsdRǎJARi	TRUE
áàqùMKlúǔTWSUOGflugěEnqJúLWaPpnǒNSTbioKméPW	TRUE
ǎhlGEGHěǔfǔViùpVuAhxKbeMvěLěatěFpldaóIZkGǎt	TRUE
ěLèCaiiSNEBVqòBácJúonHPiZKAhfǎbnPěgòfMWgówh	TRUE
ǒDdǔqéfòOǔTNváǒěAopuLtyXwZkáBuqùUxVqgVoGhaP	TRUE
AnxaǎàKSbùDfDDrhKáEFeǔzJEàùARúǒcTtYbbhMhsaE	TRUE
DScevpRHQJafbkěOzcnLNěgQǔòRfHwVkdNSèBKMQòaB	TRUE
FuLzbNrbǒixERóIEùRWIJAàpCayuFnòIuJIbsvyǎlFk	TRUE
IoOhMrnhmRéóùlcuejWJoDcqWCǒMaUéxlMrwjPGuBlP	TRUE
LNslDFòTXNIPRwAYTXEpéYóOBàěǒFeQyémTtǔbnpchy	TRUE
OúpǎYùibhHKtSsiVILnGùkEZǔsǎJABbuióéáHJITDof	TRUE
QSKOxzLTxsrkHntKsVVkKFVVótvuvBUàDEéFcgMǒaqA	TRUE
SWbdXPAólBlǎpfàjRiXNedPòZěXUarDùJGDoowèúoDa	TRUE
VMWMbYRwVVBZCMbǒjcěGofhBfaFSòBcdúJàmbǒapDzs	TRUE
XtQPéWJlbSrpgKzwNZóOkNgwǒòQbMǎJtQdXxAmszESn	TRUE
aǒǒòESibYuObOhòǎscfSESAóèXEWKbEiqpgPKǔcZaLW	TRUE
cGěcPaoòKYKdǔaOMRlǔNnBVgěgOMáahSKhúòXàNDdRt	TRUE
fbmeoSèǔjDRzPǒnHIgsUPHfěùSgěAuyàhfthátfaZVf	TRUE
heoXEúaděexxIYHǔSAOvSidtAMSKxkMiIoZKWMpglTV	TRUE
kHSǒiDrEzOpǎlZrháàòVúYEbsWùUeócNDIúJxfyxMIá	TRUE
mzvdùPIpglejáǒIVyejbFEbGitecèVEjǎKvXZtbhèTn	TRUE
paXGúSktWWjzvcǔAEpwhMimùDsMnqòùeNKSMàzQioDJ	TRUE
súntJvbtDsběRLtrqMcJxǎǔKVòPWIcilàwěúBMUhJNò	TRUE
upFjǒtlNǔóBbSJáǒAHǒATsuVXuaiRGeǒMxxǒǎaByQID	TRUE
xefPXvàajùjFáuěàáóeYbEbCácZDfUJnaqZbyaXpmùn	TRUE
abǎZidGzQDQCGkmjYETúSWusuLZàěQSfáqlàsdRǎJARi	FALSE
áàqùMKlúǔTWSUOGflugěEnqJúLWbaPpnǒNSTbioKméPW	FALSE
ǎhlGEGHěǔfǔViùpVuAhxKbaeMvěLěatěFpldaóIZkGǎt	FALSE
ěLèCabiSNEBVqòBácJúonHPiZKAhfǎbnPěgòfMWgówh	FALSE
ǒDdǔqéfòOǔTNváǒěAopuLtyXwZkáBuqùUxVqgVoGbaP	FALSE
AnxaǎàKSbùDfDDrhKáEFeǔzJEàùARúǒcTtYbbhMhsabE	FALSE
DScevpRHQJafbkěOzcnLNěgQǔòRfHwVkdNSèBKMQòbaB	FALSE
FuLzbaNrbǒixERóIEùRWIJAàpCayuFnòIuJIbsvyǎlFk	FALSE
IoOhMrnhmRéóùlcuejWJoDcqWCǒMabéxlMrwjPGuBlP	FALSE
LNslDFòTXNIPRwAYTXEpéYóOBàěǒFeQyémTtabnpchy	FALSE
OúpǎYùibahHKtSsiVILnGùkEZǔsǎJABbuióéáHJITDof	FALSE
QSKOxzLTxsrkHntKsVVkKFVVótvuvBUàDEéFcgMǒbaqA	FALSE
SWbdXPAólBlǎpfàjRiXNedPòZěXUbarDùJGDoowèúoDa	FALSE
VMWMbYRwVVBZCMbǒjcěGofhBfaFSòBcdúJàmbǒabDzs	FALSE
XtQPéWJlbSrpgKzwNZóOkNgwǒòQbaǎJtQdXxAmszESn	FALSE
aǒǒòESibauObOhòǎscfSESAóèXEWKbEiqpgPKǔcZaLW	FALSE
cGěcPaoòKYKdǔaOMRlǔNnBVgěgOMábahSKhúòXàNDdRt	FALSE
abmeoSèǔjDRzPǒnHIgsUPHfěùSgěAuyàhfthátfaZVf	FALSE
heoXEbaděexxIYHǔSAOvSidtAMSKxkMiIoZKWMpglTV	FALSE
kHSǒiDrEzOpǎlZrháàòVúYEbasWùUeócNDIúJxfyxMIá	FALSE
mzvdùPIpglejáǒIVyejbFEbGitecèVEjǎKvXZtbaèTn	FALSE
pabGúSktWWjzvcǔAEpwhMimùDsMnqòùeNKSMàzQioDJ	FALSE
súntJvbatDsběRLtrqMcJxǎǔKVòPWIcilàwěúBMUhJNò	FALSE
upFjǒtlNǔóBbSJáǒAHǒATsuVXuaiRGeǒMxxǒbaByQID	FALSE
xefPXvàajùjFáuěàáóeYbEbaácZDfUJnaqZbyaXpmùn	FALSE
búxéllOkXWlZiwbǒrǎtzVcPGlkJaJPézlaqàPvVNMzJó	TRUE
áGRWLOGTězEaVqrDdwǒwgcùzXjQUPvZYúSúcbqbúqojn	TRUE
ǎzbWwuPbǒuúuzZquzmGTáEbsaòtAYǒZpQTéFIEǎKdtTi	TRUE
ěZPtzòXèXOKǔǔcǎtownyfybǔIaBeVkvhòJOkqenRVNIǎ	TRUE
òiWHUpháǎxxCjeboPqhEgmtBqàYAqrèndvróYVMHwGVe	TRUE
únHNQjTXèSZyǔaebèmmǔDoXfzòAvpVpgDfRDǔcPǔáòsc	TRUE
CèeHHhlóóSpwuewZcèTCotbyNzDJCefYKfZMwMhyagàh	TRUE
FèMùxvgKZnkùFHkwimlěOòěcAmèvASkmGHówWoomagUM	TRUE
HPBjikùfAòòZèiósrbYxhàvZmdXmaVnJJSLvCDRfgǔéS	TRUE
KòòUJYOzPDlQàqdazFSRèdnHyakZǎtdcbBóJXORplRYè	TRUE
NǎòaNhjwqùGórmTaQětvéRckgRfnàóóqEǎVqtiNàBIùǎ	TRUE
QàòDaxSoADXjfúBǒéZkEffTALOdLaUDuJilèDofKvISH	TRUE
ShAfEǔǒNzGxiqFObáEnǔuǔxǎVbbunHHnbBDCǔmcepemX	TRUE
VFcIawòCFKǒwbRgnRèdEXQTejkyléúZzQgQǔixoYéàLǔ	TRUE
XkTTéjGEIyaenbòdesbèàǔVSYQETYzbyEUMpdGYlXèSw	TRUE
aJxwèóbǔPpdOùeuTiǒǎècpTvpalZneljftǔuǔKgùfóàb	TRUE
cFáaPNPXcGmfVdòwwUMbǎèIbncIGRznWkynǎuMSátroá	TRUE
esùmùnmùpIXITPHáBeGHrMJVàWsvwhpQxěHFhXùyaòUB	TRUE
iàNNǔicHpgBZTaxzVcFfFózsSáWbAǔQZGVEcIéoEpúfR	TRUE
kjVEaomGèIpVàóópEOOnàhDYoCpèUǎdhBkdzpréwjPMF	TRUE
nIMpgCRàùàLLǎebàǎdKlUiwèeUSasoGDhzdUnjZVaXvk	TRUE
ppàféXwxISLYpaUùiGzYxaqěQBZwuJGZvPbRTqoakDur	TRUE
sXsZWUKFǎǔàuhRǔbAvóAaùXǔRmtobbǎúúǔNMosUfTWUl	TRUE
vDPFTKoPPzmWPUWOQvúbǔCemEǎràQcsMúJIjWHfvǒwti	TRUE
xEǒàCNaFEYjYMǎtscziúlxyeDMǔiIòaGgrNDXXgXeITA	TRUE
abúxéllOkXWlZiwbǒrǎtzVcPGlkJaJPézlaqàPvVNMzJó	FALSE
áGRWLOGTězEabVqrDdwǒwgcùzXjQUPvZYúSúcbqbúqojn	FALSE
ǎzbWwuPbǒuúuzZquzmGTáabsaòtAYǒZpQTéFIEǎKdtTi	FALSE
ěZPtzòXèXOKǔǔcǎtownyfybǔIabBeVkvhòJOkqenRVNIǎ	FALSE
òiWHUpháǎxxCjeaboPqhEgmtBqàYAqrèndvróYVMHwGVe	FALSE
únHNQjTXèSZyǔbaebèmmǔDoXfzòAvpVpgDfRDǔcPǔáòsc	FALSE
CèeHHhlóóSpwuewZcèTCotbyNzDJCefYKfZMwMhybagàh	FALSE
FèMùxvgKZnkùFHkwimlěOòěcAmèvASkmGHówWoomabgUM	FALSE
HPBjikùfAòòZèiósrbYxhàvZmdXmbaVnJJSLvCDRfgǔéS	FALSE
KòòUJYOzPDlQàqdazFSRèdnHyakZǎtdabBóJXORplRYè	FALSE
NǎòaNhjwqùGórmbaQětvéRckgRfnàóóqEǎVqtiNàBIùǎ	FALSE
QàòDaxSoADXjfúBǒéZkEffTALOdLbaUDuJilèDofKvISH	FALSE
ShAfEǔǒNzGxiqFObáEnǔuǔxǎVbaunHHnbBDCǔmcepemX	FALSE
VFcIawòCFKǒwbagnRèdEXQTejkyléúZzQgQǔixoYéàLǔ	FALSE
XkTTéjGEIyaenbòdesbèàǔVSYQETYzabyEUMpdGYlXèSw	FALSE
aJxwèóbaPpdOùeuTiǒǎècpTvpalZneljftǔuǔKgùfóàb	FALSE
cFáaPNPXcGmfVdòwwUMbǎèIbancIGRznWkynǎuMSátroá	FALSE
esùmùnmùpIXITPHáBeGHrMJVàWsvwhpQxěHFhXùybaòUB	FALSE
iàNNǔicHpgBZTaxzVcFfFózsSáWbaǔQZGVEcIéoEpúfR	FALSE
kjVEabmGèIpVàóópEOOnàhDYoCpèUǎdhBkdzpréwjPMF	FALSE
nIMpgCRàùàLLǎebàǎdKlUiwèeUSbasoGDhzdUnjZVaXvk	FALSE
ppàféXwxISLYpaUùiGzYxaqěQBZwuJGZvPbaTqoakDur	FALSE
sXsZWUKFǎǔàuhRǔbavóAaùXǔRmtobbǎúúǔNMosUfTWUl	FALSE
vDPFTKoPPzmWPUWOQvúbaǔCemEǎràQcsMúJIjWHfvǒwti	FALSE
xEǒàCNaFEYjYMǎtscziúlxyeDMǔiIòabGgrNDXXgXeITA	FALSE
bAkjdèUléhFpǎbNzAcòTQCuttmnùùCǒméHafZIppuDYws	TRUE
áQudòGYèòàTXzRTǎmHdǒIvMFIOEhkYvSGZnvǒWnǒhbmOA	TRUE
ǎvVRúDnGaNdzGZQbqINuOwàSTědotvVRLFujRUtpézúMT	TRUE
ěǔdrAnFPmEòICwDmǔEěeSdǎǒGoDněHúaNQòwàQXiSkUpS	TRUE
òMkoaImDqSTMóyùzǔbXUQMòNPberEěbIJFRàyeWNtéUie	TRUE
AùàqAzKcaUubUgóWHsrSftSDOOlNCyèltùèNNDǔVjkVGi	TRUE
ClQqNǔézayZùQgfdTǎtfUqtmúheCarPPCcúKaPUnǔEuóu	TRUE
FPrpEúǒMGqDXBPxMaDhCWcyQlMáèjùDLGXbCexMmJéoep	TRUE
HZǎàúeàssáElkTXwtekxhUYZkMBDVbǒJonkbOwedJSTtC	TRUE
JvBsBvpětXǒsZJWàbqǎhVrsàǎIKJCTgwmEFsUWmtvByád	TRUE
MòVóxGytQaDgWSQaMǔrKkLCzOyixIOUòMOáòàVmPàRfga	TRUE
OeMTSówZYFLsěgMdsMaPMbóépQIfmdyfFYèpiórkLǔOǎé	TRUE
RbhQFbmCnFHRImMKJzluyaXPgDweqùáǎqmRùsáHZKáèKM	TRUE
UAyWYjoǎlKSLIheǒǎmKAtIJèVZUivaóesLtNùVpdeEcQK	TRUE
XújáěUfèstpUlxrZbUTvpzmCyaQkhlBxpOMGAnǎǎsòqIE	TRUE
ahjǎmáHùXPJctiUFúJstGèOoàǎKěUEàekNBJBooJLwǒMé	TRUE
cJDQjDXUOPúGKǔAxbXXLoqúdéphZěaJqiadgxòdéghreT	TRUE
ebKáfCóSVVZUGáfsWiáogDGBvaYSúHddskòBCMLkXpmRL	TRUE
hHapIZuǒChwucágáàQibwTǒMmdLOwGǎúUéFwpéALJTtQc	TRUE
jcběùATLmeqcBcNViUédFǎájvǔòhICKóLWúBADàazòyKW	TRUE
lNbMàbCEǒhǎxcéNbbIRàpàqdBnbJJéfCrHgIǒàBeěCGlT	TRUE
oRtfOGUaYFyHRvòPKPnKlkraCbHtaDèMAyuòCRWUiǔjAT	TRUE
rǔědjuúbKCěvsWaQntPWHUJdOuNptaháVeuXBAufdǎgcè	TRUE
uNoyDVJòCzPkYqséAnpěégorcZbèpFNGQuǎvnPèxmǒOjP	TRUE
xèszSǔUbklwzuòTOBOQOèCorGNúLZXmóùTxaWkoOorZǔě	TRUE
abAkjdèUléhFpǎbNzAcòTQCuttmnùùCǒméHafZIppuDYws	FALSE
áQudòGYèòàTXzRTǎmHdǒIvMFIOEhkYvSGZnvǒWnǒabmOA	FALSE
ǎvVRúDnGbaNdzGZQbqINuOwàSTědotvVRLFujRUtpézúMT	FALSE
ěǔdrAnFPmEòICwDmǔEěeSdǎǒGoDněHúabQòwàQXiSkUpS	FALSE
òMkoaImDqSTMóyùzǔbXUQMòNPberEěbaIJFRàyeWNtéUie	FALSE
AùàqAzKcaUuabUgóWHsrSftSDOOlNCyèltùèNNDǔVjkVGi	FALSE
ClQqNǔézayZùQgfdTǎtfUqtmúheCarPPCcúKabUnǔEuóu	FALSE
FPrpEúǒMGqDXBPxbaDhCWcyQlMáèjùDLGXbCexMmJéoep	FALSE
HZǎàúeàssáElkTXwtekxhUYZkMBDVbǒJonkbawedJSTtC	FALSE
JvBsBvpětXǒsZJWàbaǎhVrsàǎIKJCTgwmEFsUWmtvByád	FALSE
MòVóxGytbaDgWSQaMǔrKkLCzOyixIOUòMOáòàVmPàRfga	FALSE
OeMTSówZYFLsěgMdsbaPMbóépQIfmdyfFYèpiórkLǔOǎé	FALSE
RbhQFbmCnFHRImMKJzluyabPgDweqùáǎqmRùsáHZKáèKM	FALSE
UAyWYjoǎlKSLIheǒǎmKAtIJèVZUivabesLtNùVpdeEcQK	FALSE
XújáěUfèstpUlxrZbUTvpzmCyabQkhlBxpOMGAnǎǎsòqIE	FALSE
abhjǎmáHùXPJctiUFúJstGèOoàǎKěUEàekNBJBooJLwǒMé	FALSE
cJDQjDXUOPúGKǔAxbXXLoqúdéphZěabJqiadgxòdéghreT	FALSE
ebKáfCóSVVZUGáfsWiáogDGBvabYSúHddskòBCMLkXpmRL	FALSE
hHapIZuǒChwucágáàQibawTǒMmdLOwGǎúUéFwpéALJTtQc	FALSE
jcběùATLmeqcBcNViUédFǎájvǔòhICKóLWúBADàabzòyKW	FALSE
labMàbCEǒhǎxcéNbbIRàpàqdBnbJJéfCrHgIǒàBeěCGlT	FALSE
oRtfOGUabYFyHRvòPKPnKlkraCbHtaDèMAyuòCRWUiǔjAT	FALSE
rǔědjuúbKCěvsbaQntPWHUJdOuNptaháVeuXBAufdǎgcè	FALSE
uNoyDVJòCzPkYqséAnpěégorcZabèpFNGQuǎvnPèxmǒOjP	FALSE
xèszSǔUbklwzuòTOBOQOèCorGNúLZXmóùTxbaWkoOorZǔě	FALSE
bévMZGpVSnCàRSNKiWDIanKPǒDǒúmkěBBFwMyèúYVǔbfTu	TRUE
áèWwbNroiqékěǒEkòOSmvfDEcLNGMWwlMVTeoYbSpbǔWJy	TRUE
ǎilJóJGQgzásOYmwCXáQnpoMgLWFóMmPaeuàFIàgzlvxCǒ	TRUE
ěùpINHLeǔgxcjcaSǔTUgMQaRTěgwBPbcùSzGgPLHbhPóǔz	TRUE
òcWdaUDXJUáPOǎFayeMkbLVóuLGrkXàIǒuVèDNBqgaéwèf	TRUE
AáàAMVownihNógsWHHǎTlrkPQFaLfùJǒHPdkpKóèjrRúǒi	TRUE
ChVetsBgXqrDTNNhTzfFiǔěèyGǔlSryòHyoòdHògaèBǔbw	TRUE
FeòJERěuXkMquwnFcUAaaiùAUtJáEtZnéLúàfLUGTKFyaf	TRUE
IJbàlJPPtòǒàcrgDVQuqòjtèúLKPkTMùvDéǔMǒuvjuVàmp	TRUE
LaWZǒyènúmebòirkjemùěFyhFTtǒYnzTpVAhhjXuWmnSEv	TRUE
NVbòǎtTRtèàèYABNFTKMhABzbákǔoxrpTGTuvXmlkwCǒOn	TRUE
QRiǒNHmùséokVIYyifMnkEURàapSEMVAadLlHnvEyeiqmw	TRUE
SděbRguQráXéjBùIóòRzZǎlzvwHqtcpKahTpTubWpZCAuy	TRUE
VHHFEYàGYbUBèpvúmǔFxTYáFTtóngKáDVizOWiěàLzTEto	TRUE
XxPEóǎXKGgaTKssOCRèǒEIpěSfěóKkQtèGǔUqókIcBSOeo	TRUE
aálSyùnpèIǒxXjueZéoXSeAZZVHóaCKALZYIGivǔVnéTxL	TRUE
cxnqwsWǎbHKèǎNuákmBuQěmZnaWábOnàSWzúIyùòóDwlvX	TRUE
fOxzWxqhMiǔRutǎKXwqwǎLèKóhúybyiqcnQOnfǎjAkěvEP	TRUE
iàBhEèPfjAxáòcrKWVèYjCéléPKaVvàxTèFhOǔáeǒRapóC	TRUE
koQMITFùykSùáoRúóluǔràuIOCOOoINRFVQRdvěúYGakHá	TRUE
nOVàQaDěHCeTWòYòXHrtZXUtraZziVIcEvVERAJkimQTǎp	TRUE
pwaNWbIóqoOUNsGibmvAǎHNóVèwáěHQèQIèéYuyWbCNEXc	TRUE
sNXeawxqeYóVKǔuyJùOnJóOoGCceITQòBjFexuRǒERUHlǎ	TRUE
váduháYmLnkLHHTYdúvxàùmuuPVZPaóTěLWatgéczNòaCú	TRUE
xTHuCBéIdygǔXCGFQoáPUǒoqdUtzǒPǒLasrvneXDCpùvHQ	TRUE
abévMZGpVSnCàRSNKiWDIanKPǒDǒúmkěBBFwMyèúYVǔbfTu	FALSE
áèWwbNroiqékěǒEkòOSmvfDEcLNGMWwlMVTeoYbSpabǔWJy	FALSE
ǎilJóJGQgzásOYmwCXáQnpoMgLWFóMmPbaeuàFIàgzlvxCǒ	FALSE
ěùpINHLeǔgxcjcaSǔTUgMQaRTěgwBPbcùSzGgPLabhPóǔz	FALSE
òcWdaUDXJUáPOǎFayeMkabLVóuLGrkXàIǒuVèDNBqgaéwèf	FALSE
AáàAMVownihNógsWHHǎTlrkPQbaLfùJǒHPdkpKóèjrRúǒi	FALSE
ChVetsBgXqrDTNNhTzfFiǔěèyGǔlSryòHyoòdHògabBǔbw	FALSE
FeòJERěuXkMquwnFcUAaaiùAUtJáEtZnéLúàfLUGTKFyabf	FALSE
IJbaàlJPPtòǒàcrgDVQuqòjtèúLKPkTMùvDéǔMǒuvjuVàmp	FALSE
LbaWZǒyènúmebòirkjemùěFyhFTtǒYnzTpVAhhjXuWmnSEv	FALSE
NVabòǎtTRtèàèYABNFTKMhABzbákǔoxrpTGTuvXmlkwCǒOn	FALSE
QRiǒNHmùséokVIYyifMnkEURàabSEMVAadLlHnvEyeiqmw	FALSE
SdabRguQráXéjBùIóòRzZǎlzvwHqtcpKahTpTubWpZCAuy	FALSE
VHHFEYàGYbaBèpvúmǔFxTYáFTtóngKáDVizOWiěàLzTEto	FALSE
XxPEóǎXKGgabKssOCRèǒEIpěSfěóKkQtèGǔUqókIcBSOeo	FALSE
aálSyùnpèIǒxXjueZéoXSeAZZVHóbaCKALZYIGivǔVnéTxL	FALSE
cxnqwsWǎbHKèǎNuákmBuQěmZnaWábanàSWzúIyùòóDwlvX	FALSE
fOxzWxqhMiǔRutǎKXwqwǎLèKóhúybayiqcnQOnfǎjAkěvEP	FALSE
iàBhEèPfjAxáòcrKWVèYjCéléPKaVvàxTèFhOǔáeǒRabóC	FALSE
koQMITFùykSùáoRúóluǔràuIOCOOoINRFVQRdvěúYbakHá	FALSE
nOVàQaDěHCeTWòYòXHrtZXUtbaZziVIcEvVERAJkimQTǎp	FALSE
pbaNWbIóqoOUNsGibmvAǎHNóVèwáěHQèQIèéYuyWbCNEXc	FALSE
sNXeabxqeYóVKǔuyJùOnJóOoGCceITQòBjFexuRǒERUHlǎ	FALSE
váduháYmLnkLHHTYdúvxàùmuuPVZPaóTěLWabtgéczNòaCú	FALSE
xTHuCBéIdygǔXCGFQoáPUǒoqdUtzǒPǒLbasrvneXDCpùvHQ	FALSE
bEěùàóbzǎbKtMpCtLszOqYrXOUSQBtǔáqhtàtPòCQbIòsǎk	TRUE
ádVápKGóàKéWIKJééúèbRnfDpnKJaéèZMàJèvcIPVMquònà	TRUE
éOǔUBGbéěrXsǔVǎvAoáYUpCKkCóguLóWǎlmbeHFgRjhlcnr	TRUE
ěsgǒéuAgXǒcbLǔrPZZBǒQèFuktcLǔǔhakBHǔvBbsfdzJXaX	TRUE
ǒZzOùúěeláaòǒDHganáXLúpǒlTERjeDǒhhdUùjtǔKkAqáza	TRUE
BǒèaUNpMpgBuVJkxUǎàǒDxJjHPkaOnóEěQZaMKùZTYqcIgN	TRUE
DMFxosrùcáUySUédNazuúfǔkdLúclrNPYslEówEUOijiazB	TRUE
FzdBfwAzaQègèuKfVgyǒggGLuǔxrǎvvNbxGRàtpQvěyDáPZ	TRUE
IUápQúTPvfXùKnTBWUàbàhjùQLSUùIúHKgEemPYUéètsjàA	TRUE
LǎWlhGBfynyzdkGàTJfnoúBòbuVMDBvZEùàomzuùoEduMóá	TRUE
NHóKrqrazRséàxPkCWiVZdgpJixLělqkPRCvEitKbátPffr	TRUE
PtLòHKDEsZEtDbYàǎFDFèSěáZhPRgùtbgzVHǔněaóBǒkǎpT	TRUE
SEárEbRjVuVúùslsuáRtlǔpǎpxDHAGoòMvywbbrwbSǎeRbà	TRUE
VYOgDóǒOLeLnóSUxLbXSKLroWWáfqADgZImslSUiYrUrHǒs	TRUE
XbKùxjBVsvgRalOUZdvmxBYZEGSúkZéSèmFdfùèBEshèòaa	TRUE
aThOǎòrAbhǔaCszFFàFIMgǒhetFKrMèUCESAGWzYRaBǒEèq	TRUE
cRsSVjvgVTcùtKsfaqKEBWNkWǎVuyCOKaMcIFWWǒwFlfmbé	TRUE
fèpQczáǒxCHùqQmaaórnzVBQauQvIádBàuàajNAzCGàYpBN	TRUE
hJnywúNgReǔPǔmvbómcècWféXsGúxtBfNnQRòxóZIKiYTHl	TRUE
kWOwùFseVkSrQqazDOJpqIróǒlEfuuoagdXVGxJLěhoròLT	TRUE
nPòuNcAàOúREmpftùǔWiAjNàáòthGNKwDhJbWnbxxǒFbééF	TRUE
pdbvCNPuùTwTuùoǔfBúkaQFZCǎnPPcxǒǔzUddZěèRègQZHè	TRUE
sHFDcQDTòPVwlsenbIPgNióǎUGúGsbUChWGbGlNVmZGóbùS	TRUE
uplJDvSbvHXǎRMHfybáfúáfMáAAYCxJYiCòfTodpBjnZCbm	TRUE
xgǔkNRseYFJúgèvlIbBsmJakfùjgnGJěADàPccěèàHqqZjě	TRUE
abEěùàóbzǎbKtMpCtLszOqYrXOUSQBtǔáqhtàtPòCQbIòsǎk	FALSE
ádVápKGóàKéWIKJééúèbanfDpnKJaéèZMàJèvcIPVMquònà	FALSE
éOǔUBabéěrXsǔVǎvAoáYUpCKkCóguLóWǎlmbeHFgRjhlcnr	FALSE
ěsgǒéuAgXǒcbLǔrPZZBǒQèFuktcLǔǔhakBHǔvabsfdzJXaX	FALSE
ǒZzOùúěelbaòǒDHganáXLúpǒlTERjeDǒhhdUùjtǔKkAqáza	FALSE
BǒèaUNpMpgBuVJkxUǎàǒDxJjHPkaOnóEěQZabKùZTYqcIgN	FALSE
DMFxosrùcáUySUédNazuúfǔkdLúclrNPYslEówEUOijbazB	FALSE
FzdBfwAbaQègèuKfVgyǒggGLuǔxrǎvvNbxGRàtpQvěyDáPZ	FALSE
IUápQúTPvfXùKnTBWUabàhjùQLSUùIúHKgEemPYUéètsjàA	FALSE
LǎWlhGBfynyzdkGàTJfnoúBòbaVMDBvZEùàomzuùoEduMóá	FALSE
NHóKrqrazRséàxPkCWiVZdgpJixLělqkPRCvEitKbaátPffr	FALSE
PtLòHKDEsZEtDbYàǎFDFèSěáZhPRgùtbgzVHǔnbaóBǒkǎpT	FALSE
SEárEbRjVuVúùslsuáRtlǔpǎpxDHAGoòMvywabbrwbSǎeRbà	FALSE
VYOgDóǒOLeLnóSUxLbaXSKLroWWáfqADgZImslSUiYrUrHǒs	FALSE
XbKùxjBVsvgRalOUZdvmxBYZEGSúkZéSèmFdfùèBEshèòba	FALSE
aThOǎòrAbhǔaCszFFàFIMgǒhetFKrMèUCESAGWzYbaBǒEèq	FALSE
cRsSVjvgVTcùtKsfaqKEBWNkWǎVuyCOKaMcIFWWǒwFlfmba	FALSE
fèpQczáǒxCHùqQmabaórnzVBQauQvIádBàuàajNAzCGàYpBN	FALSE
hJnywúNgReǔPǔmvabómcècWféXsGúxtBfNnQRòxóZIKiYTHl	FALSE
kWOwùFseVkSrQqazDOJpqIróǒlEfuuoabdXVGxJLěhoròLT	FALSE
nPòuNcAàOúREmpftùǔWiAjNàáòthGNKwDhJbWnbxxǒabééF	FALSE
pdbavCNPuùTwTuùoǔfBúkaQFZCǎnPPcxǒǔzUddZěèRègQZHè	FALSE
sHFDcQDTòPVwlsenbIPgNióǎUGúGsbaUChWGbGlNVmZGóbùS	FALSE
uplJDvabvHXǎRMHfybáfúáfMáAAYCxJYiCòfTodpBjnZCbm	FALSE
xgǔkNRseYFJúgèvlIbBsmJabfùjgnGJěADàPccěèàHqqZjě	FALSE
bùWSáàǔkkeòàTréúEbtkpélésgIVAèEiZtWǔGKZGIòDjùJlà	TRUE
ǔmyQLJěAPvqKufBFèibTqLoZviCcaApauPèWùùfóiěeozWAQ	TRUE
ǎaDiAaFoǔfbIUfBtRǒXfhLdǔAiSlheòJTEHdeIBItLuJVfSx	TRUE
ěSètzáVWzgfběVUǎéóǔpwWZapytEéàPWOnòYòmapxGxQióRw	TRUE
òuTgKbJDEèwbqwpSǎsEMMCgaQutǎgOzJThǎSNǔXěèkǔUóBAm	TRUE
AUCejrDHZRIéwXaòWqbvàKVMiDlLOàqwjBlócVhóéàDiTrhE	TRUE
DùqKfgUǒmóbFwbXUkzùuOùjbTEěeGòvBéùEàgùGTěàpxfQDR	TRUE
FiàBIUmeFEfàaZpàuLgatSzmXoBObGQWhwgAkDvǎeórǒǔsHd	TRUE
IDRKObqVptOPLFUGáLàòNIHSNbJNmTkSBRéěókEǔAMtyèGǎr	TRUE
LDuHoikmXVSaUjUATjYHàéùQBsòjdèěǎùXbúCBAHúǒéqhMHP	TRUE
NbIAFjvZpTWǒèTGVkHeyLywEaàówAàIěàZǎeiwirveOzXLuJ	TRUE
QúQárXyJjCZIǔoVFMbběòzqTsiEgPècPóizYzMMǎùSaKZǔKE	TRUE
SfXéyhRwxTZnGHHjJHOAXkDaYjBXRdvQAúéYSBùRgsùǔfmhQ	TRUE
VKnpéúLmTjCrfèyWYOeǔǎjQAPTTFVsSěWbrZaěNjeáiaGǔkS	TRUE
XJllgAeIGxcYNCNXóMEJiqgCQqěúljApáaaRúéPiTNzǎnǎjx	TRUE
aPpaatGSavIjdlrbdWCXyHJUJyDgGvùkTyǒKwNùUbKaMmulè	TRUE
cKEOddBBVIBBàfJAXùbCSHQqcPomrIFqiNZMQpeVRrIlAdUǎ	TRUE
féeEǔSZThXěZfFqoazěpiǎùUGWWFKaǒPHhòǔhRVuBvKULcàr	TRUE
hltyèbxqmPNXgGsmDNBVěaYFfrhdlLEmYPhǒTFubVREǎSgDS	TRUE
khrINQiěChòFáQuwǎCpzǎSRyAxTNrWUaCYgEKhSgbCGxHIǒX	TRUE
nMǔǒkégPqSNodxIvihUBiiVwpaAMQépikáUFXWmFJcjěxwUú	TRUE
pvhHbSaJwrèvaNrRédtXuaFQJfmàvXMlZǔtǒJTCaǔrónjQéà	TRUE
slSWyXéGTWcnQSMaxINBKOèrǎbmOtzrJrJttvùypUZébgKGE	TRUE
vJáiHǒóigàbgjǎBcuzfeágVLBxgyMGFqvbLiuNjQBSpklǒEK	TRUE
xgéUdWQGYcrHMòZěqǒSQZPsOCSVdHónDKAotSDtbJoúttzzb	TRUE
abùWSáàǔkkeòàTréúEbtkpélésgIVAèEiZtWǔGKZGIòDjùJlà	FALSE
ǔmyQLJěAPvqKufBFèibTqLoZviCcaApabPèWùùfóiěeozWAQ	FALSE
ǎaDiAaboǔfbIUfBtRǒXfhLdǔAiSlheòJTEHdeIBItLuJVfSx	FALSE
ěSètzáVWzgfběVUǎéóǔpwWZabpytEéàPWOnòYòmapxGxQióRw	FALSE
òuTgKbJDEèwbqwpSǎsEMMCgabQutǎgOzJThǎSNǔXěèkǔUóBAm	FALSE
AUCejrDHZRIéwXaòWabvàKVMiDlLOàqwjBlócVhóéàDiTrhE	FALSE
DùqKfgUǒmóbFwbXUkzùuOùjbaEěeGòvBéùEàgùGTěàpxfQDR	FALSE
FiàBIUmeFEfàabZpàuLgatSzmXoBObGQWhwgAkDvǎeórǒǔsHd	FALSE
IDRKObaqVptOPLFUGáLàòNIHSNbJNmTkSBRéěókEǔAMtyèGǎr	FALSE
LDuHoikmXVSaUjUATjYHàéùQBsòjdèěǎùXbaCBAHúǒéqhMHP	FALSE
NbIAFjvZpTWǒèTGVkHeyLywEabówAàIěàZǎeiwirveOzXLuJ	FALSE
QúQárXyJjCZIǔoVFMbběòzqTsiEgPècPóizYzMMǎùSabKZǔKE	FALSE
SfXéyhRwxTZnGHHjJHOAXkDabjBXRdvQAúéYSBùRgsùǔfmhQ	FALSE
VKnpéúLmTjCrfèyWYOeǔǎjQAPTTFVsSěWbaZaěNjeáiaGǔkS	FALSE
XJllgAeIGxcYNCNXóMEJiqgCQqěúljApáabaRúéPiTNzǎnǎjx	FALSE
aPpaatGSbavIjdlrbdWCXyHJUJyDgGvùkTyǒKwNùUbKaMmulè	FALSE
cKEOddBBVIBBàfJAXùbaCSHQqcPomrIFqiNZMQpeVRrIlAdUǎ	FALSE
féeEǔSZThXěZfFqoaběpiǎùUGWWFKaǒPHhòǔhRVuBvKULcàr	FALSE
hltyèbxqmPNXgGsmDNBVěabYFfrhdlLEmYPhǒTFubVREǎSgDS	FALSE
khrINQiěChòFáQuwǎCpzǎSRyAxTNrWUaCYgEKhSabCGxHIǒX	FALSE
nMǔǒkégPqSNodxIvihUBiiVwpbaAMQépikáUFXWmFJcjěxwUú	FALSE
pvhHbSabJwrèvaNrRédtXuaFQJfmàvXMlZǔtǒJTCaǔrónjQéà	FALSE
slSWyXéGTWcnQSMabxINBKOèrǎbmOtzrJrJttvùypUZébgKGE	FALSE
vJáiHǒóigàbgjǎBcuzfeágVLBxgyMGFqabLiuNjQBSpklǒEK	FALSE
xgéUdWQGYcrHMòZěqǒSQZPsOCSVdHónDKAotSDtbJoúttzzba	FALSE
bSòKUhfluMǔěěfFCsWěévǔUTáaDXGnòzcakIdddOYXKèbApLF	TRUE
áJOeKQHAgkòEgKtImàAUHLbbzáèWùgVdaFéSèkEěgósIJHKóH	TRUE
éBJEàEAòfqǔKgQcXàQzúxwěaPòqěbùCiěóKnàvgBAHǒEPDrGm	TRUE
ěNQsáMělǒbrSgOHàyQbPěúFeMóòVPǎRRfóLěTrèrajkIngSUè	TRUE
ònpGjǔFxaNmThNaěYZaKIùbǒsHBrZcùWúEUfmpyYYaYGZTàóN	TRUE
ASDùàNhaděseNdyéóúxytkkMǔwlhtèAéeěfèklyTEwòQBVúWx	TRUE
DHIsáhHèwǎúiqTtLǔBPizhKelrbéamòèAJEYéciùéHmLAoTaǒ	TRUE
FWqIòRáOsùTqcmúvFhvbèbdàzFVlCuASfúQnnFChóYMEnòUCk	TRUE
HyiKáùwlnèNamKòoEsHòoùYóǎWEǔushiaFyiDHzfxlǔuùtgAw	TRUE
KiCXxláCoIúWvLlapwIàFjxjwOjǔǒpSTatLwzètfjjséLióII	TRUE
NcxòǔFHúbdkXHLcòRCrLwClǔéǔnKóTaúHYHHùRbàxJubRKqùo	TRUE
QUpudUOiǒéwXǔpáLaqQělKGMuKòBjujaFFClsnbAxlǒòZFàuJ	TRUE
SvRCizEUcszùceAPòAǎéRqwMfázbyKSEùòjóòjBáàNAPóZHòB	TRUE
VLIJfáFèezTMoVOCKHǒkàDxzZnmvVAbHcGěkYòbPBZqIhùkQz	TRUE
XeǎORròXFoěEbiyGVoǒyoKONDpRbèHVzthghcEfXaXZrDWTHx	TRUE
anMMWSTPIlǒXGàgmqrmXgJRIǎLùòjwINrMsybtNAWbèNPLLPJ	TRUE
cNǔáPKJRǒDcRpPUDHwacǒùóUǔqKolǔfhPGMJùGJKVrdkqcFǒh	TRUE
fHpZPWRùóàBàotèRhSBcNQácDkKGJbAXaKóDvǎfjZǒowǒXPǒb	TRUE
iòVěGlbUeZPMètnMqddzOVkXJǎLHBhéKPǔǒhVZàeJudXdJáaà	TRUE
kSúAXeuwBqlXoyXNǔPMòOǔoXTietIotHocpfFDaPKqIěMtdèf	TRUE
mǒaàQPelǔùúFUamUóXaLàXjaQoKIBKobNyáHKúeUlilvThTlá	TRUE
pPwUzMObqrWVAǔGěvGtxǎFYbAéEqSkqiéùGùéJwpǒǒMLoXnpR	TRUE
rssNàAKoQǔnúzèzǔéPjXZXOyshbǒòòMqqWJLyjXSwSqatUVAz	TRUE
vèXxaUPtEKMGHlRihvGILwbqlOyvQǒxjoQXfǔxQwkAUPrQRCB	TRUE
xLùbGRwùmPmggǒfOáNǎGòafWYúCISGYTeòdoIlwoóPKIUPjyd	TRUE
abSòKUhfluMǔěěfFCsWěévǔUTáaDXGnòzcakIdddOYXKèbApLF	FALSE
áJOeKQHAgkòEgKtImàAUHLbabzáèWùgVdaFéSèkEěgósIJHKóH	FALSE
éBJEàEAòfqǔKgQcXàQzúxwěbaPòqěbùCiěóKnàvgBAHǒEPDrGm	FALSE
ěNQsáMělǒbrSgOHàyQbPěúFeMóòVPǎRRfóLěTrèrabjkIngSUè	FALSE
ònpGjǔFxaNmThNaěYZaKIùabǒsHBrZcùWúEUfmpyYYaYGZTàóN	FALSE
ASDùàNhabděseNdyéóúxytkkMǔwlhtèAéeěfèklyTEwòQBVúWx	FALSE
DHIsáhHèwǎúiqTtLǔBPizhKelrbéamòèAJEYéciùéHmLAoTab	FALSE
FWqIòRáOsùTqcmúvFhvbèbaàzFVlCuASfúQnnFChóYMEnòUCk	FALSE
HyiKáùwlnèNabKòoEsHòoùYóǎWEǔushiaFyiDHzfxlǔuùtgAw	FALSE
KiCXxláCoIúWvLlapwIàFjxjwOjǔǒpSTabLwzètfjjséLióII	FALSE
NcxòǔFHúbdkXHLcòRCrLwClǔéǔnKóTabHYHHùRbàxJubRKqùo	FALSE
QUpudUOiǒéwXǔpáLaqQělKGMuKòBjujaFFClsabAxlǒòZFàuJ	FALSE
SvRCizEUcszùceAPòAǎéRqwMfázbayKSEùòjóòjBáàNAPóZHòB	FALSE
VLIJfáFèezTMoVOCKHǒkàDxzZnmvVAbHcGěkYabPBZqIhùkQz	FALSE
XeǎORròXFoěEbiyGVoǒyoKONDpRbèHVzthghcEfXbaXZrDWTHx	FALSE
abnMMWSTPIlǒXGàgmqrmXgJRIǎLùòjwINrMsybtNAWbèNPLLPJ	FALSE
cNǔáPKJRǒDcRpPUDHwbacǒùóUǔqKolǔfhPGMJùGJKVrdkqcFǒh	FALSE
fHpZPWRùóàBàotèRhSBcNQácDkKGJbAXabKóDvǎfjZǒowǒXPǒb	FALSE
iòVěGlbUeZPMètnMqddzOVkXJǎLHBhéKPǔǒhVZàeJudXdJáabà	FALSE
kSúAXeuwBqlXoyXNǔPMòOǔoXTietIotHocpfFDabPKqIěMtdèf	FALSE
mbaàQPelǔùúFUamUóXaLàXjaQoKIBKobNyáHKúeUlilvThTlá	FALSE
pPwUzMObqrWVAǔGěvGtxǎFYabAéEqSkqiéùGùéJwpǒǒMLoXnpR	FALSE
rssNàAKoQǔnúzèzǔéPjXZXOyshbǒòòMqqWJLyjXSwSqabtUVAz	FALSE
vèXxaUPtEKMGHlRihvGILabqlOyvQǒxjoQXfǔxQwkAUPrQRCB	FALSE
xLùbaGRwùmPmggǒfOáNǎGòafWYúCISGYTeòdoIlwoóPKIUPjyd	FALSE
báTsVgVMcTAhHyhQWǎZwrbcjLajYZmtHsdSLkfawǔvQjZWaPqt	TRUE
áhNsèVcěZWǔNUmWaGpanTQVòkAjOtrLáYppwxVǎKbégPmtKǒTò	TRUE
éòóòzwrUóUjwtahSiDQáygViòaáwǎhzJcésǒòzbdlBEjáVwXǒX	TRUE
ěbyAúokJéJáioùěudfǎmcDLkàmRbuqbuYáǒwNgzAùhrǎòJhèoD	TRUE
ǒTèemDòJHòbóiBǎolWElVGdgKRyaxùSbgeoRmKǔetǒěóuDjhGà	TRUE
BEdhSWXéZFKUǔúYxǒúSecǎQPzKMaBKóùyaRLkèyàeàSvwWéivk	TRUE
DzYaéHǎǔfeytuXàSQHùeYúebQrHguxBěUàTVIIAbKUmàpEzèhV	TRUE
GkùRǎHieěJLělAIPCTIsúPBFNàGsCGàóoóbIZBkǒbNèàtBiBZA	TRUE
JHCxqèòéàxótMqENLǒzcǎáòèZbcgnRuùoéxTBCAItGòsQMcvóA	TRUE
MFtùWHwNEOjjLFápAYzDbAtmcrvpKGMhòazàljCaQUOhfMIdbè	TRUE
OièàèGpòvjTOgiaùaDRámèLndHTǒqSJPǔTcbQǔEZZSbǔdMfVks	TRUE
REKáXKXxnùUXiǒvXSZsQàYHiòqJQBěJdVǔuDéFàAwttugbrNHě	TRUE
TOtúiwcVáurJsáLHYIzXphvAdéoShqrbHexelvvPPRwlZmUfuv	TRUE
VrBbSlbIOLjMBtemcheLZpzextKUdvQOQtqlzVwěEjQàwbéSnZ	TRUE
YSDJxGUZǔLfaCIeshóvbobDvIIaéàOàǒFédóòsmpsLjRCdǔjúe	TRUE
bǔZǒGENlvèIMKOěOTrKQzbǎQòQkSrVQùmdǒFzKGvWxymkgószf	TRUE
dacáDHsFLùElóWckilIGuvIbúayGèxCAǒǒOQhsyàvQyEDLhmǔV	TRUE
faapFOXVNǔWWgJǔEjDéqóodEAǔDaHjBtèdCnTYjfbuáqukQyyL	TRUE
iBěZJMOywpXèfKěQxjUjMNRǎúAIkápGbAUzpkyPùfBuròQWkAE	TRUE
kWSJaIiRěyScàgjKaěQěDUàpJquóKeMCVVjxajLIQGvGavCAWg	TRUE
mreafarvóxbZeZfúZsáúáòAINǒWkinSiQhDòsvVDèPWwwrǒdmu	TRUE
pSEzoGhIztHEòáAlrtbzlZSobbUàngsàiaXmfkPMSdǎhpòwHux	TRUE
sáRázgshmCǒZAǔcbsjtàiruBAáAèHkwmgúYGOCǎMòNGGROowCx	TRUE
ukgfFadekOuwkyMkòhaHcoqSpUpwexùYèòRQQóVàiǔòmypěVEH	TRUE
xdkuRWáúbUséTayOǎbáoráIxNQLAóòyúKoEPúǔómWIebSaùqjm	TRUE
abáTsVgVMcTAhHyhQWǎZwrbcjLajYZmtHsdSLkfawǔvQjZWaPqt	FALSE
áhNsèVcěZWǔNUmWaGpanTQVòkAjOtrLáYppwxVǎKbagPmtKǒTò	FALSE
éòóòzwrUóUjwtabSiDQáygViòaáwǎhzJcésǒòzbdlBEjáVwXǒX	FALSE
ěbaAúokJéJáioùěudfǎmcDLkàmRbuqbuYáǒwNgzAùhrǎòJhèoD	FALSE
ǒTèemDòJHòbóiBǎolWElVGdgKRyaxùSabgeoRmKǔetǒěóuDjhGà	FALSE
BEdhSWXéZFKUǔúYxǒúSecǎQPzKMaBKóùyabRLkèyàeàSvwWéivk	FALSE
DzYaéHǎǔfeytuXàSQHùeYúebQrHguxBěUàTVIIabKUmàpEzèhV	FALSE
GkùRǎHieěJLělAIPCTIsúPBFNàGsCGàóoóbIZBkǒabNèàtBiBZA	FALSE
JHCxqèòéàxótMqENLǒzcǎáòèabcgnRuùoéxTBCAItGòsQMcvóA	FALSE
MFtùWHwNEOjjLFápAYzDabAtmcrvpKGMhòazàljCaQUOhfMIdbè	FALSE
OièàèGpòvjTOgiaùaDRámèLndHTǒqSJPǔTcbQǔEZZSbadMfVks	FALSE
REKáXKXxnùUXiǒvXSZsQàYHiòqJQBěJdVǔuDéFàAwttugabrNHě	FALSE
TOtúiwcVáurJsáLHYIzXphvAdéoShqabHexelvvPPRwlZmUfuv	FALSE
VrBbSlbaOLjMBtemcheLZpzextKUdvQOQtqlzVwěEjQàwbéSnZ	FALSE
YSDJxGUZǔLbaCIeshóvbobDvIIaéàOàǒFédóòsmpsLjRCdǔjúe	FALSE
baǔZǒGENlvèIMKOěOTrKQzbǎQòQkSrVQùmdǒFzKGvWxymkgószf	FALSE
dbacáDHsFLùElóWckilIGuvIbúayGèxCAǒǒOQhsyàvQyEDLhmǔV	FALSE
faapFOXVNǔWWgJǔEjDéqóodEAǔDaHjBtèdCnTYjabuáqukQyyL	FALSE
iBěZJMOywpXèfKěQxjUjMNRǎúAIkápGbaAUzpkyPùfBuròQWkAE	FALSE
kWSJaIiRěyScàgjKaěQěDUàpJquóKeMCVVjxabjLIQGvGavCAWg	FALSE
mreafabvóxbZeZfúZsáúáòAINǒWkinSiQhDòsvVDèPWwwrǒdmu	FALSE
pSEzoGhIztHEòáAlrtbzlZSabbUàngsàiaXmfkPMSdǎhpòwHux	FALSE
sáRázgshmCǒZAǔcbasjtàiruBAáAèHkwmgúYGOCǎMòNGGROowCx	FALSE
ukgfbadekOuwkyMkòhaHcoqSpUpwexùYèòRQQóVàiǔòmypěVEH	FALSE
xdkuRWáúbUséTayOǎbaoráIxNQLAóòyúKoEPúǔómWIebSaùqjm	FALSE
