ùǔMcxRusvGaCrUěGácaa	TRUE
ǔTzLoUcsEaaMKiRRIQCY	TRUE
ápHLcFúoaaǒeQfúNzxǒR	TRUE
ǎNUóǔikěógǎcMOaacěvú	TRUE
édlSqúFyHceTioZRVsaa	TRUE
ěǔtvpùSdDcuuAdaajháp	TRUE
óDDèàNeSǔOcaarCǒVALm	TRUE
òaTBcaawKYRPèdkqiǎoe	TRUE
úóGZxUgjcXyaaVrùsáVJ	TRUE
AZpdhcstIsáfMTaaFywG	TRUE
CàSjHúmDcGRaaYZyùzOp	TRUE
DOkFWcóěeaayóQBcALzN	TRUE
EecézUàvlpiHDaaONěcY	TRUE
FwjuǔáOUvǒIQEnLùcaaf	TRUE
HcxOgDryHCRIBǔěTaaJt	TRUE
JIcIkkfǔǎtaaǎmhjStsr	TRUE
KsLHxcèúMZWpPiùYaaUT	TRUE
MOGLcznéaaGaRGdDúNBc	TRUE
NcSjaaIěJěqQnyéseEpA	TRUE
OwPclóǔkóTǎEaauFtBTX	TRUE
QNuùSJLcuFqVZWYKaaFé	TRUE
RiHiXzYuhGcMóHóaakOi	TRUE
TBòeáwHcáuPdmCaaBéEJ	TRUE
UkEújKLPiécaarupFVèF	TRUE
VxacIByzNsjaaAkEèroQ	TRUE
XBǎcTZoánaagùhoYplwr	TRUE
YQLǔóvAAǒrsGcǒqǒCaan	TRUE
ZwhBcǒEKlǎǎaaYNǔtZvà	TRUE
bIDSdXrEólcFaěaaklRt	TRUE
cèiTzrkKXtfNWúaaHHéa	TRUE
cGIWnógéFdQKálúaaqZC	TRUE
cSpaaChIFEúvyBěFfhǔé	TRUE
cbaàKGmSZQzdSaaLcàbl	TRUE
cmFhdǎaauhGUpIamQmIl	TRUE
cyTùoáSKoCbYaarèwTlp	TRUE
eIvXcǎBdlVyxhrlaaMǒt	TRUE
fYYEscWBqRèYJiIwNaab	TRUE
gophpqúmgcfJMNTeaary	TRUE
iScǎgèGXVpaawzXOǎGpX	TRUE
káITǎaǎQAFOQEQEMcaap	TRUE
lYEuYòàcjMiàaaòǎhFJA	TRUE
mwiOSHeBòJlEFzcBòqaa	TRUE
oQXEkcwNaovSSòcPaahJ	TRUE
ppiocxjgYdyqymaaMBwi	TRUE
rLFHftfRétTcbaaWáUKi	TRUE
secxǎIaaUówJHMYCUouH	TRUE
uTdpSHVicDaaVCWúpSzI	TRUE
wùCzǒZTyQǒppdcmaahWV	TRUE
xCgyrúuUcMèaèlKaaQùù	TRUE
yPóǔkcMǎwèeOBáǎXaaǔǔ	TRUE
ùáLDARJxòJXpQNdwQXNA	FALSE
ǔòěébùLSOVQèǒarUKAXL	FALSE
áEHlàDQTóIóECDeiBLpó	FALSE
àQaRoCoYfBJáǎnFuMBAr	FALSE
ǎoaWmqtCáeFǎmzqòáùwà	FALSE
èHèXGcqqRàPESeàzèWaě	FALSE
ěgǔhQYDóKùeùIàAFcmOě	FALSE
òPRqrTskèvuAXOftXfEó	FALSE
ǒsGúODóRǎZpmzWSzgVug	FALSE
ACbpAMjfJjqIUrǎzúGóc	FALSE
BRfúǒQVsQBNJrKpdéàOw	FALSE
CeàǔsòXùYwCcHMMGeǒrd	FALSE
EóékòbPssFiUòóqiùkpH	FALSE
FCJxmivwgXàáóNpǒdzcE	FALSE
GZEWǎKùbUJtQyFFDzyXZ	FALSE
IěGiVYmrgùtxDufvfhób	FALSE
JOoQiòkUWaNáTǒOkùkei	FALSE
KjeqfjeJGgIwǎXFèYBog	FALSE
MáRkXaěkTXxéTóqjGùVj	FALSE
NKKoVNVoPwáǔèfzwǒOXk	FALSE
OSkhKEfSLaùLCjRdàELo	FALSE
PuǔdXǎcatmhIiáxLBFIy	FALSE
RSNměJqLfpJèQtPxYbIW	FALSE
SpéǒJSUVZoyóéZUNgioE	FALSE
TwècgáfòLKmXypiLDcPY	FALSE
VěiXaNěeJMátpASkàpmK	FALSE
WRJpuUóNjábúKubUòydq	FALSE
XPUUǔYéAzVKRWàJheumi	FALSE
YfWěyéSVcáònNKxYFgCD	FALSE
ZmlbBàKLmWPtbqyHkùǎl	FALSE
béùSFùèLcfYaqmvyFàNg	FALSE
cLfHǎcstzptmpfǒeiHTv	FALSE
dcǔòúókjDHvDQxImYAMK	FALSE
eimdéKǔyěùQpgXWQHbFw	FALSE
fqJhlZsgSóSIKQGóKjVF	FALSE
hFtǎàxmǒHQbáErNShèsǔ	FALSE
iKaewSaéFóEzPNoòDǒnK	FALSE
jQGdMCzIvWGǒqbqèfòyE	FALSE
kgDcIipGOyVJQsPKorgq	FALSE
mùCEYǒúwBvlIUyGbkFtJ	FALSE
nǒxZYǔzněmxKFRǎrXǎzǒ	FALSE
oOPúNùnplcúsytsaWKdo	FALSE
pozIyUiǎKLeLkigoQJho	FALSE
réudRBRómnLlgqFpPwVǎ	FALSE
sPèrtòKajrdnJǔBetKsU	FALSE
teúyHrLmRbuATBUHòDGE	FALSE
uqdCEUěBàUhbLFtǔpOhu	FALSE
wEpùfgsóhIQsGúAùSKrB	FALSE
xSYóJfqùTgJIhúeAjYbn	FALSE
yqpJtàXLwǔxUquUTdǒeu	FALSE
ùùUcZwóúfqǎaaKtpRIxLǔ	TRUE
ǔSSAùFNèTóMYócaaěxxxc	TRUE
áuáyújecqMAaaVKàeàměc	TRUE
ǎGdOǎèYccllLSmaaZHemP	TRUE
éfcWègNdRúméBǔaaFOZlX	TRUE
ěJcAaaXIváTvěòKYǔESùt	TRUE
ócwvtuTwěaavèǔMadYDpi	TRUE
ǒǔócYtXlDZhBSMaaGUǎPw	TRUE
úcDoUOèNWmDbaaOdLvnZf	TRUE
AgomZcaaEGfbzNMRGxjrN	TRUE
CFWàcHoěéqhnQRaaFCVxg	TRUE
DcaaùXuTIUWFCùnbsIéWc	TRUE
FEvDeSVbvDnZǔcaaZQàaP	TRUE
GhCvjòduzǔmNFQcaaǔJDg	TRUE
IùPrúVmCGJYcZBFKAaabq	TRUE
JKwqhHUccZnHóaabseoga	TRUE
KsòXbAcumwòrDKAaaTaGY	TRUE
MQcSfaaRmòdDtvPvIpZLb	TRUE
NqěyBNWIěmOAcxInXwuaa	TRUE
PCvIksiǔBVcadJpkMòEaa	TRUE
QPwctbxóRaapDTZúěfIùj	TRUE
RmHUqjǎQZcaaèHvjLǒJón	TRUE
TěLwǔvaXGhácùàyZjxǎaa	TRUE
UcYahgSgWVEǎǒCllLEgaa	TRUE
VxáyBaJPcxbùbwNuóaagx	TRUE
XZèIòZiyOxjcǒwpFtNaaé	TRUE
YmaócǎXǔTècPnópIéaafO	TRUE
aWrcZXpMrJJòwQaaènZqv	TRUE
bgMǔjòTdcZómYpAaafpFl	TRUE
cǒCsúYazKNtLSáqOaaqxZ	TRUE
cNǔGaaIhpkúLiKEènObéB	TRUE
cZQǒDZyHdnhóxàùaaieQi	TRUE
cjěDPúlěAòaaNURsùúpoY	TRUE
cuNSèqěCkaaVQoVLMwKsr	TRUE
dcHǒPMùFGaaVoUqAaMHNǒ	TRUE
erqluáqcBuoaamDGèLTIs	TRUE
gMLVcRGbaaYiéqKjWceNx	TRUE
hsǒDrOcmLDjiaǎXtEolaa	TRUE
jKSiDvCWzKITIXvdBcaaE	TRUE
kpYUksǎMgvDGǎòczaaDYN	TRUE
mByjMchDGàaaWKúDcúàpO	TRUE
nacaaVrPbTAěmdcvZuThG	TRUE
osrDcaaùSǎòXǔUéppěvsú	TRUE
qVěNypRCnvwgymzcIydaa	TRUE
sùkeCrfòMǒǎcWABáaaùbA	TRUE
tWòǔnǒLHcMvaaúRKJaYúV	TRUE
ulvjeùòcàfáèjaavaXcáǒ	TRUE
wèkQXacaaWazyxZQvéXNú	TRUE
xNZYéěǒcQěòNZàbFuaaaU	TRUE
yceMZfQhGùoEriaatóéJa	TRUE
ùùéTunexHALFuàrPdXRow	FALSE
ǔHXVmòǔáhzmǎyYbmTgMQF	FALSE
áZeARéxòHcYyRěòKCsoXT	FALSE
àzfuYXoukjpEDúYèuyDJw	FALSE
éAQǒHbjjcòáòLQxRJSfce	FALSE
èMrèrTZTtààYBàOZJlDOà	FALSE
ěhTúNǎázhǒUEDOhcnqiVF	FALSE
òLuAtMèJrRcpóKGmáETèH	FALSE
ǒgàLtězWsJVopWELVPWgC	FALSE
AǎxǒRJVògkǔNVéBRvěFjF	FALSE
BòvCcRbBùǎmFZubKRVatf	FALSE
CSsRDǒmXMòtùpTEoeVGKI	FALSE
DldCXEǒJwVaróUKVMOpǎó	FALSE
EvúyěQVěòěVcěYèaYVěQI	FALSE
GǒJBCfěSHOéMiXMTazèsu	FALSE
HKrúuLàgIHXNyqoǎrMRea	FALSE
IjóáHzBuAOGaHxKtMKesú	FALSE
KOzéPáQYbněǔexBúnèCkB	FALSE
LRaCpCOVUZèAzTXlXbgFb	FALSE
MXEIUóUùgQbdiVavZSmXz	FALSE
NqbtXBHbnPégVcPQùDxsh	FALSE
PADèkNWsjuhIZbǒBLrèZV	FALSE
QHMFFQáqqStsáhohAěǒZs	FALSE
RjfQKaQBCuGUòKHkúùdAC	FALSE
SvHǒMqsěpèBnmHtgxKQuk	FALSE
UKBzgáXòèMzJxQCxvmnQY	FALSE
VgPKFbsǎàǎaeKoOSEFaCu	FALSE
WxuaádPflcFvtǔPúuzèpV	FALSE
YFàXòHUBUùJuvTVZyǔNpy	FALSE
ZavExlvgòttLèJvtjunlR	FALSE
bùèTJdpbeFásgǔXLànwtB	FALSE
cúAàòóTǔGHKYqIYiupǎSǒ	FALSE
dFuYvzHgqVgHFzmymGfvh	FALSE
eaǔDgǔMVFNDècáSèvaAqp	FALSE
fywzOBXLjDGcKǒǔtlMóLù	FALSE
hCQgsPXiwWHftDnSmòlHk	FALSE
icFáIqAvUjòisuCyHGNkù	FALSE
jkódYěiqdeisěbQiQmRée	FALSE
lùǎhConKèqUXúAWǔòQTyi	FALSE
mJOBUlGǒtXiáxthhpDmǒǎ	FALSE
nbLkǎPdAlDdIsdGIOYpRz	FALSE
omLǎhNWDLaqQtNZznXxIA	FALSE
qáQnlAǒawYzoóKfǒHPDAz	FALSE
rEOcKrúuCAiVWQGxǎPfqL	FALSE
sSiYcqfrǔEepCěYHtyEQu	FALSE
tdùvtoYásEbaGěGjúHBoǒ	FALSE
uzùAnHèQKFǔOFuuReVǒèT	FALSE
wDSoǎòKLbésAKVNèjHBéè	FALSE
xSzTPòQòrytCcGpjplpbǔ	FALSE
ymqVficwtYémysHGǎGǒcL	FALSE
ùǔJǎwcvIrJaaùGáYkmVSěT	TRUE
ǔcTgqoàGpUBQYAzaóJvaao	TRUE
ávnXòAtglhcMòjmǔqǎaapZ	TRUE
ǎHMcPVOǎROFcoyqaèTaaép	TRUE
édRǎécxgfěùmUaaHgrUcùt	TRUE
èxcǒórFiaaBjLFwEúnoRdm	TRUE
óZccaavkpěràXsBeiúDaiG	TRUE
òhbtcǎǎOaaEòwqJheSgJGD	TRUE
úAcOCTàDpkHaafTeKtIVwN	TRUE
AaHcaaèMdIinpgzúRàVZsh	TRUE
CóelwoTǔCaZYOEucrhaajù	TRUE
DcéRQwgTjaaNdgHmukpágg	TRUE
FéAlUǒVEPcaaófàéQGMèèC	TRUE
GUtKuZLcKkXnaapZěmióxt	TRUE
IélGEcnióqGNWxRaaěZMǎY	TRUE
JcKaKdCaadNntDiIXLáeZU	TRUE
LéYLfUzUHdcǒNaaeěěprjL	TRUE
MVPlFtDYmOùúcaaFLDhXyǔ	TRUE
NuqfzOtgcDiSUóájcaaaiU	TRUE
PLvuCOkCqcJOvúsliraaMB	TRUE
QhǒSypBqJòěauVHEcjaaQú	TRUE
SSYZWcFòkMùPxDǔGaasbtx	TRUE
TcjúxlupúyaaLmlpmxHǒbg	TRUE
VòOòcwùaaYǔáWQffòdmQfw	TRUE
WkNóXICFlcóZHaaagoErǎě	TRUE
YǒgcZsǎNgaarZTzqhàrjéU	TRUE
ZTAùwtécTZùExaaGAAVùjR	TRUE
acréáZYaabèlRfUIiqXtEO	TRUE
cùTIRFǒěFRaaQEGǒèVèòòZ	TRUE
cAaaEAtpboTLEfYKWdgSoà	TRUE
cOyYdpùqGUyùbcJwwaaAǎc	TRUE
caaBgQHaóěfwqcSbugSirT	TRUE
ckUǒPrNèTaFéELyLTbvnaa	TRUE
cwǎaaiǒNùmVěóKoóàwMxKǔ	TRUE
dsvàWcǎgfaaLJVZVmRUSqD	TRUE
fTZcPumóFxCbNAMQaaEywc	TRUE
gurvQdeJBlcADYsěEYFaaM	TRUE
iAUěTDóQRǔgRBGckoHnyaa	TRUE
jWSúcòàHǎlaaRADojfXiǎǒ	TRUE
kzSAdoQùFjcaalWzàkcǎǒf	TRUE
mRWWcFwuwZaabTyrljNpbB	TRUE
nhfcNBNhoaamdqKEPěFoAò	TRUE
pèNNFQuGvTLzZKcnuaaskK	TRUE
qajHzTcuèèosQHvLAMVEaa	TRUE
sékIbcaaUaLvLSAFKcspoǔ	TRUE
tPLPùNcuaéùfvRbdaaliyN	TRUE
ucvNSQEmaaáòbApPkòEPXa	TRUE
vhZUágòDgHocaaúSéSetDA	TRUE
xǎfazcóaVrrhhgúOBxàTaa	TRUE
yTGGPcXMqAǎyóaawnusWuǔ	TRUE
ùùLgkOAjǔOzómFlLpúǔǒiD	FALSE
ǔMHiǒgDravFTqGcTiKcèáě	FALSE
ájǔCQjJKJeòbùtOARúZxOy	FALSE
ǎèxáyjǒmrQIqUFǎWúKhhhL	FALSE
éPgǔinǎSUǔWněèaúzmywKo	FALSE
èfZzévdiOtéINDbqxǎtYǒg	FALSE
óáapěěMVCáùRěmsverǎUyI	FALSE
òLdúòǎxùUUUSiltUcmLMVx	FALSE
ǒfxAJKcěpǒZIxébLIXloXò	FALSE
úypNlLdPVbRDuqERIóxéXq	FALSE
BHXecYGàRUàyFàǔQYEVtwF	FALSE
CfmRmZvFQQiKéXdicohǔpg	FALSE
DxaèǔcééojKhUNdóBápǎKH	FALSE
FègjtdKcIWBsyDIdkRBǒsx	FALSE
GNrOrùlMLvjiZaǎEèaiLàó	FALSE
HTFCTǒINèNǒiaHKhoòeKzx	FALSE
IgmGaubvǒFǒHnXěómèěAǒl	FALSE
JqWEvJwEglzàlTóAIyOkEC	FALSE
LúùvFigUnbfzundjěVAècà	FALSE
MeZdúBPěéàfòFénweZOYdo	FALSE
NyJèZCXNDàeaLqéFETZmZM	FALSE
PFHmùkmPuusJtxLhSxFNcM	FALSE
QTǎwáéisVPnTESpdVúqbnj	FALSE
RguěZKtSHxuoytYoxNàGNK	FALSE
SxGVHǒUJjWJkòXAàáOěiPP	FALSE
UNYgPVxqǒóCEoVqǒnǔòTVc	FALSE
VjǔTmDèHěqǎěSZdáFNtǒùc	FALSE
XǎvTdvCVSWdCvǔNDúTQěTZ	FALSE
YTsXLCLàVUvBEBHPHBRHtv	FALSE
ZYPgINYnVIEpYcěFYùyQFQ	FALSE
ayASHrHáùNayVOqursòoèé	FALSE
cǒrELAsSùvDGjurcǔjuwnH	FALSE
dBOsMxxUkǎTvZYnYmGnIcb	FALSE
eToúaGTàUCkXMZàKQWmbFě	FALSE
ftZLjXDZjAǒczǒzUdsòxǎK	FALSE
hǔàIrAdVǎWTxRǔYNělQcrA	FALSE
iFCsOzumsBwcoaLěvǔupSN	FALSE
jZeTǒBYuRóbFùdJxxěTvrǒ	FALSE
kihávJNyDERKMpCplUcthi	FALSE
mǎJáIEèPifùTrKùSVoScòj	FALSE
nPTYLmǔùfmǔBócaèǒcMàóL	FALSE
ouEúǔyOCGtoyodTtaYdùúg	FALSE
pxèNUKúxDWZKǎwyLlZjDgù	FALSE
rèEuXyùmghRDYjixùUrùCé	FALSE
sKǔzurXěVVQyiYPLgVǎAAǔ	FALSE
tjAéǎryLnipdòGǎòMIAFNN	FALSE
vǎdéRòwVtGǎwòZhAboLRèV	FALSE
wJávhVtGUnOlpěEFiakODě	FALSE
xbàkěáòeièjWeAtàMVúǒúu	FALSE
yfpyGAgVùqěJvěomEqRWDQ	FALSE
ùùUǒJcěNǒzaavUgaJAEDgDY	TRUE
ǔZǒéFěZcúkzqyHàaaòěSmqc	TRUE
àúǒYVcHsvxbcFKláXaaPASW	TRUE
ǎVKUAlXnxácJZqXǔáqJqaac	TRUE
ésiPdòtucsCèTwSaaǒVàòoé	TRUE
ěPdqlqcócpaasKbnèVydLMd	TRUE
ókXYǒoQvgfcxpǎjEaamàMZg	TRUE
ǒLUJAcóaaèLkqméémPjcDác	TRUE
úlbFxiwAAOyPěvcàaagGmxA	TRUE
BJǎCJYcTVvCzHCXǎGPaaxmd	TRUE
CeYcpqduTjeafèhaaòèàátz	TRUE
DyvǎóMVABcàyuXǔYàwaaǎěm	TRUE
FSpsPOfwclLhaaECéVrǎZQl	TRUE
GcWlaacnCébnvIvǔikLXěLf	TRUE
HwnmNpSJIgèájǔJcaadTaIq	TRUE
JPFviDbǒàcpaaèúǒDěfBzdG	TRUE
KqèKAǎscBGěkihaagěAXydc	TRUE
MOWtQácLkBúnaaSEógQǒnOI	TRUE
NdcgbspvVaapSuvzdòGDàǎl	TRUE
OyAcWNwWàátLJXhzúǔUSaaT	TRUE
QLcǎeJIXhNèlhYeúèèùaadb	TRUE
RiOPKfgVLcQJnrnzáliaaiǒ	TRUE
TécRMFCayúGfGaaòKHUGótu	TRUE
UhBccJcaaùJTzXùfjjèynai	TRUE
WèxWypINWlcYqMexaavgkoH	TRUE
XVNQRFcVRxòvnnvaaqAFzFú	TRUE
YnTpwgQxcGǎùǒIKaacDSNRS	TRUE
aJzCaéwWcǒuPǒIqúaaIèsRA	TRUE
bbeqciaaYuùRòlVXsEaNsgX	TRUE
còěZsYQxPxZǎiCòaaAkqooù	TRUE
cKKQKyjkvǒyKcIǒaaseQHru	TRUE
cZGxMODòNvxFRlgaanbyCec	TRUE
cjeRrrPgqásmyvjquDwCaaD	TRUE
cxElyaaMmZGSgàWCòǒǔǒroj	TRUE
eMǒlǎLcbLéPèaaCagZXbáiy	TRUE
fcpYHIzǒIaǒrqovaadGrrǒE	TRUE
hèhSGyWbhtkLTczEBaaǔQwù	TRUE
icaaUápǒcǒxǎdAAWGfáUEUF	TRUE
jjjqzvLcoùǎBruaaògrSaǔà	TRUE
lúcdeWmaaréLDǔeéèTQUwGd	TRUE
mcKnDDaadSuBèěsUoCjpBàǒ	TRUE
nsmSaNAAOWcJUZVělRWtzaa	TRUE
pRUFcaayQPQDVRrZsIěfámù	TRUE
qiljMAvòZvJTRWcJéooaaDh	TRUE
sàLùDǔCFoǒKǒnzXnèǔSxcaa	TRUE
tUHcáǒTOThfaalòzyAGIBKJ	TRUE
ucnobǔǎPUoóBJàtéóaaEmyà	TRUE
vlXReòjúgěcgcnaaYúiěòVT	TRUE
xGmILvǎúXeMCUóyècùvPǔaa	TRUE
yfiúùMcjYwYěmaabqwéWLCQ	TRUE
ùùVUBHòzcǔMPùYFWQbCnVMú	FALSE
ǔWěqKatAdxzvJEòTóoóWVSX	FALSE
ázBWgLxǒòkroóehLbeeuJCO	FALSE
ǎNHèǎgMóIàihAgeagPjóYKw	FALSE
éfZIjcJvDpéWCokoWJRHIdǔ	FALSE
ěàPpPpGuKtTLPNtfGaǎOupi	FALSE
óEgúBùZjjGTéKàHTrrtǔoQz	FALSE
òQěòdxTsaTusKùmBǎhěghfb	FALSE
ǒmzPTHáǔcùoIàGAvmQQoDlG	FALSE
AúXbaldéXzùHvOnKnróKffd	FALSE
BbùIPSFáBBNQynDVYBYvIxm	FALSE
CeócváSěEvǔéSvúyqVMSqbl	FALSE
DxúǒymUWDeMJkuèJiOèqejJ	FALSE
FùùùajNDnrGzaámjèǎWlfák	FALSE
GNǒDěǔaaǎmZsWcXxfúWpCng	FALSE
HZbbdxiwySfPèKǎzúTvYǎte	FALSE
IiqrsěáErMloěRǎBDLhUOǔú	FALSE
KǒzgóSúfjwdHúTàǔIaěwqpO	FALSE
LRXvCAAGmùpYtWJyfznFrúp	FALSE
MrwěABEùèfǒymmádòEóùbIL	FALSE
ORCJUóěmsIgDákVǔEYsúTRh	FALSE
PnimzyǔééSàNuVǒLǒzlwrWL	FALSE
RǎPcmDyUróáúZgfdEPBcmoB	FALSE
SRRZDvCzTOEáòdXKzǔáLket	FALSE
ToEùdQJXTtWzGSóuEùjDksm	FALSE
UpjYùjCQkYnkAzLEjjUQwJL	FALSE
VvcXJZykXjtjyènoHFvMyVZ	FALSE
XúOOQtkaǔěKHlNJmǔIcéSck	FALSE
YLvjbxèRBógubGqrLBgWQqm	FALSE
ZdzBrRHQóZggSboiànaDwfU	FALSE
altaXPQLrhqSějwOTémáNiD	FALSE
bupǔěTJéBWkěEvèZHJeXvèP	FALSE
děZOmùyéětPWRòQLfNněmCs	FALSE
eYaTóVvYzcàcMòrǔélépPGK	FALSE
fkVgCKnòRJaSZrvNCdGyvVS	FALSE
gtqdManQyfEácXhzkèXyLrp	FALSE
iǔèZǒúZpPxnòPèúlúwfěWHA	FALSE
jFáDqiExYnúTǔkPGebSQBrB	FALSE
kJYliZpcpáěMúmmàPéúòUfu	FALSE
liGǎPzLsTYdlkyExtSlQIEu	FALSE
nèSUòQBkBvcdmGéúRòMeoké	FALSE
oPJPěEjHěxkSFrqOtomnyqk	FALSE
pdRJNRWuàbǒǎetUNKbàaúǔb	FALSE
rǔLratfòLmhjEúAǎywólLtB	FALSE
sToilòcXmbdgWpvajvóOùHY	FALSE
thynzszfǒjzCsesDfZhmpòS	FALSE
usSyòuǒBǎntpYjéehYěùǔaS	FALSE
wDBòySàSSóAATǒòdUúdwèoe	FALSE
xSHrITUSzěXSrùLpuGWǎàCu	FALSE
ylěòxWtwMèyǎwéFYPWǒMMJó	FALSE
ùùtDSiueOcbiUèSùyaEsàaam	TRUE
ǔJRYswúhaRQHvAǒcjWWaahás	TRUE
áqècPòNbpSnxZǒlNgcoIcaaE	TRUE
ǎFZoOòhédEBsYqcPǔhǒaaXéh	TRUE
éfsIGcpOgéaaFǔWhDèǒWáoSn	TRUE
ěèQmkXsiFUEYSUúntcBhKhaa	TRUE
óHHJùPéěcANRaalilEpuúǒOD	TRUE
òfzwóQBfWuSRucèèxCaawúMn	TRUE
ǒyGkcDIRYòMZòaaChvFǒlJàF	TRUE
AKǎaǎěeTckPnVróóTKùvaayá	TRUE
BwcsǒkúPBYfásLkuqéJaaVQě	TRUE
DUòócdxǔMaaHEJòRSseCǔwUh	TRUE
EyGǒcZTYǒVJKPCjaaHóǎZǒUd	TRUE
GXyvVEcaaAMUDMùlàxivQiyj	TRUE
HsxVvEèavwécaGYaalUzSLqù	TRUE
JHcPáTvpiuCCIòcEUaaNVMxu	TRUE
KhBfRMcEocTaaeuwUèzAóQGL	TRUE
MùYpEewhòlcQaazsòveOéhón	TRUE
NPddAǎqYhhLOecDqAaabRYip	TRUE
OjQpAcaaùRǎwbGXmUUdNázRt	TRUE
QBAcHDVYaaAuQRRwtZòXgrùx	TRUE
RZàrcqǎvJaaEFKhóBpssdKnJ	TRUE
SvǎóiBckaafPGxXmmKRciiok	TRUE
UDtwHiyNRQabcVěéIraaFzci	TRUE
VcèòAxEPěAXěIDqCHsUaalnG	TRUE
WxGEpSJIMóxúbóútcSAaaIèO	TRUE
YWVVZcmLsejPJǎYaóeVtaajS	TRUE
ZgcěaaXjSmltàúaàdONéGZky	TRUE
bòeKUAbwǎTǎcxeIǔéǒqEZraa	TRUE
cèéHZIPjúYùtLEWaaKùRárMe	TRUE
cHJaǎtazǎENGAěIPJjaaLMTB	TRUE
cUdQhNFmHaaVieéqóPyivcdK	TRUE
ceùoijěynKXhsafAVNLbHpaa	TRUE
cpTpěHxaaEùRqMTùZLOApAèh	TRUE
dSQMChNcǒgǔàBYfnZESaafeé	TRUE
edcvaTkùIpkuaaXPǒCQsSèSP	TRUE
gErUQjbkGcòWàuúhVtàòUúaa	TRUE
hcyúFSáaaSkiOVàDAdlǒbtHO	TRUE
jǒsoYXcUoóáàKCRhhlcaawHi	TRUE
kVGhGcXéaaóǎúuFzsmiwhVái	TRUE
lxvNXúUxXAIcNQRsVipéǔèaa	TRUE
nGZWTùěěrRcUàaaGXUXóǎPHB	TRUE
ofpzrYǒzèyéFczaaàmmJmroW	TRUE
qECHXEǒzwwldúvěcáàMúhaad	TRUE
rZùPBsMPIàfvqhjBWGcceéaa	TRUE
sczEcOtéAqIvbTAaaaBǒhJHd	TRUE
tvjVciYeǒjqjDuMEEvvvswaa	TRUE
veuúZěSIUAúKúwèpòcpeeaaú	TRUE
xùěǔuWkdnjCwǔDhwANlcǎCaa	TRUE
ySVáNVcJTXRTAphBAaaòKEfb	TRUE
ùùmbCVsJyvòèǒjxQaDbvNSiC	FALSE
ǔúfáVXRsARMKEPèèSBLDabéà	FALSE
áWavPTbbCèúhnTàRmǔrfpzRè	FALSE
àfWdFbrCúaUXzOǒNYzSNèVón	FALSE
éǔùINNZwèjlccsElCúOwòáVC	FALSE
èCvTJoSaSIWrRCaúZxǒúNOVú	FALSE
ěVkTnDhyTNvǎqqdkykǒmevjǎ	FALSE
óqèàúpeuèMFùJòǔjdGědwybf	FALSE
ǒònEètúEdyǎkJvJYeDAǎiRrD	FALSE
úNòtgèBIBxWèaXzOúǎjXǒhFt	FALSE
AYscbǒGóaùRuùyèLwGuWyhKU	FALSE
BczpsTPóàUNzArfImweùTpTP	FALSE
CttAPRkZUkxgǔfbáùVVnxóeé	FALSE
EàVaMéhcOMIitáùánuǔpmpDB	FALSE
FGYJGhNKHQoàOxyOezDSěcOD	FALSE
GPéfǔZUéhgéVBǎRKǒcOvěvEK	FALSE
HkǔUoubùHGNmrMxCPCǒrbuaN	FALSE
JòQbufRRGYWNIOWEǒAElùAxF	FALSE
KPKuGyDfdómugtiTDúIuéFic	FALSE
LclzmxxkLrXètnVgEwtpLshb	FALSE
MzDvCmIyzmgioHYáěIvccDbK	FALSE
OIàMùsvvArmWUzUSSaqòètèF	FALSE
PfsǎuàsKvuěctXFldJiRKcěé	FALSE
RGFZImguaYòǔóDEGFYróàZNǔ	FALSE
SOUsMyAXlpIbóùeéǒVuWklkL	FALSE
TgmsJóOwUDFZénùgtjQypObw	FALSE
UoDèkztGqTidGiòOEòXhùKěU	FALSE
WúwrǎàkmèdxoèòějkǎNàhfwó	FALSE
XPúRabtpLYkEOónnPúMtDLPF	FALSE
YfhNtRNaùddózcHlqqRDGSàB	FALSE
ZtIKsqáBjǔcléopBbiCBdgqI	FALSE
bCetkDàrTùLJpMhTáKPIEàGó	FALSE
cXIPEZZàóèFRcqNKWcùBéFóa	FALSE
eěàCóMBVdCBmǒéqùgPZQòàqf	FALSE
fXCéJHèvcIIHaZrtǎáRHùúIǎ	FALSE
grailěyyrMNòQOáGNiXARvàá	FALSE
hoGúqlXysNúnóǒtǔLeKQzXzǔ	FALSE
jEǒhTPsxqúxrsedbOjttǎiùN	FALSE
kKèAvbáCWàqhlWěRdxXbLNèZ	FALSE
lgqfǒXynjYYXěqmeDdjmiRti	FALSE
nDáFGúTzCǒWauQéóQbjYǒTxo	FALSE
obZHéòexYGǒúPEcNLNùwVétk	FALSE
psVRGgánběrósǎYùhHwǒcúpV	FALSE
ráLCjhfàpYàoiSiZYrmcZěhi	FALSE
sADJBǒNjyzAqRRVGbJJiOuǒK	FALSE
tXvHscvPdbLaTmalUOfRGzaX	FALSE
urvpfyFKvCLWDRyFVǎCHDOWK	FALSE
wěkǔèJPáICsbNiáwPRLVúGXE	FALSE
xLsěaepkttkKùsVqCmwqHěép	FALSE
ycǎYZhJBtnKmaKLEoBptEvěp	FALSE
ùáGSNócmXZwòcnaaéèèyěúeKF	TRUE
ǔdaérIcVLqábnnjaavéuaOpGè	TRUE
àLIQlmNjyYǒwùyBIXcsbaaAHl	TRUE
éùNMJcgEddùěgiDaaItǔCáBxt	TRUE
èLbèèENVbácúcYcaǒdVraadhk	TRUE
ěeMAéǎDjúNúwctèBnGNLVFYaa	TRUE
òáecHhbTpChùxDěCùaaAIaXùX	TRUE
ǒcPúèQààizáaasMgDGyaFqǎdR	TRUE
úxdcZHǒanJApXGǔoaajináBuT	TRUE
BRáóbDMěyMcǔléòYjggJZaaZa	TRUE
CiXcLFouXnAèkwJcěaasAǔmbm	TRUE
DuqúhuNNáóǔLcgqHàMllWVUaa	TRUE
FEPQbNBZěácPkHMbkkcKPaaál	TRUE
GcGXlYMéVgFzXImSUHZMaarSE	TRUE
HzoVCǎLSLvDDKqcOdIaaTLXeó	TRUE
JPJUFvLuróUpdhNcVaaomBmCe	TRUE
KiǔetǒPAcPǒèppǔyxǔBmaaaTS	TRUE
MǒěGcuoagmiTNoGNAFOxaahǎU	TRUE
NcfpóFCvnaagppNáǒGMFúSLěl	TRUE
OzòrwǎxvcTóraaEàcdKqWkWěn	TRUE
QUAáxyòbwicDdaaǎpàlOeFTaé	TRUE
RlBKèecVaaGhXRòǎRùyLVTlye	TRUE
TédòBasCPmUcàbCJLaaYckYaé	TRUE
USkcJǔPbXhgSrkFQùaariěVic	TRUE
VgtMuòdncEěéWxkaaVǒIHwòiX	TRUE
XǒwfOMzéKDJLkélczmYfaaPDY	TRUE
YFsTitùdǔcvaaěFEúmAǎxYIJT	TRUE
ZuùcTvEhYKnZGaapzzHsqUshv	TRUE
bEckldowbDcbeZpǔdKòocQaaC	TRUE
cǎfóRWWwvegBafQjQxaawuHoú	TRUE
cGACvUàCXmFzjtaaúgqrVucjK	TRUE
cWjaayruuJùGSyZTvNYǎRSkEI	TRUE
ciyFòálCdTIaaAéGGCOGeiJFn	TRUE
cvITQYWeEěiáááaahámuqSiFe	TRUE
dzxclrjbhadMSZtYUiaalqyjě	TRUE
fDpPVrPEpòcáúODnaaAóóOěQE	TRUE
gcLUwPjJOeOTyuaaewséyoTáy	TRUE
iéósuRtueBcvlujGnSeǎidaaL	TRUE
jNXózHEUWCfVlámdècDaaBùDN	TRUE
kctBtaacepCǒáeswoBsòvdMvv	TRUE
lvARSTsǒgùoCLUúczaaYOóvQM	TRUE
nFPoèOlcaaMǒǔZBjoéDnáǒZlà	TRUE
okcJXBWiòǔoǔgCoaayjknáiàě	TRUE
qJBaTTYyScǎújuVfKjXNLaaTc	TRUE
rUcCsèXzXzqLBWVkHhaatDàóx	TRUE
suOFckZnǔZDwhNaaǒrQvxtJoh	TRUE
uMboKòPCjócvójèGFǔfvzaadà	TRUE
vhPcwjmeNaaHtáJězhFMlTsǒǔ	TRUE
xCjTcyXSKUFwKnǎguJmfaaxhK	TRUE
yYKqhcRYDlIAGHVǒETaalzaùH	TRUE
ùùGHóZǔwyHNKDbHLchixbyBeZ	FALSE
ǔEQKDzùcánPApaKiEPluUaVěP	FALSE
áVhguCǒMZUěUBlǎGzfoeElYmù	FALSE
àoIZQtòǒNtùisěYQoBMùRkRFt	FALSE
ǎuérTòDDbGGúèfTjgùwàZUǎmn	FALSE
èǒégóǎUYèCLbGfTěkOxOnEólg	FALSE
ěAgItqKǒjéAúcǒeuXwWDuZHEi	FALSE
óXǒúqDǒrsǔOǎfmHLSqdBzNuWk	FALSE
òměWYCǒDzVùESvJǒXóúpLPjTP	FALSE
úèBLojipltrvYLoRxYLjMàwGu	FALSE
ACLúxtbúXrǎaWǔěELMǎEnxKMX	FALSE
BWǒFfsZIxSùncgǒgDgùxqjUCv	FALSE
CkGěPQOóéxQKajIqvwóTǒěBǎá	FALSE
EěTPkxnCytCtqùcnǒFǔPfHAxa	FALSE
FPMùùaǒbPǔfjZǒeAyáúKVùoáX	FALSE
GTěNpmǎàòǔWBvapgtxMOAmǎSe	FALSE
HXpmPxóBYhbpOXUgpWsBLwěóz	FALSE
IrESáFmdòBTDpsQSòaCWlYnǎO	FALSE
KAUOihbnYfHUěyúmáNǔDdéóUò	FALSE
LOOǎxNDAZédKěScvDurǎzoSǎM	FALSE
MWCmPǎmvYqGóqBzFMéOAUQMpT	FALSE
NolànmùAòjnsTCTěCYbpIYnEl	FALSE
PǒrTPègúbAáiloqFóWFFQNDlG	FALSE
QaǎdSjMuaMsvTěrvidNécpVǎf	FALSE
RplynSDzxyRgQUqaLvHeieòFr	FALSE
TDFzwwyóKeEMGoNféávTǒòcnr	FALSE
UNqwsqaóxòNNùHAèNǎěIǒèQya	FALSE
VYfǔHgZáHěebthzcTRAPBKwCé	FALSE
XǎplnuyéZktjúVAudCycHxPlt	FALSE
YRMòTPòxJJeEDòsZMěóHREIúz	FALSE
ZtCěVJěsgFwSǒpXzeqsEzODúM	FALSE
bààáGwThDsěǒěoqKqàiLPzáxJ	FALSE
cJyPOTADDùjXdIǎǔóǒvkdcTlú	FALSE
dmǔursxAwúòeBNmxbYqVjBecP	FALSE
fúnpàládqlákAExadahuZREJǔ	FALSE
gbòèJxOUwMěWDRpPGVAqxsRYr	FALSE
hwmwWúzuǒXzoEǔPkèúchXORiJ	FALSE
jFJWǎHTTeXiswOàyǎuTZgGǎDU	FALSE
kSǔèDǒfWǎUeéjùgqylcMǎIuhw	FALSE
ljHoHfbOVELOùáùwlCómúncHò	FALSE
nAXtrǎBMeyèPǎáǔhmxeFqácVh	FALSE
oQHuaNNfliYèXzQùěBátxjǔJO	FALSE
pcSyǎEqQBFCwNóFùuLYwGoéǎǔ	FALSE
rǎxǔqKCěKhjrLwnAlXlUlGLVQ	FALSE
sXEjkxQúIèNJěáJlUPǒùzkpEé	FALSE
tcDVWUZěHZévBězǎdwSRwěójá	FALSE
utfUPpUGkúXOFrtOGèacQěǎPé	FALSE
wBQwJiJàóóxutNqjZwPXcoGòx	FALSE
xVzhEáDVǎRoZpeQEáěǔcjSFPě	FALSE
yfókóGgzPNFaPIèNwcdèzǒEOe	FALSE
ùùnáHiifoècaazóvmNuMZǔQAeI	TRUE
ǔIecpQQcDNLDěěDMaaswUizùúI	TRUE
áVEbǔlrécaaJEYvQRPàKOitCǎM	TRUE
àkmQkYppcNEIqCCxfYIgdaatow	TRUE
ǎzOóvnLfxǔrJSuècQǎqaaèsáóU	TRUE
èWyùMsoPòMcpipJěmvSaaujdov	TRUE
ěsGCdǒEoDuLácGXvùlEVOUaaPi	TRUE
òMcsxFYGxaaAwUnMrinXSúóàTc	TRUE
ǒpzoqJmǎZRiHóQLèKQcaaiwòzè	TRUE
AGjywieQoǎHHxcqJaLezZtèaaN	TRUE
BdMMcùòYcFaaPJMXéRMxVtúóXn	TRUE
DèxúwoUWsuvólkǔCWbZUfHbcaa	TRUE
EcBCBiPzèòùwlzTWaRlNDGaawW	TRUE
FyvéHTPtQcěMcdcIxuOdsaaufé	TRUE
HLúUféKFKúcDVUaaHNdvGègfyú	TRUE
ImTebLSucóàynàXpPihùcfǎaaN	TRUE
KFjóFZkODúDwùcrPpLNqGaaBzX	TRUE
LcZǎFaaKpLmùǔzAtppjRTxIeOz	TRUE
MhmsgMUPmJODolclWǔaanTdFOh	TRUE
OFdCbZCùpWFPOHmGbJèTJǎxcaa	TRUE
PRZZáóZódZmraèǒcOéaambcLTU	TRUE
RáKcYkNeǎTOyZEJSaaYSùxúzTh	TRUE
SLIXBǒóoǎuMéhfcxFRqnaapzKs	TRUE
TdedaAcocfóaaNkEYnpVRmCWpè	TRUE
VAZcarǔdzIJZyvaavwMdQùpgGx	TRUE
WRzámcvPfSgkVjùhDlùTAòuHaa	TRUE
XXPYúúfCNNGsLwcpFwtsàZaaeò	TRUE
YvCiZúVbTyItScaaǎOóTwOEgLw	TRUE
aTcVdxWqfBoUiaahYYSóbuKTiC	TRUE
bietKJǎVAfhòWXápaQxcǔaaVVT	TRUE
cúOLJNoaTPowEaaxèqójlfúppV	TRUE
cOèBfXTRVHòèAhZTaòZjnhaaWk	TRUE
cakǒdNCěZéPqyúBǒǎAKaaéǒtǒz	TRUE
cpogIAGǎFcrxIDRǎaaóUcFděeě	TRUE
dǒKuTrcxovQPLTqOaaùnfdEěǒH	TRUE
eféyrHrcXijucfhcMaavlóǎBùc	TRUE
fxóéRJhácWdEqvròùaaWXváóóy	TRUE
hNěqYqávhcbfnLzaaKXdMǎeúèL	TRUE
iYJCmcIùZDJpfúbVHIPyaaPùJǒ	TRUE
jdubcPPYkZcVòSYEPWaaaYeSěN	TRUE
krDòbIcBvzeIèxXvaanuqutvUQ	TRUE
mSYcárQYèuYǒTdtaaùAsnǔvzúě	TRUE
oùBOòWhIMcùMaaùtCjQVàlyiGo	TRUE
pèpAXPZúcqszcaarjSkBgoFǎQv	TRUE
qcyèNaaqùiToáǔhpéTùúMǒOFòH	TRUE
sóYlcBJcLqǔFaaxbǒǎiǒalàqqT	TRUE
tkclXqWnDsNhǔaaqVǒxéxMFRmT	TRUE
vBRcǔAQuújWyjggaaSYGaKaěAù	TRUE
wdǒbPIFuqSlúvpǔSKǔdcaaéyZs	TRUE
yPǒMeàbsXwúsúvúPǔùrcúNáGaa	TRUE
ùùuXKǒCǎGtǔyàázBfOaaàTcqèD	FALSE
ǔbHvàǔXbANWalMNFnLwYYNsREI	FALSE
ákMùěéyGQjjSsahnwRieeJcwZk	FALSE
ǎǒèKúiSANoevwnYIhqPOúùiYlM	FALSE
éRǎùúdzàUàGPǒavzVtúPéLBjaw	FALSE
èqmNniNxkKsówéiJDǔoúmòQfib	FALSE
óEùwpúxnǎNBVùaǔájkSǒvwùúmá	FALSE
òYtLbKhyàSclIQǒXPzVǔràXVPZ	FALSE
ǒsBzKHPèààǎéIDGEǔáPǎBòǎFǒq	FALSE
AéTInfIUdǒKBMXAdvxQǒsGEáMd	FALSE
BòynQwimgwlsGylskSsDEXwHIZ	FALSE
CMǔjJǎǒUTèQákèòěnfLSyJnùǔj	FALSE
DdùufbjjAlfFSàTgZRQKèfKéLv	FALSE
EtYQWbVrAWCòpfozbhFmFkQICI	FALSE
GèHDmeàKfgúMJkèrvGCaiéeZJG	FALSE
HǒàùOóqjtUJXhǔdiéqǒǔYbdSus	FALSE
IZqsWòmBCwvWyYEyBěNbyVěfěi	FALSE
JglòèJWáCEqAMáJunlóFqpRvmn	FALSE
KvCJgIóXtzcvsepEǔhHàCfòèzP	FALSE
MCEókBáqnTHfsěBiTYYkmBbknè	FALSE
NWFùèNucgnyàùeèoKVótTèAFúa	FALSE
OxàtsòKQyNǔVWFòbLtQnúdPPáè	FALSE
QAjzkǒIyKiDeNeǔGFúaàFoYLOU	FALSE
RXùTzHorbQNWvàQmedYUISDksj	FALSE
SnùKVIàáqLYFTsOàWOùIRYXěóǎ	FALSE
UòoòuNWKPeGaeoFumKObnofoHG	FALSE
VPóJiùóLQhlKUthaGáoOòǔRKhb	FALSE
WgǎNuEYSFèChfBǒDiNsáYxpSKQ	FALSE
YǎKdHQqVJLpMdXugqiěúxGáLEn	FALSE
ZRdxHǔóùàluLHlsaaEwRmvjòoy	FALSE
acQǒòèAwThGJZmkEmqGxtdeLeb	FALSE
bjògAhèěběouIyrdàKmBmGǒzZX	FALSE
cpZjwTxQUéqnYVQCGTMMulùnGK	FALSE
eCzFTNYagsáZàoǎaHDczTǎKpàh	FALSE
fUGPEznKwRǔTKIEǔaoněyJsRUF	FALSE
gkhamǔóRZSRMDyEFPDúLJYKRxU	FALSE
iǎBnYiòINǒPdNDùLǔbǔyóabmeU	FALSE
jONQěáNpWLIrǒfbLěltMCoYlGc	FALSE
kOWǎoúmKTpòlZORTXGAòlxDjaà	FALSE
lZmBGéxAMLhLkàiolǒaǎPSDyDq	FALSE
mqzMiáTxLtQbvfTZIziLThPAFy	FALSE
oFondQbálZcSbNKUépbHJJhyàw	FALSE
pUxkptFPèJydNSCóESJqlzbYIě	FALSE
qtgúMBwBSVlEqáhtVBWBáVzrfó	FALSE
sAEFPZxzàněùTHòèAdmNGkZQtF	FALSE
tiàcOSsàsfLyclZzhrkNuòndTI	FALSE
vǔAKiHDXiGǎhéóLnHèhDHSNdrW	FALSE
wIrèuWqEoJZkAápUVIòmwLyeka	FALSE
xcVGIěpLDrPchSnUQIRIfùmYèè	FALSE
ytUFdRmhǎWlǒbrxglxJYDúOExu	FALSE
ùùǒZsrcéJqmWdaéPfhBJSRaaóbk	TRUE
ǔPxuGěvQEEWbàiúMǎcvaaèCèjjn	TRUE
ágGénEAzopàHFxvDWOcanPaaHNX	TRUE
ǎěcWsMòPhúkAéKcMyàaasGDLsLD	TRUE
éeYoYúejMècRKaaúbGJNfBpwěvu	TRUE
ěěyějzinpgWcoàAaaNcUpzRWhXI	TRUE
óbwèóMISeBTXhQeGKLěacùhòDaa	TRUE
òrǎPddòlUónZróoQǔówJcYnúaaT	TRUE
úDyrceWDOQUǎéoúǔqlfpVjaaémǒ	TRUE
AcácèaaFWqOfInlèQaCaXetXyKA	TRUE
BoyeMcdtSpIaaUEéemàovùnǒurw	TRUE
DàGàOcVuàPrcaAèagaakYgzúJQL	TRUE
ERùěTcyxsOksOmxóèfQaaòoúpdě	TRUE
FròdeDuèxNǒjdZcaaǔYPrénuLTY	TRUE
HEpTǎSéGhIócǎqYtoSBwYotǔùaa	TRUE
IcljětǔnVSaacJósHFWfFnGjVIi	TRUE
KèWscpIMUXUòMkeaaadKpǒmuIyò	TRUE
LShkgSbjNcaajóDZWZoùùqfǒGdá	TRUE
NàDDclxvDClóǒPRjùǒǎCaaǎJdiZ	TRUE
OKebcXJKlsaCaaCèǔKSagémòZur	TRUE
PtcNqjgaaOYljnféEbqBěmQsxHZ	TRUE
RTèsRbqyBWpLcZRtmralJEZǎaas	TRUE
SnààhTdycPRaaèéHròéQtNvohOc	TRUE
UEcKUóqRiQKoDAjJZYULaaHàPrǒ	TRUE
VcQIěWXxùaaNTvǒǒJAcwZMhǎYOp	TRUE
WiIhKHxǎYbfǒcàcugpsoTwěeaam	TRUE
YúàuDcǔNCSaáBSaaFóXBniZZMiq	TRUE
ZRJQétHpeGGOsrcǒcgHCǔaacéZE	TRUE
afágQpWpyuTnrueoZciDLGgáxaa	TRUE
cáiBNsLyTumyQǒVmàóuběhdAaaC	TRUE
cDtǎNJQgvǎKòDPúfOYnèagWaarG	TRUE
cSPQaaJóSslbwyDpqPěCsSBtàxi	TRUE
ciQNǎaXáNNjrěǎFeiYKaaTǔinpz	TRUE
cxTNMúRyPòúqodhèaaQVklǔáǔóQ	TRUE
eòNQFcěUfIgúHqěKlUáDAOyaafk	TRUE
fcPdAhVYLéOGfòúaahKǔAǔkkdvM	TRUE
guSVcnxeFQjooúZNfAPgIaajUcǒ	TRUE
iJqcIYrOVMùLpkAbúSJaaIeǒpaY	TRUE
jhriZcXpOniúJCZhCMEVtěaaVSó	TRUE
lǒrllaZUXáPUyMèěwaAcěéaaǎZv	TRUE
mgaFUccǎgFaaánmexjLxipBqAaT	TRUE
nwǎhrbchPZSèYUdfbrRDMHaaSúA	TRUE
pLáIFLcCBGyLxèaazlmLedǔpàgs	TRUE
qctIMaùutcéMgǎwGHSubaWaavZN	TRUE
sDDIOTcǒOzógaaqrAlQCdrJǎrUD	TRUE
tcDMvKyǎsaauzSioOyPZiEbbYTd	TRUE
ukésEèDdcGaaMOómbiEbSwjDaGu	TRUE
wóTùcjvZjxEFfRVNlaaòcúPbGQf	TRUE
xZjCLAcqxaHTaacIǎóBmGJeǒòov	TRUE
ygkrRatFǔfcofqaaHrDYòZxaFyY	TRUE
ùǔělTZVBQUmqSKZúǎaObàjǎlIqx	FALSE
ǔIYgWixPsápwúděGckkZǎúMmCtA	FALSE
áeǎvYruDhciCGGfFVjùwjoOXrEE	FALSE
àznUbbhěaHtvQNTaEIZěZòmVvxp	FALSE
éHJafáóǔZYYsOmewXxVhKCSáKbD	FALSE
èbAnjógpFmqfdéqǒqGùYtYéBVJq	FALSE
ězgOVdZPYVqziSùvNUCSkrèZkuU	FALSE
òěNtRwTeHedéNHekmDCkQRGinKp	FALSE
ǒMbáàTXúVǔgpdCIdlHèRnqMeHLt	FALSE
úhPúqVwBghfAWquimVZihCVriuo	FALSE
AtvrcǒGGfycúnrJltpajQFkYhZZ	FALSE
CSrMwávwrgWUùtIbòawECSRunhy	FALSE
DeMùbJFóǎoULǒkVDěCuéAúwDáIǔ	FALSE
FùòóJùTCwáajzOmPozèqTdZbjeu	FALSE
GBkQbykCdchXPòwJJébAFuPtòQq	FALSE
HTFFAEZPděbzWláǒhYZFǎAǎWězn	FALSE
IrWtvwwIàǔWǒDàEXuànaxbòXPòá	FALSE
KěééLǔMVlákxEaRqLQuoJgnHóóě	FALSE
LZHzgúXJtWQxLáxbúvMIǔFbkPJH	FALSE
MsAWYZjbiúWLúqhHMDsnyéwkàDó	FALSE
OATàTópAGcjIrNSaOzEevHEFjQy	FALSE
PKzehCyGdùvwXòèwQnrAjWuzOèX	FALSE
QaKsPmbòyyfDòejMròèzpmEgxOW	FALSE
RpSuǎYiqfDeXsnRYeGrxTIRuHZá	FALSE
TócEǒmHPMJUvQwipǒOtYóLhIPFf	FALSE
UNcaVUnàeHXǎǎiàcsXSuUMǔLkab	FALSE
ViǒǔòuRǎQSǒyáCyEǎzqiRRgPDlD	FALSE
XúùèSAUéDRXCcyǔZveBǒúKèupFi	FALSE
YHaòRFmWGLèHNqXztBCXǔúFlosd	FALSE
ZeZOKékvùAPrXNnwltexETrcFzB	FALSE
ajhpJEyoWfAlLHpLIhuRtuGúwhG	FALSE
bvKzǔPweZtDOlRdòòTMàEWkFMsX	FALSE
dóOAaTtNMEoYMLvòrbdpVkGǒENy	FALSE
eòoFJTxjPEqiéBPxPkpàǒTàNurF	FALSE
fKFcdúoNYěMàQHKGsaàǎFIJúòZX	FALSE
gcfègFizdMgeásGgxqkuoALoǔǔS	FALSE
hjBnǎJàEùuzjKúXsFúNsbLbvGLz	FALSE
iskppFMffFZkELIǎqkRFimělmzr	FALSE
kòNdòxǔOSzJdjPsǎacèXuòlqǎpM	FALSE
lGVǔJHlbElPCèféNGsOòRZeUècO	FALSE
mbódzCOYJmKáBnsdmSPvqlèkYhd	FALSE
nrpzǔLnzsfoVKsěFvúPuAauYjló	FALSE
oyXèVNAtJhNjfBVqsVǎBxVtBkLè	FALSE
qFèONMdmXZXěOévrjXMrZNeMFbL	FALSE
rloxòWXQQúMǎàKZvàlěǔáǔnèKTz	FALSE
túǒOEPcySaFlwTpxzHSIěUèPFfD	FALSE
uSaFXùPJùSFzWmúáadEàNFódRǒú	FALSE
vzúwRBǔYYunbtuúoIigóTJcUPXf	FALSE
xJiggVèrXeóéJdzqOEvHǒFYěVtF	FALSE
yiXàsYdǒhSàNZrlJqDóóiIvGzbé	FALSE
ùùúyjZwGIcsèávdoUIyaastùTLtǒ	TRUE
ǔUEePvěéYUVwziIMcAaanoDqOknx	TRUE
àǔysMOUácsKaaAaeùéXDnzyfDyZě	TRUE
ǎLAfrkNcxǒwGlPZRhcyaaUFRikec	TRUE
éixXlMWKVcLaaówjAbYtoyibOIxb	TRUE
ěǎcmKZYbxjěaauLgHVXGHKwxRpFq	TRUE
óaCuùqHKKwXfrLéDcodbAóúǎéaaF	TRUE
òsPLQrcXěòKZJhùócrXylǎǎLbTaa	TRUE
úUlZTóXkjZDúVznfěcúěhyWzbaaB	TRUE
AqtDcqngDmrBjòSESaaèsrRgvúùF	TRUE
CHDxmàcAaáàkaaAymgYAǔxDEagtJ	TRUE
DLEeoNjuKǎbcULofxǒóbVoOaaAGǔ	TRUE
EjòLKcOTaaqvwYóǒAzcoLyajGuQf	TRUE
GATeLHǎIaBBqZcjZnktòdbrISKaa	TRUE
HSNGYMcPAdqfPCéUyZsóaXnlǔAaa	TRUE
JùJGáSǒqgqzěmJIcQkWVaaUPRèwj	TRUE
KNkiuNèǒTQáKqVméqcúKXzóCúwaa	TRUE
LmrPRDěNodwlwFlHcfnvaaòPxǒói	TRUE
NFwLaqPùylmRagNòNtIwbchGraak	TRUE
OcnòběúoaKcúJáògphgǎgaadIǒyB	TRUE
PsCbAFèracXfǒiETjEátgCtoGaaC	TRUE
RPeùfmOágTNUPckjSaaNnfjtEQAf	TRUE
SběòxaèAZptgǔéGxZFcwLléGaaxC	TRUE
TojnyuqwkqfǔcyiǔgùbcaaYèpǒLé	TRUE
VBacuRbimuRěoEèmHtQóOUxhòaaP	TRUE
WZcéPMrJupúókùòXlgFǒǒaadLúYě	TRUE
YùěMNYféǔòclevypUsgaaúkqOZUM	TRUE
ZFbpelRáabckkàAxUàyPqaagOWYò	TRUE
alCèmjtHcěaaǒDúèQrcnǒLUhNérO	TRUE
cùxlNIJDpKVyiyGěbaaJóLZYZJMH	TRUE
cGnóèpPaazIfnnkmOXdMáǒòèSàhR	TRUE
cVǔdgQhrLVǔmoěqgháIgSaaDaWwo	TRUE
cjHaalnúyEpvpzZeZǒGuQámkNèóǎ	TRUE
cwkǔěOebákǒgàCCfùàmdaaxměHHR	TRUE
eBTjMBòlajdsáEócXzBwsdGpraaF	TRUE
fOmVsdqùàOcHYAqNQYgrǎKHcaaho	TRUE
gnZLnsVéUcBgǎeJCcGTrxaaZPsqL	TRUE
ièWJzúLùǒAFLwgcaaMxǒYEWFFàIx	TRUE
jháǎudSEěcgGaEǒóZǎaapǎàòǎfrf	TRUE
ktGùRNMǒgccfyfURsbaaaoJúrAWú	TRUE
mIPnexXXehVcLGmXdǒigHdfgEcaa	TRUE
ncSaaIáKWJTaDkNZtZiNvpMtrYlH	TRUE
ouMbtěewpyǒEUWfélFcFpXUaajTú	TRUE
qLiCǔXacFrykTKFaayOUzúiSVKUà	TRUE
rskPwMDěqLFNMcPNaMUJPsaaóòtm	TRUE
tCxeMéfEixPZYZUoèucǎJtPaaTzu	TRUE
ueHdJcǒyRJǒMaaàtàùyàjgàgFǎQg	TRUE
wáèFmchaajàOtlQRyùSúémYrDdRǒ	TRUE
xRcNkěWraawvDdóVávyǒóNTsLiNI	TRUE
ypQDfxYwVàWcIěXqikEaaxVyAarV	TRUE
ùǔQfCdhWbJPàNQagLUcfǒMlRfBGl	FALSE
ǔWsǎLcjBǔsjěvsABHsámúEyVyMkě	FALSE
áiSSwCOZoCETUǒwsHóòirwLóXBaK	FALSE
àuǎSuzIéIvZǎRMttBUHmhFYiQiQl	FALSE
éCcJúqphAMYxǔrPKjótùwfdYrEtù	FALSE
èHGvHgIUéTYaJwaáUvpjntèáerxú	FALSE
ěWGEǔvLqiTAHGóQUaBàPFjMiYVFǒ	FALSE
ódUKDIJwgRpuǔTběNORXugbLqxEǔ	FALSE
òvtkmqmQkBHóaèéòqcěnifwǔBXEs	FALSE
úèwáGèouJáúǔcWǎseqgmoykǎeǒoó	FALSE
AIéǔNIMLrjWffUúCWějhAJóBJòZm	FALSE
BeéFSéjoLCúVWǒpPXRLlmǎmáòèZa	FALSE
CsDwGWsQùbǎizlěBsTJzawLmRITi	FALSE
EóLToéúUjDFBDRtàzěDzǒěTIHmoA	FALSE
FCPdòǒóopbDGSfjǎUxSùACanOlzt	FALSE
GQCLGBQyàWqóFWZèèXúGúqdfámǎq	FALSE
HfJuǒYfGěMkrrQvxTQWVHKjwǔzóP	FALSE
IsiBfzjpQgaYóhàǒoHóWsrSwyyHU	FALSE
KàLkxjMhHgCPwFùAXYXdòuúSflAR	FALSE
LYùiEWvkXǎeébQhùwzufxmEByMJn	FALSE
MnZErMúMfJrzHwxFPálOokàzaDdA	FALSE
NwZEblhdòòhzPrWKaeDnDèAgVyǔK	FALSE
PGóBHgaVmfiènbòwjólaYVjúzeóS	FALSE
QOwéPDXDélLqjsNerǎùIyyǒOYFJF	FALSE
RuAuCyéXYFúfKGrvXEjvǒTòoUtHǒ	FALSE
TEgtFgBuòQqxWhgCeHPfeUhRNfIù	FALSE
UrkJxSòQèpfDóSSHdulJaUhEHnVr	FALSE
WGJnQOwgòTfvvǔhdtOEOlǎrAwSEù	FALSE
XZbDuGxětLogěTfjǒúxhcèGhfjTX	FALSE
YxFCKxGtTpZymmJǒLpMupyJAqZZě	FALSE
aLàfUjFKffòeEyóóǒhSVǎUòakEzH	FALSE
bXHúfnTUbLBPpllWgiAzdúzyMuIp	FALSE
cSoypkùZlGDvsǎrDfqmCvRZRzUHq	FALSE
djDjOFàlBǔkLgYfebWmentlEpòWE	FALSE
fúIoéNǒgSbvObcKliZcaIzFSúRYW	FALSE
giǔKWBúXòYnGPAXfDleNoCXUwàSA	FALSE
iǔVǒBgFVNèQJBVAVǎǎKKojěZrRct	FALSE
jFtsFcsAMrèPFgYNyVOcjULZqnAE	FALSE
kekVúGtàHyMàtDEècDàVkóCFElLe	FALSE
ltHXggiuZTgINàpKvkúòrcDjéwbó	FALSE
náFiùFNěGnàQurèaiKócuncnOQgp	FALSE
oévDSǔzWrWnyaliáéHàrRAcolèvJ	FALSE
pOOaALCNsRBoOriLBgúpmOlChTmU	FALSE
qlTtaoYéIELgvèéǎaóJWǎgTXmjnu	FALSE
rxjNggniDóóuhYMCkXYǔrRcrxgEz	FALSE
tàióéwRoajJyéáBfsPLǒmrOpdlèL	FALSE
ubdPkúějNèaǔoxkQLJMZáRECWPQó	FALSE
vqnDàxSXéXUàxZBduJESSSsVEMIe	FALSE
xDYJDoóùǒVVQVCwGdQvpfWǔuièIJ	FALSE
yUWWKóóNVPyùùaTLǒEjoFLHSFùòj	FALSE
ùùBòcYCòòcSvLpjaòJonLraaIfsHě	TRUE
ǔCwáWawacMXyhJTRQǔoFVwivaaPzi	TRUE
ácXBEnnJLékQǔfhàSBACcSpbewaaǎ	TRUE
àlxLyAZúeAxbcdváúnwnLUkǔzaaěw	TRUE
éJuAdsLèENEaUàJAkciawpYaaěNRj	TRUE
èYáYrZYcxFòǔiDlùéQahogaapàOóS	TRUE
ěrtòCFuGpèuWIeúGwQhcKqdaaBàiM	TRUE
òRúGYzrXLYùZcmZGTxkúxùDaaéfMo	TRUE
úáǒjhàéYdWùKsàóǎcWGLMDndWlGaa	TRUE
AXvjnGcòúàfoFtxVGérfTaaEóoSSǔ	TRUE
BgVIDǎfcoqódkLèàHaaudSAQhxSgè	TRUE
DédYcwaVEyaaHVvtcòMkGzNxdmUvI	TRUE
EMcQlsOIJPeèFXWxidraaòPJxlDhH	TRUE
FdIèuMrKuXxycupǔhcKfWeúaaECts	TRUE
HMmWAIscBosuhVùBaTIVSWKBpaazc	TRUE
IcfwFPaanoěRóǒFútWYfFSèqPeěcè	TRUE
JrCcúfaCNiLQqgBSèaaYáměwPyálb	TRUE
LDàKcpsRèzǎèVaaèiSoJětaTeǒCàV	TRUE
MbITmáéoUVktbgcaaàNJqúóhMkBjò	TRUE
OéMLgOtslǎrpbvsDXècuSaaxkóizJ	TRUE
PJbaTnFRkcHmucaBDCgCHaaiSjiRú	TRUE
QksáAxwqCAuLàFlúcaaxrgàpIBqbC	TRUE
SEnWUcQsnxǎJOHfIffǔǔècúMOóaaI	TRUE
TchzeBOlǔaaeKábdFLxQzeyHNxdiZ	TRUE
UmfJUwPIaOPtaUcRǔaanluhpByǔZd	TRUE
WBXjOPqMcgKxaaàǔrozóBNOǔZAFRb	TRUE
XcáYáHJxEtdtDztzaanhjoeèǎcǎxs	TRUE
YuCKěDMVáQOMAǒAMrOqiwcBiICaae	TRUE
aMQǒLàěGcFgaaewWvxSPlmBRǔdǒtK	TRUE
bfjécaaBLjLyjxèǔǒòndPQtHzVUàé	TRUE
cújVWYaQTDsoRvEYZǔóKVPmYpHaaK	TRUE
cPaalEJVnVZNLpárzénQbYAóKGqHm	TRUE
cesěflHměrTuGFMoUcKAWgnaaáMùǎ	TRUE
cvaaVeármàGyiTBùEWFtBóěoVTmnM	TRUE
eBcpéJúǎmgHLpObJDAaǔApzCaaiSz	TRUE
fXAGrǔAdrwyRNmCtWCWocbSrRaaNě	TRUE
gmWhzXEXhdNLlòmKIwuácpVúecaam	TRUE
hyáUIfàTǒcròguyveNEfgaaěgkběX	TRUE
jNlùsfWòBòOMXcKebLNAFdóxYòaai	TRUE
láacěǒRaapVUIekiúóAJǎAMpCrMǔA	TRUE
mMtZBLvóysódǔHúcǎVuhǒùaaSEPyZ	TRUE
nfólKGNwyèscaylvGODaacLSpuktz	TRUE
pòLogǎLcLjdRdOéBǔéfSbWzSBaaRú	TRUE
qcSKǎHRdqkéUoBaaKCápZKgJyPXùB	TRUE
rvdéTTOGuPrGúóWcBúbeěImWaaMeJ	TRUE
tBàǔLxǎHEsEvcfKTǎHaQYúaaDzebZ	TRUE
uZYESBěǎLòóuàuHckvmIAvVDExtaa	TRUE
vmàHHGBkàOIGcHzaatéǎAJleAOMmV	TRUE
xBàPMurNajcnèdifYaUeJldLǎyXaa	TRUE
ycYFyCácèùlTJaagzHuGáhgwèuǒII	TRUE
ùùaǒDoǎLBGdùáxNfǔylàfOvweHTtě	FALSE
ǔǒuUéèZOZóXLhQjteèwmzXHjpZpoV	FALSE
áJěanáQODQUFrQceqùCwsúoslMjyù	FALSE
àYUDXyáfzimsegknQETDIéeCbSjIq	FALSE
ǎexPYwùmJtOaqAkóùBIIàjAMNKMaM	FALSE
élmCQDkèjaYOǔAVdoPúxJIcièúàHo	FALSE
ěRyMpzkòyBGajTpǒFOèsSVéEeBFLò	FALSE
ósféqmCMbDǔgBZePAJǒHfVRsHICIj	FALSE
ǒCRáAEYKcLJmfhvSúRqkUiOOUòOOz	FALSE
úVeXWIéáAàQuuóARGiùNlVLTǒErlS	FALSE
AsùYbWSéNRhèRěNJejhAVàéKPmpǔU	FALSE
CǎMǔlúoúBfgxGuhhzesǎIQOqnjGqo	FALSE
DNtydwǔdáòMtwhrksJùtMiEULSTLX	FALSE
EYZdEjMzFdaóSYowǔDBiFéJeǎHjpH	FALSE
FmjdIPzQuQèKOálZsěbSómGHùqjCt	FALSE
GxEgòNvJZòRHjèaMttCTFCTZEpujS	FALSE
IKZoCàXzfiSLvuMiYrOrEfěCeZúóN	FALSE
JXkbZǔǎùóRvDzùMtoMcpcUpCWěXxB	FALSE
KzPSénmDàTòQwNLeSqrMwKYesxlGD	FALSE
MDwYAdMqHZHwebxzǎJJémyaMbótkg	FALSE
NQkqSKaFfHqòtúBfěsAmQmúzyAzéè	FALSE
OgBcGséDǒxRMwPbFzepAòhIRfùJzt	FALSE
QùHóBOFJwoStjyWěccgiòCuMPWRVé	FALSE
RáǎèhMVfBIuUUeywHhWOOǎǒáTCFwf	FALSE
SHépAlnvkxDèmwkfnMpxěrGofOheǒ	FALSE
TNLáIKBYUIoCtXUJdGèBòEùODdrJw	FALSE
UlGPeùěZmVHǒCǔoXlJRQKdSkLàOIQ	FALSE
WǔLnCLjfzkEOěrJezòvùúRXtKlěZO	FALSE
XùshSòiónFHdhxBehcJècqGbpLxtx	FALSE
YBaǔPNBhPwSQqieVlmYǔèeòUúxùjR	FALSE
ZaópBmaDqEryǒxBaèADXNòJDcsIlě	FALSE
anfWhadrbRúSnLxEdpzVewǒBJfvLb	FALSE
btèóLúmOǔikvQNwSùPMǎvówXmemdL	FALSE
dDAtsPsIhviIléAOǒrIǎSpǔHrsYéó	FALSE
eezlWaéěnlěyDyùXKEúhMwuMlgǔPq	FALSE
fuhkNgrOSzwsZZgNiDDdHXwàòFzáu	FALSE
hSyebpDlNBgnoAxVrSNVBKFKǒPpci	FALSE
iqCmUhNgHòeNuěQiKyróIejDCKápG	FALSE
kúZSGGóOùEzPWTcWájbAǎtjnnpqǔG	FALSE
lbǎáglOYóNCpàxèryZGTPklDǔpréc	FALSE
mrǒlQyybèmaǔmKSégFxéXápWFWJPǒ	FALSE
nxASbIIDpǒérYEOàBePéAMtIIWtdi	FALSE
póàAtfpxPFqVaqUOfàúVotFHWTéOǎ	FALSE
qVúDéwěLEóéòGBoJǒgBbtSùaQàDǒX	FALSE
rmNywièhYdpmǎgàYJQàóyZàYsNàbó	FALSE
tCùBóTCszLqgLyJKBǒrmgèDúǔwvfh	FALSE
uUprhpěLfKrRgWeFovmFèǒwCoVApi	FALSE
vmWóHrlYTMVdPUNgpBGWqIcwURàuJ	FALSE
xFoúPěùǔúubHPhjtlǔVPhVsèóbJlx	FALSE
ydWJZLKfMbRúJmúoěéeZdSúAèǎěix	FALSE
