ùùSCHEcQǒeòtsXúádMdǔùvsBxbeyóGX	TRUE
áKaxjZRehDěósNpudTúTWflLSFxǔǔHi	TRUE
éBchklěiKRyUeXZMKUKavzeyómDYǔXr	TRUE
ěWóoiHHdUYwaiSjZAhJtPifésjBreXú	TRUE
ǒHBfwFJKxLYǒsnewTěěDóhnmeencexL	TRUE
AoIbqúIqRTgGwRCòùLMWZàzgóNEEùóà	TRUE
DǒòèQgzxùCCUáòEPHfáDwórrNsBLPǔf	TRUE
FhUvěǎLDSBEYQpEXYǔYcěTKfgDuBONǎ	TRUE
HzóljeGKzéǒkjnOócMngLǔeiotyòZǎx	TRUE
KBDèLOGIBfHkpshqxHMAumjěhuMILuB	TRUE
MmOvudǒSxáMàěthWZTLyHxLqmaéfjFp	TRUE
PgNěNjVFARAvnWXyeddxEàLYfCkdbPV	TRUE
SVàXecoMògFrXDòQPrESQhxCǒQFlèàL	TRUE
VáYDMXLǎúiXRGAèlPoúfoOKfuyMmuBé	TRUE
XjaCTǒBoezDSrùtmaKóòtieǎnBùěEěA	TRUE
adahUlOeZRjGoàdnVCMAJtáwRòExTqS	TRUE
dWMYctuùkDYnSaBbborěWlZRpggaeza	TRUE
fzqǔáoáybUéUKúvyrGoXiaAMúQLěcpH	TRUE
iByùáOúXogMǒtpùMkpPKRàzyMLdfSrǎ	TRUE
kUyLfvéRbiFǔòwcpAqdsFěǒDtfzsPIs	TRUE
nCOeipQNǎwòoVúǔnNUznzvUpxfihěnZ	TRUE
qěpiWfmULyàKxgóLyyùgAàBáěyCYPMj	TRUE
sFósàvfèàRróatDctXHUàksKlvDMFWy	TRUE
uyUGtCWkILxzIWOGǒHTEfroècJSvBTj	TRUE
xRǎYhequqXMgTrjMqyúáǒRoěIógizGP	TRUE
ùǔeWoǒéaaaaaaqCaùǒoàFhcéPLǒQbRb	FALSE
ánxkuAaaaaaaǎlNYěòYUFXbmRrwGdbj	FALSE
éZóaaaaaaèMKòjEQióèIbèyEǎZncSIb	FALSE
óqHǎPnǔRaiagpAǒaaaaaaoǎěCóbbedě	FALSE
úUIaaaaaaqJuBYObpUnbFWhǎwIúbBQh	FALSE
CYFNAǎnAnNaaaaaasiZiHbEóébpZgsc	FALSE
FKóArfěaaaaaasǎéwDWyFsdSàJbbBCJ	FALSE
IaaaaaabzMóǎbLdǔnzbéNěgaTuKuHQD	FALSE
LdGZAUITònJlqOKaaaaaabTèAlqkbSC	FALSE
OjjdtaaaaaauTcǒHbqmLbhiMcòOèvds	FALSE
RwXRaaaaaaěAáblNětjbjorhfWMZàNE	FALSE
UQVMàrěaaaaaaRYSafbfàTObòkQěàèf	FALSE
XCCvaaaaaaóPmKQéěbéOEQAmVCaiotb	FALSE
aGTQpSQétnǔOfaaaaaahòDpwbBsvbRá	FALSE
aaaaaaHwsuaóbòUèIXxùPnoóqBúbduù	FALSE
aaaaaabjNùFIǔCiiBibóulǎKXjqóIob	FALSE
aaaaaazbpAáQFTěiSébrzeéNNpJuNLG	FALSE
cybǒhkZSjGaaaaaaOràseàbAàubàMxy	FALSE
fzúqávùqpaaaaaagbebOFpNkFDòiVBM	FALSE
ilCgkAkaaaaaabUbáJmMTrǔyMRlùWPg	FALSE
ljCaaaaaaollěQEbépbLNrFYPaóyfUC	FALSE
púyLhPgaaaaaaéblmnbWSUéxNfqmǎòú	FALSE
ryinuySThvNNPaaaaaaJnCyibLYUbPE	FALSE
uaaaaaawXGQbcVJbvEbdtLjdòIdvvòú	FALSE
xOfáiǒQFaaaaaaNlVduRZjxqúMbùDbN	FALSE
ùǔUcòUvPcòitBtBlIbàUuòmIAslYUuea	TRUE
ánàbGǎéùHfqzaVòpFjtèNZǒJuAUqNiYT	TRUE
éadmgRàDlòJmùnmWJRHyǒèǒvtfQúwNaǎ	TRUE
óùUáetúVlAsVhVaoyUHpBgóǎudLkácVǔ	TRUE
ǒWpTRDùsSbqvDoCVQvZfBCOhěnaiMhIA	TRUE
BèRKǔèQxSuiéazWHSPcǎuUyGaGKDTuPq	TRUE
DadTyvzSXSXZTHámNmZAEpcmSórhvUài	TRUE
GDKXSBěǎQonfióvlFmgKhJóhòIOGǔrXt	TRUE
ImnóKIwùPfWdKQmárbàGCQggfZzaUaYǔ	TRUE
KvioànǒPOrhIèviUzGèGrkùgQèalSěMé	TRUE
NYoHIeQbcHsǔǒbJlSsháADKQyVNǔxěSQ	TRUE
QPPAqóbGùHhoKndaaHvBySyáQǔxùóTCX	TRUE
SceéBhǒPlòseniúóMúVéUQěùěSrWoxòò	TRUE
UoDnLgzFTTMòsóvPFRBzPKGchúsásjgě	TRUE
XXyóFèlEQGbǎǒwYAwZahvfqXèlmùǎVúà	TRUE
aZózRIApQǔWhfúzDlsmrsxPúiǔrjéWàu	TRUE
dWQCPHuGúQInóoODeoQWZRWiQzhbCjùt	TRUE
fváNFWwxéWpxHFkvPOJykěrBàóuZùlPR	TRUE
iYǔBGàBuáGzcTtVniAàzPsZLZuàtMBér	TRUE
léRtcqWDewvfDúvuXgòtycáJǒéèFYǒlo	TRUE
ngfDǎtutQnCRXQtoWBUKZEùugCgRǒHEu	TRUE
pxsúǒòpùWwduvudLǔUóVREhbyjàiMzXó	TRUE
sStZǒQgnéTqáúxGBwejWjbùwXrèkaMěx	TRUE
vAQWjQcfrbMèyàDǎTvjkWkwooWóEècùJ	TRUE
xhkǒùHThVTóHpJóòFZóNrùkqfhslWVòù	TRUE
ùùǒKhXǔèaaaaaajbAURPbqQǒUTHPoLhè	FALSE
áváYaaaaaajbIécàPwEAkGDǒuTHTbcQY	FALSE
èaaaaaaQokqxGYuYKwxgbiXTswǔǔiVbǎ	FALSE
ózmxfVééWǎAXbIaaaaaaóbzmnoJgbNKù	FALSE
AǔaaaaaaSpoyJxEqvNǒbedEbòfpéKǔǔD	FALSE
ChòIgPàytMQlHpaaaaaaXbáEaibBHáAw	FALSE
FHaaaaaatfQěárOYàéLVèlǎhbiAVrébC	FALSE
HwvHèhTDiLjaaaaaawnMnbHqóuǒǒCUbi	FALSE
KaNdmǎlhPaaaaaaXbyfMIiYucbALDQPd	FALSE
NdéaaaaaabZǔlfvVtoSùTnbǒSliouVuK	FALSE
QVèwaKuKYaaaaaaFbpHGbbeáUéHQsRwq	FALSE
TEUdjèaaaaaaAQHldFaVawiLbNLIUSěb	FALSE
VrqyěòkitGaaaaaabOxPùváWvsPbgWgù	FALSE
YcaaaaaabWryéEZAǒsèEzúbOǎàgZnPCi	FALSE
aaaaaaǒNǒVMUQǔJjvOWNKirbéfctyBbu	FALSE
aaaaaaZwcJCùhùóúbNàWxǒNfwbimǎPhV	FALSE
aaaaaavubùFydǔSZlàFLbeUPWpYKhOlG	FALSE
cmaaaaaahubYliarqMKDJěLgRsùGbmgJ	FALSE
fPxkdnprxaaaaaaMbèQKbKeáPStéCmlt	FALSE
iIwaaaaaasFdkblnOPGltgqEòkecybFǒ	FALSE
lIǒGaaaaaahúěRbSxwuZtsEFbúmjPGóà	FALSE
nwěaaaaaaùgúòqKǔǔaiENbǔybǎWzyIgh	FALSE
rùeaaaaaaPǎIǎADbròZbuyOHyǒHèpáJX	FALSE
tpzWéJkdqmTcludntúaaaaaaSbBbOVeO	FALSE
xáMyaaaaaaooCZcútǒGǎBbUDáhQlhbgá	FALSE
ùǔOpfqGwknáEǒBAǔONdGeyZRAǎDyOwòòF	TRUE
áfWǔROèNúdéòbqLZjejèEIéNdAAàeHúrt	TRUE
éJMHzóSòRznsUPThCaǎcCBqmTDoBtvéoè	TRUE
ěYVmèDzClVKlháyjóóukùéVZedEPwivyH	TRUE
òsQrQNWwqiFcoWcWǎVSǔERSIfLàlAfind	TRUE
AEKzIYFbSeArtǎyZWkcòěGcèǔNmwxhtEF	TRUE
COwděmrflLquvlKtKkmǔLUúdPCXLvylǒj	TRUE
EueybórǒQOùYbpDWSwùXǎGuSghhgMIngE	TRUE
HúlMhgqpHRtBórKZDkxPáooFpWéumfCùM	TRUE
KùTwéqfgQórmhnqBjVúmJzhugǒmKXèǎfǒ	TRUE
MulèPqnKUKVáǎocQwHAácMrWdCqhkHXxi	TRUE
PZFsèRvZIkéfrsircTèusbǎsZStUDǎPAL	TRUE
SOLCKsZwFoeOwFSàIaEShǒRfzyIUvljRT	TRUE
VǔNDǔzozáènbWXvlràsàDNAYúEyHhǒèTè	TRUE
XtkěhwgyCroKòDrVùrAjUGiójGRaSsDfk	TRUE
aBgbfixdiWfnIIùěOjKiùZHiqkgYúfóto	TRUE
dàcYFLBVWBoXèěrAIaóiFUHGhdAùmKhKP	TRUE
fcxQXxóbKèáqfODQǎuFjvewxáXùDGKnòW	TRUE
iéMmVtvèQlooIMnúǎweoHQaJKVváBǒpMǒ	TRUE
kKXùQqJPpCIléJZzBFbriWǔLfáKVuèqTo	TRUE
nǎèPWàPBiIFhǒJboDǒvóábpsYvXpěfKèé	TRUE
pXSCěaúoTǒòMITbúmkSbtdmádAXDnùèBi	TRUE
sLGǒmjDAVwhQyHtAúJLaMVVdBJsúěFyCA	TRUE
udCVSLAOCprtHyàèYDáùhJécbPXNQHwnt	TRUE
xIuéjshbRnZěLFsAFgdOdófZLEIiLWnuk	TRUE
ùùAlsàaaaaaabTxsGLùǒǒIqPèbaiTǒMǔw	FALSE
áaaaaaaYaùùbAúmúòYBzěXLlSGbgěéCTk	FALSE
éZKMàprùtuICélgaaaaaabKětnbEěiúvm	FALSE
òǒCtUuJzpáUǎáHaaaaaaKǒIzvJUbccǔjb	FALSE
úgTHiághevdHUóaaaaaalbǔǔkáòlgsèbǎ	FALSE
DENúaaaaaaAóTPAPbrjóEèFXpòblòEqdó	FALSE
GǒdǒǎPaTPoZaaaaaarQqLúIjSRcběbPNe	FALSE
JKvfskàoidaaaaaaRdhóbwnObcKòjZóZx	FALSE
MDWQòaaaaaacěLetjInfǔCblbkJMBsmZB	FALSE
PùyLuHUritáaaaaaarYùVbZFnXNObPpEK	FALSE
RaaaaaaWPpdebhSlhZUXbówkùIáDBáYQP	FALSE
TxaaaaaaRéFZLoaUǎFbyEFzàbàLeHyjuà	FALSE
WJOISaaaaaaueězOXiZǎKZnbJmbpuHHPY	FALSE
YsKáaaaaaaKybNsbàUfQPgbdèóGaniRqP	FALSE
aaaaaaǒODCDòěUHSTRjLVóbvRoùwbSkxu	FALSE
aaaaaaakùóIpbmévNULbIàKFǒImscyàZǒ	FALSE
aaaaaasISbQWRéIhRJóěbMaòcúDLpgfKR	FALSE
dJknURSftgaaaaaaěmXPúNTpkZWbběsAu	FALSE
gúpqaaaaaaSRáòutSUbndXMéobLooKrěn	FALSE
ijgaaaaaaMbLǎyóúwIpóOscóiAHAcnTzb	FALSE
leKdWUNFǎewCUaaaaaabéóYvjoPxtaǒmb	FALSE
oúaaaaaagaAbUsHèiWǒLóéǎiOlbaqivǔd	FALSE
rgáMfBDZuTgZèùqBMhnòaaaaaabidnàǔb	FALSE
uVebGVǒWWGsxVaaaaaaLbFuuèǎlèàFbGk	FALSE
xXzǎaaaaaabVSmBAWUYZgóuBBwbEóUVǔr	FALSE
ùǔIHáScKKǒǎzzùdMWOfJlLájùGcCVàǔOLe	TRUE
áJhLbqwGXágCǒlshZúELXSLGmauuXǔDàRǎ	TRUE
ǎOmFlZtrWTuntZZKajòǎráicCPIeèIBCqH	TRUE
èpùòDkUóQByKurvSlAhqèghwéCǔlMeCFSs	TRUE
òòóòVkGùěòmRKóCHòsSWOúfnYvLóòàDxaK	TRUE
úUǎJěésXPUrEDuPǒúhqJbǎNsARǒGQsKkVb	TRUE
CéòLèLpgSnhǎJòhǒLòcǒnàxxbSéheBùbzT	TRUE
ErúǎxǔóQészEhpBYIbbMFHáXWeRěQFaymn	TRUE
HDdJUAótgNvigmRǔúUTeLrrlawYzgdgèBA	TRUE
JcmjágsDvòèkǒǎxfǔyhuuPpRbLuaiáULLc	TRUE
MXèiInràúYǎzmSáebYáxITaSzjCwrEùIQH	TRUE
OwSMGqyòùEèeLeioxVǎkdaujMLoAùsopuY	TRUE
RkOéWFEAXIgJlzǒǒKQYáéULaNIgBYDCCcé	TRUE
UAjáBlEEmwOLcevNGàLúoycMSGleDyzJVQ	TRUE
XCRYSèEwvDéJozGQHèDěFZǒsúèJNCǎáDáL	TRUE
ZIùúOgCódhmNegkJKXPEIDdauldMTPROèu	TRUE
cábmmYzTIáaWàFjLjǔábLBSqápHucúMYog	TRUE
ePEaǔASǒqDǔtQàóócsHBVNOMomzOuHeEBw	TRUE
hGeradjBvvsHvdcFtòxxbpXMmòtQhMYcra	TRUE
kBǎǒOarNbsáiJmáǎBéudbLǔoávxǒHàúkùL	TRUE
nàhèNVRiMNcAKImMGNRùEǒtahZWscysfsè	TRUE
pRéDKnhDkktTvKǒcrfrrràVèúaBIbLWsvC	TRUE
sFSouaǒǎdSFdhyVDfVbfóWwTzùpbáOeSúè	TRUE
vùěOwéHǔòpzYAoèFNTZzdkwwnCòPQogYjs	TRUE
xfOKXAáGwzezHAěPzèHQGDUBKuějjRLuZN	TRUE
ùǎGǒtBùSVrùoDxágwáaaaaaaTpnYyGJbwb	FALSE
àéòàiNmúQZaaaaaaCDbbyalJEeeějaeuók	FALSE
èáaaaaaaoàfmKeCǔbókKgAPAJCVrbYXXàV	FALSE
ówlhèèenvzgNǒéaaaaaaFbèGFyKiPRbJró	FALSE
úIédYúTZGjaaaaaaDJFbORjFTYúqCoběqH	FALSE
BrlaaaaaagJJfzsErywRnǎyěbbjJwdzVJè	FALSE
EvTYùAsǔBsvHVUvaaaaaasXdIbllebǔJSù	FALSE
HlXsǎjihaaaaaaRqRubòwXCGfXFúùbǎǔYg	FALSE
KlGóǔvòrTUúnlQaaaaaakObhvtàkbpVUèǎ	FALSE
NhKOúaaaaaaaGiTzvMMIhèěwòrjrbbròGZ	FALSE
QWvEvIaaaaaaUzMMXCigtbyTjwbeàqsMhr	FALSE
SvVǔnnfVlQBUXaaaaaaZRWAfjiabùcljbN	FALSE
VaElBuoǔoaaaaaaéXójFbCfhbǎMolgtQYz	FALSE
YǔRóaaaaaafuǔbAtbAygFàZmHInMPSKúǒB	FALSE
aaaaaaábxBjǒbxěaPXIojàNǎáhQlǔMgaYN	FALSE
aaaaaaTeHJnyǎerVgbábyěNkxssóidQùàS	FALSE
aaaaaavfibQǎiáàsòGJǎjéAkbehRqúGvoc	FALSE
dHpbWnoBPmlNlMGaaaaaaCOnJbsJCdbuGV	FALSE
gDJòaaaaaaeǎUùHǒDbBqQYRabhtGiolákd	FALSE
imaaaaaafBpáAiRflkNlxXèbPUbBOjǒwpX	FALSE
lxàekInǎǔòQdriiLaaaaaaOoFbIRbOOSVo	FALSE
ojèùxiaaaaaaxbTUbxIRòiWcgIdbbSGkqJ	FALSE
rUóYuAaaaaaaucGYbóKjkJFIbgúijváhLR	FALSE
uǎSblwrúFrIHBLvDieHaaaaaabOubewXóx	FALSE
wquctSUòhàjeGITùǎQaaaaaaEuzqbànsPb	FALSE
ùùsHwcsseóQCBùàNEMhlEchùsJGúójWCQeA	TRUE
áuLaùFrhhnCTNDIùbǒIfIoIéǎVàgdZbjbRo	TRUE
éFICtZHmkàcùJzùYgěQfcǎùwHUxFGrǔPfSw	TRUE
ěvSmUKdDoǔEOhhmMúúlxǒkúEmgzrKsjGóvw	TRUE
ǒaRaàKóJBAdCGVygLUkězgRCieCGéTáVaTA	TRUE
BIBumúuZRsòboEBRàBEjeNHeDgRNélùDěoǒ	TRUE
DuǒTwUvBBobKúYiTWTHXbCòLQtèKWvèjVyn	TRUE
GhtùiǔLlrORBǔrtRBtóáùjBiXggjòòZUjXà	TRUE
JFVráisZtCNPvrFvwsouyjfaJnàWRCqòzIX	TRUE
LnQjqcjBěTáPctOAlúYyrblùyěWIFBòFhIc	TRUE
OMKòàhtSátpSlUJUtjajèèJKVpǎFMWólálg	TRUE
QnnhǔDTcryùaǒbzBkUlSQdmOúaKllUQNěJw	TRUE
TèBXzùXKnMvngJhxNKqěqwèJCǒNlóspONùL	TRUE
VFJMstGNàéXHkIrOéhSSbZFiggeTLǎlRàóx	TRUE
YKiáoqQjWnJlGtQZhRěMTòyUvEPǒfTěǔSoZ	TRUE
béàIéájwqldenLIALèéQadFrIHkǒdtfunfú	TRUE
dOFcDhfkLYyhJéxBXketCevJHbúóOzwBGps	TRUE
fZOěljzTIOědMqáyveCǔIgùpdzDjaECKéǒò	TRUE
iKYèvǒěCfvEPdnGrMáXéodAèOAfHúáAuOIw	TRUE
kpěúúVIDóBjùzésvXDfKNpROǒgDmAVCTfEv	TRUE
ndcYxdsǒLáòznaimKUějHòcYwWnPwnyjZóù	TRUE
qùBRXRkáEqTwxCZrkbKéaFNtMGbiHǔKFCqà	TRUE
sGLǒqdyéòQAmòúùHhLòqmBTlPkjàtsDlYKz	TRUE
uzStIXdXMJWùJéjtsypYqDzCqWVfQcèpIhT	TRUE
xIejvHLlrOtoLtúXedloegqwWGeZqBvcJda	TRUE
ùákDAěvxNááětrWXaaaaaafodIKJbráHttb	FALSE
ásOvyVhnJǔWjaaaaaabEZENkLXXtzsbEdyx	FALSE
ékúShBpfaaaaaavbVbdófèǔzqyěoeàMǔZOs	FALSE
óaaaaaaPAáéúběHdWǒbAiPvqúXSPZmRhYCk	FALSE
úúFaaaaaaZkèarùhcBárhMùOJǔNbrǒàfáxb	FALSE
ByZěúnguxaaaaaaéAéjboáJkǒǔecbLdZwzG	FALSE
EaaaaaaiùbXDKcǔZAFaVèoǒeǎuKZěáXpǔbé	FALSE
HdXèqCADaaaaaanAaiBCFHUzmXKǎebiqwǎb	FALSE
LávaaaaaaùqfdmUGTabypWoabMXECXWEkáJ	FALSE
NyAaaaaaafèǔběàedEqáělgScúbZQasNelé	FALSE
RédGDHjkaaaaaacCCkBkǎIxzbWoújùǒbzěF	FALSE
TaaaaaaHZylbòDOvèutkXeNMWjljdabmMka	FALSE
WdmNMěnEàGnaXZaaaaaaIbjevSázbOqnhǒo	FALSE
ZǒiAsJaaaaaabrjoyQybbpafuTábwoRnbFS	FALSE
aaaaaaAǎbòàǎáǔeBcbHúsGirAYrVXáúQmCj	FALSE
aaaaaaagXjDEàyWábbmqdTǎoxaòǎWcaèaDn	FALSE
aaaaaaybéVhújYeZbPWdQiedznoRǎédszlt	FALSE
dCbTaaaaaacQzxiZǎJǒújUvNbMVǔbwSUvlW	FALSE
gVaaaaaaPkvCiàZbTYjbwsebULZSyèhsYBJ	FALSE
jaitvcyǔaaaaaazEAXèbQNzezVùFyANzbóE	FALSE
mDFxUbGùCNJaaaaaaVbFXnǎtxLLúZnpboVY	FALSE
ozvfFSgEToDymcFgbeRèǒtibeaaaaaabbǔH	FALSE
raaaaaaAIfOaǎxxǔwtpbnKgěRIRbǔOBúyJa	FALSE
uDǔbaaaaaaváfRRtqRobUòqApNwiúDNósbs	FALSE
xúRéLaaaaaanOPbòoèHRIěhMècHHBHaélbO	FALSE
ùùONágDQrStRYTHuǔRaNkrCfSojǎNXsXAsbU	TRUE
ádRZěHěnIpnisyúBlHQéNMcVVkIZiúuqùǒòǒ	TRUE
ǎvhpkCzásPùXugVdáǒkujWnyDlǔeTmdIryEa	TRUE
ěHBqDRpPGùáKtcnóqTOeóyfómIBǎBKDflmZk	TRUE
òtòDsTsaUdzaUItlllbZXAèryùfuVrgULMói	TRUE
ACFTzqOKeJVCZáxHEKkàHHXdxkOYXYhrgéSa	TRUE
CqpVěǎBcróěIivPgrJRoàsCHDZvZJKEngOxV	TRUE
FIFgZZhjùcQFěěnqpGsXqàùrZBBJVpoZEwià	TRUE
IWúJWǔáaIvjGlHhZúAqPBfSUvhiaòDùJBUUE	TRUE
KuPcYaKáVòXyMQnLmǔmàKuikGCMhèxèǎhiòR	TRUE
NóUzáYldCǔpGǎěDwgGLlDbIQdrtScàxkdèPǔ	TRUE
PXdoRPyHOpvpjGYHCwoNGqǎgwXfǔEHJQzbKO	TRUE
SMEǎyRkáǔoǔByUòKzqzZúsAOHOsUKrWXmkéx	TRUE
UgàGvEFydnKLóSóPrHkKIdGNùùEFCLxDzYLě	TRUE
XóvsiMOòyNYnzHdzbqNjEkaZeSVtxUQMhèóě	TRUE
ZwǎjwKobMIBuKVNeTSùWXúbczIgeCGXmkScE	TRUE
cUgóDhBKětěkMufFAsDPòsNěUdxRYdgúChIq	TRUE
fRIhàvdumúòùùSIUqWHóIěMǔběEòOcQohutó	TRUE
iéFROsèáWKbbàuáQàoYSmPbimTWOèczJaNbf	TRUE
lěYKavòqSrQǎMsǒǒqSSděOteYVXYwISXqNdX	TRUE
nEyqěMWiúdnTAMHaéuIXVǒajNPwUqèALǒwǒo	TRUE
pxòòkEJèTVPòRuSyjǔRCZèswuHhypXgOlbdW	TRUE
sffùEKVbǎqCmlǔUNbpkyUfdjIRQCBNàMRNGá	TRUE
uxrzddǔuFbaǔQRUHnuóYvVenhnGuoYvǎxWjn	TRUE
xdCVwǎàWMCBǔYCjQNfYJhsvLtSNhnkYpWxòú	TRUE
ùùfJokGSpjTjxánúFOaaaaaabǒúuhwbSuRùO	FALSE
àéBǔRwIvaaaaaadyZbywLěfKbtèóěnmSIidU	FALSE
érFǒaaaaaaQsEbkihXgaérBlDnWkbKKNtRDè	FALSE
ódBRWSZaZaaaaaavdbnUnFQvsPeIONNNfYbx	FALSE
úXxaaaaaaRvQcǔIWrGòTbVYWdpObǒsAwAxhS	FALSE
CRbaaaaaaRyoMUéKGoigópiTSJbsnsmbànKQ	FALSE
FNriaaaaaajKùKIǒzYoèLǒKúbbUczLúǒikBN	FALSE
IBbáàcàCJǎoaaaaaaUoLFEkbmBSóúbeJShQj	FALSE
LaaaaaaXuGJGPtjWEpVuvzGbAxóIAmébtEFD	FALSE
OaaaaaaeYzniUSǔorjrDycRrtHHpohhaCbbs	FALSE
RaqqCòTYaaaaaaKéPkWIàlVJbymjbmgltǔtò	FALSE
TrxrěùTpúCFaaaaaaZsàJáWáPJPdZbvUkbòB	FALSE
WEJkAfaaaaaaAúubKbITaVZVUxiIPyinàMnu	FALSE
YyéDvAYyaaaaaaQGeJtLMúqucqevDóBNbYbè	FALSE
aaaaaaAEàfuXNábicSMboXBàjàeǒFAuusfig	FALSE
aaaaaacMbKXjAeIKNáWǔaTuHfSúKmqbKKJqS	FALSE
bCBlBdéQYǎJkMCcáHnaZlaaaaaabózóGbèxv	FALSE
dcaaaaaaJiQPoUZeáoPgúWdmYKrblgbbBUáò	FALSE
gYYevèAtJbDaaaaaacyvòbdKAáuFxeùrOpSb	FALSE
jYǎHCaaaaaaZSbcǎXóZJtwubwKúLGkFdegwJ	FALSE
lzeJaaaaaabùMwAmáuwcssFpúwwùǔukàbǒoQ	FALSE
oigBDǔǔcKǔǒuFebTaaaaaawòSbabAdùRuDZA	FALSE
rVNòdjaaaaaazpgjòKOéeVbábJTěsIsúHǎIt	FALSE
uPrjóJèGpèaaaaaabaFLVúsopnlRóukArPbO	FALSE
xaǎqVUFàGúlhaaaaaaNQBgěJjKbGkHuǒbrcs	FALSE
ùǔúEUgùàèdZFxlyVLpBgewrWǔLhSpinCùWpyv	TRUE
áeábXNcaGISVwHòHPèdWQòxDJKmǔWIYáǎAzEE	TRUE
éCIKBwGDuuWFeàZmmúFljàNmòèCFUvétJeeye	TRUE
óOfǒsriéSewAéaLnyyzoAdsxǔcCrPcǔppzbTY	TRUE
ǒzHNefSmjfǎRùeHěFěǔEHrHdgqIběXnéLTpOú	TRUE
BrSSakòǎtwibàJCnnóTnGxzaaGLENóǔáIUBLù	TRUE
EǎiPhvOgVNecZQQIEQHJqSAiaYààQTàbnǎkGR	TRUE
GjNqFPúxwKnlkwàGèlUaZVEvioùDeLGèBWlZE	TRUE
JILRoyúnyvuTRaVVcMokLAkQbeBéAAXeGvyFp	TRUE
LpòtIgESqWYQhóPèPXěpWnZZAgTGwyàSdúLnv	TRUE
OTvéúpYjsnKǎoIKtèJTBxRáóuèISzDPEZhQúh	TRUE
QeéYǎèIdyicblJTGúaúàXhveNXtUWmomMphCs	TRUE
TFVlOWKkOvJgybNgnMQBQPjeZúyuPWFǒsqgFp	TRUE
VRjǎLkěěZQSélùGWàprMěàEvJOGavlMCszgVN	TRUE
YBqǔKnǒptLIhěaBYxSóóntèjWqFféběRmAóǎG	TRUE
bégmónVZnuPéWpjULkWFjucLhiaTnjrHgàkhD	TRUE
dHDǔxIayaǔǔfSóLZoLTdáàtUsvwàvzgfòLANu	TRUE
fdJdapZXzxpkbFKǒRReDvztàOYndZǔéàgěUWà	TRUE
iIWǎhuàǎǎJInVLygmòiyOrTùfCJúJTIcPgLlb	TRUE
kxciáFGTMXhùàIKgBkěNGǒLXpGěkéRěDiúITY	TRUE
naiMIMGhdnAúGLuiòsLliAějXǔuèArpQáejùP	TRUE
qóvóxnHFZàMwNqǔǔNùbcEPRdùwfúgéHcwNjlS	TRUE
sOaieeZzTjEbkǒòJpsàUNXóàbkjbqaxFùLwCm	TRUE
ufnmèǔèCFapbtùYXMyqUZMHDlaqObèéemYMOl	TRUE
xSluwgèáBsrXǔjuvBǒWùùòAǒZXdWèmuSiěvRB	TRUE
ùùkTAukaaaaaaJǎbKQWbKězVqnJyAOPeRPWDH	FALSE
áyLaaaaaaHUOòóEǎéQbváwbBapvtEpónuDcGB	FALSE
éeaùYbbpaaaaaaěsvbNPRKSGOhPbYshjǔKaZǒ	FALSE
óaaaaaazfbjcQéJwYyoKmjkYlGbUkbóùmèand	FALSE
úOIèaaaaaaTuaAqIgQǔqbzfYAvQbrRmJBqbxá	FALSE
CEUKCSUKjáhèdaaaaaabEwǒRgGtqwhdboRéqp	FALSE
EsMcKzaaaaaakàcLiùrawSntóbqǔáǔCnRscbó	FALSE
HIYTlévtMǔDqdzKwHaaaaaaGbKikbàvVwstCà	FALSE
KǒpuǎcTYaaaaaaaGJjrbyǔQYòbTxHVBUáùmGè	FALSE
NCIRdraaaaaabúbSbògvHTXRPǒXeXaěYhLVqA	FALSE
QùCdBIěǔZǎEùoáVaaaaaahǒbIvnmpAbWpǒckr	FALSE
SaaaaaaXsNgSqJHbGlKhnúbECLqbbaWNXQǎǒC	FALSE
VEtòlVǎNpBEaaaaaayWRoùbAboJZZvpyBǔrcf	FALSE
XeDeVèNaaaaaadwgǔbubqUǒzkRcspawArSǔPI	FALSE
aKùaaaaaaKQbrFúòGkxKvVrPbXǔCJXóMdǒRkǎ	FALSE
aaaaaaMWbCQPDnuiúálvXaùVNNClnWrBRǒbvà	FALSE
aaaaaanòeTBywóFèJKPiczYybTzHbWFRysásZ	FALSE
ccǔaaaaaazslHsbKDHJǎjNjQàLeUtRxpRPVbt	FALSE
fOZùOEUèTAjFuQLJaaaaaaebàpCWdydasdnbú	FALSE
iDxOwlsaaaaaaHéPaPUbbMReeséRLěkSSsYnu	FALSE
kpqkáKèIdéaaaaaaJJbórǔióbEIqóààěJuàyn	FALSE
ngzǎTaaaaaaHwiùjreeǔCévuebAIrFAVuNèjb	FALSE
qqòpělBdkaaaaaaBcèoSOfbǎbǔgǔsùYcskǎNB	FALSE
tqQcGYctZHZòaaaaaaJaAufòXCNǔbdvòDbédH	FALSE
waaaaaaIpubwkNqKurwVbPNpJòXLUoGTSBJèO	FALSE
ùǔBUǎYxhbQuùYfrTxQhlHóǔqWxWplAǔLOòTtRv	TRUE
áDkùǔlEqpnSjlhrbùomzxDVbrvaWAbòóHYbLUě	TRUE
ǎsàDSVjgJYLIZAdxiqucsàqàǔòIěcdBKbewCPR	TRUE
ěópǒǒmDKěèǎDWYnWmFóuBoIǎaeQXyKyoèGézRq	TRUE
òlZgHFtoXùdǒKúAiQǔotMPúnwpJUHTutwòWǎBx	TRUE
AdHJKRòzKóěkTFjyNwesǔedXxoewmMGǎCBnhJi	TRUE
DIácaxWèuMNgKmHněfbKSòúYTàAgfxQEkjFběM	TRUE
GǎNǒihǒSQǎòGIRLzTBěPDMèudèeHzzútèpOIRz	TRUE
IQbbEóQoěElzéoXoYZUùKAQATwDUhsúudqǒhIG	TRUE
LǎáTòUuWoeóEqJèYwXZbAàJhěugqkHópUAéóúy	TRUE
NúěpnSGmTNuHhlgjKGZàPuWǎobákcOlPiDVùBǔ	TRUE
PnǒCAzǒěIBCgcvCsaMTDJèǒpxYEWSYaóYJShnA	TRUE
SAWnzoǔcecxCnKSdHVxǔghcphTEóáUItgrCDce	TRUE
UYIkIhqòSZItaǎRkwLèMěàkǎhRLeoMeLSlsyHA	TRUE
WvMrthaouUmEěòIhjSvDéwJúxgùzwǔéeSoKgnW	TRUE
ZjNmzPkxjKkHúQxBùapNǒéYiEzSvéyCòzNBàrx	TRUE
cVeúZbLNoGwsmTzwǒiCHòlQZYHOùKwgDSBkkaz	TRUE
fbXEéWBIòBpjAnHáCIKxBMèYilTMIběùLdmriU	TRUE
iFJRmeJcepVǎixeyxeygWGqqTVǔYaCsOàhQxMW	TRUE
lǔvANUtNCpsMsóèYPcVózQěWcHTArCVòTfHáTP	TRUE
nOXVǎjSWǒXWKùgěhjasDwmYuùFtázHxúàKziYǒ	TRUE
qORHtùCùoáVYmòjréěvǒxúJBplIZqěàěkNqEIp	TRUE
tèuJbKxztkěbDǒléjAAdáOCuoDěvóèjQǔbaHBc	TRUE
vFMRwYxwSdfQNgǒùděxbgUfǔǒběmuǔGcUMWbTv	TRUE
xTBNmvpPǎIDPmlsCùáASóǔBFoèICCùJFTSáǔwy	TRUE
ùùEwǒevCáùqaaaaaabzbeZEjeOěEUuXǎfFXmax	FALSE
áXzúTàYzUAAIwaJáǔgVǒkèXMJmaaaaaaLàǒbTb	FALSE
éQNiàǔLaaaaaabHCKDEàMbpgAěxpsKXHbvuAAE	FALSE
ófóWzdáZúLvaaaaaaǔIssbmbméxáfǔáKCHéDyp	FALSE
úUfTXdaaaaaabZhoǎNmrDdcúbóHtMéèPvdIaEy	FALSE
CùJJòǔZPqóGyDZYTèAEaaaaaaóabWbólcGvóKá	FALSE
ECKèWěaaaaaaBbhKJbyOFGǔEyLnyGrwsùdFPXd	FALSE
HKhTEúGaaaaaaúDQJfglǔbNbóqémjPmiMǎkkdU	FALSE
KàETAaaaaaaRKVWQnùDfynLSUǒbYTbIǎFDKèáh	FALSE
MvEǔJaaaaaazywOEZwHzGXǎbZhKXhJUOIbkMúC	FALSE
PaaaaaaGAhòbbngHTnnEiDáQtcdǎEYLàCVètWR	FALSE
SMnUǔPwDDlfúǎaaaaaaòǒrnǒbKUZuSbyebKVmH	FALSE
VGOtjoKPZwPPaaaaaaRybrbcDbèGTWBvYgSóǒe	FALSE
YárxFeǒkyMRmSǒYaaaaaaPcenbbvpǔIgóobzQT	FALSE
aaaaaaéǔǒJùaJzWoqNQbáuPXèErJZObvúycQRf	FALSE
aaaaaabebEgxDgPwXLǔToWhXyówLJǒErgwUKpu	FALSE
awsaaaaaaiJtMCksXbJeKwBgDzóPSJbùzèEèsZ	FALSE
eIaaaaaaqrxàǒòGGkDgbMHduèbfvvzàMǔLTéFH	FALSE
goNLeaaaaaaàwVbjrvěbTòUdCTéOXnnJWscOèJ	FALSE
jhMWxaaaaaambBfDHTbhxQóěCVGòqjùyHneMWl	FALSE
mCEAVbLfKRcOCùbQaaaaaaSězDbXǔèbúwòéVgO	FALSE
oySdaaaaaaBMgQWbǒUxqxOPNněbgBòuàPkDòvS	FALSE
sùFZiIHútBaaaaaaVYHbjóEhhOWbqnlSEǔǒbLá	FALSE
uaaaaaamVěFǎzWIùvPaGbbùzqóPváSWMNpAifG	FALSE
xKlWRModuPòxáYcUgaaaaaasViFbZhqKTCDyVb	FALSE
ùǔàùzrxéùHLKrUyMOrtúPYwáWYohYQkJWúZqwXF	TRUE
áetOHJvWBláJhGIěpdSdóbQaúbNfhWAbNvǒrMUW	TRUE
éLrIàCtǔělIGvěRPRywAáfúaYjUQtplèPXtbnèm	TRUE
óǎYimTóancBMuZDLXFòqIvvzzOrPtnhPyQǒèǔùV	TRUE
ǒcfoěVhsBHéújXoèèéDzàNEǔQLèpmEDYYOòVǔkW	TRUE
AkDuZhǎjXfgúZiaàuFDzPJwHozúTnYBURZhncqO	TRUE
DYpUPFCxWbGVYjXIXZdPPRvKZhKHpuTEdUtCǒHF	TRUE
FkgBoDuvéLxúGqfnjSOVkvóLeóJaDZWsjmJMEdá	TRUE
IǒSjQTUvàáǎóOFǔMCǒYdGYLéDYequRáPsPsěZpW	TRUE
KfGiWpHóMwhLBqAzSǔEcǎmEFjxxǒNnBsxwHXxGt	TRUE
MrjhdagZctShsáOǎnEpXUǔpeǔvrlǔòǔVàXsPNIQ	TRUE
PQèváHqoEkùggAùWáuCLoLqqfFYxdMbtvǒUMUeè	TRUE
SěǎòVǒQànihoúqvSàPòMQoBMTǎHhǎSqAvǔnpònr	TRUE
UybULZqókFbVAèjsihNvvZFQxqkQkRǒZXwddánx	TRUE
XIùkJfJoWFAfQHxXRDtqNNkjmOmǔihàòUWeFěMe	TRUE
ZNDCgvqbúǎmgsXHǔPxáSmuEABzSwluóBNàSNiBé	TRUE
cègYKdòěěCDòXYhygSrwBWrghuQùùVnyúIvJViL	TRUE
fěFXgAlěqECkFZclBnmózpěkǔwuRBúáUgRRézXn	TRUE
hpMNulsnZIzòcKgǎFEqgMyTosǒephXHBdkǔNXHZ	TRUE
kRzMMJDIelTyǔObupNwlóxtpcǎyUKúěneYLwNáC	TRUE
núOxWhUtlloyGBYyPKgtázǎBIUnryáráùcùVUfr	TRUE
piFYOawPbùoMiwǎONsvǔGěZVcowUEQHXHǎǎKDlx	TRUE
sQYuJTQèEgéqOGmqùágTPAǔbméCsZǒàǒCOstòyj	TRUE
vòVJěǔcóhITZǎBpZyúaOávvDcèijjszuLtBkědg	TRUE
xpQJQVXlCuZQáYCtZCCblěmèInHOKmRòAiSqwyT	TRUE
ùùIIáaaaaaaábòaǎpPQòdLBjZKtQUǒXbOòóVlyO	FALSE
ásdfZMněeHaaaaaaPEbWSbNpaKǒKámDeáCAjǔQV	FALSE
éTáfsnggdSTéaaaaaaUIaǒfahqbzLbdǒGUVhaNg	FALSE
óJIBéùRKǎKUpǔěcUaaaaaaESoiuboCUkxbKFKXa	FALSE
ǒtaaaaaaoqbvRnèQeZóòsmsysHQMIBbClYIqfXI	FALSE
CélLVvalòULuaaaaaaSzpBDBzIàbFXMXǒbWàǒCC	FALSE
EqTúZNúQaaaaaawsVkèàAbbRáIAVVQbEǒorYoLb	FALSE
HaaaaaaáàNeTTOsfCBBNàbVèvoObOodnùáHáyǒw	FALSE
KOóIaaaaaaadzIxěàOàLcPbaèTXǔybWurHméVHc	FALSE
MiětXEVFaaaaaaRGNVvyggVmbMqǎǔùUóZSéTmYb	FALSE
PqsiaaaaaakbFHtjvòlCcóZYdfYiOpgdjbvrzmé	FALSE
SjISVáboèùòówzpaaaaaatbnvǎAtqsáǎMbtěfUs	FALSE
VVsBoyWaaaaaanhàbxnRúispòhúFzlDwóónbNúK	FALSE
YBaaaaaazDǔKNjbuOàTbIAUèǎBvpZRaAKjEáèvK	FALSE
aaaaaaènfhoCNJǔúRtéhPIjúvcHhboLSmhckwbM	FALSE
aaaaaabǎSpFpèLzSsWoxpWVodZHAStWfaNbSVSB	FALSE
bDCPaaaaaatèbǒtHbBJXpwvFksgúějrDxwxqCǔè	FALSE
eóěqniFěqiuùǒvrsxbraaaaaaybybéRimWHgWBù	FALSE
gpBEbXaaaaaacqHbPéèXǔaCbCUUCPSRCRQǒXKàJ	FALSE
jZéFVWuVaaaaaaòEJqhpxyICbqIXfbWfFDǒTIYr	FALSE
lgDvuramZàBLǒNQvQrEbaaaaaaǎdòFEzàbùóbcǎ	FALSE
oshTEaaaaaaPGxysdiòDUdTòeQǎhbCbFCmFjDCq	FALSE
raaaaaaoobòúòwxLwóbsǎHáaxǔlZaàóIQRòKgrK	FALSE
unDMaaaaaajǔZbgrPóTQèyàgjùCRTbRóǒEYxEaX	FALSE
xONjaaaaaaYGEǔèFVVTuiuaǔòbbǔZtvZNTIkxjH	FALSE
ùǔBBxigErǔBMáFptéFàaàQkaEcokjhpdOPAYgkvV	TRUE
áGFèúMYRJfRBvvvǒCáypkUZácjzXXàEjOǒlxNzlF	TRUE
éùTWèDàzNǒaPtàdBbilVSZzZǒòejpxRǔxéWsuwuǒ	TRUE
ěDJvqXkrEGYfEglrsUIxneNSpóoUaabZClFNVybe	TRUE
òyEàMZSèpYàAQùèMDFbKUiájoàáěSnnwAwòkELSL	TRUE
APpXSERgfrkZjRMJrnSéosSeRhlMxGfKIkdOHKCW	TRUE
DFyOIGátápLCFxTCòòèAúXHfláWàOzDGKQAEcimT	TRUE
FqhèOIleXZRdaIvkGdIMYUlAQNAXCqxóXtbPWáER	TRUE
IMMBnlXLéwéLNrPUOOáàAàBOLzzúCùqàmDGXhPǎò	TRUE
LáXùZòǒkyocGokcGpIiKhAYràNkAHMrGùyslòKyǒ	TRUE
NlutkSóLFBlAtǎAfGěubBSésojǔǔApsiòlRCjòwJ	TRUE
QccbpkYsFcǒcnlǎRDCUQUnIǒAàQrZklwmKvGYDKǔ	TRUE
TǒBfdROAJMSYLNLEULlUslǒéuMjPkKRPáùWRiGúq	TRUE
ViMLèMvNTzkǔFnBNǒnQiMúTvòDuPywmegwpkVBǔb	TRUE
YIbGěǎòókYeòlóějBdxAUdàEuNěajúJòuOQcpbPó	TRUE
aHzryQtWJVjmùmGèGjsZùóùMzVAvmYMZePsxfqFr	TRUE
dOUèxyècbvRSZúnjMvDPTAdqsbHQgǒYǔNsXJvcEě	TRUE
fUWoLZZhǎeJFhéTgnygiOgBLMYkgbHhzsueoKRAX	TRUE
iàQcBJDBtjpGyiKJàatBòHěǔvǎyKVeaVVsváyáDd	TRUE
kiQmPòyuaCZóZcúuXFGEtfRIxYYpDǎúTèlRzruàr	TRUE
nYHJecsǒsMnǔlǎúHgNJóúóěèIAtMfzFéAfáTwreE	TRUE
qFlFvIúòcEAODEudZRdsasWYúAVsXyJéèWYofàHt	TRUE
stgàGHóesèmDǔTrǎAcúrpěOfvJóúkcWGHnItIIùG	TRUE
vAZaEóòlòcltǒvòúVóěClkkòUBORwóòǔxóJPáùHá	TRUE
xdxǔDbTuPjòzUucǔWeEzeznǔXygHlarqWXMxGxFM	TRUE
ùùoMaaaaaaVcQvsPevyuGbVènYLǒǎezòábIàCwrW	FALSE
áOuúaaaaaaLNsiDTbLúVCaOóDDqXéwxèdxgZHbxv	FALSE
éChèVKTArSLBóoyBpMǒxezjEgaaaaaaPǒbQbOHJD	FALSE
óCTaaaaaaGjmRmoqrLbbyRkBIcCěrLjfeYsYPzáó	FALSE
ǒqVXbTOqòèeǔěUyFǎaaaaaapbWHiqbTǎJorTvcùl	FALSE
BxIècèaaaaaatóJLmdJLyobjlGXcàMbùYnSgfǔMQ	FALSE
ExMàrGeóùùuRxaaaaaaaBgiòWáRAbEYǎkMmpZǒzb	FALSE
HFyLaaaaaadSOlxQnzsèióbXTǒTEjuMxèbGeirǔG	FALSE
JRVZJbaaaaaapòNKWmpbOBjobúruèúXHúóQěǔSǒU	FALSE
MJgxRIaaaaaaePxdIědlEGábSSPofUdbàXFJolJK	FALSE
PaaaaaaSNkJqFYAJGXOǔlRùXǔAXhVGEpPNeNbUbx	FALSE
SlnjMdGnrěooPUvnIaaaaaaóPǔdBòǎDèZhbMùbMW	FALSE
VFSOVùbNháhSázaaaaaagLSNbtlFVkběVgàONtix	FALSE
XyIùóǒEùlEǔǔVnaaaaaaJUzyqYBXlCLubCabBBNǒ	FALSE
aaaaaaǔkáYyèqxOCVRlěOǎqdGáyàòNàwvEDNUbbx	FALSE
aaaaaaVTBNdbkDblúésZàùdRcDdOáKzmrPczeàMH	FALSE
arMfaaaaaavbmbrFPFsecáRWvAJPNHrzkHúkGiiò	FALSE
ddaaaaaaCayruErfQěVàéBAfrnòqfOnbbǔùAiSvS	FALSE
grRaaaaaaòJLVvUOkdEWbèpěOsLrpUúzcòHSObFé	FALSE
jaaaaaaPcéIZAibàrWtǎveébùěpGěJLsIHkccSǎD	FALSE
mHéǒaaaaaaCmQvFpNvbVtàCùpfwVFDIeLnyóDàpb	FALSE
páǒBcǔAGúaaaaaaJOiotqěsRJUsdZabbAraLljYF	FALSE
rtaaaaaaèLsqPáùIdKlbFFxOIOjSniEsCèKnbòvl	FALSE
uaaaaaaàrdJwǒòùahuMKQdNéRèdGǎEeopDěbǔbid	FALSE
xúvPZfjPxravSaaaaaarbskuLěYáeIblRGvěULPN	FALSE
ùàhǔfàiYfuDINùIZXúQCjǒPǎjóòFzMMXeMITeNmRH	TRUE
áTUtKséQIXEpèAbWtwǎuǎóòWzàeàPkqǒèOBTBsvBG	TRUE
éFǔqǔpSdggXifòúéNhdtrcvOietúNXǒERTYnYcwJà	TRUE
ěNCkxàndxnǎǒJPxfvQmUdVAtdZdUDjěqóóHrbXGYè	TRUE
ǒúSóhqéveWmaEDKaxWBYrávDEBlDgPubddkqeYVtT	TRUE
BǎfTJèébesunmBSrIvKJěfěLJyQqúJfèrRaZqkgLA	TRUE
DhóǎóXHFéUCgQLbyAILTézHèomyBBJADzòQàRNDti	TRUE
GànUfJvVěǔRǔlussbMuěEqnúhwopdJXnYkeLGgeIy	TRUE
IxGJKǎvnèFcǎYKàRZvUfcǒTTěaJóLSkhéNTFInqqà	TRUE
LoJnFZaǎcfTyYdtuTkybvRoCiKTjWjNzdXhwàodoe	TRUE
OApPFléGliAdGuddgtAbǒZSfdFSbRiADIEFUmJèqs	TRUE
QzweKágxxEIKzPèéfzDxèrMVnUFevěèyDgTGYúJVu	TRUE
TjWFěLjòlRzǒRKRpkzéNJàRVùulǒLúboBlvTEeWRT	TRUE
VvwginDàIplrEdVYGbJCtkǒámhùBQxFDmuLMeeMrB	TRUE
YYààOIdLòiHvdMjsOepèalHXoédaúǒKrEJJjèěHAZ	TRUE
axUJSàtěúJqrGbǒvùěxgHSxVfKomzàKmlZcLòámyu	TRUE
dEIǔycěpNBèuàWOyǔVvǔIJAwkwNCFǎKzsvOaéMINW	TRUE
fxBqéoKQòBPvZzUpJgóNdyǔMDEUNuòMNqHólOiLWD	TRUE
iJUhYrJCMzuRGǎBoǒtNKwǎàòLóbgSnòèoidIIYóIt	TRUE
krcèààběajohwáMgUùHNòWlqWrǒCDOpúAǎiuSùmsm	TRUE
npKUkèòTbsvúhVxvfWèNDUSrǎfRtUVǒSsTrMsuJXě	TRUE
qPBvMFEvFHefTriǔibRhDàúvbNNFfèVUáqabOnvDǎ	TRUE
svTèJViAsCPAlSSùnhMmgdUoèwYédeOYùǎAQsNzkM	TRUE
vIgAdpǒFSjDGEfwdlxbaoǔělgbEKúǔWCHnPkrukJt	TRUE
xeHǔxtjúWuiMǎcCsgciNǎmkèvuòCjDjkkNdǒémúmU	TRUE
ùěAJHIytaaaaaazébKduǒSǎUlbCvDUòIuexBéǔáKé	FALSE
àGyàěFfivféaNwzkòigóéùaaaaaaYRbumALFQàJbA	FALSE
èBúaaaaaaPDzGxúhfǔUXǒMúuAóèóistǒibóbSuSóz	FALSE
òòèèTMèUUaaaaaabnulǔVnuRzzHxsqdbásANòBléF	FALSE
úveaaaaaaHěcLVVOdxynKèaXOǔznvèJRǔDZvwobvb	FALSE
CloHkybYhFaaaaaaoaěqboúVrqóúiDkGBdoFéLábK	FALSE
FcéOwǒbqoaaaaaaEbPFGúnúLlxGOjǎVdbvuRRbDěp	FALSE
IaaaaaaqDPrwKúoQENSàgWERSóéXàbDuQbaosǒpmJ	FALSE
LVHVCNějbxZǔaaaaaamAtbǔbuAwwYóěwKégnIiěic	FALSE
OHlǎxaaaaaadhmbAEczbjliqeXfèáùdLěYzcFǔJèò	FALSE
QtRYúGwaaaaaaKǒTmòbhdèMskJaCǒějEkǒléékbbò	FALSE
TOièEóoǒùMcùLRùPzaaaaaaòěkèdPbwNUfexbBwEO	FALSE
VwaaaaaaúúúǔWcQMgdZTAdxbtdXqxóKvaèylbGdOH	FALSE
YeykkaiEpǎsWǒUxQreMuUEVnEZXaaaaaaFbJsAbór	FALSE
aaaaaaBnbóbOnwócúPekbeobiLěhcjRàtǒgXJYMBg	FALSE
aaaaaaièxDcǒCjXxyàěMVǔVnoUOjADBDsbNJbxyEA	FALSE
cèeBaaaaaaùGCóPTuNQébcùucbyghJHóWQěnǔXXvù	FALSE
etéèERJaaaaaaqǒKNbsfǒflSóJǔADodnWAúbèobEW	FALSE
hQIvóoNòBúéLaaaaaakmbxtISyUPshWUùFbúgqdNn	FALSE
jeaaaaaaKwZWuTDeeúzáAPiRybNdZVhVYVběgNǒwR	FALSE
meaaaaaaFSsPHěqfmUjaòbbHybVyPJnzéaxXǎSlǒH	FALSE
paaaaaaGěbǒbCxǎaféùEèèxwógéTfMǒhjkijqHeAF	FALSE
sáZwòaaaaaasěuVqyJksGbxDmHǒVQVRDQsEáZMqMb	FALSE
ueWUuHòOKaiPùpZaaaaaaéJalzúyDbAKǎOadewqbM	FALSE
xMlAKxaaaaaaHeéVHDrbǎRyFúófLrlFqJBQhjHǔbT	FALSE
ùǔMkGWCTVùVTùKSyǒfǔgsqSllWǎùáFzòXzOàtqCLSm	TRUE
áTXGvtxtěéUoCǔUSXóCvvQNVfJpájvxlqEoaòJmLúe	TRUE
ǎMOCDMJWXVeFMMPDgHpIMIglDFǎxmzqUěuHmZaCeKw	TRUE
èlTuGdDèGRIeGJàyoGúgqiáfwKPyúXOERòěSéHEqLs	TRUE
òJciuKléǔBjorxòDPtOcYoYdIǔMATFXyvJZhfqhfCt	TRUE
únePfBQáaKODViěRuRvjéFoúnsgqWtaSplMDMkfDpi	TRUE
CeAwaLsEuIqSwJJZǔdFuǒcǔgCjAfTWúóǒxFxkwWPaZ	TRUE
FSoizRAǎGnyzápúgsKúxWnQBèoRSIàCfyNsvxeIOéù	TRUE
IùòèdNkKèǔBázězáásǔxǒTdùdiyòPáhOKèhJtuXaJJ	TRUE
KùXwGhpzHcalBkBǎAVVbùMPoǒnRbbPHkbvAòWBojòj	TRUE
MfòènULhzRmèIELàcDgxHǎSèiǎCnhòYqZěxPWǔSXNè	TRUE
PSékDOGépsXDGsSNYnIoRwPrGkàHoiWarNhQjjXǒnh	TRUE
SHPiyenxKòeùHeJàHǎòSZfaǎgaùTTávMSYECIPvkJú	TRUE
UsIéqGLáǎIóVyBHgNIsAMOZmǔXqZLaYxmxGòbzláuc	TRUE
XXNWqòVmUwǒAyuGMKTójsěRqwàéáJoNAWLmArURoòD	TRUE
aNNnHèǒúùVmSSmùérwVHhèWAXmUEDèEvEYQJTUáTgk	TRUE
cveTqpNAFxátKàèǒxǎGoàorAǔRlDqAhěúbùùewókWG	TRUE
fasMǔvcóPtkZsněKófUxKùǒùOdUPZpjwǎJAuntOněr	TRUE
ibBOóSwFynXwǎDaNCHVBgDFyèEFǎceIBPǎWyéáUQDy	TRUE
krùKVKhSBCShpǒbNúùcòǒaQtqcpQùNTncSkkbZFpoù	TRUE
nNSTubǔqQCdcòkóphWxYǔbésDàáWbǒONhUěMùkTdrp	TRUE
qáWPǎtKTcnnbtzòUiéguRǒezaXlGjjZnQFǎvtLzafp	TRUE
sOAXASlgDnǔcaěyevOùòùùarLtRACmòlMáDUùDiGGG	TRUE
umxběàiTeěOǒMUxhdWsfliSúPdIǎVPCaVvnhEbXQDI	TRUE
xXzpdsMzGècGGZnRkbwLARCfǒáNvKQǎUGZyBxXàòZl	TRUE
ùùpòǒXmóBqùǎǒJaaaaaabǔdMbbhnqàXnKmNDZwòJmW	FALSE
àFǔaaaaaabxáFwsNwZbHòMDZUǒIqqaAQxQmORCtùuc	FALSE
èBcbiADEZuMaaaaaaitúxKHhpNùgfWyCJiHnǒubZQb	FALSE
òLHnJJFBusQaaaaaabGWFMbPucSeéòqAMWhàáOufiò	FALSE
úlhVQoǒǒaaaaaaidSmepCYClvNrDRóótWbAbrYjfME	FALSE
CrzéásmJpNaaaaaaǔWbWYqùzóEktLugUágriOǒzKSb	FALSE
FdIApCǎcAúáuxwTYKaaaaaatnTzbXNcihUbIHéúufu	FALSE
IOfLaaaaaarsUssNbYdASAédREkkibàòǒNttúbcmFM	FALSE
LYvúIcLnaaaaaakbdbeCtmOMǒùHarFefáxISěùdOvI	FALSE
OèFwèOáòXLcFaaaaaayZMěábùabCGgMabsVfyjCeòò	FALSE
QaaaaaayXSUOJZbJmaJgPeèqvtèoQqpbqFeuoMǒfèY	FALSE
TRlaaaaaatYolEWCǔòIVbléGQfběQòhRtTWeAnHTtD	FALSE
WZVlédYTumWcDmFGáNsNeúLVwgYhaaaaaaDǒvbùbwZ	FALSE
ZIVLjBTLaaaaaaUTrǎèùbúúZúkbTǎpqhpOùóerópGb	FALSE
aaaaaaDóbótcǒRqihzxǎtáGtyWDhòOgáǔRǒómSbutS	FALSE
aaaaaahIyjcMZImHTOOIIoèWKCfRwvbuDdùǒóyNYhb	FALSE
byéjaaaaaaEgDEBEUQǔjzBbàXfsuTQbWóéMeQjéVCR	FALSE
eTǔúkFdYèùóKAǒwIlàaaaaaafdWáZèbiPZuLáèZrbú	FALSE
haaaaaaoyLyubNMóQCMoDdbǔPOSlLjOUJàSQGqAláó	FALSE
kaaaaaaPcQvyyZbemgAEèmlǔObHZùusLùùfònpRGkW	FALSE
nXLXCóuAtchhjMsaaaaaaPvQYbFHtǔǎLLLóCsSMbGF	FALSE
ptaaaaaaúěàRáfělbFXlMùépèUbtzPcUdǒGQzòJrRk	FALSE
sZmOFOPhyFǒfXáaaaaaaéFSXObSRaǒeǒúWódúZBfbr	FALSE
vǎmaaóaaaaaaonGAdJahKfdAbéBKóáèǒěúowIBbCPq	FALSE
yáábèBTZJJVǔaaaaaaKyLHjqFvauPHIgzbPùbmkDSP	FALSE
ùǒDlgàVǒWWmwèQVògqjbUDrRJxúkàEHbáAtYZLScXia	TRUE
áRfoXIKlfMOBùǔbéǔNàCrpIěAxsyěbǒǔGGPòǎMjBuYd	TRUE
ééǔLsùlZwHocéèpnsRXJbAAdtǒSèvEbUYdICùLǒěǔKr	TRUE
óǎúnqWLóóǔgFóTGRXjYaASǎvBLamRúUbRSjǒMFBKCèj	TRUE
ǒfMúpGoAxJqJWZóueáqosOMJBVjxTDiNùǔgTèWóLCdT	TRUE
AwFWǔERSBééXaujkjKlqáhdAUCòéZATKirUMGTwgjóv	TRUE
DPxxnèěVuvǒvgxúCzlPlCàdǎkbàèMiyupǎàHdǔjóásb	TRUE
GáósiPòIqáaěvqXraǔzuYúèxWFMxJBsyRfPWXwlFirG	TRUE
IFXMǔYáǒnVuSfYxǎYWmcMSùVGèleMOùYmlLàxWòRRvf	TRUE
KjGFDjkOyóAoNnléZjluDefywtGfCuDáaiwmèjoQoOS	TRUE
NǒǎfPlóyvqqosVmytxQEJAcCyafóCáěéèbZRKEǎQaCé	TRUE
PHéYúnQyIWUqqǎYEhyyFàKGHSbdLyEscjǔvěRHnutLc	TRUE
RlSgyzYEcJUcWgùsQóéhBqmdILmvxVjǎqRzahUrMNǎh	TRUE
UiZùbzDgaGdppocLcPDěǎèǒòXǒJdnRjKZúLxnRTtQcJ	TRUE
XóxSoZBmuqùcùùùLlFǒJTgIReǒǎpxnZRwurFSèhBTGr	TRUE
ZxrLUkOoeFWYzǔzMmAetTNlWmrmBúBèàupFkffVtSHp	TRUE
clúWBBězdSLvdAHcziBriJěFoěMxMnilGáJoělvIGǎe	TRUE
fSǒDárQGSVLvòmrCGNPUbPtHQrMzúIRSWdiuǒsQkTèU	TRUE
hyqěIzAvúǎWéRInwjóZJPSvLYLbETSGOǔkTVSfsbGěv	TRUE
kJwsjoěQWsǎUdDalxóVMsBpVaIOTéyvaEADxSnEnádi	TRUE
nòóavěmJǎeáGLòaQkTjfcèòéúyUjLOkHoèsóAzQWPWe	TRUE
pvkZěhiGKàǔmXJkoóSoiùànPtsùumoarOzcmiOpèrgě	TRUE
sLMgToTgYYJFcpǎǔPQMdpOvjerhOéutvóLxoIǔqfDAé	TRUE
véamùAisáEiPfòntzirJAoLciPsǒEZIbnKLsHùLcǎèò	TRUE
xXóùRǔSTNVTFdbZpNǎùcJOcbjSiRǔmèuǒWkZHtaZRNk	TRUE
ùǔBòZàiHúpaaaaaapBèKtbRúkzbóǒéIEiépǒEěEUXEN	FALSE
ádǔxóòaaaaaabIěóBTyNpáIǎTyoiǔjcHbtcUyRktfri	FALSE
éZBnOaaaaaaiklvPTbéǎOhUóǔuNCSèhòUBYQcQpjLEb	FALSE
óIJeFKwyCRtlaaaaaaaHbOBpLDvXiTToPlònbYèúOAj	FALSE
úǒǒshàuùYHòEfǎóùaaaaaakCàHùǎBInhkbjbǎJpéILN	FALSE
CěěhPùèǒMUqqJoXǔtáLfJXǒhzDaaaaaaěZWQojgPzbb	FALSE
EnkUZúaaaaaaKJègMNksFgWdblZxiKààěwiSeǔIùnbà	FALSE
HedNvěaaaaaaEǎulùjEbqiOSǒáDrùébEqLěcóǒliòòT	FALSE
KzèmLGVCYLTOPégraaaaaaHhqLMOcxqsGbNObnRDGnJ	FALSE
NvèYázúaaaaaaúǒówpèvúrbRùUZlTbTjNbchMlbcpmh	FALSE
QměKKatLàaNDòIVwtvòaaaaaabDQRVHFEóugMTdǔbòZ	FALSE
TòěáXaaaaaaJTCWbVGqVTdEUapgvALàtǔápYǔVbRFKD	FALSE
VkáKGZKFèaaaaaaúFèWpGyEòCAtVbèPúWWiJělbrsxX	FALSE
YbúòINTPòJhkHiǔòzrnXOoèàuEmOXJúaaaaaabSqCbw	FALSE
aaaaaaòOadùcbVioIAGoylhbwMEvwCmLRTWpPàyOCzb	FALSE
aaaaaacuQrqDòbbNǎěhCSVSHQYIIxANǎèUIvRIěsGYè	FALSE
bOǎIěnnMlùrwKǔvùùmhUmaaaaaasèbiEKfBNqbdKRVó	FALSE
eHsǎXáOuzBéèenmomǔáaaaaaabtBmFKERópòdbMqbZN	FALSE
grerqLàxfLgSàaEaaaaaaòaAàttCbévPetúsHbvZǎtK	FALSE
jěAHnJfBobǔměvěPaaaaaaquSAfòrTxbXxLnEJdǒYCb	FALSE
lxTuGlàqùJóTaaaaaaUQiviherJèHLYzbEéábghrxlf	FALSE
oaaaaaaóǔbngmgmYZNbbuoEZkoDDYáǎyǔdáPjzBuHPf	FALSE
rtqměwshVkaVcóaaaaaabYCqFcxwWcèzkAbpObOluaw	FALSE
uOMeNUwDKQCiěùDKdzúrcdpUebkSóIaaaaaabYNbfRK	FALSE
xúLaaaaaajEgéhěAPdpbzvidbǎǔTrǒKxěòDfxHyqárM	FALSE
ùùOǒézGAQRumDCnHáùǎnlàTYPéDfyJLKoǔsùInkdAcàr	TRUE
áSCfPWǒEǎpwǎgojDViòBǒsùùhQqááFDfYfaWǔKiúdrIT	TRUE
éHWagěpEUùpROvHǎxbóǒeTécBiúKàdASZPAóuǔZyFǎgi	TRUE
ěvZphqIǒkRéZsmMuJóehVèegùJCzRáàǔtzmTHcKUPHrg	TRUE
ǒEgWRjǒápUǒyǒaGéDsgSGSúBTUSrChVYGTvIRFhdhefO	TRUE
AigqfDèUiOQHvósedaǔZǒhubbGSqUdòcúàkPCyUHFIvf	TRUE
DúJYzWYMFWúúTDhrEWRQAúYumǒTFMVOItZGmyjLbPEkL	TRUE
FnXDsóiccGWápáRQBáKECErǎOxrRnsEzAIùrTSgyǎuèá	TRUE
ISèhǒàGSèDJlRéFeWOPOGnéjQéhvayùèětòZpbRWzvPe	TRUE
LéàKnRpLihaYMcUHaǔDùGQòmgeMXduCǔkLMaPTPàútJd	TRUE
NRDFTwgUGTEBfǔqótkogmLGzOòuxànOMvBQkHBJQBhbt	TRUE
QóMJCqdSZNFwtBGsffVYovqxLáaTHhuCTěSNvaACǒgdn	TRUE
SbjTDKFpǎMwqTTxóěóJVrǔàXóQyxUtQtKǒPmBJjúúUlt	TRUE
VJpóWWlóPájFBEwzvipóDěáKǒdǒgQǒògdWwúàYFsjkvS	TRUE
XhLRjěǒgèKùdWGRrZǔXkyèoEWNcáUiǔxùǔEùòTǒDéWyx	TRUE
aTónTFKTBxZyaCRRuwúéúIRkébúoQSmoPáAǒLZǒKdqòn	TRUE
dBEYRbMYFtAsBApkkáLèndWYnfRKgqfcoLLǔěFálWIuA	TRUE
fduDdvVéQYVmIúeaisqJTdkgmRZAqzIDVDWǒáCoaqvNm	TRUE
iEHUYPWxiaDQhAuZIYnòáàoòGúRRdfGéwSNpǒjUWpWvU	TRUE
kqRjIsUpCVJǔdmnWZXǎěkvǎvTòpkuOHoBǎEmhRxmlVàf	TRUE
nSxèVDxàèòYqvHqIòXlUNfhEVmèhckzzmUDjQnlVHDMi	TRUE
pxàKHTóaǔSRobuIcYùHEùnIGeXùKaSyWúGEozHùtiIaù	TRUE
sNMynawKvfělzěyGQàXaYúveTǔvXòaEapjlQCYBdaywi	TRUE
urǎébmazNèqLTǔbwTiAVóbjQóbpiTrRqMqYrymDǔǒúIe	TRUE
xWvlnNaNimBjaóxKJMfDjòúěǒěKmUYyJǒqòBGákLVdǔU	TRUE
ùáMiMVPǔjùvDúgǎaaaaaaygněTAkFZbwXRInPrOihnbé	FALSE
áUiIYúYtWzFKuéaaaaaaArǔSRbInǎpBwENDLéVbJbǎkz	FALSE
éHlNèaaaaaaFbXxuVGWqBMòécóDLxbùsdWQkóyěyRYHV	FALSE
ěmQjXúQǔMzZWócLǎLaaaaaafMNHhgStǒxZuXbjAubewe	FALSE
ǒaaaaaaTSllFCaóGúmLnwruòOqVuhúbxIrFIbHrnǎsUf	FALSE
BTsyǒBQBgèaaaaaazECGqldLVHQJtoOsSbvbPseJsdóM	FALSE
ENGéYbanQgwFfiméisCQlaaaaaabálbZBáóúVAjúImMi	FALSE
GrXèFuéAHaaaaaaagHbsaXǒùyOaXYuKMbàRTlvqòLrèo	FALSE
JRSóaIPCbYluuIUùLwzUSHUGzaNdeZxǒaaaaaaobfMWb	FALSE
LqfTfvéágsJDMZaaaaaacjNúeerúNbznRLNéwaMbXTǔM	FALSE
OoěCPLúxjQcrqpǎJXoòaaaaaabzúPJyǔupRFWEbTjXto	FALSE
RaaaaaaihQèEbQùhěDCGAèQmqTǒfIEwAbóVMTúHNbIBn	FALSE
UěKaaaaaavsdnjrbádYfùàUXHHǒfTmjècRJKbdqòKysò	FALSE
WaaaaaaKhgdèlBàǒBpkdypdtmrebjCUgAJRzbvaeGdkd	FALSE
ZHmaaaaaaSGǔzbLxTùfkúòAkZbooáCdMqDFflèupEfxm	FALSE
aaaaaaCIhWhTúSdhèXAfiǎTwoLBTPuùbxrYOóAEùbjLQ	FALSE
aaaaaajEěiyJYjyOùéIoWuUuǎóInbúbHfsqtrdáEpXnF	FALSE
cipelkMóhdQIFtúPTBeaaaaaaKǒSùáàbéaúiwiBbvKOD	FALSE
fFdrsKpCaNaóeraaaaaaàhiBóbnAUǎěuYTyATxǒcvbRO	FALSE
iMSnhZrXkuswIUjSbrZaaaaaaXTSbbéǔWGihǔsówgxèǒ	FALSE
kxaaaaaaQOGambCkvEpkWeàsbULRwcǔózzXhDàǔfùcáx	FALSE
oBaNFSMdNaaaaaabCKvètúágEàmioRDPáTVBbXéxHwúH	FALSE
rxàaaaaaaGqimgMbjhMBLùNTNVǎzQbVǔPwóXBIYMóILm	FALSE
uLáhFaaaaaaokkeCdbNáOpáJWmkqbCEéùónněhxDMDEE	FALSE
wzCóógSòěpúfhPwaaaaaaYKèbǔAǔzééǒZBIbPpQmodoY	FALSE
ùǔxòàǔIúhJǔMǔBbòǔǎLàoěDěEtXoJnHNbǎmòjóéúèBUQǒ	TRUE
ábDùTodqWEfQsgùSTmùhJbwXZMJǒǎáanXTǎǒygeVyPàFN	TRUE
éàsqBFuYAèǔNRcGófhuqòùcUTIóWnvbMWikJkIByHéMXé	TRUE
ěDětwNùzBěPGgFkdRcmaVYVhèlKNMáúèKóqKzKOCACúBb	TRUE
òyàémóěúléodbvAnwFjfwrmpělSyzdieXěLxpnlnǔǔfVE	TRUE
ATsǒoǒàǔrtǔCixhAiKhnaǒThZaohǔdǎàsòOLOpuVQyùCE	TRUE
CwStkbZVUMXùXLfúTáSlPNùMBNLójDláDAHqěEGmfpHYǒ	TRUE
FǔJǔEJJDqòvvrAeJúTěǔǔQVPXóilaptjGǎMAùútWowLyJ	TRUE
HhFaJYYtGQTùsjagKnaTOJjmgsNúHrRyzéwmHRùnáTJéW	TRUE
KzvóLùbAùKàvmziynpoLáHzvfLxsMMstdcfVatYRDáHQs	TRUE
NxkCIPHǎEetsKqzdúpYéDéUtCòwFyǒóBUTǎUisqiěhpeU	TRUE
QHèděHUjRěHtXMuPùpMHIǒsojJUHfIkFfǎivcsikyádLU	TRUE
SxowehqYqRùtòsSLvoùhánpAùscrGyhzsVJNǎzbxymeVǎ	TRUE
VKBHěneXXkZfAéHGěEEóǔJqmVHmògPuǎAluVpDwǒnǎQái	TRUE
XhyMúUwAPHlěQJyǔtWDiǎJCǎyUYMbIRBTIèoIMèCxlOòG	TRUE
ZkbTéZEPLmwpTòtzTcEUyFYRóǔAULXQbKlQsIDbIwBkpn	TRUE
cOúbocKúěOalDlPásZsyùáèyNLZwǒveWuKóYáIOǒrUkfv	TRUE
fBQqrlmtǎěOèúqIgPéKzhEéúJráfeúùifhYéDLanPvDKP	TRUE
hccbqJCòxKVwyiéKEQjZvěVLNàaàúYǔiUTSIúnwJUnzDU	TRUE
kIwèSVnsLFséUMfòpdThèèqEJǔNCcDTgeilXADRúxMGYò	TRUE
nùèzzPéUXLiqLLǎXúDExTéégókeNFàiDǒqylRěxLXèfqh	TRUE
qǒYǔpáǒIEvjobAafùAdVWómbjlrZniFHómzHagfǒhJfnf	TRUE
seSuogfnYfkvDYkGhVrěǒwKMesdKDrTczéBFxcePWcruà	TRUE
vIXOAYOCiOWncáJóùòdChtUtjǔzuǔhúJjPMěQoTdYMSrU	TRUE
xjGetAeTvVùCěYǔXMdLAZòFbDòKséJraorziGMfLTúMxò	TRUE
ùǔfpRpplxtTfVXòaaaaaaJQkAnRoJliǎèǔAYbbiTǔSBPs	FALSE
ápWBPEólǎWaaaaaacáZbphnpóiVhFVEvhmbDTAVhFKKZY	FALSE
éGFVtyndéwjSùBfoaaaaaajxJebBOèHRwFpiMWHDbBMSH	FALSE
ětOaaaaaaAràoPdhbúwlbbldkCvàbǔúzeGPQXóprwGVAǔ	FALSE
úEěVYǔeGǔVaaaaaaWǎbwbScXZhRúoyeQsOMzyreHwzWǎT	FALSE
CBaaaaaakóxOkvbARYbtèLǎGUgkruǔDemùhNǎXxGJóóOV	FALSE
EWbCaaaaaaUuóuWjǔRHvjoldlldkNKQbIbUtuCáTKFOSL	FALSE
HaaaaaaalJwwOZbbòjXmuéLxaǔoJpqpudfHMOQFèeJFdě	FALSE
KWwhùyQèVuiQuUPcjFaaaaaaamIUWHbvèUARYMnbbPNDv	FALSE
NMMfóéivAèǎéaaaaaajebqqBcúyAyoeMNiwbEMgùóáMmA	FALSE
PdHZWúHǒtyYHòGDmHNěVJlsFǎHRBIqaaaaaaěbybLfDùh	FALSE
SOXáaaaaaamWnààQmeKlOSStVscBeUěbbakǎktùSǎQWsé	FALSE
UtiǔLeLRcOéyObYjHsaaaaaaAULǎnwjlaucbMHwbǔVkJi	FALSE
XJèaaaaaaǔIámùNnúOAbMSTéyLcDzěòFóxùbRHauIzHXZ	FALSE
aGjJJloEgcRaaaaaaùeCPQeDrHnsAibǒbYBwacUuQyVYò	FALSE
aaaaaaVqǔtiLYqfpQbIfvQOmbkfLhaNètBDLZBWkMSumr	FALSE
bAUkmZMBHsúJzOJráGiaaaaaaùyRZěblbFCmXVwěóhéTf	FALSE
daaaaaaùZeFcGQONHxSěhMyibàbXèǎgwcmRVdIKinAzAp	FALSE
gěCINzùhpdVYKcmlFgùAàAsJKèwpUaaaaaayǎbbéZpmEé	FALSE
iJeǎxtJYaaaaaasPrnEbfPúfUévhlkbrǒbèxMùIǒělDpá	FALSE
lòNKaaaaaatzóVpAFbKtbúúǎGxfàjóMCeǎSMJbCóèugát	FALSE
oBjnQùGENQiěùLǒjlwjmyrGúoQIKtgéqkaaaaaaybbùCq	FALSE
rduFyVdRQNěiGaaaaaanZxEpxorqXdbUSòJFcRéàbplxv	FALSE
uaaaaaaXURBPcXYMòawVTPqUbKPLùijbFaxOXxàxsqPYK	FALSE
xIVwglaaaaaaáJbbOYǔxoféJùOFúǔxùddWòkSSRnòzSZV	FALSE
ùáuEeGTHJhyòryǔěrùxeXjwqLXewùgVqsJDEWeMQazòózC	TRUE
áVBáPúHQGǎSǒCuIFkVuǎhěǔaǔaQúVzQejKǔXIYagBéOWéj	TRUE
éKZdLtTeMzyvěkZLàRjxQqóèBúAáǔUoYMǒmRwdCUéFavgǎ	TRUE
óIasóbkyOnèkWúJhMúiàOYáYEpxétmrBIctlhhoǔgOácLě	TRUE
úNirǎáiIqGKJLùábǒYHbdyJiuǒáoutJzmIeHóóéSěZèJMF	TRUE
CǎRàgzEYeWlzFlHnSǎycOqPàiěǎIThFTIqlpFEkMnòěwKV	TRUE
EdàNáUcUPKnjRUVěùòRbnhVaUbóeojdóùZGàgòdcOěòsum	TRUE
HbFùwsáuzuǒZYǔvAIyhyIjgWnOaHDèirSLfYKǔǒgsexùTQ	TRUE
JfnzDURrUGKXMfùTMWGúǒDFqHgjGděvǒsoúèNySóBKgànk	TRUE
LvICěFxABěrZUniYqràNPrzIětúKámèbsEbOiVXwZàZeba	TRUE
OGncPmSòtMIdskmbHXédBRpxáVyDAQHcnMUcMVKGEUDMúc	TRUE
QRKǒbLKpBQǒyyowBerdtǔLgggǒiEóCKYUááwněZyBáyZne	TRUE
TǒYZRAKěGgUIóPcàoAZozDTekElrmhVèkzYòGéAAbtWHyI	TRUE
VfspàBqǎcTUEVkHgUǔNvVǔevHtrbrxuioeZYùětaZǒbTRz	TRUE
YǔWfIeGGXGúKAkúWGCFSEqBǎěWèYoěBáYBOJKòdbdgěDwP	TRUE
aěHfǒZgFéhDqLǎoNFEvnMRnrhxrohQiaCǒrhOfzEbzègKc	TRUE
cqhěàKzSěéěBǎWwBàòvvRdJnětiCgóGHFiOmrzIgèátócà	TRUE
fiǒkLTkKaóMbǎGxvZBuòPMkjSúYQsxSnNAhGljkǎBjtLZo	TRUE
iLCurHeuKdgffwDjòsytsNWQlEiBHMSǔqvfsHKKsWVqěWj	TRUE
kezXEDhIOcúuSbǔNSCxTkVWHQfTuCnxǎóeqmZǒǒǔxórmbh	TRUE
nKucBIzùbihkbLfoěéoBLCKOqjmàSǔKCCtXúEǒcqNYmzYx	TRUE
pOSELbgZINóOxtHfgězéùúudàòǎVlCAHInqéUQRqèdNGòu	TRUE
rVUGHéfOCczùYRvJòaèòǔGěPqRfYWǎOfjrUbJèOGRǔnEGw	TRUE
uPùyèdfEèmivóNúTóTTYZaCòZbwtfáúúuùDhZbokrǎHàbS	TRUE
xáJcǔOǎFJoAóxhTúINpARRJúézúaHTyZIPèùXǒFSDmjvLd	TRUE
ùéiǎYVaaaaaaàrBMZánwòbXZqwmIIhNEbrdFFwdolFmJWW	FALSE
ázǒvMaaaaaaDsUjUWěwléwYǎòmsoěXlkfRbEkSbpyciLól	FALSE
édlInAtCTáwBúfǔáMlaaaaaaebóHSǒWǔAèTBhcdbmIBVkJ	FALSE
óǎnBtODcaaaaaaIlOùnzabóOgópyZGCRJzéuDxFULóábǒà	FALSE
úáǔwemǒTaaaaaaHVfNDOapOxJúdbfměRibZǒhéUMaosǎQj	FALSE
BMgVtvBOfvaaaaaaVDgpKóGsUáěNzbNKAQgdbgvcaàOPAá	FALSE
EáIèMaaaaaaéeZHlSaxsòyEzBvGfrúǒzbbaQnéVúkǒlkǔǒ	FALSE
GpxèwITZqxqàggàǒgǔXzDùiYaaaaaaáHMbpLMulbbdJěvù	FALSE
JaǒXěqpèaaaaaabáZbaǎjKkgOHLOóéáèLmQéǎGDFivwSUU	FALSE
MqblaaaaaaùèogAgoLyGkòWbYùBGwuoèElxúěǎfbAJqùXJ	FALSE
PRGKQefPxǎPYcaaaaaaměéétmsJèagLXKLǔlQbbMwlZuHù	FALSE
RunBYnpaaaaaaZLàbǔatTǒmIkrtdGCBǎsgFUwCbTGerpěú	FALSE
VùeěwqADRaaaaaadxZLbsPMkxXáJyEJPFfPlnlHùhGbjtu	FALSE
XlWVcVědPgéóaaaaaaiǎAsQCmkIywQGbOxbPFěoxXNRjfp	FALSE
aaaaaaávéVUoTIXDOtkGfNvUCvbǎěàlZcxdIǎburmsKlùY	FALSE
aaaaaadobúSǎcljZWmDErtRPGujǎhanmfwPqAYmebclRYM	FALSE
cèNjLDǒfxcvIúSaaaaaaqàwěPuJQuObnxQBéIǎaIUzqXNb	FALSE
edEXTRPlPSLSáaaaaaaYyáxKsǔcKNjBisXbbkpXfázLsqc	FALSE
hèaaaaaaZPItgPaBkZǎúgekmbéMNAéyKeAbúmYuCǎvaLfú	FALSE
kéCVjUMGaaaaaaYfLmuwqejyEáOvbWwòéxVRYLhědjSǎgb	FALSE
nàRuEUbVǎáoMPKKZwaaaaaaPáAYNbbxCKPùFcPaYYqèùGU	FALSE
pXgYWtuúOOYoHJùéDárZeládYaaaaaaWuěCBDbǎVduǎbls	FALSE
sòǎpFwfaaaaaaàZbJJOPDěmbSYMCǔieǒúmnNjtcQzipQlK	FALSE
uaaaaaaEòAteYúAbFfNUUóǔtemùpùólǔbexTlmèCubǔvLe	FALSE
xJWaaaaaalěbnyjayJWbVàwTmòálvkGpHcboóéBzfyIhGW	FALSE
ùùOéBkvXROGlMgUSPLǔzQáhhěvqDǔǒwsKEDJéURgDOéUěǎm	TRUE
áOuBTGgWqèDálǒèkDùǒǔúPfúmtZqéOQfěhONGIécsXkzGhǔ	TRUE
ǎděEoWGVPHqJsGèiǎVMDWvVujòLwPFOoTCCCsedeNBdEepo	TRUE
ěewGIkTmcyFniěGEqsèqnóIèBRPofBǎeFuàokLcdbNgFǔdú	TRUE
ǒfǎPmpoVjàmrZQZkmàiGYaQauOsdOFxVWǒmPbèfLmYILIsx	TRUE
BǔxJJcóOVnAzAKàRPVVGXYáyúKùAqǔdypRxRnGXághyMOFE	TRUE
DlypěQphǔqnoLvùMpLauzělRmHKuWlSxEeitVvHótkeSkěK	TRUE
GWypuyǔJalidSaPzúQBJfAǎBVféHUlpadRQèumqWèvfDHèU	TRUE
JǔLlQspěúrTsmǔtǔaYvOogǎVpqaIQkǒrGGJkqNekàkUFLzk	TRUE
LbqPrěùPráezdJSlNMrJnNVIwZhhálóèdáLZúIzGDòaoàdy	TRUE
OEMCtkǔnnzKpFjtRaBFǒáHǒUUVRPJhFUVàèMéksRzpnèwWG	TRUE
QWCrǎtFnRàUSOvcCèěyYGúvEnsùISTsupYPwáùYdtlmLLǔa	TRUE
TěBsuRpUaiQbNNùawéèéàiivóikJhMMGxCUiáZhqIvRPdJq	TRUE
VYEǎFikzPdáUnfòthpoèKQWúlsrKFAkgxèáWOMgBVéHèěég	TRUE
XxkYrRáVXáQtgoùMHMktěxEjIPBùEiLomiédótaoóMvEBòq	TRUE
aeZkImGéxjùZangRěúlaaReòzGOYOnOQHLYoHKHCPUvMòǔW	TRUE
dMIAEItpQàygsúKVClòǎmZjǒaiNwqlNeóBTcRTtNVkhDXbf	TRUE
gǔúhàròEbHVifCFvHàóJpLxLtDEQjlcékzGAcDgoááfójóC	TRUE
iCèhpmWYeabpèbUePfEGDHOòYEéGcnGRáàCyDfFzqrérùéH	TRUE
kFqlvZdeàwLEoèáǎélGSGSNDǒFcoǎlVaùMOóBǎùMYZEeMCl	TRUE
mqsyNjàoxěqvlpWǎòWrtnEYúptCsgObeTAaOVDEFqzlBfRX	TRUE
pddúCmòNIMYmSBéVònjqgIHǎZtUZjdrWWoèXEqRonfRViuj	TRUE
sBzfIbjLGǔTnEHMagzbPrZóěXRGsLàdhzuirXùLénZGZtAH	TRUE
umòbNJwèbogěNmXEibZxYEKǎUuIfLqUXUvEOHfRksUvPKIp	TRUE
xPCFBtiDNéAéǔfTFǔòNzsRogAépalkàLMèzwDyTcncuwFxt	TRUE
ùáRXcàQtaaaaaaSuzuúSesUbVnYoeMITzbPwQyKUkvZéàIQ	FALSE
ádFaaaaaaáTěbábSFdnFeSǎěpLbKEgKvXàěǎèRMUSkáMxqv	FALSE
éTicMàOPBsptjAaaaaaaYbgěHNmOqMEwbyúWgxLJUtǎksXV	FALSE
ěpaaaaaaaèFUòSHQQxMcpébcPNècrCDuSnIbǔRSpscǔFěvx	FALSE
úDKKòHMCběNaCùYuaaaaaakSuòpzbMlbMXWlyàǎiǔtySOXp	FALSE
CèaaaaaaAGysJbRRlcEvKnǔGBNeBójLdCLDaksúúRPǒwbVF	FALSE
EMkvděnUgcXlǒyRlJěmaaaaaaNMogLFFnkskWiábrgBbúHz	FALSE
HZóiéetgCQHYgzDVraaaaaapEseáòQgjbCgaCWtcòmùbógO	FALSE
KRzUdKPaaaaaacǎbIHpLukdúrRmiYeRWúnZǒdCSiùKSztbj	FALSE
NGXGòxójKIǎeUdvǎèCPzeTYUnaaaaaaZbEúěByǒHǎbmuXBj	FALSE
QaaaaaaCóJuBbBJIIFDvXzbBòxBějépSgayTǔRaEPlRZWTr	FALSE
SuybdéùGùPDèǔZaaaaaabHEYpvǔfIhǒWGOatbTCZKhfpòǎe	FALSE
VxúaaaaaaúkóǒybéàbCuGXKSdiczGpdèěǒCzoJFuéSěrNèI	FALSE
YDKaaaaaabuFéZàqKKpdózZiIQqbdViDGRúfUCiGmRéqmXI	FALSE
aaaaaaáYpmlěPéBǎUAcbJJyexwiósKKAòuúEXrZyKDeǔZbc	FALSE
aaaaaabKMLEǔqóRoloéiivNOQKBzaEczEwNdzrIZxQcǎúbǔ	FALSE
cěsáúDáaOáàFtVaaaaaalzyHǒNvtldLbpZCqOgFúybImxjd	FALSE
erHàuzIěhIItzDVQRURslBoDFafaaaaaagèFaabbvIbrwye	FALSE
hZaaaaaaròuoaMzDáójaSGáXeSbSlpMPFjEyomsúXbrtǎNW	FALSE
jzaaaaaabJXXǔtDèTZùBáúshLàDVSqEDèLZcbdúRywětIeù	FALSE
mDaaaaaaweǎYEycXONKGfóòkKibtFǔcWǎyFiǔMbWBjRúǎlǔ	FALSE
oPòIKveHFpvèǒeaaaaaaxbYGuaǔCàbOMeskxijIJIcPTNcH	FALSE
rDakTaaaaaabPEòaOzGIGBYroèkhhǒwkqnLaúebSúKEènhn	FALSE
tnyúaaaaaaiRcMyxxòùveLURAaxZpbSiǎzrZFúbvnFǒtOEe	FALSE
xětkcvaEàzJGHiBrUòaaaaaalskxybéXYWvwvbTVDUpCSKc	FALSE
ùǔsáaǔoàpUWndVYéAjàlVVáóváYBùPxBXMyTqhaCGVPQoifM	TRUE
áXkAèDrIhSPjòDrpfǎuWgEòzùKmBRǎǒHvěKPVHoùgVrfYKlù	TRUE
éXěóVùvNbAYYàAKtúgPvNěyOnTeǎsqnyoxúRDQTLZJLbkfdx	TRUE
óòzGDAAJtCkùWkěNSwǒdiQTNRrHXHòGǎnHóWǔHmHxswTBtLC	TRUE
ǒwsGqUmtúgàStysùǎiwòéCAYDáxVewnLùyZtiHFysPIAfkhf	TRUE
BúěúHǎTzéeZWjvbJHnzwGéTvMuAùgpXgqCnrúVKěGáSPCwPw	TRUE
DMkOErJǒHcLGlSMLDǎULuuCaCèùCpIdRààuùǎhógohgǎsxǎb	TRUE
FvéxCREǎCBiYnCwǎOWYNòǔUXeěqèèXLhRJfRgPBěǔgiZzTQd	TRUE
IGNOLógPYQLQsáCfajǔBLTODuùsQaWmkySoěFUwuohUlúGòG	TRUE
LàeBTiCKYèdsHVKxùyàzYèéQrVEiaéDtmAluǎORQTTMcYMnL	TRUE
OSeMmOJkóJbFpùhjFZkZmuakPédBjyGJTEtyLKiYiKJònoTD	TRUE
RǎǒGRhTěsúvEojKàzuwQXóàKTcPWDqlhùoRsoRuótoCèapòt	TRUE
TgMDvóouFTWOvXwzoPHaMBMwHaéǔQǔgHabTFòěqdWpòyEHcó	TRUE
WǒrRjFvjJhEtYWoFNáúTJbúdèěùUIumgGWútPBLévLPvQszX	TRUE
YaRUOMáaWxBqòGNngppJbnSnCeZCNVgtSAchEVGùvùNcLNkK	TRUE
adynWXtWǒiDàSjěòQhcFbMěěNBHSrNWKHěěǎúfyfvpUYJlKǔ	TRUE
dQǔCbhuPàěèkókHRHěvúéQOdFǔàvpjBGjǒFmjEuxFjmGYaYI	TRUE
feiàEéónIuCEUxMsKNmbRóoájSèahǒùBzrPByoqKDǎkǒPRdǎ	TRUE
hzpIVPvPcjǎbwDXXàyJqOpdǎqeǔCAràqvMúgMjèZǎrùáùoBh	TRUE
kmèHgǒhěgaáCLjàeWòǎANoKTéCRwhiMdǒáGLeYqeMYéJlTvè	TRUE
myfZwTwpgKvòQvnPtYpcaxászKOpòGxRrǎwuTXwhwCuúIpzQ	TRUE
pàFNúrXCzáNbRPgIAsjCRRwhxEeSoRcSwQgwtZTXYdAtBZNA	TRUE
sǎNrwvjyúFSBfxáFNahshwJyNEǎCGúèoéěKWDGYuJnWiAfǔG	TRUE
uvágBétEòépzZdHHIayváYcvCUOhGWqzXWjyhZBéSZáIRdúǔ	TRUE
xWuwjWIǔovdúKZAeKRQoQDBwIǒfWwjlGdzazPtahCǎbEANpD	TRUE
ùáòkaLòkZbaaaaaaxGNògOHwǎádúbykBxBTKhhávLwbnèerz	FALSE
áSIcnSóZDQKkxXaaaaaaǒbnèzǔqtbèJǒeóGóHIvùPMSouqmi	FALSE
ézmPqZRèjùDZhIǎOXOěXgLrTqPSPYǒsòaaaaaaqfǒUpHpbIb	FALSE
óyaaaaaamvdbàibfNùCUwPgúǔémǒRǔKHWIèlAwQùrVèpNyEè	FALSE
úaaaaaayYǔùWǎNWówrǎfWbǔXBǒhúQKngèbylǎǒenJúfúGéZG	FALSE
CAòKétFǒaaaaaaQANPRYAosCJbhVǒěbZùNJhálTvjlGàwerW	FALSE
FǒntTCBLnóaaaaaaǎzzspgRmCMajJyQàZbfbhuvǎěZePCòWK	FALSE
HtBnǒUěróXaaaaaaěǔzERghùoshClQbhoiYùMtZòbmDHVsyj	FALSE
KmrRbǎPvYWaaaaaarWWbaetvlAhWgaùúsVQNGKbLGnauédkù	FALSE
NpjàyxxWaaaaaaUBùěoUmKàQtMbEnbDIgOAwOǔYTwáózgmMě	FALSE
QYmóRèátzòELxNhKbXmǔǒokRRRaaaaaaávHnxǎěèbNòBbxKù	FALSE
TWOJGyǒzaZXvjmaaaaaaNútXFDVheObIùPéèeLOdZxúUǎFXb	FALSE
VvAuùLwuQYNfDǒfoZROpfyèTaaaaaaDjfebQNVUuAzbcùRQD	FALSE
YnWaaaaaaZòNHAVblǒùQveàUhEpóǒháǔuǒGlYchòěNHbZMRU	FALSE
aaaaaaCzoǔěàéDXóoCbsNddeAuddàBwGàépEUvZCkbtJaVSB	FALSE
aaaaaaoVNSélbvJǔfǎàQMòkENyèlǒBFóOáiTbbYkùDvBovòV	FALSE
cSNKsbORaaaaaahDúnGǒmROTlǒirbpèudxHNSbWweoFàpCTR	FALSE
faaaaaaTBfvpOhTbòxóJLéMaùYúxaSupǔmKhuòlǔPjKièGKb	FALSE
iLJúaaaaaafbGùMQemLFhBnUxǔóbYúěaZPAMgzEkèkmEkaIE	FALSE
lGaaaaaanévjMXDMEùwJYLAPRZhJǎxQpOtLqObnOwùXǔbǒFQ	FALSE
nsàRdjGbfxkùǔXecRbhóQvPenaaaaaaòowBBbQBbFúědVVsJ	FALSE
qòIXaaaaaaHGEèhěZdLjMjóBáèBtVzǔRúEúBjYàbbèdAǔwKè	FALSE
tóǔIwNútèYzqHoHǔakriQDaaaaaagGvbyduAǒèuèbNnTyTDó	FALSE
vRAěóMeùFuFDùòùqèáWsmdJIRVéfDèoUòaaaaaaètnòbvbMà	FALSE
xppFmBwGaaaaaaqZaIoóbvǒKGǔYrUvlAwObǒǔaWVkiěLNsdk	FALSE
ùùNBCoBBgrkTWLqěBIgWèxiNGvéRJccLcLYaǔeWrsóHEAXZrR	TRUE
áRúhùpNǎQZǒvNúElgeègSúBhkǔDqyFpaùnlhcikWèdjPgezKW	TRUE
éEoReUhǎǒWCwǔXǎMhólǎuvUIǒáWGAMkhblNqéXOAávEjoQmYà	TRUE
óJIOVqkCgàúmǎàjyimvGUfNsUǒVèǒTzùzVoaěesGGdjéfySWI	TRUE
úDZnYyèdPTXùYgLFKZcóùuEhXzqPIòRjknuTPTyHVóQěqeUZp	TRUE
BiZòmhǔmùBFdCKhAluswIKBèfQcdLHaiGyojààlbWqgSMùmLd	TRUE
EnfúEmOúDmZùiSlwdaQóaFMfàVIvpLVRèfàDcàtnJCmcyMHIǎ	TRUE
HósUéjZdDXènzùTjǔùXvǔbUǔgǎcasHeiSěóTFVTatxwocMéèL	TRUE
JTTeEǔCǔàrsGteàIxRRziRGFVZgGjáyZrFǒàùMeLqwXúòvhmm	TRUE
MEùttyQZodqeéǔVàRbQYAòWNybCéEǔǎJaxQDvvvěpGèòhJGeD	TRUE
OgmrMfZDhàljpOYojagáaxFGHpuTGlcvGTCfqbhgoJéZJúVRG	TRUE
RèPHQdmDúèsbNwcvlwéòfdòqwYWVnNáfYǎóèMZruLtUAQdQSv	TRUE
TplUvǒoǎxYHǒyoDěCisélmIUEnèqcauqGNxbTtkFefUkYfSRó	TRUE
WálèGCXjlfěújhPSHHgèfVJnWHRNmgYúSPkLUYKNrHsùàǔPUr	TRUE
YbWAzrǒarZDXQrIuexiuirpeWxěyNZicVjǒòpHsjRYTPLǔNbú	TRUE
awvncveTfjEszòJùxjXMhúalbkáxPgYgBVVGspErKúYvòZBwg	TRUE
dNbovDOKqHSroQoéByUYrOfKMhònpnTxtHGxgkpqovóvaorff	TRUE
fqǔfYRuDgNbhmPómxNàbkwKémIBTWIVmBubYDVáHiiLkviRcG	TRUE
iáoMǔBWǒywAxzMǔBHǎǔǔpQùPukùlyúkyrPyMLjcVRmLaWMCAZ	TRUE
kéAǔáXéuIǎOCàzCZóGòWoòěIǒgZBǎkdmměgpwGLBdǔipóHHSk	TRUE
mjSqǔěNVYpXVKékwáMIóTnisǔwúéYólJǔqCDbkQOLòdùèiWéR	TRUE
pkkBLJPQAZTGsGtIkDYETURóǒpLJYAaXZrgKhFLEUDtéàQaFj	TRUE
sKàtJéFběJHdtáNONlSgktWcòiubLvLkèZjYIrCYǒùHfSNuzò	TRUE
vàKáMaUsùfJǔjWiǔLBvWMzTIBZyibKpáóTwyfnúFHAěNfPsTw	TRUE
xfEějBvGSrùòjeTxENártqcIJvcxthòdwhVtWOkiekhùXshSB	TRUE
ùùlùHDuzòǔkwgaqGysèWSQDKzaaaaaanqwFbEVuwWǒWZLbBwy	FALSE
àálHBgùjáaaaaaaBúéboZkMòauTWZúJòbqssmògscYyèUěoàR	FALSE
èUéltVnbwenuEfmHyèxǎnaaaaaaabjnjoyyaeòstpDIùRHEbm	FALSE
ózKkaaaaaajcwbrbùeéFgJòǒZCLhSSFxieSbsVcejEbkúFFVM	FALSE
úUTIléyaaaaaaiuBCJUgtrLéYúsaNǎèzIùbUZòggáIFjSbrcB	FALSE
CCMóúXqaaaaaaveNbááǎdǔNjhtùégRKoòDǎMùlEoǒAEJoěbnj	FALSE
EgGnúbZPTAyàUCiageòFěqáMaaaaaaoXYrYòfuQùvǎMènbbnù	FALSE
HsVQpXohhaaaaaaáhabbYbhòvzHJlyvúNòqnOeuèXaóEǎRǔùZ	FALSE
KnxTgzqSvěJTGcpVaaaaaaKbfXqACǔbNqlWIòHuAòuQvAZGéò	FALSE
NRaaaaaaViVukǔPQbgPszgxàèléZKRbPtyètTyZrYMNeMuWgǔ	FALSE
QBUDOóěòComMzUnaaaaaagvTECDnYbQvhsSàYoGVfSEùMoqbK	FALSE
SvBpaaaaaauDólǎǎAryGYsLmJJhBásDOgófHGtMbObJǒěáěvá	FALSE
VMRfXCóaaaaaaNbqgòHKYymhJQJpdAFHPǎpNzNOSobàWiFuEv	FALSE
XkqnCǎaaaaaacXZObkDǔHgzVǎQIRyFgéUFFóyúqrUóhpóQěbv	FALSE
aaaaaaùkrizměUbbǎàdyPxòwSLxJlPqQkKòNSCeSUtoOěLOym	FALSE
aaaaaafúbhnCvgèXTXOvxXdZueiǔACǔǔVbKeòXYshtjHǎòUMR	FALSE
boGsVòCmpQXNMuaaaaaaSbjpèwAafsVGoibKmdEUTalbúmGbá	FALSE
ehètVIùaaaaaaábzdòáAsáXrDhbyǒhèAPisbAvLXnuVWgIzkQ	FALSE
hJBǎYyvbVKhěhwZstaaaaaabIàExBùdcWzgǎFbǒncǎGjEkndS	FALSE
kěoMZaaaaaaothybuxTwùzrJkvHáPPIpYkDbóZXzjHaMǒàpǔK	FALSE
mlcěvéáBZOODvLAzcaaaaaaIóEvúPUǔeadAyZDBkbANHODǎDb	FALSE
paaaaaaǎùbZHmǎNIkQkúbǔzBujsǔúsRtPfóǔLǒúxkSnèeAǎqQ	FALSE
rxàxJmaaaaaaIAzHBgywdǎYvCèPlutáHècqbǒèqaTnBtǔOgCb	FALSE
ucǒUuLLPVYoLASBgqaaaaaaJYkdlgrWbOekBdqJóGbyèOkolà	FALSE
xaVaaaaaaGBbéNHùeRKZOCGgbOàlCJeáyDohhBetYLcJopǔNú	FALSE
ùáòivmLFóAèěCBzYàDiOǎEIǒTàOqWjPàRuYwmDElxóvòbhVjHu	TRUE
áxgZaTQKHVJǎYóIUGǎuóéǎúbmkqNwrZixSPhàsaàzoCydsvBoN	TRUE
éSUoémsRǔàoágINBDiwDPVoPijEsqfáJáEoVbSRQstùELqǔZlT	TRUE
óùzVtqgbèlShRqWtqhJZùtLsLHěMjqMnǒuKkgcmygàVFgzFVaq	TRUE
ǒXykLòtbzslèBépENǎSPuldúzKGSyhèFǎópdǔSúUVcǒSxDQhGx	TRUE
ArsZhzěàězagYFàóUnowlSFdùéjènqàběfWǎǒěVqULvldúBǔYá	TRUE
DCzjAjmùLQAràààMJCnDqxkPLQQùEzwZvYpXNHcómrUbWòMNVU	TRUE
GèmWgMqoxáuQUrLQDxYnotUmLaáCcWvěèESOmOúaKngoùMhLFT	TRUE
IHzNCòèfYUquoGúóěGkMqRvZejDGwoilwàcoOYxGbáTwèfIHǎv	TRUE
KSǒáGBpETiwhàyAVbuwěgǒèdéóǒèécYBMMuěZSZZqLkFuóxNRr	TRUE
NHuBrToWLwgqFóAòTVúěObtfwyZRFMTArYjEǔugDQgRFòWJBúl	TRUE
PfremjnqhnoVtOàwkGdfyXHCyIyCǎclLXfqaěWdIZlrnóyjJLv	TRUE
RtcáSqvpyrXosDněQpémqNkEòUfxPyúUJakXAgfhyaGJnztvéq	TRUE
VFKgxyUblDJoFTQǒIǎsDGRurtCGNsdmràuDetaèHZSóRvUdJǎj	TRUE
YGògsCGuVPiIpjǒRèvéǒZMàBDJòOuwWHwCZmǒmDxOMQIupVOzé	TRUE
bUTJxmvaVZMHǒùgQaǔǎénanùoěwóǒDvǒàkpWùmRIjrDóSúóoed	TRUE
dsCLVBZèGVsfSóWhútQèǎóemámqmrJǒDMuaYMáKúlhFdTXóoYt	TRUE
gěZHděrbǎoQzpGUGPDDqOeùbéEEOGodxTOGOnoHǔMPnnaCèDbk	TRUE
hoarRTSDCNUuBqóekcZnZéùIǎMqWDPFuYexòpúBveùaKKoféáY	TRUE
kAumKéámxJùdlzjFYsáLlǎlsWlBFAFNiShhǒóAEóúQyAcTUDVT	TRUE
mzéDèreùdonfkGDècKtcWáácFJlàRJoèóàQéNMZpcbpèqvlMǔj	TRUE
pSovXfpLqfYpIYDdǎOwkfSófsEmCcéwcXACjqoLǒJZbjVMMkàZ	TRUE
rxzlǔěHYAǎéOǔusLxjǎPvTMfWtàqQBFeOPpAgVsEwVeCéePpeD	TRUE
ufISJHǔèQòsXVòóeǒHddúKOǒúhwWJGeQGKholěONXHEFkràQOJ	TRUE
xIòxǒotvYeqDDEgsùvávouJděeùSòBesgPeǎpǔéHvGàMkúckXl	TRUE
ùǎSRLPzKZǎEaaaaaaFbdebǒbàbéyBhFcóAVNoěMvyjzEGXWjnZ	FALSE
áhouwávaaaaaabyuééOQTrqxMXbAVBXGXYOBèviIKlPfbtAFLà	FALSE
ǎxdNwòPǎéǔèLgaaaaaaòirǎéjZOpJIWbfhělùNXbmpCgNWZJAc	FALSE
ěnèúZdFaaaaaaáDIRxTBJǔrfbEbSfuvaifVèYrtHkǒCMLaIlWě	FALSE
ǒXyfQzlZinmaaaaaaEYwvJyǎKQZhpeIhyOpbbDUEZóAóNYsklZ	FALSE
BaǒEILnitBiXěúiSRNěpùZQAegquMeaaaaaaùKbJfàmwISiǒBb	FALSE
EOGGágKCUùaaaaaabGDpBJDaREáVEéúǔoǒzòEXSaéZbZòedJǔf	FALSE
HOibmtǔAGǎHIèaaaaaaKTgNqwùkèoblgǒMAúǔOUbAásciFbXKp	FALSE
JwhpoǔázGqálǎnkJaaaaaaéècnáfCQIMefyibMzTGbXpFyDIěj	FALSE
MiIúrQSǔsaaaaaaXwWǎúrObpfàYqyqsdZǔfdcéaXpMpybǎrZuò	FALSE
PNFenaaaaaaKMCàKwéWEfPMsGǔqbqbYhvsAJekHúZgqéDdOimn	FALSE
RaaaaaaHSgkràbuěwbfXulVUKǒAsNAkàmóUùPqfKBqěCIEYtrx	FALSE
UaGRWSVaaaaaaàJTOefuhnREguaúnmqhgKbjZTǒFDdMCébXVSò	FALSE
XKvaaaaaavóHRZjdVGzaMUBqybvGDàWbYXOǒVFRNáfVǔtlzWáQ	FALSE
ZfǎyjjgeaaaaaaluPLHabYvZacèmybJPfUNúUWuCxcwǒǎyěúěǎ	FALSE
aaaaaaYBúVKǒXTJvCImMUDOEohMlǒrpábemdArtébóKRélmHGz	FALSE
bcEYxcóùáòékǔNàèaaaaaaXóGWbDzbuóókkIdzbòěZHuywEqOq	FALSE
fPGMJloyKqmqaaaaaaáibkrrTúBètRgCóěibvGǎEXDòèzSwHaW	FALSE
hvWlAQóuaaaaaacfgpblYtUzWoNbLUGeadZsTaàRapàBWèTjyǎ	FALSE
kaaaaaaybyúVbRclvòQmqkAúGlFǔnBWFiSdòRZQGvoCxyBsEmz	FALSE
myǎóooRòvvaaaaaaǒwkDEOǒsUbQGúmInbaětEYdcěgqmXuBáLb	FALSE
pKTqKǎhuFCFǒgebIěNOVoóúXbBaaaaaayluuvúbzyoPmxiqbco	FALSE
sáflPnaaaaaarǔséǔjèLECPHxóFebKaùDNhmèJVnhboqǒjóaKy	FALSE
unàAgooDANIiǒNoùzthvRHKàoVXaaaaaaYsusiFbpbXǎZOhGlC	FALSE
xRqnZaaaaaaQVLTèWXòMXbNbaPuNúǎLěVBiùggMqQMHYjěJgKT	FALSE
