ùǔYuóPqaaaaaaueǔmSQa	TRUE
ǔTaaaaaaRdPhóxfúllòb	TRUE
ádqvǒàUIUaaaaaaéUzfk	TRUE
àzBkIpfYaaaaaafAéiHw	TRUE
éVGRVuguòBaaacaaaavé	TRUE
èváúaaaaaazóMeúǔXDmK	TRUE
óhxfksóǒXVeFáúaaaaaa	TRUE
ǒúOaaaaaaěrNèěǎùMyáQ	TRUE
úaaaaaamCèCjděfMvkIh	TRUE
BèUaaaaaaWjSCgWjKEPh	TRUE
CMnaaaaaMhaaCxgǎPWUF	TRUE
DjoBDrmaaaaaaèmuǎRcp	TRUE
FǎBZewZaaaFúQnèvaaaa	TRUE
GbQàRácvaóNaaaaaaxLX	TRUE
IěáwBuvdaaaaaaqRXěGw	TRUE
JaaaaaaàrfCěpuMIqěoà	TRUE
KqENbzIQiUpJálaaaaaa	TRUE
MCQvNMéyyRraaaaaapDs	TRUE
NjhuzpaaaaaaáInNófèà	TRUE
OxrDHqCrkaaaaaaiGRRq	TRUE
QOaaaaaaéUDùòyebUKcp	TRUE
RrèGenfimBcoaaaaaatY	TRUE
TSLětqWwàoaaaaaaǎVcó	TRUE
UmnCUázǎTagaaaaaawbO	TRUE
WCqqǒaaaaaaTExDJòúJC	TRUE
XWXJRòMWVXWVpUaaaaaa	TRUE
YoucaaqáJqNèTmaaaaaR	TRUE
ZrSTUDSJhkIgWaaaaaaù	TRUE
aaaGràDaaaaJZKgSoáNà	TRUE
aaaaaaěQóQTaWóXBSVgn	TRUE
aaaaaaVOYkUMVúhhBwVm	TRUE
aaaaaaxKháGMyGHNMQsà	TRUE
adcaagúaaaaatjGvPSǎF	TRUE
byOYGaaaaaasxzeBpyUC	TRUE
dOaaaaaaeúwCǎútòsXlL	TRUE
eiKuqgpzùOqshaaaaaat	TRUE
gBaTJFóaaaaaaFRVBàtP	TRUE
hVZoEtUKvmcaaaaaaBMz	TRUE
jǎJǔnaaasyGóaaaagnǎw	TRUE
kPéAzùBDèéDaaaaaaPmè	TRUE
mùcNraaaaaagMsVGaoEk	TRUE
nAgaaaaabèhùXfaaFùhY	TRUE
oUmYkpUáaaaaaahzoàpd	TRUE
psAraaaaaaèéèmBVmJvW	TRUE
raaaaéQaaaDacVYěHqQr	TRUE
svVcyáKoTBKaaaaaaǔUg	TRUE
uGtpgQCǔYJBjǒòaaaaaa	TRUE
vqàNrroYaaaaaahnAKfB	TRUE
xLgueZéědxJngIaaaaaa	TRUE
yZjǎDNRmaaaaaaòòHmèz	TRUE
ùùKTrTYsùngúFoCǒjlwǎ	FALSE
ǔQLPOPdǒúǎěxmGózuJjn	FALSE
ánNgALkvkRsUJrgBUMjs	FALSE
ǎùGlEbcEYèěEóòzylǒkw	FALSE
éBvLaAùJHVZirWǔkUKSF	FALSE
èNééáSElxéWPoEáwZKhc	FALSE
ěntloWvdóYèuMáǒVclqq	FALSE
òějòqàKIjxKjzgeòéQmd	FALSE
ǒCeVEǔùòòEáCjhTDiaǎO	FALSE
úPòlèIYfIMCsswèGEXSj	FALSE
AkútFéqófQtaazbbCnKV	FALSE
CětawEǎTèozóJWbwLIǒy	FALSE
DUnGámOkgcàyǎúPTǎòEs	FALSE
EytyǔHàùYǎǒóWùJfOaLo	FALSE
GGBaGUóEěQRǎkZWseTcx	FALSE
HSbtZjjpRáùotGIdGrGW	FALSE
IsQIsfààkMjPúoǔewkgZ	FALSE
JuejZYCLeABIMymbjwěu	FALSE
LMCSVxúěBúDéTCJavfǎM	FALSE
MYTRRxQDjODràvbgúoxx	FALSE
OáujJǔDAXAfqNItgxèSě	FALSE
PQNuBIeczZAěAcměCmGU	FALSE
QaVQǔjFòwCUbftfDrJXè	FALSE
RqtWHùIPiièmTAùtòSúé	FALSE
TèEǎALélLwpPlNuǎFyùG	FALSE
UKHTzNzoiuùQUpwfpéět	FALSE
VMdIEPuKIPAóUmvcAáfh	FALSE
WhèsVdbzòpaǎblraqQel	FALSE
YáAùMLazdhyDexpJFIRA	FALSE
ZúPSxéOTùúutNhèdVkBS	FALSE
aNwèYybhsbsNGznlaúQD	FALSE
bgéǒMǒFdWutxnFgkGDhm	FALSE
dùBùáSLlngSfjùéQòUlá	FALSE
eGsúUQPDpúTAQhùfwAmù	FALSE
fbVrRpEkKéònpTQúOGtá	FALSE
gtZETyINTTEYòhgGfKDX	FALSE
iòINytczqmǒKóGeèěLùK	FALSE
jHSCIdfGpARzòRpSehyO	FALSE
kgmEJOOrUBúnEqlXGoMM	FALSE
loiběOKEěǎàHuXhsIóDq	FALSE
nBbqeáǒuKSùWwAǔBWoǎS	FALSE
oJaAEFefrgúxǔLHMQòèu	FALSE
pRRfHǔqàóTAoZNuDWdúz	FALSE
qoúúnzmXyTDbtFfUlAǔà	FALSE
rwSNúJxèLcEáèzzHoQkE	FALSE
tKmpéLIbMXoFaKRYEoàr	FALSE
uYFXǒNPdDcusǔRqùueaL	FALSE
wǔBnnreNvMǒòxeYxBddW	FALSE
xGNfqǔSóèqààèYOnYsùW	FALSE
yekǎsMXKPSWMwèáùCsDy	FALSE
ùáúzwnAeaaaaaawúPóùMr	TRUE
ǔaVWnòYèaaaaaaZKwddJi	TRUE
ápMlyEKYaaaaaaQRNuloZ	TRUE
ǎHPMaaaaaèáávóǔúaauXt	TRUE
éaaaaaabAùǔMoKTǒyúwùr	TRUE
ěRǒwòGYaaaaTàyěgóaaaò	TRUE
óqèávcjTmúěJslaaaaaab	TRUE
ǒCzMǔvwMqlèAaaaaaaYQJ	TRUE
úRvaaaaòBTvúděBFCDaaa	TRUE
AjEPgtUzEJaaakFaaaaza	TRUE
BzMQúGlhaaaaaarRùeáGm	TRUE
DRKsSfàRdGaaaaaaèmzWV	TRUE
EhaaúmraaajLNzxdvtaaa	TRUE
GòYgOúxbraaaaaaFoǔHSc	TRUE
HMZánFttuyszaaryaaaaa	TRUE
JòòVIFsèxCOMxaaaaaakG	TRUE
KaaaaúkAEeKUMSúRádaaa	TRUE
LuDAmxJPcèkRaaaaaazWt	TRUE
NVdpěaaaaaòvEkqaaxáwl	TRUE
OyWùáuǒYùòyèWpaaaaaaz	TRUE
QGHáeMAfXQYREgaaaaaaà	TRUE
RdòNqaaaaaawdhvǔàHBBv	TRUE
TKGGKrCpyaaaaaaudwǒLj	TRUE
UaaaaaavmXaměbVsúXTèL	TRUE
VruǎòjuùaoàaaaaaapKǎH	TRUE
XIknQǎóànDJVǎLeaaaaaa	TRUE
YUYǎMùaaaaaaOuóXZVyAO	TRUE
ZppaaaaaazvLàOègPúHrQ	TRUE
aaaúéNábWàGǔWěgaaaaLǔ	TRUE
aaaaaaèxEáQVáLhqyAwXL	TRUE
aaaaaaTtzěFbZmqhùnTdV	TRUE
aaaaaasrYXéSjFHeGxGǎc	TRUE
aaněaaaaakJqBVPMHmWjá	TRUE
bnLéáVYTaaaaaAEòázaak	TRUE
dòRrVykxaaaèaaaabKǔyC	TRUE
eTbLTRaaaaaaǒLYGOkiǎA	TRUE
gógǔAbjVóDaaaaaaXzGVo	TRUE
hdLèǔPigěTHtměaaaaaaS	TRUE
jCDaaavOòéUaFwsrǔaaaa	TRUE
kbYPaaaaaaaPzěpnúkwTd	TRUE
měWǔuaaaaaTbkaaoLACOě	TRUE
nSòcUaaaaaavEcwjXBOBR	TRUE
oqGMEpftaěúaaaaaaqqkq	TRUE
qMcqnWeSěaaaaaaMwRsBN	TRUE
rcóGdnǎěéaaaaaagCDUvV	TRUE
tàféàrcSHaaaaaagápEáp	TRUE
uVkqMaCLtaaaaaaǔzeCZd	TRUE
vgLkwWǔǔygEaaaaaaUgCR	TRUE
xEELàFVòvěPaaaaaaúUóè	TRUE
yaaeěBúaaaaaqQuǒéǔéúx	TRUE
ùùěMzxEoaZRěǎeSmgdVAc	FALSE
ǔGúáIEXěWFRbNQeElkqPW	FALSE
áILTxYrVebXázGnUàǒeLn	FALSE
àdMVZygVǔnqIoJjdQQFTQ	FALSE
ǎqxàNùicPzkéáBebBvvIN	FALSE
éuLiErDǎPsTěǎBvEqIjló	FALSE
ěèWbUaHcPSèóIHeOFwWRg	FALSE
óOGCRjlǔMLHUXfNǔsRSNg	FALSE
ògàeMMfWeEurèlǒFibjhu	FALSE
ǒstSéèxkmFácglAeqǔǒBǔ	FALSE
AǒYóEcftǒXNódMUguVXúi	FALSE
BSDMěkqdfKDMjGáFkzIǒà	FALSE
CdfópUTpxvkQěIusCúébN	FALSE
DzOQúèBèvuàIeGjDKFdBG	FALSE
FBYòAzVLBPhjáěáùVTUhE	FALSE
GMTyhIhWgymúVhnlděZNR	FALSE
HrěsslHqAàjmYǒóeěmVòp	FALSE
JǒráYrMsUJLunàQoQGQVt	FALSE
KNùSEckápyftaSYHLHDxd	FALSE
LeWdbHKMXyǔJqóKKSfuèY	FALSE
MrúeeMRDùàQrogdhKUvHM	FALSE
OIamúVYxyCOéhùMEòAZIv	FALSE
PtAěNGRZmQHùúuéàóGéEI	FALSE
REgònbmIoZòZvMMKfsfDb	FALSE
SVYóBSòzZtuówITòJmgáo	FALSE
UěNjesaSMULmFsUILDKjh	FALSE
VYDvSstFMKbǔIWggWqàqò	FALSE
WmTnxwHNizásxǎHjXKàRu	FALSE
XwoYKsjlNmhúHófoZàtǎě	FALSE
ZDblvcCyNjCwTǔHWupZQj	FALSE
ahRJdDuoLMdFAGJúměNló	FALSE
bvMONóeAèFxxGòzIvAvSj	FALSE
dSáeKSWbyYóoqlGměZGNI	FALSE
enèzeAEDFptVEbXtYǔMuC	FALSE
frQCcpéOUrqeVěuVQgkǔǒ	FALSE
háZHsddxFpdmòǒòNěbaǒè	FALSE
iKHBFBtywǎIFVpwZDYjNv	FALSE
jiǒkLyrNóécSCmXDTSúfǎ	FALSE
lúunSKègǒUyPàNEFáWóqT	FALSE
mZvùYLpdNZwRFRkFLvAgB	FALSE
ndvaJRlwNjoǎàKòbráóbǎ	FALSE
ohwIàUùtlCQnFXRPcáéXj	FALSE
puèBWAùEjtVùyiHBiùQxb	FALSE
réàGàqmúúèSeBùBTǒéǔDE	FALSE
sWúKmútùmaděpLǔxiGùQz	FALSE
tlHTYèWOeTLěicNfMlrqr	FALSE
umǎrCatféOáPOkǒáORfsJ	FALSE
vzXRǒAOjVuDgKèFTùòààT	FALSE
xDèAcUTNVPIǒFóXqáùǎTs	FALSE
yQsáóNǒOQeSúmyósěTkVK	FALSE
ùùaaqwúdDDYMaaaaCaauHz	TRUE
ǔaaaaaaXSotmftkwúrxMdù	TRUE
árSaaaaaalǔYéǎeáRǎYáhM	TRUE
ǎǒxFIaaaaalARǒgNjaaJIó	TRUE
éaaaaaaGXqúcqBoEGMoǒòr	TRUE
ěéonWVWaaaaaaèKòKBFVěU	TRUE
óWèlǎXuóaaaaaagQRQsvsà	TRUE
òzPPǔàóéyaaaaaaKkYhFlI	TRUE
úJHxhěaaaaaapZAdrUěàVo	TRUE
AsámǒRTuLetaaaaaadhDkh	TRUE
CEgSúgFaaaaaaurvGISǎòE	TRUE
DuSIRFswLyaaaaaaOjWjóy	TRUE
FJqmaaVǎújúPYǎLǎOaaaaa	TRUE
GdvěRgzzpBgmttqéaaaaaa	TRUE
IDkaaHòǔbBMaaaaakpvWèF	TRUE
JYKWDVovlmáETǒaaaaahaa	TRUE
LAXntEaaaVRSEaaaaWofGs	TRUE
MVJExThSraaǔGoeozaaaaa	TRUE
NupRàyesQaaaaasQbAaaoA	TRUE
PTSTǔdóTRòJzhIaaaaaaiú	TRUE
QaaaaeǒtMcPfaaaúYxJhTx	TRUE
SóRěXàHwjOlaaaaaazMSfJ	TRUE
TLaaaaaaulòJWěsěVéllzé	TRUE
UcKuzǒnaaaaaagfSDAmOIQ	TRUE
WǎoCáfěmpfúTaaaaaaFCSp	TRUE
XQǔHyeǔòMùtljdòraaaaaa	TRUE
YjbZAoepfaaaaàmyèuaaaY	TRUE
aFxpmhbrWVQHéDòdaaaaaa	TRUE
aaaaáqiqGaaauèUuZVznpZ	TRUE
aaaaaaCpQkDaJIDMèjàjSV	TRUE
aaaaaadTǎephBhǔèSDúNAT	TRUE
aaaayKǎjxféaaaJUáebhYy	TRUE
bHfaaaaZOěnBiZaaaSELfx	TRUE
ccGáNotcéVkZaaaaaaǔClè	TRUE
drùYAGvptDǎòvrǎnaaaaaa	TRUE
ewWaaaaaamǒFvmYèyhàTfw	TRUE
gǒLddaaaIùběúSIaaaapFf	TRUE
hiaaaaaHOhTTeàúǔaaCKWx	TRUE
jCaaZlvgaaaaaEbàGlbaué	TRUE
kgódúcúguRWěǒzmkaaaaaa	TRUE
múaaaajdiàaaaQaOiǒBZiD	TRUE
nWóEǒyáuùaaaJKzcaaaagz	TRUE
ogaaaaaamjCcEǎèTuógglE	TRUE
qOTJHOLyRǎTáJaaaaaaúóǔ	TRUE
rkáPàrDHcaaaCaazaaaeIW	TRUE
těgUoaavoUVyQaaaaajxlj	TRUE
uSaaaaaèRdGIlRyuaalygH	TRUE
vqxASùUJaxǔAaaaaaaGbnV	TRUE
xéǎDnwaSEúaaafSPaaaaIq	TRUE
yXpfsaaJQPlvaaaaahyeěc	TRUE
ùǔvNJMcxszuHsZLqwIwqII	FALSE
ǔUUIbaUgrJzàTlAjèXNDJQ	FALSE
ánAFMiOYznǎáHétxIHCèCù	FALSE
ǎàFCKWUnwǔzCúRZpoòèGKg	FALSE
éèVoěkJeYéěpYGHhuCEIlc	FALSE
èIywCndXùIByMsǒdOFUBvc	FALSE
ěXHǒKKwfaKctěnààTqHaVq	FALSE
óciIǔfCSǎIláZZhCKbcsxs	FALSE
òqsàGYaéBTóiFvblLJǎePv	FALSE
úDlLòétiuJúZúsJQERuhMe	FALSE
AXWZrǔGlpAEEwyxHàFVèáG	FALSE
BjcOPUòNkCfnǎXIuèNKDmw	FALSE
DBLuzPsMxYXáněágUuxAǔé	FALSE
EUIszǒCpFQǔdIrvXYsěvkk	FALSE
GùGyKXyPRiǒZǔSBDGdijiP	FALSE
HPAMhùFqàFszbèXùcúeZbà	FALSE
IfZǔàSǒdHsSóRygDqNWUkw	FALSE
JuNLèhlBexWJFmèòiapKfc	FALSE
LémèùcùSUòsnwdkcokcdmK	FALSE
MCórGjgBbiáEdVeWwuLèHG	FALSE
NKbnzLTCpMOQAolDsJèGAQ	FALSE
OhtǔCBYZǒcpBFénǔsPnFbz	FALSE
QǔYjǎóaSwòsYúeouGdRXàá	FALSE
RIzoésRéeàvyIúQèfXúóéá	FALSE
SbJimógdthTzGzxjixYèJó	FALSE
ThvfchQéEQQTùzǒAPàúúKo	FALSE
UróLQòULtQruEMáéDKtqKé	FALSE
VxdǒNzrěSHYòóIEIjzDqúò	FALSE
XEtUáWqéCBgfvQhfaQROcC	FALSE
YZéVpětVwBGoJigtpvtnow	FALSE
ZoNhdyxóàQOóvláòQbǎóDj	FALSE
bǔPòDydXǒaAmbáQWbSZaèj	FALSE
cHazqGuoWDKbúUtuNáySVU	FALSE
ddavBLkAsAvUUéěVeIGéDú	FALSE
enkwzZzRTvPFǔlugBJsòwé	FALSE
gFapgvxixxZSópWXàRǔWué	FALSE
hdxGuoòBfbéHKQQzjkhWZQ	FALSE
isZUEADéòKTWYWJymFNXrq	FALSE
kěWùYKǔEqGilàpXBKaEòqo	FALSE
lHuTrèxUSǎEFANtDxuùǔJY	FALSE
mTBTGzdrDMToǔáiZámúfmV	FALSE
nphúzúSRIagPèvWHZFAHZP	FALSE
ozàKpxZǒpoKnMuFMEǒCbfd	FALSE
qòjdORZjilSnSPFwIělózǔ	FALSE
rcNCádZǔuZòwóǒáXVDeOpp	FALSE
tCokèwLgXoIBOhǎvRuHZàQ	FALSE
uhawBrqosòSXqMOsGhUnND	FALSE
wǒypkMJOmXyǔvgáwjQhjke	FALSE
xRywoVySJǒèHIiFsioFAvO	FALSE
yixviiPéwúNMoèaJVHQèRT	FALSE
ùǔěúKZlCěpCQXzěaaaaaaòè	TRUE
ǔIGlgefruHIáuAxmFaaaaaa	TRUE
ábǎSaaaaaawèPlkDTkgfNcq	TRUE
àwjaaaaEèHaaaǔBVùMqqcaó	TRUE
éFóědPAnmVaakjaaaaagjRn	TRUE
èrdkDréKdjNaaaaaauMjóJz	TRUE
óYwTBZguOèyěáWèókaaaaaa	TRUE
òxNmyTaaaaaadIuqBǒǎZBbP	TRUE
úQdNétaaaaaaJHěhxCxysPá	TRUE
BǎfyUIRDaaaaaatcsQLiáfs	TRUE
CTBgobòSaaaaaaùoóǔfsYRè	TRUE
DdNTáoPzmtPTItaaaaaajǔs	TRUE
FèeaàCaaaaaaóxèàévóeUǒé	TRUE
GNyFáTIcUbòǎVaaaaaaèCǔà	TRUE
IèwYaaaaaaúetNóBdlxgSúò	TRUE
JPúǎrǎOúyǔuyHYaaaaaaVàW	TRUE
KtlqdSdaaaaaamooxjRMvcr	TRUE
MOǔbCNúYZICHòaaaaaaLzàp	TRUE
NdèáQjdùǔcaaaaaaxúdzROǒ	TRUE
OyoZxákPVXxkáPBkUaaaaaa	TRUE
QMeRACkMZzCòUǎiaaaaaazi	TRUE
RjǔIèaaaaaazygǒmkqMbHGé	TRUE
TAKaaaaaayzGòFMúLhAǒxvL	TRUE
UeǎZAěóaaaaaAwǔhaaFFXnK	TRUE
VuNRaaaaaahHajxIXájqfMl	TRUE
XFIfUTmywkxdaaaafUPǒaaa	TRUE
YNěNieaaaaárhxQcaaaSkěA	TRUE
ZiZtXCvypaaaaaaVJácgSkY	TRUE
aaPòěVaaaaacVyAeoèDPáwT	TRUE
aaaaaXéǔpUMxóúLMVYQǔúaa	TRUE
aaaaaaXNúáfǔqDxvNmǎqaòh	TRUE
aaaadpywekaaaLùàlyIrBNT	TRUE
bHóLPúUaaaaTOXtkaaaTPáA	TRUE
ccKHslPpepUdoaaaaaasund	TRUE
eǎàKGCCVòàEHaQěaaaaaaZě	TRUE
fJsIdwòYùhcǒaaaaaaěAgfG	TRUE
glJvlóaaaaaaZKuǔóèlLjlm	TRUE
iásRuòAZCniOAxxiaaaaaaE	TRUE
jRǔYAHàuEoJaaaaěaaaJèáX	TRUE
kfsvúOùIbDaaaaaaZLqǒèdr	TRUE
lzLaDEóraaasBaaaafRkósH	TRUE
nDedóaaaaaaěrpOAowUJáLK	TRUE
oaaefWyWaaaaaUHùFbVMMom	TRUE
plrTEooaaaaarpAèàmdNaaM	TRUE
rúbAspaaaaaafTcáUwjǎáúB	TRUE
saaOLèpKHhbIpyBaaaaadsf	TRUE
ttCCeFnaaaaaaáDiZECtywó	TRUE
vSeEDPDkNyàRujTJaaaaaaB	TRUE
xúVěDàuàplaaaaaahEààúób	TRUE
yfaaaaaaúxedXudqlaCbVil	TRUE
ùáGmCfémǔRoeYvEmóXHMOQK	FALSE
ǔMZVRhFjèXbVèNEsMòùWqóě	FALSE
àèèCyEVyReěLsQXTúùǒoReE	FALSE
ǎLeqǔAJeYHGxyáheIwùjASě	FALSE
éYtgǔKRYLjVémbǒSmVǒcǔDB	FALSE
èeNnǒoCMEuyWèIvcCGěWóuz	FALSE
ěvysúàǎkWJhqJrEsXrFěPtu	FALSE
òúcJGEWQetfSWóMjrnxúHSǎ	FALSE
ǒWoUVàXPBóXckSVKjxwyGDZ	FALSE
úeGrqnJyVtzyVDfKLrYùjwè	FALSE
AyiùJxpEiCrǒijUngFwúBzù	FALSE
CCrJiupeoùàéèqTYǔMIgxgb	FALSE
DmdYRNOnèCpdvGKěVEáRLùr	FALSE
FàBǒOaTaQFùkěLxNEièGZjF	FALSE
GǒeSjdRZhvITDòdQiPrbéai	FALSE
HXáuWdKámlQěPWJOqmlAVRl	FALSE
IkWogxEqWKOlfúZypgTAogP	FALSE
JsUùkrànRqKirǎlúNSKPvBq	FALSE
LóZeBhZzdyěRPEymxpJáěey	FALSE
MMbFESuqMxèùTFGOéLIòtèl	FALSE
NiKZúgUóTdZěyAPKWgPwVtú	FALSE
PBwJfěAlEQKqumxáóILjdvǔ	FALSE
QRnhUtFúFwrnwùgǒGqNdJjD	FALSE
RnóórlFcědfSgCokáUsesbù	FALSE
SzgeěeXOLlbwHJImbNZmápc	FALSE
UNENAoKQFrFXijcjZbRhTéF	FALSE
VkNùiùPvhFbcBàbHejHjfúà	FALSE
XáZHPPCMgdyXjpHRnYAǎàqs	FALSE
YDǒéJMpRZPéaèRfGvqVQWpF	FALSE
ZNvuKěuewlRlFCǒjlvCYnCQ	FALSE
aNFěièàuuSjèǒtwFSDOàopf	FALSE
bcVNsàIuLqtCPvNǔUxZUcfX	FALSE
dǔUQqàuKdBPOTěǎUFáóóáNT	FALSE
eEixNǒZUDUIPxVIGWuOBgnǒ	FALSE
fcyNoǔKǎCbDyúJèwgNXvrèE	FALSE
gpòuděCěSóaòpQfTARhgárǔ	FALSE
iùcByGxWFxaSxnSáhEwùJiZ	FALSE
jCjivzdǒSypezWúBuAGQXZt	FALSE
kTihùueouLǎUnNǎebsPurkD	FALSE
lkéxGǒsùaèXJAlǔhJgQBAàd	FALSE
mznnEFVbVòctóMúǔBUpMèmZ	FALSE
oDBGzHAAlzǔmtqóHOuVCsUz	FALSE
pakmTòpòBKLngzrmhéùcúlV	FALSE
quKórZTcúǎccrhEǎpZVOuqm	FALSE
sCPLKlMoTCCBLWréSeoZGfǒ	FALSE
tShUFDxghuqKEkPLiXqdaOo	FALSE
ufuúdjùhqMfziemysLRlǒMU	FALSE
wǎUVsMkULgKTSǒZáxóYeRmc	FALSE
xPHárATLGyfUPRjǎNKhyrZP	FALSE
ybùjCKlóyrmlzFMAěpYJkóp	FALSE
ùùmItdyOgSwaaaaaaSscDISG	TRUE
ǔYrdPTdZEcBMvmlxaaaaaaǔC	TRUE
ámǒJcaaaaaaólbFǎUèAèshmu	TRUE
ǎáxLoFWtaaaaaajxFvǔLjěVy	TRUE
éLgdaǔQgOaaaaaavjFèGqOSJ	TRUE
ètNvfèúVbaaaaaabwPévWSMn	TRUE
óITAUGaaVaaaaaGGzSéiaIBD	TRUE
ògvFxhááyoWOoAúáéxaaaaaa	TRUE
úěcEtùYLAxGDQaaaaaaaLoeó	TRUE
ASXaaoaaaXGaaaBSPtkòùWxt	TRUE
BpaaaaaaGjMTkdiéǎùMfhièǔ	TRUE
DFBsEèIzdYGICVmxjAaaaaaa	TRUE
EaaaaalrYQIwCBYmsFkaacéA	TRUE
GùeyoGhdlcHobèsRaaaaaaLJ	TRUE
HSěgZiúKqTGaaaaaàuèkkaaQ	TRUE
IitvaaaaaaIQWAUgIgSqQXěò	TRUE
KDFKvvaaaaaaCqěQIòrmàyNT	TRUE
LUWJVdaxHYSAjaaaaaafKUsy	TRUE
MkǔZiǎaaaaaaDàpRowpSmDGH	TRUE
NnàISrmWvaaaaaacǔbNrqcFP	TRUE
PShwècTaeègnaaaaaaPoááSS	TRUE
QvMlgefBáùdBaaBcaaaaTaaw	TRUE
SBcdLbWPKgèZaaaúaaaajszi	TRUE
TcPRkòLpdoaaaaaaóeLtǔjSe	TRUE
VùMRgaaaVcoaǔóaaaaàtùrvè	TRUE
WǒéOěyAtaaaaaadmwNèssoǒU	TRUE
XVBkpěJàxhkMaaaaaaxeRsQC	TRUE
YaaaaaǎWsuaaFxǔRèyúRpBRu	TRUE
ZzǒoXfSùowùaaaaaaDqraXab	TRUE
aaaaDczeKmivóXXaaamóEDYh	TRUE
aaaaaaFyeěWsèFgSeEáuúdAw	TRUE
aaaaaaukxRpQlióiVOǎòǎnXj	TRUE
aarYnqaaaaaqGóqǒLXmLjALf	TRUE
bvaaaaàxvXoòaaawókjjNPpp	TRUE
dGqCSpPaaauFZsaaaaBaKjXQ	TRUE
ekTeKéAaaaaaamkcèèPPDmVH	TRUE
gǒKVFEUúHAtAKúaaaaaajǒáò	TRUE
haeaaqURaadǎraaaáXóRLaaN	TRUE
jèrvMizvccNZpgCJYoaaaaaa	TRUE
kSEaaaaúlǒaaaàZiRtooǒévS	TRUE
lmbMǔměTaaaaasaaùyEUXKLP	TRUE
nòRòhAúqBNWòbxPzèaaaaaaH	TRUE
oTBfFfmúéaaaaaapCDèWuàyc	TRUE
pnUéaaaaaaAFrGHǒhEǒTiùMm	TRUE
raǔhHVaaaaaaiaeRuhpòXzyN	TRUE
staaaaayaacNòjKsnàDGtáYz	TRUE
uaaaFMnaaaaúeKOóabúúuSZy	TRUE
vjNnódoeTaaaaaǎúěSaaùwfG	TRUE
xúàRkIaaaaaaJBGacKvnéQgb	TRUE
yaaaaaaóYDOFúTógáèDqIxAY	TRUE
ùùiSóVvěUmScújTmhVsǎáqòB	FALSE
ǔòQSòFReúJfcJmCRéúsYóAqF	FALSE
áGpèPúuJgPmVHxjSùòldrqRU	FALSE
àVNNOgTlFóGptòùEeynUnáby	FALSE
ǎmpiěséǒùònOǔMwVnOǒsCQGF	FALSE
èàòTRFroJǔRěyTotOXVěhúéa	FALSE
ěPrmzèORgpFFfUbLóùJxZMZò	FALSE
óZBrBónRpZlǒeBEàDCWfpùYx	FALSE
òhbCáEákèòMúrkCyǎwNyNǔTn	FALSE
ǒsYJoGèuóyrlJXzLtéjBiRáo	FALSE
AǔThWùěoGYbèdóSBNZQBNbey	FALSE
BKfVǎAdxéǔDáSBQuSxǎYGPòs	FALSE
CciòYvTjuvǎZJqjQqséAKnFf	FALSE
DnùJBPnAMǒiSOVlXèémgligl	FALSE
FòSUimOAàIrYxQàPUqùyhwze	FALSE
GOyKóèxòKhoqBgaOsDábóYVE	FALSE
HqajEǎěeèǒódápUkeRùakohf	FALSE
JǎhwWMEicDzzKòááepúúGytá	FALSE
KQWǎpDpEHviwzlHAhEbknzYC	FALSE
LoJbrǎwǎRǒěyKqDuùbYqfKhc	FALSE
MwWlNHDsVàúLDyBóqGoFMcǒà	FALSE
OTHmǔuRwZáUaudèyPǔIEòNSm	FALSE
PexbQòóyqAàhXúkWImEXQaav	FALSE
QfHMZeSVǎFZtSùuQnCzORPǎV	FALSE
SùyFHéIgCMpbòyfǔROvEOrIj	FALSE
TKlsWXsàCpETǒdQAbàAEáǔUZ	FALSE
UbǔǒxèvòérsxDIúIniZqèWIQ	FALSE
VtmUyMklěúZwùNSWemAPěqGK	FALSE
XCTcUleGqXPóafjPùxfrrvsE	FALSE
YSgCxqòCKtxjETVnKDsqvwGě	FALSE
aèCehEákRnùEmKuIetMuUAHV	FALSE
bKUlJmáUdcFXěědTNwùJùáHá	FALSE
cfTjmvàNckzUǔFEéfQPòdhDǔ	FALSE
dxgknáWPsAMBJQCOWàwfsfjó	FALSE
fNzyatóǒǔZmYlmbHFùáèòwGě	FALSE
ghCNzvSDHRKqWiǎbPárawbdo	FALSE
hvPRNjOùTmwIézhaUMRNgǒjv	FALSE
jIqjàFqntwJwXjDCòòHIuuhǎ	FALSE
kběvKóáShóPkYFSDMYyYJBWK	FALSE
lvYànWNùxGWěRhǔUPǒóuRgSC	FALSE
néRMIǔKeibEMuZeěCPeeQWFm	FALSE
oCGnWxiUtbeAwǒǎédmaSnfwC	FALSE
pPHIúCuúdǔyDEAùcòAcAqvYc	FALSE
qjzCǒZOIcfǎújjhmkázAZǎmà	FALSE
sèWpWdIèqCDGrfINěFxoǔQyW	FALSE
tFHǒXwCqcSCDQrèyYvàwIOéT	FALSE
uafKhRVDEyyYLnpdOofBbJǎU	FALSE
vphCǎiTzrpPIǎIawóUóReófS	FALSE
xLHdmEmóèKOǔràùòXrLFQKáf	FALSE
yRWvIKOJPLUFǒbRXMmIMéYch	FALSE
ùùfówKbèvBKaaGTaaaaauofòE	TRUE
ǔIǔQaaaaaaduàiFwqFhuYsǔHà	TRUE
áWkPHmaaaoLvlúOgaaaabsàOk	TRUE
àejǔaaaaaatwfqkkyqyùHPhaz	TRUE
éǔaaaVryXmdaaaaòdàKdSSdjě	TRUE
èaZNAaaaaaavOXCGùGZonèxTǎ	TRUE
ěwǔDngàòYxkaaaaaàǔaaskxoh	TRUE
òUèaaaVxZmwBěDVòqvVaaaaVJ	TRUE
ǒiSIǔLLjyámqHěBPaaaaaaZjb	TRUE
úyǎKǒǔiaaaaaaúeapfKǔrOLRi	TRUE
BaaaaqeJHvAlvpuǎzéaaèeFaa	TRUE
CwàaaKózaaaaaJfbniòKúcǔwǎ	TRUE
EǒaaaaaascOaěòpaeRFkdXVvc	TRUE
FYheFǎVSaaaaaaòcNhièoJrZT	TRUE
GyaljjpaaaaaaePIéFèéǒrzuS	TRUE
IFOZfǔáYáMFgVaaazaaaaùèPJ	TRUE
JgVòódRSHGhcgzfòLaaaaaaéǔ	TRUE
KyPǒáHǔxVgaaaaaawràIWèóòè	TRUE
MQGMOAuvaaaaaaiXuòbúYWsùZ	TRUE
NbégbqaaauěAVRwMSQaaaaXxP	TRUE
OtzaaaggaaaaNnEhspèwVrVǎK	TRUE
QcOrdECahàrxaaaaptaaaEJpF	TRUE
SCDUTcbJpZùaaaaqMQaaaEětf	TRUE
TbXǔPfwéOUJúTjaaaaaaNòǒěF	TRUE
VàsXnVrFOoDErKUòaaaaaaǎTC	TRUE
WUuYbYkaaaaaaculǎjIùtuZHǔ	TRUE
XtKóhzIèqHóBAaaaaaCCaaNCs	TRUE
ZDeNhKSlèmaaaaMhtMaaaèbVE	TRUE
aVIóCaaaaaaVDùLJójèUdújLt	TRUE
aaaaaàlaagǎRhLAzasAùkǒWQB	TRUE
aaaaaaNěeuòvfICEéVmYógǒvT	TRUE
aaaaajLBbòYòǔzèaaFǒkKèoyt	TRUE
bàYmVZSjfgfwoEèyUdGaaaaaa	TRUE
cTYaITzeWcépúKpoaaaaaavúD	TRUE
eùUGáBácaaaaaaéGEXqMurroD	TRUE
faaaaaaòeKJúǔRǒdKoúHNUoyc	TRUE
gwǔfdRéǔaaaaaafTEvSóOGázY	TRUE
iEǒkttnEtCsNXaaalaaaaeMhN	TRUE
jlaaarVǎQLZónaaaaEQAkǒUNQ	TRUE
lKéuòěaaaaaaQlAoòHoWYHoqf	TRUE
maaFHGkLaaaéBpAqézaaajkxó	TRUE
oòLXmzGBaaaaCóvGIwHaaaixI	TRUE
pGlsFjaaaaaaEléqèúLGázFrV	TRUE
qwaaaaDdóDQFúYaaaRDEaóQPK	TRUE
sBZxoEotaaaaaafGRRzxueǔyr	TRUE
tTaaaXtJtmCraaàCǒaaaxFHTè	TRUE
umtaaanxMBHěúpaaaaVyaNěcO	TRUE
wEtVJFaaaaaaZùhpEEayWwKàs	TRUE
xSdaaaaaǔoPaagóHmsùkhtVJm	TRUE
yhèoaaaaaawwOcplqxeDuaǎúi	TRUE
ùǔrQbǔkNaàuBIBéPqhòxlèlZu	FALSE
ǔHVDvQáuOLkDyyàJqeINéǔMMb	FALSE
áfggoOǔěLqFéóhXdpzrYcnaVL	FALSE
àvhbpJBtěAWiwǎdEdcǎtntSLp	FALSE
éěDXpTDHgéISBRunǔótzoEaGE	FALSE
èBSuóòJbuWKHspjòkháRòwLKC	FALSE
ěKHKKMXASeNgSóSEoéptZxrrF	FALSE
óVéjHzilqIzǔǎnRTFMǒswaVHw	FALSE
òcoUZérgLDrVikéJNáPǎpjmLu	FALSE
ǒnzNàshOUccěNXHtASéTEiYiu	FALSE
AǔuAEknDrvBlǎǔvBeòsSGéLěy	FALSE
BKvtkYFmnúNmáyQTciceRipòl	FALSE
CdóAéeysyúebBxMXUiZCgmDVw	FALSE
DnHMYDXáúuhùPpOTànxQléwpP	FALSE
FàJzǔùacMhuMokDIǔOòlDWBko	FALSE
GODáéfvDCQǎVQrJǔeSIUrPǎQi	FALSE
HnBèbQYggVZPEyqJEHJFBNEIó	FALSE
JáJYzéctǎwHòguFFzeRáExèrQ	FALSE
KZPXUaSPVvuǒNpǒUpKóqéEtES	FALSE
MòònqdiéǔeeěqRHWisákwlXQǔ	FALSE
NWeXEhZhtWséěysǒvXǔGSeěeL	FALSE
OuJbyUzYófQCMTSOxcIúáVliú	FALSE
QEmeapaMYàpgxitDFáPòquxSG	FALSE
RdMAjSFPàUcNaǎYaéYóùǔhùǒt	FALSE
SrQèúAenOWtkEJDghxHǒQáaPǔ	FALSE
UCVǎGrxQlǎOgùěUcJMPMLǒaát	FALSE
VZCgbOXQuoWxATAOdvúXoSlWI	FALSE
WpdLYtmsùwdyTlgòUaWUKaBSP	FALSE
YBlhAZvQVlAAhgèFSéRAAòOox	FALSE
ZRtdúVAOàggJǒFGFMèPnòTvcO	FALSE
agKsiNBiyCSTnIEQZǒáGCRANq	FALSE
byéJzemBGmVúLtaitCZUoáfeH	FALSE
dǎWòOǔVáěPIfsOWKumgóéYSup	FALSE
eHǔiHfNpLOéulcmNkZkxgaFCh	FALSE
fPLyǔXfgpewùàYuaAVsBnVOút	FALSE
gbKiHxrIgIAeKèlBipDKgshhq	FALSE
hrjXnKtYyZJyCDZAòyGexhaLǎ	FALSE
jJùǎXRǔvRBcóUQsrRvhlmwzrb	FALSE
kahuIyǎOSQRccěfIyThsrSKxw	FALSE
ljtejBUTuxCbZJtNSnxèbyiKn	FALSE
nóxWFèEGóáwcINkvZyjǔPuYxR	FALSE
oQCvWdIDlNdAekPKfesAejǔCb	FALSE
pqAfVIúKfHvwùgJtpREsvtbqù	FALSE
réóicHwóDfSFybFTJǔwrLòNěW	FALSE
sHwúEUEǔùCùyOimPùIiUǎgThl	FALSE
tKRlpgjGwWSQOUJKéòànhFFvA	FALSE
uQàǔéJOmBGjaFGsjgbsUstFǒl	FALSE
vsoMnjoldiáiEwkyJLaQAhIpN	FALSE
xFNRilwNRPòrǎMzyzuXYéKùǔi	FALSE
ycgiLUùicKéuèoyUrVqJXXDsV	FALSE
ùùVGmatèjméLVàojaaaaaakQjN	TRUE
ǔRsioaaaaOrzejvhzaeaaaExKú	TRUE
ádyeMdvóMqaaaaXsraaalxDgèN	TRUE
ǎBMRzAFéaaaaaavFzpXbmvbjǔK	TRUE
écáDDIaaaauaaaiLGXmáùaWCDǒ	TRUE
èoAGTDsaaaaaaéGQmZdáUpYùPi	TRUE
óǒnùlvúaaaaaanNOóóGwYVdùáq	TRUE
òOKHDaaaaaafǎIQEZfqkqroěGq	TRUE
ǒxfóVEQqLIgePnaaaaFgòXbaaa	TRUE
AQIGaaaaaaGHxIMqFkúbnDFILl	TRUE
BiTuOkjàhLoyQFàQflynaaaaaa	TRUE
DěIaaaaVEEòuéúfoEPáaaaèqeě	TRUE
EUFhjVbntLZZEqnaaaaaaRyFrǔ	TRUE
FrYkaaaaaaòVDòJuhCiVcwRhnE	TRUE
HǎCèzěhMMEùraaaaaaDMówYaeG	TRUE
IZaaaaaaǎtZYPyèLSèǒoTOCjTǒ	TRUE
JiaaaaaamQáróǎLIaKvSéáuxLI	TRUE
LFùNauaaaaaatiZXRJùLOQAdLi	TRUE
MYViTéèniTBmùàéhòLQaaaaaar	TRUE
NzàaaaaDYXKeònoFFaaamǎpKFe	TRUE
PMPàwarSIVhSkráaaaaaaETǔBè	TRUE
QlǒLwaaaSěyAěǎzéngqxòaaaaú	TRUE
SCèǎIPgoéVTLěóúaaaaaaczZWú	TRUE
TaaaaaaSxchTtrSuózáEZDHěYS	TRUE
UzFǔǔMvegsHKaaaaaayGyCǔBpv	TRUE
WdǒBNùbjaaaaaaZmòUMKáAdódr	TRUE
YázHèzQNgèàymuójyaaaaaaǒUě	TRUE
ZoaaaaaaphwwièqǒQLúLAFqmǔc	TRUE
aaaDEwiéHWGZHTaaaaYěmMcgMf	TRUE
aaaaaaòAmUèyǎsoCtULáNwòJDw	TRUE
aaaaaamewrAUpnRcwttokǔlIáp	TRUE
aaawEnbHaaaaQMXRùàVbtòácně	TRUE
bbhBǎdaaaaaaéUùPlLDJOXùMjV	TRUE
csdIFeUoáěěóězAILǔaaaaaaLá	TRUE
eIǒuVěAàaaaaaareJwáóVuqAUL	TRUE
fbvěǒMnRaOaaaeIgszaaaagNAǔ	TRUE
gzùoaaaTgXǔvzaaaaúBvhèsPtM	TRUE
iMLóLzYMaaXaaaaabǎYpyWqléH	TRUE
jZTniéàXycOSFDUqKXòAaaaaaa	TRUE
kqGFIHjCǎfaaaaaaùELqǒvWòIW	TRUE
mFFFWxàùjùmaaaaaaQsúdVuztF	TRUE
naaaaěyFómraaaXrtáFhnàtǒǔB	TRUE
pGJeXǎrhkYaaaaaaLcúsáneàùO	TRUE
qhèàhVhrZpapmlcUaaaaQTaaaU	TRUE
rzèerQhataaakHěFkvxòaaaaěj	TRUE
tǎkVTrFaaaǒoOǔOǔXCaaaaHCOě	TRUE
uYVqhECàoEYWOnIǔéaaaaaanlv	TRUE
vyzyzMxyQYǒàbSOaaaaaaasHqv	TRUE
xAáNPvsaaaaaadqiRBùsxAqǔsD	TRUE
yOrcúNaaaaCjǎOjzBeXkaaaěàt	TRUE
ùǔàěaóTVlqǔxePòDvDEXbzǔmùè	FALSE
ǔKFǎdjàgpfCjěǎPgMxěgoOchou	FALSE
ákdSúùjǔcóPdmQBlyóásXaLLóh	FALSE
ǎéGUòoABMǎeváMZBCthQzBHbPc	FALSE
éITSPhXbúwàsqbZhárǒCFdTdaá	FALSE
èfyFǎlAOàwDàògHhDfMOvRiKmt	FALSE
ěquòsVrRtééBEaujdMoCMVǎóéq	FALSE
òAGCkrmyQkURFCTNeiǎcOjlxkG	FALSE
ǒTyOHKUbQùnSItFTmTsZIǔòkxQ	FALSE
úfedyJuCòOUQDùàDRvZLUéǒsNJ	FALSE
ArlǎQYwNYlhruoWMalhZSpnQCx	FALSE
CàDIfxúwdXtNhjJéjbCàoěutnh	FALSE
DLPfvúgzbJAmFXuZrBúHáúlbVk	FALSE
EnAPǒxúòPqNSwNcdOadrqPXGmC	FALSE
GGbpáǎhWJmrnYsMPsHqzòIyUrà	FALSE
HTwòZlEzóVOAqVSDěBèbXbitZe	FALSE
IgoògUvàcNXrǔkòóVwCúyUgyùf	FALSE
JvórǎpuxgIPǎxqùoAYáQóDUUyò	FALSE
LQUUPSxzFEfqPRDLàǎQnaǔFCok	FALSE
MgzfOsàKldàùùNUhljPznUcJiA	FALSE
OǔYhùMwáEVǎSyhCxfBúofYfdnm	FALSE
PVMódSǎJvVzabEhhmQǔLǎOzéùt	FALSE
QkáaXèdqakóóráèkznúMWfkheM	FALSE
SMaBMǒTIHiGóskAItSoqNhXHàT	FALSE
TlnDIéFaYRevmqháGmIMàóxèUJ	FALSE
VBRoáKhRyyXCGUZàhbsáKetaáY	FALSE
WkDnKqSCàBáěkWNgàáóAWIuMěW	FALSE
YěǔúúWEVèsèkAANWYbǒLFjAGáE	FALSE
ZDJldWFeMúóUNsEHQcpGǎKòǒjS	FALSE
aUoxaoKáDZGrbPDǔuèSGBEqnHO	FALSE
cǔZqGóféipMPFZIJdwQǔYǔàbIǒ	FALSE
dévzxOuOLòNAwáCúěHěUǒrGpǒL	FALSE
eǒPeKǒWWoXoúWànyhOxGhchCǔǔ	FALSE
faàbRAlgJaSqLnkRVKócyRJvPI	FALSE
hùQKQAǎtvcImIcgáDòwǎslJúòn	FALSE
ióXBròéOCáópnàòsOGAQǔèIǎYl	FALSE
jIGhOZpujáKUqEDóhúsOwaZZgá	FALSE
kOeòkTMCuGrYibMyiFǔmHVòKUC	FALSE
lgǎdoěúHàgǒJCéCAbǔBAkWǎuèZ	FALSE
mmQvlovlúNnnucntnòAcLáósVǎ	FALSE
nnàZweXlZzdOhdZúVèězQzDfqQ	FALSE
otftcIóoSCPieYHBNmRùBdùxTo	FALSE
pxòmXcQQQcùbòESYGhjGtSCsFk	FALSE
rEvòEKPWzIhICrAVáfvéGniyHn	FALSE
sOEAjàkècETmZúxWwLhEěiiùpě	FALSE
tYǔfgZHNǒsNǔBèàátzsèfSUòàr	FALSE
upOJfúgxXGaAVziRǎrRpxQEbLc	FALSE
vyOvlǎXKǔAěbaúhHekzBLUEPàT	FALSE
xNaqiěmdWwǎǒGhXRRBLgbGOzUt	FALSE
yZgeùbtcjkEooFniǎCyOLBTvpT	FALSE
ùùaaZSaiXZXzaaaaaePPTxxáNGN	TRUE
ǔQBaaaaaaVgMěeàTàxWoDBBzzvy	TRUE
áfCIoaaUènaaaaaIsYWkóePtǔqs	TRUE
ǎáùUóǔuJlAtǔGatjvEaaaaaaóGY	TRUE
éJZAaaasNzsávtxrnúCàbaaaafé	TRUE
ècRWMwFBùErOGéaaaaaaèQsauǎs	TRUE
óǔOkvYlVeeKuRDFèàrjIaaaaaaI	TRUE
òTEóóetbnaaaatTAábIPnaaakAH	TRUE
úáwOuǎgDDdfmidóyaaaaaaSkptH	TRUE
AclEhǎaaaaaaRcFrHFmsRJyFixá	TRUE
CéVEejámeǎáJgUXNvpaaaaNaaaǒ	TRUE
DKxaSlZNpaaaaaamAmSITSòésIJ	TRUE
ETwèdQaaaaaòOKóSèiMtééhaaYO	TRUE
FoJvkLhksiéPZaaaaaaiéBKluAw	TRUE
HòǎduccmFúBKaaaaaabècóbrBkP	TRUE
IdkPIékcáoNWcDdMpúaaaaaaNEo	TRUE
KòPQWlXYgWRTblMaaaaaaòónáLǎ	TRUE
LVnQǎoVCúPXYCmWfaaaaaaOOGaè	TRUE
MuKrxSSruOaaaaaajRmáJemKQep	TRUE
OCaaaaaaEhwHGVòZúàDfióaKULG	TRUE
PgkGaaaaaaǔánjmcàIACǎiulqóh	TRUE
QvqdNQaaaaXWFaaaOWǔLYjdDKAs	TRUE
SLéIèwrAfuoEǔaaaKojUǎDòaaaa	TRUE
TguZDefClVaaaaaaàòǒMkyouJOx	TRUE
VFkaaaaaaEFDiSBPOǎgyEdèòkǒk	TRUE
WTěhalEkViUaaaaaazóxEDGtWUV	TRUE
XgSRbLoGùéJCKYPváKaaaaaaeáǔ	TRUE
YyPoèBòcDaaaaaaaqngKfZPbuuá	TRUE
aPZaaaJokRTSEúzXOǔhùaaaaèWq	TRUE
aaaaLǔósQFijsATBùnMfKaaavdy	TRUE
aaaaaaNǎZdMgCAěkaBVWgBKtnxk	TRUE
aaaaaoaaiǔCaRxBvHIùfǔEpMòJT	TRUE
aueǔǔCJNkSKèóùnvgEraaaaaadP	TRUE
cUUKúkdCexLúNnuǎaaaarZaaagM	TRUE
dgaaaaaamáayOóǔǎròAnxnLòBFv	TRUE
exòaǒnǒxgMǔAěǔuaaaaaaBQGokn	TRUE
gZNaSPmWHnWoPxEěaaaaaaùǒáay	TRUE
iǔShncgzgkùHaaaaaaVGPǒPMUěd	TRUE
jYúaèàFyFIQòáMCóGsaaaaaazúP	TRUE
ktqaaaaaxAXSBBEǎUjYaaLizmQY	TRUE
màhFUòHgaaaaaaTZòòSGùeifYQB	TRUE
nOóTókUHfAaaaaaaèlóJkgJvgye	TRUE
oxIwMùKǎxIWsRTrKaaaaaasSOaX	TRUE
qWFIcivGkaaaaaaUpěGeWHhBwkk	TRUE
rovVeúDbhfaaatààǔVeaaaaDVGD	TRUE
tǒùhaaaakHèòQRcPzmUaaamQqKW	TRUE
uPǔAnvtRgTmZyQaaaaaagèpcvyC	TRUE
wápzaaaaaajTnBLMiáPkWǎrǎCWc	TRUE
xLAqyòWaaaapXRFOǎEaaǎbhóaax	TRUE
ypFHXsèòaaaaaaQYlHúwYrUDdùv	TRUE
ùùlyTěóXúJòxéááMZKXócòèPJYX	FALSE
ǔOmaunXfYjkfREMLànNdrEGLùgǒ	FALSE
ákǒfNnAàqèpVúxnnǒsǎCWòdRVJU	FALSE
ǎágVxKBèDdqMaOèjǔqǒhianfHǒT	FALSE
éGEěéáoeyWGikJDóHlOBsWkFNap	FALSE
èTòGegqvuwRǔwVcdpwzěIKlěhǔa	FALSE
ěpàqúDǒěmoànwEEeThBzVǔDiQgH	FALSE
òGiSSoncubnftxegqDifyLjxLEJ	FALSE
ǒGlbXBJéàCAwFzúèubùmVǎPúqnb	FALSE
úSFnFǒKaAǎqùbúCǎSVXlBlSǒàsg	FALSE
AeèLùpnrJkDěiWZpwQmtUeCúáól	FALSE
BttFWVIljdzJbRHxiwmrJHYrqèl	FALSE
DCNTLLdktkLBéNMeyCuAPSJQKCG	FALSE
ENArjààsúfKǔǎdalbhPYMgqMgmk	FALSE
FSrSArVibáSygpéqDgVGCFumNvO	FALSE
GkkgEMFóOiwwúúXQfxqTmTǎkámz	FALSE
IáTYOHǔkóMQOlHnxvWèTgzZeèpC	FALSE
JJuògùDòkyháclépAgiIcPábTAq	FALSE
KMydIéǎáfQldynFxěǎFJWdnAsèQ	FALSE
LoiǎèfóqTDǒAnsxkRwǎxHBéXáYL	FALSE
NěZgdúWlLYKozuPgNZPdXàCǎPkè	FALSE
OSZNcFIǎGHqFJZvDYDeFXcděDdH	FALSE
PgnOáAǎǎQZpóoYhòqlMhGááàèCV	FALSE
RóùiJóvòBòHJásmùTKPéòTzBhák	FALSE
ScpsHNdKěGoUxWiIQgDhféQCTJi	FALSE
TtěěkxóégéZmàmBcǔfoWéTǔěRià	FALSE
VAeùPǎxKǔDòegǒLóJěyòMdvUpǎQ	FALSE
WStSFHBFHFUásbGJoSQKóhCvrji	FALSE
XdédǒgfzòDIPSNédpnnUǔǔQúàSu	FALSE
ZùsúCOQumffeTzCásgMznfDgWYV	FALSE
aPàWnAZgèèKMHAxbXPmEǒflEVhJ	FALSE
bbtěVzǒAěDkEèákǎwFMBxroAěJd	FALSE
cqXnqHmádfěMEuiAfToyDYkòBèR	FALSE
ePǔIidjiǎXAóoYtvBNOFvpBZpKZ	FALSE
foqJújVaKXùXǒQrǎZjjXeèVáeéF	FALSE
hěùěúLéZvbPǔUMEAbHXwGcrǎVsP	FALSE
iUBqdpsmSZXONdxAeWéělěgèNkq	FALSE
jióáitFWNfěiWéqúzǔEzCǒXBǔTk	FALSE
kwóBlòzuLTYáYymúǎwpéQZbfIdǒ	FALSE
màEKGZéPZAéoDLUùJqCAbzùvòlz	FALSE
nRàSěQKwTUhZjAcrYáoBáǔSxbma	FALSE
oPYUmNrǒLMAOhXgGUalIihLǒLép	FALSE
pfyoraVJDúgjWKZIǒjjtIàiAnOi	FALSE
rùpuèzEEEKóTbéxiFFsIǒěmvPvf	FALSE
sGaháěáRSòKlwǔlULsYòdfNǎàWi	FALSE
tVěqOHpGǔWtgàOZqxuBPjěwtWqn	FALSE
ucVItLPAYWuWfdědiOàǎHěwǒvCǒ	FALSE
vxàTqnLIZgQurǔObcNjǎpáxatsL	FALSE
xIIǔKsAáJěPoZAoèeYwáCglSHGs	FALSE
yaKfQeoàYHǎKFDòXYwNǎáNqòǎaz	FALSE
ùùiaazMakwJaaaaapVAHrJyěDpTj	TRUE
ǔNaaǎéáaùBTFhEzaaaaaYéFpcitg	TRUE
átvǔsXaaaaaaQǎVPqMBoNwrSSmǔP	TRUE
ǎDexgAXèWaaaaalaaGSfwègiràvd	TRUE
ébécTPpwTZiAǒéQLgQuvǔaaaaaaH	TRUE
ènOxRGǒCWWzgjvAUàRiaaaqWaaaa	TRUE
óCvaakbjhQCaaaaaCǎnglTǒxhUFo	TRUE
òOúMuùiJmJbXIPZzǒsDfrpaaaaaa	TRUE
ǒdcaGnJgYaaaaaúVMHfaawywèUtK	TRUE
úsJaaaaaěcGgóIYdpBrRLóvxaaiA	TRUE
BOXcpaaaaaaKwǔLǒúziáTùoǔéKph	TRUE
CrèYGěWómMǎadKZQuvJulaaaaaai	TRUE
EJgdǎYptǔwaaaaaVKAGIIeObkCaa	TRUE
FYMúHǒOgxeábXtqaagfùSaaaaaPg	TRUE
GmoaakGcuaaaaaQèòYnbZIoeANúZ	TRUE
HkwoZaRCuyZqOáYkaaaaaaUXáUpY	TRUE
JBvzsáYéUIsvDYaaaaaaflEixFóv	TRUE
KeaaaaaaázEwAyZinùdgOUúUFtWs	TRUE
LoaaaaaaSIPrWoCJaNǒKuZJtǎFcě	TRUE
MzěhěáùxEaaaaaaǎYóXIǔIàlTmaR	TRUE
OóPLDxaaaaóùòXoMCòAEnávaaaIǎ	TRUE
PVzGORJyǔbDjDMékàaaaaaaTùéjc	TRUE
QuJjUTKGaaaaaaóèWúwyǎoPdHsMp	TRUE
SǒAvaaaaaaDELhácmWRAàvAfeYúB	TRUE
TNùGóYnUSquQaaaaaaQqcwdsjxiV	TRUE
UnUuměewaIPYqěèqrTrmaaaaaaHh	TRUE
WAoOvPgVwǒóaawpNǎyVǒkGqaaaaa	TRUE
XgPǒpkUfaaaKTáǔjàáfèqOaaaaNL	TRUE
ZAáDZXTǔǔaaaaaaéeJUOBLVSTawa	TRUE
aYNTòKgLNhIxAfHbǒyUGwaaaaaaM	TRUE
aaaaaIigaaǒbèJsDHòfcóhUtoLai	TRUE
aaaaaagòXkWvlErLUCQPzLOuxzlU	TRUE
aaatxújJnOaaaaJPòRǎUvólnúTrF	TRUE
baaaaaaZuzuciqKdduiZRLzAàBrd	TRUE
dòveěAtUfaXeQktpomxgaaaaaaxQ	TRUE
edHúeákZEqóeraaaaaaUykWsyèOl	TRUE
gàEphJǔtóriqsarxuUcaaaaaaòNN	TRUE
haaaaaaàazZàFóxzdtàcpaúUièúG	TRUE
jǎZrpnmepàaaIDàojYlfaaaaagRá	TRUE
kaaaaASLypMQFVHǔDèSúóAgSaaaW	TRUE
mǒECkqùercIVbNBsaaaaaavjvlGD	TRUE
nKbUdzCaaaaaapéqQLBéPvzCBSlè	TRUE
oiTZtQPhaaaaaabEǔáQaátpXalKg	TRUE
qáMùcaWaaaagdèxzRzDéEǔzhaaac	TRUE
rNxvPtòTǒtWǎHJáPàaaaQZhvaaaa	TRUE
suqGBysòyeUèjaaaaaaxXkàpJqcl	TRUE
uKzamiǔFOOSǎfvkJXKěaaaaaaùIe	TRUE
vaaaaaaEòoALucáVpqěmqxVnPtjB	TRUE
xǎflZHpUHèfoaaaaBěaaavěgúifV	TRUE
yRzòFsùfDMznkǎòmKaaaaaawlvBE	TRUE
ùùàTLkóiFjòǒpǒLoIocOvbaǎéqCY	FALSE
ǔFSměfOeFBbHUúòUǎOǒZAaWLyòtc	FALSE
ábDeòFpySavDoIěJéLRáoWzRIrSL	FALSE
àuJrgBkàyQaEǒKěMJkgzrhTUPSUé	FALSE
éàéaHqrXmiǔCOrTyQBFsnéPhóébf	FALSE
èěFZiàěgfEdUhPáéZirzmBwpběWR	FALSE
ěWKaáDBVeVFJkǔkgówwLóxZóànxK	FALSE
óhKTqǔèiWEsyXioěǒMhFOlJAPFlá	FALSE
òxUXàLràzJfAnǔNBèCYùTyáIMéVd	FALSE
úJúòklourěEMsPkRǒMhSàZVPSObp	FALSE
AflAúòuVmIJfQGntáNfBTeZyosSy	FALSE
BpqHImùUkaùpjYIDMnòvCiuySLpá	FALSE
CxlgdnéXeCǔvnQuǔSvuhsnTvqmfq	FALSE
EOnyBVrZǒsBéDiFPktMzpmZTyLPh	FALSE
FhDànRZdChmewKǎZGvmCZòlXMPdc	FALSE
HùàKqJtbTPhóeúQléYAcJxstSbMq	FALSE
ISVDApéKHáIuúzeàǎHVǒCkPéFqJK	FALSE
JfrcjZusuUKúOàqvHBLvwiwqóéFb	FALSE
LàééPvFNIJPCPhmFxWCaùAkpuhyy	FALSE
MDgEfáDNábbéyùpfnèwQqwiDvjSC	FALSE
NVXXKPZcIEiZWǒyDXhLstnóèRelO	FALSE
OswcaòWǎǎfybǒJjDUNKpXopJODZg	FALSE
QLgkkEjkěèèOAékUaXbǎáUùFAǔué	FALSE
RlráǒOTHpǒxózLGgttdahwbDWásf	FALSE
TǎrěVògZhòMfdAgjwéiTEXubljùF	FALSE
UJCaywǒiǔZěsNTzcPmoEQyǒóèBùN	FALSE
VWǎDmJgWMnhbgeJEvǔnǒǒIeǎTBEM	FALSE
WxwfkppYLfpTobèYrKwPsMQwMvTa	FALSE
YéYéqvKxTocsobqVDbkGéjmdvAms	FALSE
ZEéPJCèwáJZèálzóCàEguckHSwěv	FALSE
aXgbvaSbàAxmcukběLmIuTjèábág	FALSE
bnJTHpgYinhJTVktùóeláhCéKJUú	FALSE
dǎToOMIiactùHùvyQiǎxXltàLzog	FALSE
eEiPYBlPWXEbBěcsYKOVYǒFTtcgC	FALSE
fJqaukXrPLzuaGHààSpqIěOGáaǒJ	FALSE
gWaaǒuǒXbcúrěěaRòbbzTdúfmhVf	FALSE
hrèǔbCùkNlcAǔboXTuǎPócKgNKèv	FALSE
izkbEXcNPXùàHCKPeDvrJAFXmljě	FALSE
kBWFnGXBJfxAZéXlRTHMOkfKDwǎU	FALSE
lcTiòLhAbuCúsXsljquOúzIjYrùQ	FALSE
nàěvdtúVǒěJàrbLúkǔvmPSúKUdFu	FALSE
oUFMXǒnééEòBlqZSAtpàgYoǒpHhN	FALSE
pkǔyAfvIǔirfgAòOWZRhlznLtEoJ	FALSE
qpUèiivwrcBFióCtoKTDóJubsVLy	FALSE
rshDsWhdeHNtgfǎQébxnRGóSeáNS	FALSE
tBUvifjáTFCdkktRZRǔóXxnYythú	FALSE
uarQXtszCùFqPKpcvàJùIEKAǒǒCó	FALSE
wùkckKYovéXOáWMgakBvOXvJEágq	FALSE
xBWRlékBòWPFgTùYJTǒpǎTbxùyaL	FALSE
ybWiPJpóúHMbBxěxQPhlOměMeweT	FALSE
ùùùaaaaFMXhlCKrTnaaabDéqáoèKě	TRUE
ǔaMfeTnaaaRiNCeARepaaaaTSrjfu	TRUE
ávéAtHceéJěLEvmòSvWsaaaaaaěòà	TRUE
ǎFkzVnKaaLnòUtFaaaaaNuywtmweG	TRUE
édtFQIàIAXaaaUùJDòaaaaKòDLibv	TRUE
èyRkRTUnKIèěZqFjaaaaaaétxLiPé	TRUE
óRaaúaóPlmaaaaaóènTZagWeAJWUf	TRUE
òjaaaaaabOùOǒǒOMaOǔáoqGrHhKRY	TRUE
úúwnèulrwéyaaaaaaneIcPóǎàmOěG	TRUE
AXgaaaPàéPéKYOxgSyFHBaayYVaaa	TRUE
BdolSutaaaǒPòǒrkáaaaaZúóěèzóY	TRUE
DǎsYóktRuǔǒaaaaaaANoOejSfPMnT	TRUE
EaaaalDaaùdǎyrcwǒcReaaeLoyǒrT	TRUE
FqVfǒSiroEvKtTCeVGedaaaaaaVBV	TRUE
HǎoSAoFJZKGjcQóaaaaaaLǔmMúǎxK	TRUE
IDékIZeXpMùǔYLnaaaǎjMLbUhaaaa	TRUE
JfHaPaaóMskOěEjQaaaaLéaaWNufh	TRUE
LèIaaaYuwISàúaaaaàògyAòQIMBNǒ	TRUE
MlQsUMCXaaaoAǎhVùcTJgHywaaaaj	TRUE
ONèaaaaaaóLǎJǔmIábfùlHSédqrmA	TRUE
PaaaaaaXNáADnBáǔspQnWKAUMúùFs	TRUE
RCbyhbyǒàǒsIaaaaaaUùhdáJévěSf	TRUE
SRgàNHDóǎòrIjèúaùKMZaaaaaapZx	TRUE
TcgTRéDpáàLiLǎnLaaaabúTlhaaat	TRUE
VCykědjTfZNsANTSBSoZyaaaaaaěo	TRUE
WWéaaaaaaPdǎpólreGhaVzIrykChK	TRUE
XuoTDjùěWaaaaaaprAOpéAxxBhRFv	TRUE
ZBKSoòdaaEsòyǔllfaaaaagNwWHsǔ	TRUE
aPQiKvbKJdhzOgGqaaaaFMoFVaaaf	TRUE
aaaaOMKaaWlxènjFLèǔCIaavǎAPmO	TRUE
aaaaaaVuNǒUsDzIúxUTVtAJvYbJid	TRUE
aaakqHpXgOGjáWgujHáùtfùaaaanǔ	TRUE
baaIQchTàlwdaaaaafoqDUpxpMěqM	TRUE
dóWCMffPsrLYúOaaaaQFaaaOihSgp	TRUE
eaaaaaaSúiQxFáBHnwspMimàWQhmà	TRUE
foùBZoOúAáèaaaaaacUhlywEǎHdEu	TRUE
húvgóórdHǒskaaaaaaLArmJrǒJBCj	TRUE
ieaaaaaoóGnaaZěFgkkǔZSMesǔBPw	TRUE
kàéOùDóPYhòKcsGgbDGfaaaaaáqaa	TRUE
lRuuKǒXXbaaDwjréfyImrZrRaaaaa	TRUE
mmNcaaaaaaueRvtVcNgóàmZGEzkCJ	TRUE
oájhhúǎuGjaaaaaaeótNgBěǎzYbuu	TRUE
pMàqǒěaNOǔaaaaaǒoǎdFeàrqutaat	TRUE
qQgoLTMFxéaaaaaaXùudkDvbzfUEb	TRUE
sǎsaáùcàòUXqWǎǎEUsaaaaaaaXTWy	TRUE
tOXsjYMaaNhockdlòSUaaaaaDCnǎR	TRUE
uWBqqFVVraAxaaagKYáaaaaTZbEqR	TRUE
vkcZLHmcúspIbǎSXaqMaaaaaaALOz	TRUE
xòUKAtURrdKèaaaaaajVVgIcǒfúfg	TRUE
yQSAúwqFDkěraaaaaaKěpLùjòSlgq	TRUE
ùùǒkJzóóǒRBIàbfàPfEqtwsErUàóu	FALSE
ǔLmcpPWǒzzCHúGBGekoéYwUFqáAxu	FALSE
álESaeNùacéHcstBVxEǎaQèwOlèMl	FALSE
àtKCKéytzMlKójzMfwèGrSwhEIjQé	FALSE
éDQvSQdèLPEBdeQǔBYùaAoqǎBèúiǔ	FALSE
èYTáBWxAvbtǔXQNisXwAèLguUhvsM	FALSE
ětúBéVoyRdWvzXDjgOYpOIRděcJcR	FALSE
òOinWlKJAfULéùLhǒEafDQmàPǎvgJ	FALSE
ǒeUpRlNèIòYwLkVóúagTMszěfléth	FALSE
AùxYémyrWfMqéóQhònNZzrvpzǎhsá	FALSE
BǒUjbrNzUtOAMùWUgLcěǔlùDdgǒeh	FALSE
CMHgaxzyfruóǒàGDMOFyfúùOnRlHa	FALSE
DfClQOkXKáqUYWFcEnèIQSrmzeLHn	FALSE
EpòJZcfGCéYxBYuDsOlUAjRYmVVlR	FALSE
FxVòWònPCQGUJxTXúáSòAsVTtwKIk	FALSE
GwEQqivúepXùǎkQAùmùTXěrJSbàhà	FALSE
IRhLCvgGiHoDǎpkúpXwYxVUoXXǒMt	FALSE
JojDnrFfiǒmVqvóEvhIYóHrǒwèRPh	FALSE
KywùfAfQvǒAhdhPrǎJQděxùsSWùVU	FALSE
MIcUècIhnǔNiYVwRvQǒKuskpègYiǒ	FALSE
NbpjědoaHFòúveNaNùlCvvsǒzHDXV	FALSE
OtZUfòéòALrTYntMamaéRWHsàùéXS	FALSE
PzpKfteaènèHqGoDhWkěVxfgǒcBuK	FALSE
RúTzfSJyèvYSZKLcAGFAfzzDCJgwN	FALSE
SRIzWjdQòhdCCMYbDWryPYEèáWBeá	FALSE
TfRsloiWǒwúnfúèFeòtSǔUOwuOTGH	FALSE
UwwhHJziHBwèǒnYFqNlznxRnrgvzH	FALSE
WAzèpsESHGǒPcpscKWemCHèèxlHàX	FALSE
XOàntdikQkYYYGmsiǎáúfOkáFóiéW	FALSE
YjXèXàprXFgqpKcIYHoPLVNuvkòZd	FALSE
ZypcáiSJEVApdèǔèzPsEdéLjhyYěF	FALSE
bIXéGJHNEOútteXHkaeQFMSHzómTG	FALSE
caáunxENùjdǔJpsPOVgUHEiXCxDKk	FALSE
djIUqhéfdhézveqěoJtSrǔsúhǎééR	FALSE
fòmmǔěáězNJHurvcMVzaIǎTJdhFVò	FALSE
gKúaùěkxTrúGYpNààmKhKúIStJědj	FALSE
hgNXmHdemǔfúyJǔpjcxsfQRnǒEsCá	FALSE
jǔxriùAkSxióòNRòǎQnWrZésDVQBc	FALSE
kóMaHùvYòCVmnúyceIDènWjiǔLInǒ	FALSE
lMczayhèsòtDókùǔvCReMRawEwAǎQ	FALSE
msaRehYJúBGFjEhoǔNPwKrPPBúJEj	FALSE
oCkùOvqHmhXoòGbuodwòNZǎèaYLQQ	FALSE
pfZiYpBgmezaěWxLǒwHáèhExbxǎQr	FALSE
qsǒnvǎZAfDVuLKsLKXQEGIURrùqSl	FALSE
sébiéuqQBmJbmFzQneLEKsIcYVLZù	FALSE
tPèKdUgpywxIéMédáiKùhjaǔTdóYB	FALSE
upuJěwfpjásAGsLéuKvMwUTěQUúMK	FALSE
wáVQgjYBhSBynwjéǒVǒxùJhdSudǒv	FALSE
xPnátòǔóvbUáeuAPǒǎǎYáěKlnOZLA	FALSE
yqKdcIǎGqyěxěwěriiuCUTxQMAXhg	FALSE
