aùùJèCVpèCzcRFhaaFrywbaawòMOSlG	TRUE
aáWnǔaàJdagBtcNùOcaavzúTqzkúaau	TRUE
aécMqdCzTNZLIrCnTYWnaaùjTzóǒaaw	TRUE
aóKsqubcéiàùébǔZcxdóaaaaQrZjàUW	TRUE
aúcbaaòzPNBaazfzǒyILEnKvBRfǎoDZ	TRUE
aCàQZgWěfǎtUPcZBnLUIuaaibaanUty	TRUE
aEcaaǎkjóměKfXglAgNbWrAaamcàKck	TRUE
aHcUNówùáězLlaaNAYUvěotgraatàXè	TRUE
aKTHMxzcERGXfxFkaafYùiLeHkiNaaó	TRUE
aNKrQKNèzmPTNgghhcaarpdyRoùòuaa	TRUE
aQorAYcéGIémYaasǎzaUéáqEǎChkaaú	TRUE
aTRBErHěuClcSRvòkaaaauqFjùaàǒrz	TRUE
aVyTncqOLaUnmvfAǒEVxqáaaaavyDjc	TRUE
aYhvOckoàEYRtNwàsvlTMaakqaaaDWi	TRUE
abOcaMnwxzfzPteElaaèyQaaóùbvuDy	TRUE
acKQXWUjaFfèàedéLfRTraaRjǎQhèaa	TRUE
acdǔùEQóaaUpYaaùFLDaRUyPVtqtjòw	TRUE
aczaaeQXoWiNgyJǔxvQVacSenaaCNnk	TRUE
agémXáǎAQBcMHtàuXGùécyDaaaaáogT	TRUE
ajHzWiknScfAèGàFiaabCEaaóyGnǔll	TRUE
amékfcaaaaouGkboOùhyOǔlUqǔZXeTW	TRUE
aotròyMúAcJHtyaajèeaaófBbúǔwqfo	TRUE
arpWeǔSRcUaaeéKWněeéaaMáBMjáóLò	TRUE
aucOQKYSfEIHIXtAàóaaVNaailLHhUP	TRUE
axSIcrKOkTHaazùbǒèaQaaèàAlAgLyy	TRUE
ùùWXúeyFATjeFNBpTpKMàttqòWueEmc	FALSE
áVGpáàqSRslàxBúnVEèzǔóZOaèhAnQF	FALSE
éóTMTufzMJaGWUzWéwNnBaIàezZLiNZ	FALSE
ěidsmwúZYàajQQQǎbTdNkVwzXqòoOsJ	FALSE
ǒSzEXUBéoáǎUǒvoHgPápnùTbduùfFNH	FALSE
BúFHéAGxMyfqbnùjNAXOàěkFóaYZóǎe	FALSE
EǒǒéLgOěsAjdUdPATHráyáEpàóptònA	FALSE
GsPzúxéNaSǔǒSòǒQsFjTxyùuùùRkafB	FALSE
JěǎyChTRblFzOèsbZbLewAráPúWbǎBM	FALSE
LYZpEBQMdóybLlEUUwijVHXMTjWfqdR	FALSE
ODèFRqygrmòcsáRqZùùNwáVqExaXqèK	FALSE
RùRNYuCúúHAùòtǒYMègKJURfHǒàǒVFA	FALSE
TEiWiRǒPJkǎkgVxPOfDbYátGFXlRkyx	FALSE
VVǎóBǎwèUGkKsdOǒoIùXpWUàgQuwǒlà	FALSE
YàsSRlwUmùPáIFóZhHaóeNEIǔǒwtMSr	FALSE
aPkPdǔtKzròPgfrNRfpwsfgKDeDòBǔG	FALSE
dGJkóèǔùwPHryNArCǒrlTYQvDNIèǔrM	FALSE
fVfqtEěGXQùLóVGBVQóuOdxéAZcYIJá	FALSE
htǒùhǔóBCGHàoHCGevYWòkKWCFúBJlW	FALSE
kBrKaIhPjvaHyOItàHXbWǒgRyúZxHNI	FALSE
něQvzAZqvmqdeYàgGQuěHàYqúXoIiJR	FALSE
pnuJTLiVTMǔSúǎIlHNsǔEefWnaFéùWz	FALSE
sǎěwRzXYbdHsQcQùqEapgDBSZmDàXNM	FALSE
uchrnqèròlYyiěfYaixWwěǎamIpRFCm	FALSE
xBǒUóLNSaěǒrkMHúBsGlRoOdǒsHKkZI	FALSE
aùǔǒǒBucúDaawZaaZqZràělUNJOSrJùN	TRUE
aàrcesùFLiWtaaěDaxwóěJCLaaqǎúNbú	TRUE
aěáIWòéRZIGǎHywàcqmPQsòaadlaaǎrM	TRUE
aòvwcTuKùéJwmiǎIgòkGEVòyaaxaaěqV	TRUE
aAZVgàmOjYMCkcaaxMGátPúDbaBQgUaa	TRUE
aDRcSúàóaaaàsSdgoókcúKaapúWWàǒiE	TRUE
aGMócIWUáèdaalPBahùXèfaaZykCwEVn	TRUE
aJGBAqéRKSXnEaSúlòCcZaayULUhaaXr	TRUE
aMLpmgcRCCOěBeóùèlXTaQWqaaNYaaOn	TRUE
aPúǔkcOófzseNǔúaaezgGGzvegqPFaaǒ	TRUE
aSèùZiǔZFcòaúBgfdnEuQàUqaaWòòaah	TRUE
aUXzdwcATqéXJoàcSaYMpúSIpáfaaUaa	TRUE
aXbòRUJǎQHXviècMaaFUéEJéaaiOuyǔQ	TRUE
aabtoYpǎmtMseùcqfalǒXRJDaaGcGvaa	TRUE
acòUpqolOěpXDaaEDNěaaZtkYdTfoòDe	TRUE
acUaaDWtRbzàHJlcvBYxovSPaaJdZQKb	TRUE
ackplBWpǒKǒAcGfònEyADPaaaaaSPǒǒó	TRUE
aeADceUBòCǔVWUHUaaJcPóòzáFLnkaaT	TRUE
agyxLVjEYcpvkaaùaaAYvMuWxWdhèCóW	TRUE
ajbdXtéOàNgCctKZJJèwJVusNáaaglaa	TRUE
alnGbLkcRòaaIKZǎRUfwHpárǎrHJRtaa	TRUE
aozcIraDéǔèjùDàkKaaVvGyVplWDBaai	TRUE
arVǒěRVQfncòPàTPmVoJóSòvTWNkaaaa	TRUE
auLZtcěgsuǎEUàYkaaSaaSIǒvàEcudte	TRUE
axJsTmáKEcACaaqjěNYbzciraasùéKeV	TRUE
ùùWQmNATtújóbXpSUòLpUbpòFǒaTWSer	FALSE
áglMRdSzáHmOKhèǎókwCXfJegFVǔtvyA	FALSE
éFeTvgfrKdKwzWWohUUTBIIeqpuTNpPù	FALSE
ěSmVjGvóFMǔmùǎoUawSǒcNCBVHebvVAJ	FALSE
òsHrSòDǔYáWGYqlùYCQEjólfPTzàlorp	FALSE
AtwBǔěcYVáxHéEZGPKksXudúPmMBDQEv	FALSE
DǔNQLbsèkIězvSsuéénlRpSlaRRRSóTr	FALSE
FěmsǎvSMhopsZkPELOGcfqéXPXANsBGK	FALSE
HkélEDWúúQjDUùJqDLěàóaYmgLuǎmǎFg	FALSE
KáDLgàLěùóézurtbòQVFEnépZěqǒYàZé	FALSE
MxUdFǒèaICékólYáJúrRkJbGǎxhtAvWò	FALSE
PàfUáèDRubSveFWfOèUǒcNEaértUOeIY	FALSE
RtárJfHWàztguòODǔJEmDěJxpLpStehl	FALSE
UgQIùYfsifYSǒapKáKgomǔYzVáKyBvQC	FALSE
XúKTHéqěǒóYckjXOYPùqYDrǒèvXózàSz	FALSE
aDǒěhXfGzZHbLEěcLfqzěmYqsàmGKéWǒ	FALSE
cXNXéjMKfOdBóvaXHDDeTMXèVtLNqèàF	FALSE
fSHKbèbDIéhdrSUPLmTHtCawáèLUdWjM	FALSE
iěàpjrkrryaNUUúGINxHòWeǒRRǎPgivS	FALSE
kbvaBPcQBqVjLGLAóUGGpbǒǎeQartqWd	FALSE
mtúOfMHwǎqwSPěǔwfMùLyúUSxrrJPvǎe	FALSE
phdytaXrVóárnOqKvFúùouúzkuRGáVnU	FALSE
sUBoFAàqdújbCVqěKQuVǒàSWFDpEfǒhY	FALSE
ubpNǎOùiqKUhvCáPFgKssyiBOǎlxèTnF	FALSE
xJóǔDDFéoǔǎhOYjKfócGwHEWaFmJèKlL	FALSE
aùàCcOěNtóKgáYSaatěcǒmnvpǔMbmaaPZ	TRUE
aáwcèQsmáèQYzATpXSqyNFGáùoaaDPSaa	TRUE
aékóZYICBQòicyaahùqnGěúègǎhTMlaaE	TRUE
aócléUzéěsoTóǔIIEBWaakeaaYxòlǎTVl	TRUE
aúbLěPxDùXezZcIHkóAǔJWKaaDhRGvaaI	TRUE
aCánWàòjcJúLaaqlaaxòSfrCóNHQKWQLM	TRUE
aEqòáuqaǒácAwcùùǎDNspsaaoócDaasjb	TRUE
aHaknTLwcPùcDVóaaQerǎIXjmsjaavEbL	TRUE
aKáòùWtcMbAòyVPěUjRaaSlzaaaVcOpBg	TRUE
aMcaaǔaPéSáàzxaaàǎoiIsWoyJPUběPIé	TRUE
aPKeUJRzvVěéEifPvUàcaaxGqéváxǒaaM	TRUE
aSùàniFPbcAmaafǒdaapDIbLdQmEaANKA	TRUE
aUxKcJsSqWTWInnHrRZWmaadRXZWSaaOI	TRUE
aXcgóaaGqXzǔtruǔBáǔDEFbgnròEAAtaa	TRUE
aaJóOlUpMTcqéCCTQùRUaaaapthWèòkMe	TRUE
acóXeǎrhaayHYhYcTXVWsaaxǔKUzùòJLH	TRUE
acWmzHaaFkgDeaaǔarbFxwrgěQjQtFvMs	TRUE
actGRUKóèrUmAaasróaaroèQoeIàxǒzùu	TRUE
afóAvyctrbJSePQeaasěgHǔǒgkjFèaadǔ	TRUE
ahacàaEùaaykOHǎrùmaaxXSSLORANkxYA	TRUE
akGǒòlylcRyDtàRPluùǔóaaǒaaMǎIXuAU	TRUE
anKúèfěQAhRlztIbCqvcraaMBòaaǒfsBl	TRUE
aqócVMeSkMaauáTMOKYúaaJljeDRèBǒEF	TRUE
atKHOyXjúcBnJwèěBnNùaaúhclDXóaalg	TRUE
axàTcwaaAwBéZRthstFUOsaavvCiKoàeN	TRUE
ùǔEǎCNwàóǎNIóòssOYpkKVWóCVǎyBHkkG	FALSE
àùxǒlDdgTbESdsxqSCǔéBkǔYsSNzMHeàv	FALSE
éRLktNguQhmóZǒAfDuDfaolàùeojǎELéé	FALSE
óScWZYMúsvwǎDvóZéOnZGbnoLeqAmZoIb	FALSE
úàKWúhPlSuJQcrUcxbrǒeotXtéNVvAUěD	FALSE
BQùjroWvOúRAagRaOáKgyqúrYěikyfrbg	FALSE
DLfzCònWsrmNǎeEfSRYóNkqGEmLoqáMSa	FALSE
FrRZàèUHSAMOlavAEǎátfkJrExcePěkFw	FALSE
IǎRǔfUwúóSfMUZiZTtálXRyCOIGLFTùZb	FALSE
KrKbKWFcNkDěeDkGrsYéEFGVùmqXǎaofp	FALSE
NLǒàZǒKeònèúIXěVvGgMKFJVFEvǒwZaVa	FALSE
QHYèèBkmLuXCWIQNWJPóSKàěuKuèTEbiù	FALSE
SkùoobJuyCbPuaǒBJǔarpyoflaQiQbùàD	FALSE
UirtbHLBràSUyǎtúDhrDfRNOXǒwòvedǔǎ	FALSE
XOmaXlKcgZhsrǔoZóǔjOSODfntwaDzQaF	FALSE
aaGcJúcpjmzjHéNfǔzdiYèFOrěJiNpZii	FALSE
dBóPǔfBKyuéLAZáLwZèvásWnúIqǔHLehN	FALSE
fuěpmEYYhWBrhFaEbTěLéjZrNgEAAjaWQ	FALSE
iqgCprLèFrPQǔCHoSmǔNjRúBeGLHǔVAlH	FALSE
kmtGrrHóUlKkOIUOlèJbǎZèXAjexDúàiá	FALSE
nKuKDBnztbaUIbáUvěnoxClQbǎXǒxKùúV	FALSE
prcIèKoFóáréiWksyHdTbgéWàHNérSOTT	FALSE
scgbolzěàúnIYLfIYIèáàjKMXàxáhRKxl	FALSE
vèSJèqúqěùKéqBOéKsrOpBkjLnlúǎWwqé	FALSE
xlóIQǎNuUTáATlsMgkěmAoahhyrpYTěeT	FALSE
aùǔXěcwCaVuuCQhQUKuKYeaaefXHBaaNbE	TRUE
aàBòcedvcUKrrClWaabkqKèfèRrwmaaAbD	TRUE
aéqkMPNQocaaǎSópaaMùqnJèúnDFXRqKNd	TRUE
aóxCèzǔMósEHnQpYXDǒVQcuaaJaaNdDLàT	TRUE
aúsěWQǎUAOoPcaaThbzmàòBjfèvasWgaaL	TRUE
aCQjtáhchXlBcpjzsěnwYCCaaorjEhnaaQ	TRUE
aFcvǎIlàHmRCRqYwNXJcjhǔuaagUviUIaa	TRUE
aICcZyCYaaàqfnwěgYZaajZóxZwzUVjTGù	TRUE
aKcrǎómIgNFyTmENRvKyqaaaaOIúcrVysd	TRUE
aNcBkWOaajóaaGsIbybLJAZùǒiBgAèxRre	TRUE
aQAóHlMIcúdǔMyRòbKIǒmHèùiUVdǔaaaaA	TRUE
aTFòFHQCeUNùùcliDVèGùpFaaZúVGLoaaC	TRUE
aVfEPfáDHBHwpQYeNcaakuǒZǔtaacqEbUU	TRUE
aYMùXvTUeéZUhrsMáKDlùFcùkbYQaaBlaa	TRUE
abágVkgeǎYǔnàXóLhAcTaaóěXaaǒvJùtiá	TRUE
acDHLMDǒZxgrFdZIKpóCùAoópBòáVaaqaa	TRUE
acciuEùmqněJmPsEqaaiqeaaGvNyTǎWwXY	TRUE
adBhKwKoòQMsùScaaObJèǎwqYaaòadEòèu	TRUE
agBòRDGEmYOScAtǎaalqASěaauXòbRfDúK	TRUE
ajáipBagGYjVpùclPAsǎkaaCFIpǎvTùlaa	TRUE
amOLcAXCNèUèaTRgOGaaiTěàqèaaféúqOR	TRUE
aobaáRHhuZTsǒèHGcǎqOcaaNiroaaóúXnM	TRUE
arěRuVHtsswcnZJěóVndzaaaaDotvYGvCR	TRUE
auǎwWKKXVǎeLcojvápaaWZcǔèniaaVVmCu	TRUE
awylchaadzicRVBàSàMyěFqaapcTfMóZFt	TRUE
ùèfǎuǎiàKuJcǎǔèRdcpoeiHKáuFuklGRǔc	FALSE
áaèǎrbwboEtVyuPrǒǎWgPMqKàǎzázgScúě	FALSE
éFoDTgLǔěWcNwOZZFqéRTěèeDǎhoáVgTkǎ	FALSE
ěnzKXrHHfUTMùóVáFeSMFóFǒósówRénSèl	FALSE
òzzEdGèUǎuascmaiNWfUTwGǎhSAKàWfPgi	FALSE
AMeǎIUàZLékKrzwgólKyFKOBKcFèckpozG	FALSE
CdvrTIGàlpzSLǔqiáěBzFoóEàkǎRnXZoqu	FALSE
FòQpjawvóéJǎnGXSEJGFsMHDzǒúHeNTUog	FALSE
HiáiZǔBTèóEáyúdQmNeTUòNuIVSZchfjfF	FALSE
KGěSgVjdoclHkǔiùBDLuhbòdMUvaGěVDGd	FALSE
NAàóEIèPYuWrQFǎǒǔJGUjVrǒúGOJKqKògǔ	FALSE
PLgóadcLAóònFxosIfěqVSdùáàtmǎàhOUu	FALSE
RUFwàúdEdEgjxLOSOsdFJBxòKWàdEViRDA	FALSE
UJJQgmùoWAMOSGDZiwéRtǒAYrtQgUVERěǒ	FALSE
WtǒwvvsnvqóIkQlǔérhuǎKcMBpbPxcADSI	FALSE
ZéuEéǔrCazaéFvTbXXXRěVItNOnúkòtlLm	FALSE
bXǔYQěVqláOtnicxxěfdyeéǎVPWbZEǒVoR	FALSE
eUèBDtLxfIǔùiisòámHIǒgeèSyrHAěpcPz	FALSE
gwmfgòZCCbwiaHdAUiAiTAvVTtáNAòúEzc	FALSE
jSèNhDFiVfórxdǔKǔbqNweǔúAxazòIhVǒX	FALSE
mCgzàPKàDCrETòeaKǎGòooxfrXgBexXyts	FALSE
otHeKWcLqwbJhncǔIxxúIyGǎMNMdèPJúhè	FALSE
rneǒùààtSImxXéPSHKRúhMqGgúTèěKeXZi	FALSE
uVlevOvENqǒORxuYdqRLOBTohicǒméòZzm	FALSE
xòPfǎzeDèEfǔqHtèeKSbFaázZyǎsGàùNRv	FALSE
aùùaJnBEwUcgǔěOJpJrWNBaaaaaXǎXYěAjg	TRUE
aájxúisyxúYVgcvRXvaaEzLàAgǔǎybaauxC	TRUE
aéYuáusVáQSZHzěcaBKFRFAhDwHaaOIecaa	TRUE
aócmxaaùòqWGMqqFLéfówzScrùóaaXkRisj	TRUE
aúYfHǔǎEMSDjcaateMǒěenaauóJǎgJGàǒpU	TRUE
aCBhsXKcrjdùBpàlpǒLAaaaNgoZnXUwZaaC	TRUE
aFbcdaaòdaamcěkézDTàRuVNóynàKXpSòbǔ	TRUE
aIJWvVRJǎbCrǎHQWUBFuciTuRiǔaanaaMpm	TRUE
aLFcyPGalQSFgsVgFWlhgyaaKLEwCrZokaa	TRUE
aNcAsásfpKóeGoYuaaǎrQWbFnrhóxVeaaHL	TRUE
aQFTdáKJVcOdnéHǔyGcBGǎaaàRBWǎaaGèSV	TRUE
aTRhholǔrǔrtòMcsykhOaaCSéáVvnijaaǒv	TRUE
aVxUoáPǔPpgBHobDJkBjjwiwKúcQBFaaaav	TRUE
aZǔqBdccbaaǒvúWbqXvPhǎWNWqrholaaLkě	TRUE
abQKqcǔCAdǒEOtaaosjGVJwOuèaaqJHAplh	TRUE
acDaapèaanQZApAzaFOIQQóùJvQpxWNRùVx	TRUE
acbcáwúzkWONwbǔCXyZzrImYaaSjěaanJDé	TRUE
adOákmáènyfùéúYYcVǒlhNiaaaaòáAPúNSW	TRUE
afriaAKcTcòǔTaakZěRRmHoǎIaactfWbTdE	TRUE
ajéMùràpoVcaaàOGTùDXDaakgoóJcNVyàaq	TRUE
amèáJpǎYcRdyJóJXèBǎQyhLúaaBaaFAcKnf	TRUE
apǔctIDOúaysèoaaNǔùrtojbQeLXddraaUě	TRUE
arlAYGMwXámǎásrcěyFaaXkNaaěHazhOxjZ	TRUE
aubtAùdGzycJJzUèaalbBfaahJòùùdsHHLǒ	TRUE
axHbnVáènùzUxnnhcǒSWúěgjuMaaEbPiaaU	TRUE
ùàXOboAàKzoèWrǒXzQNjhXǒszCqcVpjèCèg	FALSE
áVccbIxCdHYvéEZTXyùTazQFTOPápdǎphfù	FALSE
éEUǔyǒHéiòhǒVKěXiVdnyRjpJPlnOSThBàO	FALSE
ěemBOCEèógZJXòsPireúòqwbǎjZNckxAjQc	FALSE
ǒéjYAuogAvVnoBBzADIiimùuànúigErgblD	FALSE
AVQǔillbǒYoADzLQǔfynèéqéExmàjFOǎZěn	FALSE
DEùldKHnèfSHóKǔptietèOAéHàatmYHhIFě	FALSE
FWqàXCMLaǒéúnàkQtYégjIEahyèucKǎmrLM	FALSE
HyúcOǔXSTLnZUHǔgDlEfétYFǒvVCRGIKoék	FALSE
KOCEpfLMòlpTUGBBEǎeMLnDOóééYcǔaTXKǒ	FALSE
MvysǔeKDúWlDUdODXásdWdWUNDCúúQHPfDn	FALSE
PPLMàJHZKkPuZVWǒiVcòMGxàiZávWjvSwěy	FALSE
RxNxMǒYSBIROqxběgójeóǒOèuXjIHrǒorpd	FALSE
UhloBNsgòeWǒǔǔòkàYnginMIwǒDvKjTzTén	FALSE
XDiDFALZéEAèúDNTǔFMQIuYXsǔjádmxjUgò	FALSE
ZQDóTxRBùlQovtKcqyuzXzVJǔrTsefZpLDY	FALSE
cǎZWNAzRdayèhUdHCbjzJeQofYeuWltéXGX	FALSE
eaFNǔHzóǒvsǎKǎàiQkROcjzòdwSncTèMcàO	FALSE
hGlúVzǔnfTtOAdězOqLQJrhǔǔrCknOnPégt	FALSE
jeALiwthyrvEdBcpáDTCikǎápsVúuéěǒJqD	FALSE
mgvQkFVQqEfNvJBéIWBQtRǒàviXBVagTNàà	FALSE
pCsgózmrBnpIeOCěvVKhègNUèKòYèzJLmàJ	FALSE
rgqzTàrYgkyyeDgóDJáYqGtòUvwZjTFXVóU	FALSE
uYbfǒNwtǔSZaNgMtbtXXkHòaónWkMkBDSeV	FALSE
xFéyxmxówláXUèQHgròpúhRWaáSDDèWpPùq	FALSE
aùǎWyKncoBaaowHXAaayJVidǒCézHóySPBoà	TRUE
aáoZeǔBcNaasOFéEFǔěǔaaòQǎTCpoòVhJòfB	TRUE
aéHèrměxáěCcòùWZUùvCWxMhǒspbkaaKaamǒ	TRUE
aěxcéaaYǒAORǒòaXVKaamRuùǎXxTRàTàòěJǔ	TRUE
aǒxǎǒFzFCùEùqàPcGǔaayJfSXHYCfúLHFsaa	TRUE
aBcraaELòtěaaKwòPòTěnléáSǒQbETièhǒFc	TRUE
aESyZbEnèǎUwàckitURéfZBfjBzoKaaùfaaà	TRUE
aHPFctóaampNaaRfyKnspzEQDyFǔǒYPUNoǔM	TRUE
aKFZcDrAǔàaaaabhzLVHMynXgIáqhyuhkDZg	TRUE
aNIZcOVNaaǒoTrOdǔWǒWòaahewtqúKHvVRHK	TRUE
aQQùxhpéXǎVNYcTTvvDáOtSzFlSaayaaWwIò	TRUE
aTVPDKZZqceoòmàIQWpǒOáaasáAsGiócJaag	TRUE
aVuQjixGcdèútúmJúaafaaòEéIKúqGteúQǔN	TRUE
aYxtjNCKèòǎKcvRVcbCǔigrmcaaèaaERCKUp	TRUE
acǔUZAáPuBùkTéjKrfDzǒIJOWaajjNaaeJnú	TRUE
acRtAJVecKnaaAsCMFwEXǔmaaǒLpǔsTUHsWù	TRUE
acoNDDúaaJMdyoYaaáWálPbóFFPrKrVáWzrd	TRUE
aekcDaaGáǎWyTóIaaSdlDGǔrgZbsCoijYhGE	TRUE
ahDCQcaaaúoǒYgǔIhYWCdhPFaaWvHOXVVfYL	TRUE
ajpccUCEèórwWSéqùiuJnòaatFIXoǒéEFsaa	TRUE
amkècDǔGúuSTsHUaaéAPǒaaréWúhZEXǔzEwQ	TRUE
apArxuùjyNXSJwCPimtcjaaowJVsaaScòYxO	TRUE
arosBeqFksxkmFFéPrNóòcNaaássTaarMMXu	TRUE
aumóZgxZKcknFěXsLǎwmiaaJVAuCXáufaauX	TRUE
axYgǒcǒéaaOyqVǔlùKUùòEaafizPVXRgmnSO	TRUE
ùáSvrZUáóoèzèqQoxrZcxAXécLZXxVsFWHǔf	FALSE
ágOǎuòTYgpvdAgNvLvZDéMaVfǒstzkZTTuòq	FALSE
éQcUnjNvěFXòWúDáCùeDREReeMTvukRHfáěC	FALSE
óóEqMOóFquwUVApwAdùDSeBǒINGcVpdèeúeS	FALSE
úòqUǎáPqLNěMrizJàbeágXàkBTwxLYHwvópw	FALSE
BMXǒKMYhaiJàGǎIIAXURJjtpQOǔLtQYuhAJe	FALSE
DjmáxoǒěnpiatIBsxZmJykjxeItǎòuajbccc	FALSE
GWěWXfYllRHnTvlwLKTHEfBvnLibUòvzRáRW	FALSE
JébsrqMKXàYdbFǔǒWZrRxFVxvTMdàBvmóojo	FALSE
LmoIhEMObNNéáuGwqqjFeooIRnlGZqcùáWYh	FALSE
OèppèuZQqVáěCBAHóbgZVúuǔpkzvwCbbIVkN	FALSE
QkqsyNáùFànWqRLǎWBbmSGXCaSBùyDmdáftw	FALSE
TLòvǎnQShWáǒuTiǎeThSPHaODIwSJxVrDPúě	FALSE
VmááǔnèEJaVBxXtáJùèJMlqKGGǒYrfdQYPéY	FALSE
YDùùpHMéVVóǎfùùwàvnúHAzFeàKBOGRyrScá	FALSE
aVQùjPjuYnHwsùRABTUhúòlvpédUóEbodyDè	FALSE
clgHYSRòXBóDCòàtrúygByQépbqbiSúhXsòu	FALSE
emOxfHVRKhzQbTGYèKaVbdHoáákCREDCúKbT	FALSE
hbgrIkcpcOéNAZùáAòfbóCǎuǒOùNwǔxàQéWò	FALSE
kUhHótOazXǔlFoZjXěIsJGCsPèiUwùǎxAcTǒ	FALSE
nDxNZYnǒfLQEHvoqèmhMUpucěDǎtTbkǔdzám	FALSE
pRRLhùòIRVZxlTjtáSKǒZkàXjKrfYqWigáuL	FALSE
ryúǎkcvpòEùdCqéaùMùrLAoèiòDǒSFiwBqWz	FALSE
uSNcphJlécdzxbjnKXuJPMZtoZqQqXVWǒnBg	FALSE
xXGuQwuYǔYesxszczDQoJflgèJZǎnETeqncP	FALSE
aùùsHfYhCCgwcFaaOBwtCèNáóòXlheAàWaaCé	TRUE
aáueBTgeicKTNtaaǔkúXLeǔxOùáǒBǒxuùJaaǒ	TRUE
aémAbOidèmXYjMUwǔRicVcaaWaaNNAǔDRjQRu	TRUE
aóWxcwRóWawbFRbESǔaRjRaaVbúGcTùlHaaMè	TRUE
aǒygZRTcnòHmbOMvaaEéoRgyèBòyaajùóMowg	TRUE
aCǎnBexwcqGIaaRòúozaavóYùLfméJeMfhdǔU	TRUE
aEièigmVdmWInThèICKOAqaPdGwPcéaabQaag	TRUE
aHIFcdNGóthMaalQùuLpMbeBsonaaOOLkqAle	TRUE
aJwHvActIqgqzOěPúaaěèUǒaagkWTsKúúqRúx	TRUE
aMbukVnfAdáYàiǎOelcfgCaaaaeZàHnGéwBSN	TRUE
aPǒRLGcACEmZZVùlaalcVmflyUǔMcCiaadTtò	TRUE
aRaLZZUcaaqUxéNěDèaafCmKyfRàéVYTLsRàò	TRUE
aUAúfwvczùTmàEVMwaaàbfJQXvptáaaRLèoRH	TRUE
aXFósIveOPWUVcRáwaaFuJLoriTXksnWmaagY	TRUE
aZdGHáOxpCVSXfèkǔDcaaǔǒFhúYúèBǒJdQaaù	TRUE
acǎtaaDǎuSaadTanAǔúRvpWIKògyyWcrlǔnbh	TRUE
acUǔmǔSTLèxKvxaazKǔZBóaamǎxXpKbOKiàLr	TRUE
acrèSǔzRFVtZǒoófaaOumIPaaúZxEWonakALC	TRUE
afImfIátahQǒHǔcaaKRàzlùlJRǎBUUBKaahǒA	TRUE
aiRgTPcCUpVaaCeAMěTZrSIbaafihAèěFHeyT	TRUE
alemcnioLmfZtUéOguBCwaaáiǔotnèúvěaavu	TRUE
aoQMocvIpbMàswyhLhSBǒaaoHNmHBlaaèèVnr	TRUE
aqqCèXaóOoPpàscbfLéàsaXaaaapikAùclgoǔ	TRUE
atePrJISǎèéPEutBárlhúHAoWcǔaaaalGSXmě	TRUE
awvNeúGIcNǔRqóUIéǒtJvòTnZxTxcǎqaaaapǔ	TRUE
ùùfAeHfxdGáPPǒaQNxYDgǒfIcěòtwublcbJvy	FALSE
áSUYyéGùeQěSgVǎyǔWwUjZòDvSTòKtCěùbeúf	FALSE
éGeCcXuǎúQNǔHIlèMCrOǎàfúzósKwUczRqóxf	FALSE
ěmFàluYátzpémEàǒěLRKxNFuqyuBiéběcKùoo	FALSE
ǒRFúCshTOGufNetǎeSHǔoaaleNviBRDfàLqFǒ	FALSE
ARoSDěoKWPLVěTPUuòDCrbdǔSǔdtbHKwjzyFc	FALSE
CiGYǔwajJěòkPòSǒvnùruJaZHFNxjzuBǒrEuk	FALSE
FGéOácsàHSúgPǎèKlzGlgàepéxIHúeXrLEzNt	FALSE
IǒOMèòiiUmrPTSùBnYrxKhrǎxadDsCsCsaxHò	FALSE
KqùcAfyénQCéúPoedúeàDecahAnoupMGEDúáB	FALSE
NkJaiwěùákoRWOAécbKKséjwWNèVhKOFFéócg	FALSE
QEòCxèSǒkHPybNRJěTVRtjmSGoGPYǔdqwùjxǔ	FALSE
SèáPBHQCcZnUiFòLGàòaFǎZěbòèXXXgdVkèMT	FALSE
VùCkéHqarQIùmxwuLqóqdksOPOòBěyGzmqsSú	FALSE
XDceWwsXvwJSNáZěùádjuqéěMWhóExǒěpwáaI	FALSE
ZzfùcubLFeǒréziOKzèQNqOKoàyFSNTèùLtWá	FALSE
cmWhGecAkgAQBjpèsEnǎwǔúyXXǔěǒxHpRQoǎT	FALSE
fòǎěIéRǒXZyxdVTYbUágiěèEdǒLùpSkwQJovi	FALSE
hTIpǔChéQJxiiRúzITfsqèsOùxGóNRMyJǔZpn	FALSE
kHCěPXMmbCùAztěféhùaAetGWòóvRòVBKùeoò	FALSE
mjuRhlBVàpúàTCgAègdDrTEetfWǎosXTHvúVa	FALSE
pYǎvJDUSogèhOZjHtmQúemàsjǔAǎYǔkúěqqóq	FALSE
sZQvúLPǔhùhIoTtHArPnhǎǔmOXJRFòHmfòwKN	FALSE
vJCUwKTXqIflQqaweyoòoAdygknNIèòWdáwGá	FALSE
xXHáxzkǔoxóCjTǒZNzmVfFòwwBsXFjIQJsèBS	FALSE
aùácxèMWplaaJkgrMAàTYqvkaatútuXnèNOKàò	TRUE
aáZocOPòèěǒaaXTJOdyVJKaaQZéKkOAǎReLTNG	TRUE
aéJWǎqtKJǎSCMuNcVaafjJJYéUhsMNRDaaoqěO	TRUE
aóǒAkQtYcǎSKUcběnǒFèVqNaaQdODCSrcdDuaa	TRUE
aúéNIhkOwyVzǒLònEéòvnupycjaaLměcyRBaaY	TRUE
aCFDczǔgtaaaaukRSmGtbpvammzTRgtJXáèqěě	TRUE
aFbXéséuHacàúyèèCvàvèskùbaarùéBeQCxaah	TRUE
aIeLJǒgùjcǔaahlàLVLEkBaaGJHRbMùěMsmzǔè	TRUE
aLBcwBèǔkRágqiòDaaSqPdnNyèóqmtFùǎaafRr	TRUE
aONfcěǒěmDQaacTPbYEaaòfqFǎaóóèIOgáaraT	TRUE
aRǔEUcòuSGYùaaóánzHbbtaanóTtxàAkàDàsGu	TRUE
aUúqLcǔXaazfǒDQǒOFTinKLqRJktGWaamáQúDà	TRUE
aWPOcFáBùóFaauàoèdZéǎlkeJClIùMéúoaaUCj	TRUE
aYzAPDSǒPZicGFaaùHKúòlHJgéuJZCǔǒaaaorè	TRUE
acǔYLǎòfsGǎMGoqrBnRPUúGùeqBǔpDújsaaéaa	TRUE
acPúEěQùCCupóATaaróǔKàhaaHIayěEUkhWLaW	TRUE
acmǒtǒMeFNHRǔPcXMqNjòádQǎaahaaeèuólIJZ	TRUE
aeTvěGTúMXHcvnsxWgFVhàèùUWJfkEPaaMMqaa	TRUE
agxqoBwoAAVwájùùIfhàXèFxciPCoutUOUaaaa	TRUE
ajXLPcJéěuáùaabqvVqéUUaaXóàtùméYYCiEnV	TRUE
amfjQUèScPTóLxykNaagaaFàdFútHzmǎEqRuòR	TRUE
apCihSóǔavlPoótúòIěcxqdaaóaagwiNVPěyfG	TRUE
aséCkpJnxcGpswspsàqQóòznooaaUzèLqfFpaa	TRUE
auuúIrkCgócOaaciXhǔútúPAěCKSaaAykTYIZd	TRUE
axcUaavòKxHpYèdáeCfYwnstEHěcvKRWèaaèPw	TRUE
ùǔEgùeumrusTpBSkVěwǒlkKCěYtDHèkggvOěSě	FALSE
áXOIXEuASBYzxihgipDWNětbIgZXówlǒNPěédq	FALSE
éHTfJjzLǒhYGKǔaoAǎvRóaǔoeKERqpkpJfòRcg	FALSE
ěgipRfaaXéCCéTúYfOoiàRiHVJmMuglxMMykHS	FALSE
ǒóòHmwTlOBóùqZOFPaskùèúRǎjBkrěeULfHqPT	FALSE
AVděNdZlàjPIFXSAxNOimnYeHklfùjaaǎGMqcg	FALSE
CzzrègǒQYxReySQgzGkTòàáFSsaúaQAùnTCòpG	FALSE
FJIsBsilóhǔójéqǒlRàskàRqOJnEtBòúOFáima	FALSE
IétuùmPXǎuǔqvvPvLqnáǔQAàcáéFLhxòNkèlBR	FALSE
KSVATJàòveúéòjQbZHaǒRYhMCnIYHCJimAiYGM	FALSE
NOkàpWXòcgnuYuuQuǒhpziUEBléàXHdtDMxrCV	FALSE
QIBQjzálèùfreIUeTwkòPXdSCcBAPszéDEùOǒó	FALSE
SnúoěǔaFVwiehDXáyúfHYGèmcJRǒǎWěnFCKiGT	FALSE
VEJoútgkwmǔgGRfvddàsUSZjmblYfaěǎrEjcjú	FALSE
XerěIaWékVBmrUěenGRPMNKtseàYgFjLòPkwàp	FALSE
aéVwEùólNYOWDěPUWǎLajGúhAAtpXrǒqPeaEEG	FALSE
cbàCǒmustrknfBǒgTXXojzkeǔcuráoNkcUxtqM	FALSE
fOhèOmLayàfPIUNnyIcětYEdPDPòǔJBǔGěmQFC	FALSE
iJPBtXLóKlFfPCvRěaHfwBèVUéwToCióZóaPqé	FALSE
kxOOoavbffòòùpnwzSfEeàkàecCcUkǎGòdáxSk	FALSE
nGDǔǒtBmYDJLiKNCyǒnnbQǒoNRezQiEoKIZàyc	FALSE
qLCCòVinCehdykZòéEdrǒGxQjAbaAeZúWmhcxw	FALSE
snǔHiKpvěWěéDàJbǔgǎhbBQACCyzlltúueéRRY	FALSE
vOeBWǎgtyJPjwǎrFbfCXXonǒqvWXròMRǒClòqk	FALSE
xecJRnSCBkòàopLǒGzulPtqPDZljùbkQfBsuàm	FALSE
aùáwwLáPàHcxúhcGáònIǒJTaaYraaáCkòJWQmPP	TRUE
aánócXUjBkqNtàrMQjUogcaamuáRYúóADaLaamO	TRUE
aéWmCúzcCaaUǒDilLVjJaaqzUaATGWùǔaùPazMJ	TRUE
aěqiXKcMXaaIaFǔoqaaUFpNlěCozyèceùkàemVD	TRUE
aǒxCRdyvcǔBFǒvlaaxTOfóScùBaaQGúiJLDTsOé	TRUE
aBWfcTǔDWiUaaelòwǒaayóájXPěfjbóYJbrèvsQ	TRUE
aEèouIcXèHDùaaACyGohHiiQgbaAYóQmJeXaaàI	TRUE
aHèVukóǎǒbrslVubDYHQhyVEcaayJěaalZJoRGó	TRUE
aJaCxyHJécàTMiěZLjèYLàaaNKfǒzJUúùgěěZaa	TRUE
aMLkSAcGJRjQǎrizLěiúdaayéeoaaaFúUěàfoFY	TRUE
aPTtKǒgǎcqkdgHpBǒIaaACúcXaaHZmWeJCqAéKé	TRUE
aSfXóápIbóQecPAelaaBěIyǔmaaAúVuǔvvpaJRè	TRUE
aVzLlNRNIhúAcHégaaqoOaaBVCNOSǒUěóúeZiFò	TRUE
aYsoXákIcNěǒBcBEùIaaúUvQazéěéaaǒmDgqusA	TRUE
abZrSNjacaapOILpSvdouCDQFGVúUèqOùaacIbo	TRUE
acIóYYPhfvǒuěMatèYébIvaaaaPxNyquusHoVXú	TRUE
ackáàWkkrááZéKaNcMPénlsslvpSúaaaaLAJòúq	TRUE
admUdbQZcZHàNtkgoWaaybwLoRúaaFWGNǎniJbE	TRUE
agReémǒévqscCXHGKóVǔNLWMaaóSzSSIhZùaaIP	TRUE
ajKFNpiFùFèSeVNcDǔPPgrvxǔèaanaaMoVNǒHBó	TRUE
améMcùrnTùAhISGóLYdYCúělaaùzaóDàaaKyBǔf	TRUE
apizCkSúnéBYDěMcyTóóaaPùxàèaSdaanèbVgyá	TRUE
asVǔzcáBéJpiaacEgphmeQYzBFFGUaaSXnDENgW	TRUE
auuvsFnǎIpcLaaóRkhkKěhSOàOóàaaQAsěsWOCH	TRUE
axIòCEOsěǔMáécmaagǔpaaěěWwDRWUnGeàPhKmě	TRUE
ùùGwòUòTàiPèVzOVsǎǎKàgkTnQUWhvsěDOPSuzL	FALSE
áedgQtómKhòYDUjcmqdsYKZúDuZmLxúaYWCrzqo	FALSE
éKDwsFèǔybbPwéubNóUJHNNpùCcgqǒHhTFósfjh	FALSE
ěSèGáOkwBwnYpǎǎsǒOUXókBqOàyPNbúNékǔùejě	FALSE
ǒApHúVǒnyIoDNJHQyuàlCzǒOOEòàdxukPǎóbwRk	FALSE
AWéNeLCpúSCBǒQNjrùwFòěgPrgqùHBHHPLèLZJL	FALSE
DCYVǔHDPBbXelKDQJOCFoEDmóBzécUóIfwGòǎeé	FALSE
FlnybvhtùPCufPèXgERLvóesoKXlLlNRppPcrěB	FALSE
IEeZfGiéqTGbPnLhPyèérNRBléDfioúnxkyAǒEr	FALSE
LǔpBIeúGǎSùYFEUmIcycTǒnoDCgOǒfǔrèòPvǔzé	FALSE
NFǎWsiIisfCúYdQmèVKGWǎAálRòQeuvwhkWqsQi	FALSE
PUAawsRGOzRuǒxjxfOyrmcHùbMBùvǒkMèděHěXr	FALSE
SùplBqǎGBějxùoWiHxCkgHcnfbǔWuNsiqùLúZǔF	FALSE
UěPyJHuMDhPzéECbkcóaojòqěuXTIáJwlèeGOòZ	FALSE
WUǔoBYEclwbùěQwǒDěsNxoqaùguàdàǎúpIsǔYFd	FALSE
YvkyJWáXZyvOěpfúPǒnzzEóéZǔafěZdFwǎfcuAò	FALSE
cKeBguOaqgxURáKnòPCDpWtrUexJYqRgCǒeonnǎ	FALSE
epfǔBCKǔMcéǔXeqzpqjmrǔxjMCǔiBFòcYùwLùZN	FALSE
hrFXFCáFǔWaWvpàXGátzILbRYBtWwXhiLóvákbN	FALSE
kOJehhSěǎPFehDNOéaYNSsàúdHǒZàéigJTóloKp	FALSE
nHtVtDévǒOǔgèWèZgàQIDcáQdiIǔàEbwwúòhkLǒ	FALSE
qACJuyCmUBsiǔěDENsbFBFzKqZZAkěrsfnJóDrW	FALSE
sZHwěpèòjSzDkHwrDIdBùpOgèPǎdàěgdFáDpUjD	FALSE
vǒǒrghdǔáWOuOdéJwfcNbNùUEzàDjǎyhěmǎgNpz	FALSE
xVCsUYcuTZUáoùácZǔPkbzCàiIVHzUěPTCXnEòD	FALSE
aùákǎBtshqcázaaraamBSùFéòòeǎěQéGcbgUfmoK	TRUE
aácxYǎúULaappláǒqXaaòéLeéGhteVcObgjúǒàyt	TRUE
aéàòcwcBBOlMaaYTǎǎkldPáKZǎaaBkErǎHfRǒǒDE	TRUE
aóCělHalcYiwěaòqlVraazrXFsAZoCRNHaaqNnLt	TRUE
aúòymOHFǒeWgHuNcGfBaaMaAJuopJYhLPcǔPěwaa	TRUE
aBcYzǒltvěqézRòaaòIǔJpHraaPTAZReǒudOMPwD	TRUE
aEùQrAGvZěLèuFochbcxaaVAAěkxqǎeyaaQùeOàX	TRUE
aGvYBfLǔloěycuoùSǒkùUWaaWETCfWxaaTVkTUIl	TRUE
aJUSIznZúZRlcIXGOeSèmiaaRvNiVaarJRFGóuZx	TRUE
aMUDCtYKuCUbǔrtùWvcMiútpnlmaaYJzǔáSQaabM	TRUE
aOoabdOcXéǔoǎGLúoeJéěgěfygóAysaaaaeqtPPU	TRUE
aRNccjǒxcVPfraaSěFfóùqAabaaCEluybQùǒHèǒQ	TRUE
aUBCSFóaéědǔUYGCeúLúbScmkúYǎROaaUùGaaXFh	TRUE
aXIcOTNotXfZbTzàMàǒeQièàtùgòiqaaTsěaamoG	TRUE
aaFRpCKjqfaoNYDěéǎWòDdClǎgZǔàcUbTaafàaaX	TRUE
acAYsgFksFljóqYHNóènaadóéèzDKaaǎFágqVRBb	TRUE
acaapaauxOjxabQbXARuádAnEoOowVǎQVHsLluuE	TRUE
adUekgnTWhDjPpdocòájvxhhUaaIMJààrEciaaPA	TRUE
afyIYODǒcjtFòǔwaaoòKzǒVaaEfbgHQěpRàusèxS	TRUE
ainvRRImvYMoǒXRbDhóěgvIqLtFnòhbcLǎaaaalC	TRUE
alraQEDzéceBaaàěMGZRǎQgPhyiǒffzvǎWgTwiaa	TRUE
apJtAzMKxcaaaaèGncGZpbKévVxNǎqocqoúGóàǒc	TRUE
asJznfáhmwòDDrUxmiAuInCócCTMQaaymaaVúaǔú	TRUE
auyNvTcGJaaaáGqùeěTVǔoqmJgxkbLgVqǒaaNACǒ	TRUE
axYcěQaaPòVmjòlnOBTcaaSwàúJtMWfpTYDádǔaǔ	TRUE
ùùfJvKLANCRovùGěNwPhrlsFDMGsYéAaWZqmMFlg	FALSE
áemwǎbàGHDǎbáeIYKàòPǒUWffUHáQuéoZéYizěèV	FALSE
éèèěgAIXwLsójYOppǔbjùTwěZTqBJyáqOqsftlpJ	FALSE
ěNùTKZòjòzpyMkóPcdOǒOPaDàoMKoaLtséMpDǎDe	FALSE
òxygXtoAáhBáqxJjSPèvMevnfvtLtFòáhohZEóuG	FALSE
BákěckxkpACVMkǎUéNǎHwsmǎYoRBzLEEPkUExFpW	FALSE
DDZPXkIBPubprFEěCeTWàrnUWIGHHàCùNWnczdèC	FALSE
FinBzCmzAúěcLHVóDQGkèMLùǔěwlpLJěWmhhBpOW	FALSE
IHxàKKFóGzeNkzkYgsútQúNQǒZInSùùěxGDbphXn	FALSE
LùéKelboNúCBúbZTáSZmNnQouhUIowǒiakúHrgdP	FALSE
NIuNdoMdaǒlMuCDéòWǔiAukeJJmrLizVmNxJmútC	FALSE
QDBzyLàsunkGDDSxRGPUùǔùmVBòǔPváǒASRhGYMk	FALSE
SvhaTóWPilwàdxǒqěúzcMQGikNqAYǒmvTTéozDji	FALSE
VOphEjǎjhpmsaxlGbhCRáQVòYiAyzBRóKSFnAUdV	FALSE
YàTěhZcxòiQFfMréXvóVgǔkqttiMsèsódAphtxhǒ	FALSE
běnmFjEvǔhéFvǎnrPuááHuhAOAFSǔwjYBglUMǒGa	FALSE
dwYjóǔjNXPOqDrRVfmrǔáxZLóuYǒOàěǎǔmCOIFdC	FALSE
gjěBǔCFTOkáJLòYpsóevAěsoTkMpOdnhArmqJǔyú	FALSE
jDIFBPzxbùUfkuezUvMwPgnóDUěLàHMtBYkNkOěé	FALSE
lvòèRwéyRhzhgéùgWǎnLsBHvCVǒhujǔwoáRBBZBR	FALSE
oKsuǎǒIhjdJǔccSXgdqǔWéVfbàCHFyvèèHúǒlsIǒ	FALSE
qfAùlsEeMěGYzTydOádózZtrfObRèLLèASBbFSsǔ	FALSE
tèfTecěyHǔzDzPFRJReEBjjáùIHRrmùqLVáiGǒUJ	FALSE
vEtnèbéWéHwnGHQYǒaTmumJfHdèROteiVqǎktúXy	FALSE
xjmZjdMápQZKkmBédKBTokèǒóXlBoqrZdVlXyjMf	FALSE
aùùVyóBáucSBwlPDJIJWJAGmQlKGabWbBCaaiaaaǒ	TRUE
aàěLDBZIeYhXǔcmókqAAXaǎǔǔaaIhuǒzUiaaSàeWR	TRUE
aéjcehaFTjwNSCXtJFtaaaaJuùèiéRóúHseTaiuùh	TRUE
aóTMqKNfPcKiIaaYskZsmNěòdUYeUFvaaAVFúmóàM	TRUE
aúǒccTTMCxVXsaaxUVùodXzLAfaasQPXRErNNCifl	TRUE
aBnpǔàAExècsfWǎFmvhvǒvaacIKVaaoudáàrABsbA	TRUE
aEcPǎEòaaLědVbfKfqWiuSGuXvòàgámaaLTRóXCuV	TRUE
aHPyOféZyVèsùáòběcaaCLPCEVZDxaaTfafQǎMtàǎ	TRUE
aKvKcVYzéklYcfBViehYHTaakJgěàaagvǔLYTMùan	TRUE
aNWjBúqFáùDcbaEdnRIkúoèòèLJaaCTùLaaòsXZJJ	TRUE
aQDfLcòzCcQYóEYRálZBupéIElaaáaaóNúUuǔQqzC	TRUE
aTLrJAkúBécdwIvYcJweKJěáéDaavuxúaEaqǎXaaM	TRUE
aVjFpòecǎaavZóáKYqIwKvaaxdùULNbjAtòHxxVhQ	TRUE
aYOntcEJaaǔaaGLQúǎEYqènoPkamǎàǒULòEdMHyjD	TRUE
aakcǒwTHeztùNòQIHàYraaSFFHaéúDIaaxsùDecBL	TRUE
acFsáǎeymúààDGWempEéèaaNZNjcyYneEIVQaaUBú	TRUE
accpNǔxsaaNqaaóàzBOKgǔùrjHǒMtlNlRhnHqoVer	TRUE
adaCMomBLykcáaaQǔaaIyQLpéFNLjRWOXFlxLnoYX	TRUE
agǎLnxLclpzeEZzpéǒùHIWhDKoatttòòSRaavúaaV	TRUE
ajcǒUuMaaáóVXPiDEGaaZSkaWǎěBgòàěfávkTyTsé	TRUE
amàLpfNNvcàwáoEvéTvjbèéUExěěrdsRaapèhaaKx	TRUE
aoRNxGùěWdYNPIVcczXZzOMfbaǒaaáclùXqaaEZwJ	TRUE
arfcrrDGcTaaúEtlRjùúiaaáeJJóǎòuPóttNóySBs	TRUE
aukèfifúZQcKDéOògraaaafwwPxèZviIǎòiXubàǎC	TRUE
axùEjWOgzòzèlwCáěèzmcaaǔyǒDaarWbcèOSkghnè	TRUE
ùǔUFGshhrKUZjǎǎQwEBDúZnZéYtIsVXákLSlsFcùU	FALSE
áLPbèègGayjcroBUqyyǎKAděèoěùòOcǔǒzáfFǒéún	FALSE
ǎnǎEèTZRSǔFWyKTHxSeDzǔcUIěaGólPǎdběXcqaaS	FALSE
ědLSLKjfgDRNUèúhDhWZavdVXóáxEVěgvQYàBhyeD	FALSE
òmǔwogubQArOrohǔRòIMlVGlCtfàJHafJǒKkzVhùN	FALSE
APGarDKàKFRIrkVMàwWytUUyùjDLěIioiTYěygMBú	FALSE
CxzaáiéqáědzoSkYRJJPèěEwcéLDùNKRDqáǒcrùIY	FALSE
FKvéKIeFLtxtbPFATVYòǒYVDYpǎPEwxúnàzwngdLO	FALSE
HuèfúNòuRSòúqbJWSáLúSUTmZǎCUiqREèóOKcTDaR	FALSE
KúfbáwNdouKdihrUxúùRbsyCtQSěfHIǔkUPělpwSQ	FALSE
MràqFkdcunUrgwtZàVaUèRSúácnǎlaIYkgaǔtcXǎv	FALSE
PoéǒTKoBjCxàuDnVsGlCHbpSàVémZǔcNàwdwGVHAu	FALSE
SoLǔutmKzWáSXèěQukuúgKáPGsuwEcVúPTkMTǔADm	FALSE
VRáUIXǎYmRuikiYWbGàJHěiuRTéVKmděRklsovhmk	FALSE
YárUoòkéKJóáǔUKXǔJéěgjltXlBwrHsEXgpDéuǔEN	FALSE
aqGwPaòàvYBMǎKopèdEuGǎuNǎfNiǎHWFjvmúdèuxb	FALSE
dAyYOCkkRtlOUǎádstàúúócèvpoùbbàéWvúyhZCùǒ	FALSE
fglYIbjnEèHXtǔTóNQSyfOJáOfVSùZaRCDomGRnLé	FALSE
iFGqunwhxHXkCRQPrXúTǎjàSUáVrQUKěJgCEPǎiòf	FALSE
lòIoùCqMgLǔMERZNdvatAǎěhfHTZěmBrLéAfOpuúr	FALSE
nfáIfUěúmAczcvKmVEmNYjóyTǎxUPOUGLRFSLtjwB	FALSE
qIUGIzplIjlJGyǒGmbWtPTàUdjCWDRùěáetfezMrǎ	FALSE
svJGjwxoèvécPuQtlBHHymǔlAǒLNPWlǔoJNeěxsPó	FALSE
vàGùěóaRHHQzGóùuátniXhBkJKYDMúóWzSCǒoDFěZ	FALSE
xfxVYJěnRUTKsóCóYoNRèiláwHyxéHDMHugkOJMKn	FALSE
aùùKIAYCccǎnWCRlDJIXhùjǒmyFueLúáápaaaawuWh	TRUE
aábSHoǎXmYgLcàfZpiTVORóMáPyjòGtUùaaDARDaao	TRUE
aéDaòCpcúYxkǎiaaAobgkrlJdIaCROaaKPZFbòIjLj	TRUE
aóátZǒRóěnúmjcBlaajǔoRǔKNNNoiaUsNaabLgddHg	TRUE
aúéOTaIQNcyùCéWSaacòZXMPVbSQVBIaaHqauoFLèt	TRUE
aCéRcjDtPaaémhvaaSgmJdzǎfóHbCQvIDIèANftěoD	TRUE
aFúctrKùgáHZaamtSòWfèiNǔsěòdFwLaaxmLcLèSAI	TRUE
aIàVqAsfnúpcHTImUaaYlaajbNkHzWYCqěégzkòrmù	TRUE
aKbcMUDúzǔkǎeétRuǎLǔVuwaabòfiKRBEYepaqkaab	TRUE
aMwcMEXPXǎeeEfevKGIrytSǔFooaayhoVaaZszDnXx	TRUE
aPccěgffAwbILGwbbVWcqRaaCgFvpaaěsDOěGqktGi	TRUE
aScIěaaheúaaǔǎjwiIbxnuWJptrgildwúMlteǎcùVL	TRUE
aVMlcěXUhaaTrJuàpVhoòfNfèCIǎàUvmVbaaàfAVXu	TRUE
aYhiMéXbpNutàQDfufJfrPócQBEaaJlrqbaiúNYúaa	TRUE
abRFWqùwLpámèáMIěsbǔǒOXcjòJùYDEtPnsaafázaa	TRUE
acLùHVaacVaaDuehHJwDàkǒFbJZkěJtaMéoxǒKkqób	TRUE
acpxáNxGWQVsomèuTKfQJaTVGQkLcaasNwLyaaTěho	TRUE
aemcbjèàaaicVHvpxDQǔnkáaèǒKQǔrJFuàSuaaòTCE	TRUE
ahbvEókQEfěpykZCHFZAxkàqqcúTyLMaaaavZYàNhj	TRUE
akHèhPXAaQyEscXZaaiqYDfUDvJWxRFHGaaùpiSárF	TRUE
amnlcúaaoSdQnáVudlAkCǒXGóRaaǎUTAixsnòaJPJP	TRUE
apAgqgsiǔúDǒBkǔǔqrcfaakúóùéaaargáopBmINZcR	TRUE
asèqVhyrSlHtVXsGúDTckaDoPǔaaùFtcyèWNZpUraa	TRUE
avéGKùcǒkmxaaZMAǔǒzOfcàmCWAXzàVcPrKiNaapCf	TRUE
axZzLnǔHyòpǒUclaaòǒXEYWEubiRWaaOEěEsLhDjqx	TRUE
ùàHMèèèLYIúqTxuNSpdRóFgjiDmxXVCǒuEvéIgcFHM	FALSE
áWámUQùcMvOnfLsùlQUherBobVRXblOLRXáRáKxawj	FALSE
ǎdSjMqpGhaxùAèmqFAvZldjkPsOkzWCTǒkIpCuRhPě	FALSE
ěBYùDgHCòMcXàpJLFǔEiJùglSòpQNKréiTCyóZjZdǔ	FALSE
ǒCUáiIONUpEúwWkcsnéKIsKóNèIiMǒFXTbCpúijMěZ	FALSE
BǔqSyFxFYQsiyrAnboQPòiRǔDrZùSpWubgAúVDXviǎ	FALSE
EàéZZoóJXǔAnTWgármMiHǎCNACyHcpOpúfzjàémàMc	FALSE
GNeYuZnǎNtWóUeprbféǔmǒǔǒúnOuVnVùnbbAuCwArp	FALSE
IvhiAèoboRFSgjDěBSFWNuJaGIěáUrPXVzkKvBǔush	FALSE
LcJSKbUpAnUCxdúZDzZXpdBRfàUhKITALǒQcqYaCùm	FALSE
NyoxCKMúoAéUnǔUBàXjQódlQTéiRPPYCFhMxOomsjN	FALSE
QIyèHBCpǔóTJòPDXOwěǎlavITJDTCzXhòKxTYXXhèU	FALSE
SzZeDqGUǎxfNqlOtckZfztěáIHnEtlgAótYòǔRugCw	FALSE
VàǒnoèUsxifMJxhàókzglJctEFǎKòàhMhKǎǎBáěHVk	FALSE
XKIoARuKMGvLvilLàbgQǎévJaylFbMàjeKGVZǒkǎnO	FALSE
ZgEǔkyóxqTzHùáqNlóRòúKhbdXFWPpIégKZcGGMjeD	FALSE
dálDnvòKFudfjBúCděhBoePnNSóxBWóLQGOIfǎúwěz	FALSE
fZCMkmonVXIvoǎiwǎvKMAdzàmtSaòNědyWUèhèbJàY	FALSE
iOazǎMnRkMPwǔrcAHéMKǎnERBòòùyitBavàKbCDRws	FALSE
kqIwrkúZóPEoěeZèpWShlxbqlúoUNaiLcAJvésúINg	FALSE
nUúbBolùxEòOeěmcpséZwWsTEuùgODěèpàǎbTGDxaé	FALSE
qòYypVàzyYòRyàRlhmmèúYTóUANějrǔkgòBNPyǎRZó	FALSE
sEèWàáwSamCPZOFqbOBèctXǎěcaWòxhjJyAspcJYMú	FALSE
uWněobFzmUfKEKeoéǔlyréěbSmòNáLKBIBpXǒAwwHo	FALSE
xàQbòóǎǎHTYoswYSnkcééEhBqJyLFVvTVǒitBǎqOxX	FALSE
aùéNsccWsJAbimtzYtaadSzhKQJǎCěWNrnMěiyaahúz	TRUE
aáuèeùcaaQXHOsóhQsaagùCDEPcPYrèòdXeèDWbEsmà	TRUE
aéUkGSqFIfjoNmZGvqzcEYsQXdMaaVkámaaWSaIkeYL	TRUE
aóqǒǎsúmSàcEEZaaěǒxvhlXtPYyóUStjlǎvúNiǒpaaé	TRUE
aúàcyXIxyètYnPhNtVpxqsaapǎoSaaZJFǒiEMòXOàKA	TRUE
aCǒfTǒWǔGioZCwTòZófàocàQjǎxzAXQpaaěKóaaCTWM	TRUE
aFòPMǒkòAayikQEMHǎTcaǒaaxǎpǔaanuǎRuRwpCuSMf	TRUE
aHtéAIcUXcèmSculWlXMqQUaaeóáùRàREaaWǒěeqàKx	TRUE
aKcxSpFCWiRòqeaaRPhWiSvaaùmAěvshiKhWóJvéHfX	TRUE
aNbúrààDBmǔAnaJòcfZPuLèCDùHaaKFESolvxZKaaLK	TRUE
aQQzpNGXùgGwxFòáGRicZqCsóAiájhsaaqNGóPMaaáp	TRUE
aSynǒRcKǎaaQúOuHUDRLóXJjyFPEiBaaEgcùIPFHxod	TRUE
aVRUàpciaaáUyNfdǎěfěǔaaóAWzwǎoaLyskmDkHJpim	TRUE
aYcKsrQyaaSgzMáxǔQDdspspóVPáOEzfsiaxaahCdJǎ	TRUE
abUǒZaQpycBgXOéxèǎǎpskèlǎLyAǎhRáǎokQaaYaahu	TRUE
acLNULBiGhKáSwTghVoxeNQWǒelěUóaacPTùsjánaaw	TRUE
ackúyqáěCǒEúaaqmIfEóàrrGtdYSSěpCàeDRTwHQTaa	TRUE
aeOcFeehaaAGcXNFěcVeeéEGuuǎSXóSvzǒjaazfLǔPB	TRUE
ahceKrúvUhuLvOdaaBaaǒbKlennOóUelòdcVRàYwNap	TRUE
ajsǒmǔbYecNGPHaaUFwWóaaojQfSàúàSpzASEMYMjòó	TRUE
amXáǎwqmrúěovbecMIěUkéǎNùJxwvuVèaaxDaaDZLàB	TRUE
apcěBáuoixáfaajNóbwnùàaazùGSxaVrYmúlWMwùxIJ	TRUE
asQǔcǔóIraasaaěYrGBùǔKOòXPNGááEpǔpRwàqYDlsf	TRUE
auPàsajrDùaHvǒEpIsalcaaVqtWzeédEXéaaoéxrfct	TRUE
axúhqáávbIxsbDtdlánǎMeUèǒDXtcaaOaazuMútHǎQP	TRUE
ùùsúVǒvMǒCnYKmzDmqxGjqymjéuněRXIRzZFaCvèHRx	FALSE
ápdvSùmiAWhryǔaYxóveEVtlúZàdhàóxqDějIbuvmòi	FALSE
ébBùOòryVrIiaNBdTMFǎJòfgAZèhuPUIllmàGàáUùlé	FALSE
ěqxòuqaAbǔmMYmvóDRùFUCGrjsaAèáUoèjOǎòORkBMù	FALSE
ǒmUZZEAǔhJqtgùGUèèěǎSoJAeTGEóàGozteEIganqqě	FALSE
BLórTpzcúànfzdHNIǔhmjdiOUAújjěziiISBvjDdFǔQ	FALSE
DsGǎBJmmEFuiIYiWPetZoOuSCLfQǔòQJèdXTGonSHEw	FALSE
GiGcSnócJxSiWMmweǎbSJbyèwoǎksQjàFéeùaVKaèhp	FALSE
JKúǒròáKǔMLERòtTbOlQpZFvúJétGákcWùgTWǎuZòaz	FALSE
LPQóFéùSòcnaLUyěMmyàwCWàEáKjGǒyxxùCDhFèAérc	FALSE
NyFVèéamHǎnLYiLeumǎZiCHVXJKpOiCúDILqǎRěvhzE	FALSE
QerTMjBMlVNtbujIǔDTFMǎhUVDOèNDTqfVrDéwǔEyKT	FALSE
TǔuaYrYáZgbáCWéǎIileqáǒEvjéèàwkHTVdòMbccwWW	FALSE
VcóydWyèǒáXLNOzWshENUgYǎiǔPtNéjzCbtòHěKrrfi	FALSE
YEsRùuěùtMSEpvwMHkHháCLkckLkòawSúeLSdysQAEè	FALSE
aděZKdmòpGuhWyXaèqSSgTaJrCEgnexùOfMlCFSYomJ	FALSE
dCIWigyFòfYFùáXFYBJhKVhzDjòlòSjOiiGqǔJAiqoX	FALSE
fxXIBgmKDjIfQepAènRárOtTóDǒFtnsIpXujsóhTéxx	FALSE
iMzTzdǔkYEYPótEbWiòMJKdQsDJoNéZFáZéZztkDfVS	FALSE
làdSésXlQTbLuauiYoǒKEèoFJsQjqfCùVmKséfnbkmx	FALSE
nGZszigéxùQyMSxZKnvlwvQkéRèQvDzMǔqhqwNxáyoy	FALSE
pSbvóQaemxtkfěMiáóWnpMjiàpmfqěITmVáòYUHǎLxx	FALSE
sAúRpèènSTBEXjImJójeáúǒbqLbVAEIóéMFzntzmàXà	FALSE
uhězNěeěUFEaècWIsWèqvǒkNěuBqMjYvxtóMXKáFlkw	FALSE
xFPaèkoRǔMAěwwXEǎGXQnEtěEqJWWBǔKMèhèóàMPàSǒ	FALSE
aùácóREaagéZRúlèodbHgbUráXyǔjyJHéNělógRhqěaa	TRUE
aábprUpcimǎTSpiBaaomdLIVùaaWUuèEiòEkJRěBěvko	TRUE
aéěpetgòòankcdnFuaadǒàIPfFArHIpTKcèjhxZéaaVò	TRUE
aěpkiVStCàDBuVhnláǒHrYnjaúvMcEUXTDǒSaafaaowv	TRUE
aǒcbKzLdAzJJǒRxYMóqFéqgVěěMaaJpèxqnlbvǔSàaaá	TRUE
aBYXVkxǎIWǎCúǒZcèGaaZIlTdcmmCawěaaòaruhkúvnk	TRUE
aEòuJDxcùFJblǔěSZuXèaanpiěVóùyTnEàTiUaayCrár	TRUE
aGhVcBòěVNweéàicHLDáXKDxEATàTMBYRysújètHaaaa	TRUE
aJycHAjCaapBaaXvóǔeébaWBuSDAmJsMDnbmnFjòMBǎé	TRUE
aMpFóTuDhCcmNawjaaryfmejYpeòuOUqyúULúlMétCaa	TRUE
aPROCcaaHèWhéOcaHǔchldtjàúWOěGOQiYiSYAmaaGEk	TRUE
aSGpLSéVHwhUsDǒQEpWcdqyPaaxóOòmwbUbaaúRhjQǎr	TRUE
aVěsBxgULùXVéJWXNKxDRWBkMùcFéuaaccZCMaaGqXvj	TRUE
aXphGLǎQoipúhZějdVAHCvcoǎLePRèTZaaOaaUZcààyK	TRUE
aacVlSǎEDyáhDFnigxlAxòweLsòbaaANǔUvaaféjTnǎp	TRUE
acFiCRaaIpèJyzqvQǔaǔaaLkBèLSznQHNkTéěěxǎYálh	TRUE
achBraalúvNhDdNITǒàlaaohVwiQòRéSqdKLbuSfSaLm	TRUE
aeúTXqòcúgCxShMzNLaaNAvKéTHEPuàqóRaafhǎtAXuǒ	TRUE
agWùVNZgéDzùMVǒQCòémVOwhQRcxXfCtaaaabTtjrNKJ	TRUE
ajNéhFgqWHcUvCeèwKùGOCfCYǔaaaasqKrTNjxjusoyN	TRUE
amDKfěaXqNXcIqhlKTUKǔwúUdLMTIaaMúaaeOòǒBbǒǒH	TRUE
apáǒdVBpquxWKéTcsQVoxDtBZaaǎBDLéVuBèaatiEEqé	TRUE
arkgcàmzfaaGxdgóǎEqRàLéázpJuòfaaSZàQǒSěcéFeZ	TRUE
auITdóWǒiúWzěUǒjahxúOhcDMàvaaXupTpAyaaZsùEéw	TRUE
axJbMsNeMòkfRècjjfvcàùkLaapfTXàwǎzéoaaùAPtyi	TRUE
ùàcWeRěWUKcXOXJEfěLéǎhdUǔMUrJneuQfXKivǎQbbCB	FALSE
áoDòqálùǔbEùbpJópSiWKtEkCXakXosAWDuLBǎEòrdLG	FALSE
éòWúCéFpJCésefumoolMSóyábLNáǎDOxMHǎěbeORvtXY	FALSE
ěYǔCZóAwOQYiaJgrSTOUòsOhóHǎvpúvEphkpPùcmWDCu	FALSE
ǒòkúFgǎNxǒFóGlIbápàǔOoUqBLgyèxcězJJEbówáiǒSi	FALSE
AhFzQoOpQúbkPOóJèKsóvBOJCEmqjVQjoyDáLxǒǒewcz	FALSE
DalkúcECntNǔáeaóHodFgqkbBTPIéPòZffaRnwWózlQw	FALSE
FkodyúmAeúHVNowáúrGewZOEléMwDHkenèIEJúQNnZSó	FALSE
INwlPvaGdQǎDùWYQzleybúBRTIrQMkbiXgojEtSXóNDD	FALSE
KzjYXaZplyǎTcNCUhjǎkqhǒqmZPúQSùjVWGèztóòwEHd	FALSE
NǒHcfqVwPCMxJVAàoHMZtnéYebKlawiòNeUǎYgdàGNàE	FALSE
PtQXvnMBATsNnuHIáOnxAvUXFàfgBjZVJhbuépóYQyFo	FALSE
ShkAOaYCrnqjTúsoǔXPFǒǔGéùhóQUywǎDQdóhòùIùwwt	FALSE
VtVVdFùvigiLPTVEèGIéAěAMcMRnIěpsNúkUwngrónIc	FALSE
YòkKǎděùOXabSzSrJècQLěGàlfOlskǒJbsIwoTezUrhk	FALSE
aTJpUúMpSncrgIòájaMnioJǔvkèxèYòXàEHǎYxàǎpysú	FALSE
cfTaerBdXjòxèáLUcNhWYIskSufrěBMzOthWkòNéaYèR	FALSE
fóndJwqHnTuámUPUIrohpárhàzQyòúdmbYmdnDdǔIyzm	FALSE
hdIIéHXwkqmRZòJpUmZEyHbaIleXbóQqègQuvbTYKyWE	FALSE
kúcEcynyrtnlFúmujiàCJNUZtuMéxUsbsYNZgJúODjlr	FALSE
mtYsYǒPznuZróUcfěQràbMeQǎSLyqnèzùHùxTǔDEYěúz	FALSE
paxdFdRZEeKBNOZpPpeUoòuYwǎwzCZODXěVsneMzěaAW	FALSE
sBHxTJHqXzpgUKKEkrWǔxFDbdePyjtCXPotěRZOgowUy	FALSE
uaèHaYIǒLOuSVòHtFuBbwBustùótTltpTwFJèFjMjgwj	FALSE
xVWYtZJòEúAqymaCKèwREǒMùǒkóǔXgwQzoěYoěamcLxz	FALSE
aùǔIQcSnǒùvaaaabkRhDǎhRFYòbeTèbáTysBaxeBymràh	TRUE
aálmUGéLǔóaZZáFyòsuábrLcCWòaaBSsǎZNaaMJofzgGZ	TRUE
aécqgfiRěslyDèqgWTǒǒtMaaafSǎǒJyQYZkUVFóaaPiEb	TRUE
aóǒSbǔèIǔjicdSwBsdqkhMtgVvOZTǎQDaaTNideiWaaéè	TRUE
aǒlSKnéJRpGfQLEYZxsvùcrIgaaJAnòvMéZaahUmwPóWù	TRUE
aBoǎHGnmKIVGcZPmvéaabxǎnǎrSaalàùHhǎùKsqdDóoBo	TRUE
aEmbòWGdzáVcuFfěnzIoxcaTbújLaaúaaǔbbkfpúLiJòu	TRUE
aHLǔTyLcrfUaaUgwqnlrèiJàtumzNjfSoQùqCHJnaaǔgé	TRUE
aJcGVUaadNrgDLJNBPoCylrmOúKPGěRǎeaafjSFQpqKQǎ	TRUE
aMpPVsǒHáFgVùIXHcMfqFlaaběaabhzYTDBXhěrdLRBIy	TRUE
aPDAǔùóNǎhjwálWùàsEDcaayzǔaaOfáiRNèTCZWmórZPa	TRUE
aRvWJbqidǒcXéiylNUHécpTúaaOFúéWaaqFnòNsignǔIZ	TRUE
aUTAqXbèǎǔcbfLqyFǎkowòoNtvaaèvFRóǒeàǎRJaamQěn	TRUE
aXǔYEǔclóaaHYthlCfsóyaaCSSAFéǔhJuèEtYlflúbVàd	TRUE
aZgPòfweejHDbUuhUVsměǎRcPaarmèfsaaFvbnsRJhXpz	TRUE
acùǎMYNzòOóFdSYvnpnzùjzFcpaabùiYaaDtèějKPfYhJ	TRUE
acWvikKUOiúǎKkYnéJsrnaaaVAmiXdkyThqqaaNjFKfúy	TRUE
adOejNOeEPDaóFpKdBCǒsNdwbLaOnSmqXcRaaZdaaZyói	TRUE
agQPwsFòJcTVEPMjqhnctOHròXhBaazFAèXuǔnshkéaaK	TRUE
aiuùòMGyTecShlhDàuzdSUsNSDaatfXKaHWúaxaahuEIǎ	TRUE
alXyciAeuóuCcáaZRámaabFhhgsbOaazGnǎXOFUézSjKT	TRUE
aoIcdAhǔLTVquigqaaòOéxIlJxKWéHdlhUmqIvgáéaaTz	TRUE
arEpòěIUYcèóITOàhbbxpaaǎOKrCUòmaaGCBAàXóScAúW	TRUE
auEPeHeFùrǒcǎYvrGodaaDRpvKnaadějWróTCZkBǎMztw	TRUE
awftevòcCǎrcXmmlloWZdonyùjcaanǒaaKJztXHEJcfúě	TRUE
ùùeéPuáuWCCuhǔxiǒHFògóBǒOgcDàYDùòKJmPviwTUpǔe	FALSE
áchvàBZIdmXktácWtlrpntùOsbpGGxbfvZcnaVfěBùTVu	FALSE
éáFEòOScùTCzWSǒACihǎNǎbYigcDóǒHFZaàYújNmǒKUIu	FALSE
ěJVdSmàněmdéiěobLLAdXaRlynMHùGébxǔZdRrQBsrlqO	FALSE
òPóèǒaxhHKHtEUbYCèlúnHTkBWyùSlKGUwiuvNtVYàDkP	FALSE
AYpXéBajKRóóKWòóǎèPàaCèzHúwòcgPvIgVùWrúOěsòǎv	FALSE
DàzMaEGzfGBXbǎCèMqPAMpǒǔkjàsZKáYmáHcsaOPyqǒfD	FALSE
GáKfRNàóóèpCHòQǎKneoóRLsAyljnrúzuùDJtZZěPdAèR	FALSE
IjSSǔòǒgàdkhGdHdVhvjEréHPbDhwècóàMèXubjYvǔYKn	FALSE
LPuOVOóxZkPUgǎDèGTeiqvmRkápWYCUwShOáKJKLǔNMZà	FALSE
OèqkBOvSrDhFgněNnjZǒèeWDuǎsKéIOjHyGMNBzgòPzSè	FALSE
QVczQBuQáUMNǔEVǒQXfRBpàUbmdAZèSAOkgzXóHwrjSvJ	FALSE
TKHANǔTKSPJáSiImvNEóSzàùRMeéxpyexorVUCǔmyZIéY	FALSE
VqqtmVèSkLYàězcǎàFòPAczSàLǔéJǒXLufHecéWKjpòZj	FALSE
ZùáǎxMhChMrUěUfLapavòyEòlgásyYhYAGóéòsBcsgǒeě	FALSE
bóZǔkAázoksuHFxvYdLYwoHrbzVSDùsOósòbMIpnjyVAv	FALSE
dúywPwMgaQKTgMnvvSxǎzùRèmaóxKYunQpzmèDsoZJVòd	FALSE
fWjóWEěkZKUúoàóutXlǒQCràǔxyKjEtXWpLyPljdGnsDx	FALSE
hibshPZěfBhWèkrzmPàqFKOYLxúǔàiaFNǔUcǔěTIZaòsB	FALSE
kkOluTxCqáReèàvoéHbYúAǔdNèEedéPSVJDyCěBgJQSéò	FALSE
nQdkpMIGcOótPǎáǒuéacrhEdjjTQuOúáCúRyuòmmWbYoú	FALSE
pYǎuéNdYVYéziliràUcjiěvqúXMCqeXtduMJpàjbIQǎǔl	FALSE
sKArpùtFJBVCSVIMZQixhxàtPVébWNoòJiěpJbDxlGGbl	FALSE
urMCǔECaQZDòùfkZiNFHMIáSAlàOGWscZDZMdjùaVWgWQ	FALSE
xPQULòyqTpWtLPZúGeLfTǔlèSmXkJQhcáerfzadóvtóUó	FALSE
aùàǒzAMyMFIújaěwBycǒàhòMPqkuSSkEaaSyTògwMsaaaY	TRUE
aáaòǒceòméoèèàjQèCxaèbvaaCmcóàzeSJexHeuAaaèNJr	TRUE
aǎxepjcǎaabQplAáGkUDjOaaéIiǎSHiěyhJnCsIuUBkfnb	TRUE
aěbgǒcjhlsDevLkiMxtYgkwGùèXǒDxǎaUwjàùejaaBzMaa	TRUE
aǒFwEzOckùKaaóOXNIIòaahuxFqGNQTnpnEàfEòràTQxhò	TRUE
aBǔeAnéckpàzúSPRzèNàqAFyaaúnaéOrPaaMèréAsZkùéa	TRUE
aEěQWjaǎCiLfeWcóNkánUHWXzFocdaamxsGcǎEóaaNhoXz	TRUE
aGlcoFaapSǔUUàMjMùcSpPMvJùaITěIOàbéHSaògùdAaaZ	TRUE
aJEEwscSeIGFXaafǎitljafaaVPěrVoqǒéxdiyxNDTwqfT	TRUE
aMHùkUoáǎcWOélpOaawaaóKpIsSúBóFLvarRxCeQátxCHT	TRUE
aOpáVkoUèǔTpfáiqàcUrbJKaaóěxgFWPVaaGwiUùLWGqkp	TRUE
aRYqKHlǎQODùzècLEhúiòaaEPqMTuuálgJhnFrsjúaaǔHM	TRUE
aUMPYǔbhXCQIXWcOjvThaaxXWaaVWrIóXrGQEFnNúfǔbtK	TRUE
aWuóhmTùaǒKuùěxEòcǒCóeyaaròoaaIóuèǒUUwQǎIFMdvA	TRUE
aZmdùòùDCúcLèJpaaUaaXCBpQòFòXIFLDvóòèàRWégXfbL	TRUE
acǎzTějKBSPTZtùǒxYkNxJLEaaxBkQpùeaazúFRsǒgǎavl	TRUE
acaauǎNSyIéfrǎYUYijYěáǎPbzfIèvceSnfáYEdtdiqNaa	TRUE
adVPvàQbzYKWtcaaWVRǎZàiGmXxaapyujYMǎLEénǎXTAns	TRUE
agNMaqcoVXěèaaaaxKVgaBNdSuPmiNGRKxTpEQócXnBjNc	TRUE
ajVOkXómIWcLwgèbǎhYRsTUemǎáDaaZoàNǔTDGEáaaoGWh	TRUE
amcBSFejrFùǔUdKLùtwyrXěXaaKKSANzètbkHMFaaGèVOǔ	TRUE
apZBscéSYSEOZógKcǎhNZSaaHNTnlLǔóǒyěaahuágNHSTú	TRUE
asùKgzQùcJaaNXmYUgvqEqaapfwUuBòbwMnǎéqqzèàǎBGó	TRUE
aubécóPkYóǎxvùùscjrdHCZNApeoacwjyFLaawEèJJxaal	TRUE
awzKǎèvǎǒoózjtcvòúNmtaaèBgCAaaTiPQZpgrYEpQmvPF	TRUE
ùàsFfjFHiudEǒKonJxfámWyzùMYVsKùéùIksrrYEèàWtjT	FALSE
áowUǎpksqhoIJhlrEmSeuxWǒIǒIMOAICǎbkLóácèúJúoGi	FALSE
éhpzkiZZPIjeLáúzéaLáSEpNzRáěFZsSAYxvuùútYNwbwú	FALSE
óITUùéTnàWOOUzYiYVbulVtièhUhuBLxyphIQǎKJIequòm	FALSE
ǒJsfxBCowbCUphPǔmmBVLǎóhQùJfHfòecKVEMYGcbTpkiA	FALSE
BEHCéxnoáiǒzùáòèkExKbAbǎágpWJáèOLMéWeTCěDswáQb	FALSE
DmEcCfIdòucODfVcMBvCulùèiáàóqFólxBfynuymwLJXRw	FALSE
GVWXzYòtWeihYZkNDNgZóduotJnOMekGusQvǔzùSfBDOuS	FALSE
JEXJvwnxááPóHzaXyynFoofUéWMpDǒbbCZrkNMQIwhYXmX	FALSE
MEnfJxuáCrbQKPpúèrhzǔUtHěyàVúYBrJEFwyiúkXAeěèQ	FALSE
OVnèóàéyGJWJtvmiJwdyǔdPIǎGJFIxWqèNIjtéaugQBWXc	FALSE
RRXòùGGqNjJpLsjósqěRkgxměhpbNIapvEvǔEónpnYZùàk	FALSE
UóQánKěúwdAwfoutDǒvnùIFXáòaxYqfFIàdhTshGécsǎyǒ	FALSE
WSèělfldXWùǒEsqOthSlúuèFùOEWéòMCirDměgěúwòIqfP	FALSE
YsǒKèBXàcǔdiHeèafnEIZGIDPúYéyùkbièròǒqùeSǎWèèI	FALSE
bmUKùSáIEwztJkjUYLfDèGmEAǒHxCuaEYgǎIàěNSpoqHày	FALSE
eUuǎFuZJěXLévlkǒZmRhzdRòwvYKèètnCNrYCpQoGǎhhaH	FALSE
hJáZZbHQBèDROWrúèTGqmJGSBěàDǎaQákccEémoJduEEòk	FALSE
jvěéyAMòHòUmaUXoPCInSJDNcvIPzoǔZùeàpKclázRawBé	FALSE
mTóMRxOéIKfǒtwctptnEhǎGrttayfwǎYFdXòésySKěrllm	FALSE
olFrEfrGzfsnuvRqsImOkáJlduCdDPOézByFQZzěéZOTúF	FALSE
qdRjxYLIúZWrKkòYágèikoòxyxDéCTnkwlǔǎAJùoBDAúXY	FALSE
ssBvkwIxRQIVSFlUcǒgIzkbaAwNZòSJǒǔBPbSájáJězFjq	FALSE
vJMmYfEXiQXvufQNéQǎrWyóomáěrRXlCrégLiVDCGněRfǎ	FALSE
xvBZYQuLyVHoWEJvkUXUGTIrjZxgERMtqRdàMèJǔǎFjLhD	FALSE
aùóEwWàiFkYHòobcàFkFrgtǔIMYéKaadaaǔmBGSWVKáRExv	TRUE
aáZòéNcTnymsQqRéScdjùAUVRlNvuHkLgaavNApMXbfaaFU	TRUE
aǎvùleLDjtqǔArdGstuěoHxùHRcKaaPBXeéENPrDòMVféaa	TRUE
aěevhsJPvvCuJǎBsxdbaPQYxPócmLwGǔaaezUFaaBcpǒKéA	TRUE
aǒOùmùàóEPHéhQAóàǒqvQcRgxiakFKèùeaayWbaagěòlrjC	TRUE
aBTswiKeáhxIHaèUbDcWtaaCHKzBùiSaalYOǎùvIǎùióRfá	TRUE
aENáXáFEùfùpOXhQWvEéKúàcJěúAwaakǔIpǒkINiǒYgěaaT	TRUE
aGtXkBLEcaUEúcáSǒnqbLgYjaagqěntNdMMIvInwaaóxKtJ	TRUE
aJFwUkkgònXxwEEGùdzyǎIZMjěicPěóLXógPvUdhgtSaaaa	TRUE
aMáNYwxJqbthhVUYrmbLòpófèAvCécùaadYaaóZckyZónàO	TRUE
aOXzIxTBjzbUóHcJPaaZUúnSealcVdèWěròefràaaCWǒfdk	TRUE
aRúàeIyFVSQFzchùZrXaaRuaxàjéWAQSAúENlǔOSaaGcQDs	TRUE
aUYShiCwlIeQBkápgAaècráFvxLàaanKXMfEZèSódaaiǔèf	TRUE
aXéPQZtVréNdXgvsUóIòcCrěaayaaAbQòJOBPJjuhMKěèCD	TRUE
aZuéRcTaaòénBduBbBGbQwuwYFDfkSVnSrnlIjǔzTGǎldaa	TRUE
acAèòǒjfUenZfeěǎueTaaYàmbtGǎNaaGvFhdRDtmjEveATs	TRUE
acdPUAùaaoěáQaaaǒQTMHEyrFzeDTǔexsUzscOèTKvaXPUx	TRUE
adcFǔaNWpSwlDaaùZVrMyǒVedǎbMizRyoóùDDaaváOWùArp	TRUE
agpàVúiwópQcàéyaaxaRtQótOiǎjrKòOBǔǒǒwaaleuTóógf	TRUE
ajYcǔJELtvuǒDIwhpukjBjcáòuhBMkPVRfúAETěPjKaaǎaa	TRUE
altwAsbòTécOUèhdEsIDRRKROclUaacHěaaeFóéFjEAAChò	TRUE
aohcRgrYlǒxppbTwUóRmEaatǎkaiAwksjácyObRZEòTaaNv	TRUE
arǒZtLrtjJuHMtcXdágpSkNóaaXěwTcVrQyzxècxàWZIhaa	TRUE
auǔaQzáJgerZSZHjùFMpeycdlVaavmjZgLáyRWóboGMáǔaa	TRUE
axèpTqVbsgDǎmhptcFLzVRYdèBòaaǒǒKSdrPEaaMGWùpkTU	TRUE
ùǔLJJSáKCRXKǎǒpógTǔxUiWtFIǔáǎKiOjhěLǔMnwLtVásuo	FALSE
àòeǎoEVvecǎsjJaVaùSwmMúèLdiVDqiyGpWàjLbWwuògòhU	FALSE
èKáVDóězěwIQCUòǎòlIRUársQwáXùJyfQoeQwǔèCXOáTaPb	FALSE
òSáěòlQElnDúyuFuBPgòLǎIFlnVǒópHǔlsEéQKéVèBpùtys	FALSE
úVWmRstgLksǒfzùQúApsfémWrCáRyJCQbàQbPGyrlIYYcIH	FALSE
CFáJPjǎúvxTzWàǎbRiIBrǒTNgyàfWZCAòadòEEMsGàEqfJz	FALSE
FCujmTǎòYJaMpufùoMpjfReKEYRCeúVJqVrcfWóRzGYkFùa	FALSE
HVFàHgùěsAfJCTgGOùXpSFéOdgǔHTúiRǒóVNckDàbkOchgh	FALSE
KǔqRLGLEáNliGěJwiěGǔùOXǒùdlsRpàcsFóAéWnkZěSOóch	FALSE
MTXVacaUcéJvLèSZceZyBájzéJtcekěXwBtjàYUǎoDkfgdw	FALSE
OlěùKEcnYIilKbujfkHěPpǒpkmòsmXIópǔoěCqfFjEúQyxI	FALSE
QvQDJNDVMXócǒòHtiAFáSèfRésěJrhTFqHiQqèjQǒèsfZǎy	FALSE
TSKCNpdgWXokKFIhRZRsRLjpǎbjàYháMòWsUjmPZáSaOǔój	FALSE
VwéIěkHUfVQEòòǎRzBlXáàùXvNWuWSGXMKhiZohǎwZAoaeB	FALSE
YAVHWAeéaùzqtQcèaFDǎBdǎYwERYktQdàòdàMnèphvNUHIm	FALSE
aaMNheǔjáRdRFeaOAùDptbPMOQǎCcyùCkUVòoxèèmèVTHbE	FALSE
djnrtòúlVxEmSAànSrácQúkNZVrTGVrsGhTěhárcRdXBpfJ	FALSE
gIoúpOùCvzcJKhapqVèáDFttWMuúkzYNjhfoPtgBcuRceúC	FALSE
ivRSIOggnddóGeBYrSgLSǒFSKgúNhàDLBNvjLpHYòEQSfHr	FALSE
lòGgaGJúcSDxhseAOPSTlCJZrCpOèsúdGhNFjéJusMxfHsc	FALSE
nbWvváyVùALzyMDIsúQYpyQǎQPépxbGAǔYhuVzàòLuIIRgp	FALSE
pyDRyòùoIóóbUpYúfěgxkCRúueúugqDèNSClFNCUBiuéDóé	FALSE
sJǔgnwKùrXCuópuHuéDAFádhǔúuKrYèKaàcFikhéaùpqAEz	FALSE
vèJxFmbCtnLCbkkNhéáVxóqǒǔJlopozHnàQpPucXúùmSuLk	FALSE
xksjùVfPGěèccXXXWmwxuKxyYDhúLzHkXOvLrdsqEbOjǒùG	FALSE
aùùHLLqúYcávSYcAlwOUtvkhPJéIAúúvvIéaaKúóǒdaaǔxàh	TRUE
aáscéBJWEFǎDTZaaLoECàCaahFdáùXDPúDhMTICczdyOoWLU	TRUE
aèǎcYmPnzèXJǔNGsZaacfvecxrbiNsaaOéEavazúBZjPveGZ	TRUE
aóhwOcprqáǔhnOaaQYEyěgQoJièXlzaaGKFWátnXNGAyMJàP	TRUE
aúIGJQvcáUòMzmWVLùùsJYpǔAaaKYssMùléHIkRǎaaLJLYné	TRUE
aCàěPyxPcuPWjCǎàWLěVuOBsoúDlsIaaqhDzaajgkèJdFǔǒE	TRUE
aEkiNohostXcYdXèZEvǎaaLFmGjWzèwuXKóǔGGsxfIaaZKdú	TRUE
aHQAǔFèzbPXoeRcrvJqRxqéáHRMUcEěehPRbTcvóJaaaaèkn	TRUE
aKShIQFgèyúyTcerZaaNBòwGviáVěyRùěsMkùǎúvAgaaóXOW	TRUE
aNBEZǎGpHwodseàkKFEebcZaawVaFSpǒNqrUwfaawxóNzǔéz	TRUE
aQCybleéAòGsjOscměaamkQóDAbVǎCbǒaaDIeWoqGdhjIYGr	TRUE
aSqAǒpúQwóEViǒcSkAaaTqyNVmkǎaamjJWyMBjayòǔéǒǎpàs	TRUE
aVNùpfǔGcpeIùúéGhdúaaYBuǔháVěKJJtRaaDǎwnQezfǎBQZ	TRUE
aYǎPyLTǔàùJZMǒSǎǔUwckZJYóYǔIǔJǎaaǔtTàòaaUdhpxhBZ	TRUE
aachdaauǒNScPZOheǔaǒTHùSúzLaalSǔrJúEéùjviicCihIq	TRUE
acAgúyHěBDQICǎAiǔrnéIòxOéáuázhmXaèJùaaWWòètòéWaa	TRUE
aciJvNIomnWyflhVptsVfhDcmJaaEGàSèYSCpmXàIǎaaéxZn	TRUE
aeNǎùMCconkazVaaHòhòYxwésGCZgTnaaxIěMèóvEùúJynHú	TRUE
agyfJǒRPFbZuYKsekcáEiwKESeaaěexǎHéTtdlǔYùSIhpěaa	TRUE
ajjggfǎRGWùQAMcDIùùJVenwwVoaaǎèǔMnLrAbmkDOVaanIt	TRUE
amCVúZLqdcùETPDaaLkshDaaQixKóGMèxnvWùkKyZduoakěS	TRUE
aoyGfwcmZKJCIáǒlózǔNǔvǎáqfcUbǒzgaaGnuiwOsLUjaaAz	TRUE
asOqzasóXáGKWGQWcjTizwUyyRáoùIEaaGnZVBábùMaIaatB	TRUE
avǎouYYjoHkynZTEWcdArlěxyaauòNbFáwSoXrnóUjoVdaaH	TRUE
axcHèlMtaaǒDGWiMJUaaPSznxOJEkóZxfTxHzYPAVsktùQǔé	TRUE
ùùMRmKlQqèpIáOtceSGfMgǎǎneRnkfaělxnǒpPJhLBIóvǒvF	FALSE
áNèǒhsmUXpxULagZòúlhLpèWpPbGSeàhuTHZkkkrScQǔázEè	FALSE
ǎZtaKgBzdùWxvarRimlòQSBxToeéQrWdnǎjqilIǔhǎggybòW	FALSE
ěDwVàOěFPcXSgtIHSuJWNXyeecWIkéaoTaǒIFKDYmUúJuGSf	FALSE
ògjúNǔòCzOoěPèSwMtZǎmEJǎófTNccáúYoKAxbagáFYBnoKP	FALSE
AFcSozYvEZDqèUxhófbOùàpLrcguàAěrPZǔěcSjùòěMApAcz	FALSE
ClDEqQbckkěaKhTxCǒRfFWcYxdYXǒhfàcgOǎPěkcAsBasAtG	FALSE
FbLbǎtbQLaarěORóKáBeTOóómSljqFFqqtpSTXǎǎEYóǒNoàr	FALSE
HuPépúehzDèrǒOloúDaWfUDIDGMIeQqúLnvcfcYǎxKǎǔdWèo	FALSE
KZiIaIiCnRvTǒJUnLLǒtMuXqyǔjaHrBóúúIIKAjdMVDiBXZC	FALSE
MwèAzNGJúhDóFHSnlYEnTrVǔfjǎǎINTxIéMKSteSlDPSvMǒd	FALSE
PIvCGYVrAJJYksěeHfèHyoMORMxxJgěISNǒěvAětMBJeèCàt	FALSE
RmzylXqKzIǒHwHhXUQfwxVimekEaoDwaTǔgSùǔbAIotLKèYP	FALSE
UWXjoazvlHǔzǔiZPjFǔhgǎxIXLijtZlYZNTVpùJaúAGtjàsS	FALSE
XGEǒGEkmkzpbtKnJǒWLxEuGvNwfGǎmyOáOpàrmtVRyecsèvt	FALSE
ZXfIJSKǒSZǔvwYZDJIdyiǎócsgnQǔxpJpjǔUyWbdkTAYàdǒs	FALSE
cHoxǎLjVoRNuTZYpxDruznùqVlàZMEóNWǔpdèUótkòǔEHoki	FALSE
etXTeUPHLxoúzádWéUkwùlKXqòyfxèMXiEeXáPqCZesKMwǒW	FALSE
hOkMòzyidfvZrqmátINǒLYcWEǎaéRǔLvóúMnUXéZrHóZHXvm	FALSE
jwZwTǔvHObǔSwuòJàVWBBxmWcòeIHYQjúUhVbvééYlhRFZPk	FALSE
myihrxbǔJZqMéLàEéuibTFpbrètGuntehwAǎOǔǒBmǔZmwlùh	FALSE
pKPGfhJbúèeUVYóRFKIcMicrUEdXcqCjúCXjGRLǒyáépóVRV	FALSE
séFKPsaOǒsktǒyIǎDMóOsobáPQkDkoúKqTǒDnxeTnùFěWTxc	FALSE
ugnEdùtcǎeDsǔqǎKHLTùzbRriEǒasYnǒInǎasfúMRZBSZLSǒ	FALSE
xJzCàpPpmgUyoCTLejbnèGsnZzYOiLùkFCIWcBusXáwXTuZc	FALSE
aùǔIúMcfEaaqZITsScEoosàtRolhsùAjxxaùELtbhLUmMJNaa	TRUE
aàéJmmrtVwGMLdfcéòěQǔǒaaxǎaaZRWEěQJupǎjiioMRotfEX	TRUE
aèǒXmóewlciMYdXyWepaaNnèMfàWMúFMùYkCVBXLCRHaaCVwY	TRUE
aówáúzkzIKJkAcqùOTBPLǎaaOGWěvvjNUghMUlndMgbòwgaaw	TRUE
aúWcSucBphpccjHyEHǎQfveaapWtiǔdzNòaaJVpHVMvLEoeAm	TRUE
aCRSQJmSzKdZcyádRCOUǔecqOxèǒólqǎaaèsaaKJwúxwHOxuo	TRUE
aEkjxèbSmmjCMGjRúfmzMQcGVtyhYDflNaaùyaaLvGafPGMvà	TRUE
aHfPphseKQczjaaaanbYYLahtyàvpaǎǒZVcěexwxJxàPCèFdn	TRUE
aKrbSǎScúkaaYèPMHvJDxáIVQaaigùMcgchilHDbhàahvBhAM	TRUE
aNVEcTòéèhbaaaaiàòǎQxKRYàtlǔEùhkǔǎDùSAǎleǒúuǒúqóO	TRUE
aQPVsDěcrHNGwèEǎBKrěúZGxsTèbZúLIZnIXùóaaysaaXMEeD	TRUE
aSxEAJZDǎjGrBJfrvòrǔmYiyELdcyMòáPomzFxaǒGzaaFaaDR	TRUE
aVcǔJaaAlóǎJcWóètqvffaQkMJBcXWèwWyLtKfRnPFIrJKaaw	TRUE
aYóǒùlSIǎMPXijeùYcWózHèvǔNIkcgáBaaòmoJhkOàhuXóaam	TRUE
aafyOYHNjtRzQHJRShNJàcBsBèòùěaaMzyaanAPEjfHRTvlEC	TRUE
acFWAJLNFMuǎúǎnUuSóIfipYbaaDCQMWépǒǎGWǎWaamUODnoá	TRUE
ackuiIBSNTynaakpnzxGyJTZsqèaQMlgàCknaèjMuyKBxzaaK	TRUE
aeNgcúIoJèhCvhèVeaaòǒgwFcCpzDtLaagrxXXváToKqFèQUé	TRUE
ahcKzWrǎzoaTMèàeaaasiwuaoQCHGmzPKùaaIJlFEnzQBZQzó	TRUE
akBjácèǔúnAzyúJKhFaaVaaIblgqěJqAóùUGXLàPZǎcgMioSǒ	TRUE
amkáaTcNhZgqaacǒkMónCǔKnZtaaàěJdIYsntùjǔùhǎóRXBwi	TRUE
apáQJPaǔàfNQBkXRQrrcFfsèaaCaaLTBWSùúYòMEptRUèPijl	TRUE
arwPzáDRRxCóMEosUasǔHRúscaafSYaaWYQMqZòcWUPEqéVék	TRUE
auRóǎSYBcaYNKtcOAfMyOGeXFhXPaaptXwXVzFcaaVTEéuAYl	TRUE
axFPmdFcDZèVaaOaqpDeáMDfKIaamǔeVUmXZlúYǔWUIqùLěwe	TRUE
ùàyǔnHHXòlRhsUSógHqwouZWHQfNNenBIafEFSèèSFWJzyfBX	FALSE
áVuAèuFgXwHòhùaǒùzNFbHKǎeCLBoòGééLnSAaPihdVkEnùǒG	FALSE
éBpclàéóǔKAcǒpwùRKǒhFQoàntáúbǒtkTDjAǔěǎFeèxKXCSfb	FALSE
ěoGzltǎSgKxǔjèéaedpXpAǔókqózFhIxPwjcIcáPHFZKmhrUB	FALSE
òptouStùaáUAlBIoDèPZMvwbáYUǒélDcúǎbgIwlěwNRyltIIa	FALSE
ADhiZPjKubpeFWòlKLěZtjuwáCHáoFsswnHMòEǎaùZóHèuòoQ	FALSE
CvXvMvdijwCRMBáiYYcpéiSéXgóQZOOùUóǔěpsEMěCHzxiRUh	FALSE
FJaytDvbIMóxxùvSèòxùdpIzWlsěLtRMgpóNjHjnhiLBùNàlq	FALSE
IAǒQáNǒKdgcqLMHrùtUJEoNyàHVóFRiálQglRuhFUKǎCYòǔqU	FALSE
KtúuéOùSOáǎjgRiIgACfòǎyZvORkMjàǔeCHjqyóǒóXldOzcpd	FALSE
MzbJzIIAtYeQPěéSMNAaTCnFkRùVtjǔkXbwXqAgsgJwPbjxkv	FALSE
PfUǔVRyógaùkǒxcǔxRùmXNDCvEkLbcvsǒFKlCEXEZbMPmǔtév	FALSE
RvTǒCIuJxvwFúEGlZèěéDějnàùEnWZjèRWOěfaqXVjGàTqxiá	FALSE
UEVxMgVáEVUěbTMbNixǎPGNoXgjgfemCGUǎkwiQCedùsbhUsc	FALSE
WpPòVhóHFcwaǒLùJnpPNmchyinréBRvǒfceWèNPgICRqǔjrUp	FALSE
ZWáòxFwǎfWéUXAǔPhǒyrShgGVoězKáAGǔlàuěǒHOZTéMseùWS	FALSE
cèPaǔèPUèjěBOdesdǒòCsOHpòlmYǎPzYCguqflúaùǎLSHvdUf	FALSE
eqdkCIwxzcsfMcGǎùlùèACzèyQSZDzWliwSxZóQBZéDNJpIùN	FALSE
hirNújwAiyděǔěbúCbùzdtùMQùělWymZKEaaxcvEoéKiùjtěV	FALSE
kErmJwrkhhptTmuTFgéJRAbuBqxvblEkaAAPsxVNòhhfiZǎáV	FALSE
nHxOJSJWqcwEiFpRPFkjFǎyFZiHlcYlKRbàMceúkGǎBCàPuNA	FALSE
pxZóQEwHùZúdéKwhFbJgtvxQltbyfxfQRrjHǒáwnaRAQfdbsn	FALSE
sSJyècmUJǒYDkuáKRltZnTOúLnááèNbPlèYUTHApǔlhRáǒGYò	FALSE
utCQAqaǒòhQeYùzùèIdAHléYsóǎBǔAùLeoóVOZAèujPóiòAáW	FALSE
xgpqzòUUhaudǔWQdfTFgSstouVěJTyTòKěLoóyúwrǎVHLLsyk	FALSE
aùùOGULǔbúkLKptcwVjòsnSǎSaaMùàhUlwDRuàúNFtkěbaarCZ	TRUE
aáqzeJMFcAùQàBáPàYaUrpǎqaaCǔDòóǎfáFòaapzlUYbcòJOIp	TRUE
aèòJǎǒǒGòBàudxTàEBéàWgDbxóóPcécnaaBAYRèOoCěEàkVǎaa	TRUE
aówdXFAjxWtzáqRěcCǎaaycěGmǔNZèfàwElqgeùydzXMaadoùj	TRUE
aúJǔùbǎGHybcXaaWjxaaRYǒùOGNRQyPEFExZrfVáHòBtAVHzkg	TRUE
aBrǎSàZyZǎecMiPǔǎtWZGzECaaYéóàGCrfPaaVZǎrlMzùHgByp	TRUE
aEcěHkGdYexéFxqmaaùGHTǔphuópjFùacoiaauvOùóqLiiljéZ	TRUE
aHCmKSnkgUQoIBPfDQàkRwbwVdagqǎjmCàlnucdpaaPaaáTtWZ	TRUE
aJkuctVOkQPrèaaépuvicCedzjXéjDvǔsOmNyáǒaaDUKKBnrCg	TRUE
aMùBpkéjVòPItBóóVèewKcréùiaaaawpwúfDreMwáùaYDSdhàB	TRUE
aOiqwRtàhǒJvrzzegduHkPèjcEIRaatǒǒaawKZiECnAdeOXésv	TRUE
aRjXWKrJqslvéccòvùWaiàèPaaCGSKaamYǒhFVmúIIǔoqMRAwM	TRUE
aUJXǎbQQuDějNFOóaYcaaóShUqzcgXùXbaaipepmdǎZvemngWc	TRUE
aXDODcCUToùIntizfCòvVàdtúwtaaZQUoXǒNeLOmkPLaaDúLQú	TRUE
aaMsòxbrBzNaqiGXJofdHRqrcFFkKJOLdOǔXaaaQǒrúaaZaOGr	TRUE
acIsaaofoúWYvULFiǔZjhǒzAuaahrùeuqùjOCOToThDthFgCaǔ	TRUE
acimKUybcCuzxgOùvtDMVuGdsvksǎLXQaaiaaǎaèpUgJláeǎuz	TRUE
aeLGérzcnAPtzDPàKySCsGGLLTgǔàkFaaVWaaOdUYváàwQúaǒb	TRUE
agvCàBlqcMUNrXláuKéFòquUěòrNQtvQpèwaabFrSaaHgǎLsǎD	TRUE
ajMxèZoǒggVjCóKWTGLcjWQKěyYùaajnJáNsRWHVeJDUaaTtZF	TRUE
amǔtIjNnéǔNNLoPvùǒPGKòKrzcaakZPDǔaaěNkTxpáLeZNCBár	TRUE
aomHMBZLYcDwUWSbYaaFjMEQiJbrvxóáOaapAaPeòRgèǎcRZnW	TRUE
arTKXNcáèYáxwCǎqěyWpúkVmMijYùKjWSǔYaaepaaripegvkpK	TRUE
auědRHqmUBùtLkJédáTúFUOQvZHBooěěyHqcdaaqxoeCwaaèRy	TRUE
axǔáòKqIpHqWmáihFPcSǎǔnmaahideyNàùPdókaaECAááAXPáG	TRUE
ùǔǒlrZRveCàEnCzIǔHIéJJàǒNaRNkXzeggSEWAUxǒúGgksmqlO	FALSE
árDfěòXKMcáumEJòQOuLksAEàbmbtzoqAxoóBDóbòZùBQQBaWf	FALSE
éGgIXNpIoDkZpoúQaRhqJpQDyZKèCèPUewqNCuIjgrZKuBczfW	FALSE
ějWTGfààuhIXòǎIeJdèúZòtkMGTPBBAvDmIòmqFǔùǔqǒúeSúóA	FALSE
ǒBUENXJNEóaWfijGXùkmCXòFCúiAnBkCěfZfKvǔjhHéLXAvǎML	FALSE
AOqygǔLOIIlcReǎòbàùgQsrieTkpǔcSYòkSgpVójrIBWqDtVǎq	FALSE
CYkàhcYtYWcǎPQRPóFgoIVXóesùBMMQBISIJáeěKkKKúrTeùXn	FALSE
FàPcàjGBhbòPEWVúCLdVàzLRwfXúQDhJxǒKuktóHWIǒEǎiěácò	FALSE
HQpEwQIgEMOéROKdyNZEQRHtMnFOáBsTFxEPGùltqeqcsZFcwZ	FALSE
KòsmvHGfuèvěPàěǎIàúhkwArbéeěmehéGùaqmǔVaǒǒCuETdiDD	FALSE
MQWgévLIkyYMLxXCxbUáZYǎAITèèsxLásHòGbDlRsKfljssBCV	FALSE
PǎteOfefDvóǔLRUYfěNZápDVYdBtrJNjǔAMzBTxDlóamáBPáqè	FALSE
RbhMòIiUlOgDěDZrěSIurǔMùRDcssnqúxxFHèXDOBbóxFàjVhy	FALSE
UHxIYGèrLxcCjOnǒǎYGgùvlZGóWWǎWǔIVWnǔkweǎgéQSàLIXaP	FALSE
XDfúwUtoAKRzCkvpDKZuáewAǔDDpBVpyCcwVULRáQIbkoSZuvc	FALSE
aáWRǒvXxHwjǒièYLUtWUMǔpxrsóCyWKQwIlegòǔwkqùanxMoEm	FALSE
cbúJUVǔàEaxèkwèoatLèXKVSaGokKQTéFKgwmóTKbètGyáèjWN	FALSE
epJWfohgFLcèǎsIqwglPrBodhgFTsBǎJUéeEChMWVGDGdNfvHG	FALSE
hlTgQCNVzOeUZTUubscGugǔeqAèhPXmKMbBgeáLúLQvNRǎPzáù	FALSE
jzFpyfkoújSWzULqIYWéètkiiotgiTùǒàéHUoXUCRkórCdbeàe	FALSE
mbúlQyelBktwàITtIUEcGVnbNRRNPàOTOKsnGdainGLAGosHEY	FALSE
páPPXSùfàéAkúEQndhěVùqPskMLcIfPZMrdGwZICihúcéBúpqq	FALSE
sAúXlYcàRiUóRXAèfǒMěVsSAwVqKpzBuVlèúgpòièvMsMIAtsk	FALSE
uZWfGRiKORkMwipBáUHuǎRzZuGǎRzuJcóLwZheVYrLjNbOLmwD	FALSE
xhěUDqEZXSùòXiIdóàDrpPKDHwIáVrHUiDùlaǔfBZbAnfTAHGt	FALSE
