aùAùáaaaaakdRaaYKJDá	TRUE
aǒWaaaaaarGQhXùrddUO	TRUE
aHaKlVěaaaaaaFSXcBèv	TRUE
aQmdèaaaaaaEMbwEǒǔǎk	TRUE
aaǔYaaaajNèvdúǒaaǎmW	TRUE
aaARúUOKaaaaaDTǔLTkd	TRUE
aaLǎUGutfmkdaaaaaNkm	TRUE
aaVHvaaaaaowoaLǔNWèy	TRUE
aaaèaaaaeXdNHXWnGJóò	TRUE
aaaEkózǔlaaaaùKmǎgIQ	TRUE
aaaOfTRyùhSRěǔáaaaaY	TRUE
aaaZVaaaaòipéjLUlQèé	TRUE
aaaaúVaaakMtlLrússpè	TRUE
aaaaLQogǎlCseraaaSěǒ	TRUE
aaaaaùòáswuaaptXáGWb	TRUE
aaaaaBlnCLSákDUòWBaa	TRUE
aaaaaNGSàltVAhZTmraa	TRUE
aaaaaaùěyncǎzúaHAssA	TRUE
aaaaaaàDAtàméjǒzeavW	TRUE
aaaaaaékakRhsnnwYWCù	TRUE
aaaaaaòBǒnúXvLnOěVgf	TRUE
aaaaaaAEMqTùLtaeóèèé	TRUE
aaaaaaCxqijimáxSSVxZ	TRUE
aaaaaaFXnumsódSóCYMò	TRUE
aaaaaaIHIpFéáwFiévGè	TRUE
aaaaaaKpmQKuesRYABMs	TRUE
aaaaaaNZHkpRFNǒpkUHS	TRUE
aaaaaaQěDkyESjiLMéáǒ	TRUE
aaaaaaTéQáéQèPYěwixò	TRUE
aaaaaaWVmBvUikVèVHoA	TRUE
aaaaaaZKǔAPXóVSYqIaK	TRUE
aaaaaactùVXXxbúbKvdd	TRUE
aaaaaafoǔǒsFSKpNbBmc	TRUE
aaaaaaibbJúLhàèáRQLh	TRUE
aaaaaalHjkaJěOèǔiBǎC	TRUE
aaaaaaoèpǒzcǒEěǎhàěN	TRUE
aaaaaaqIǎwǎúPEsuAxúO	TRUE
aaaaaaszNNBéeNǔaVVYW	TRUE
aaaaaawGJǒREráDifIHá	TRUE
aaaaaazCóCuwfyBxRdFZ	TRUE
aaaaalgErCuèCvaapBCZ	TRUE
aaaaawXaaDèeVvtLqeWm	TRUE
aaaalMgWàwmaaazvlDǔé	TRUE
aaaayéABaaaFácFFltOj	TRUE
aaalBqhááǔèmoaaaaPJi	TRUE
aaawIvǎvaaaaǔTcjGJAJ	TRUE
aahdaaaaawjéGtnzèàǒD	TRUE
aaraaaaaePMUàHuěPeJó	TRUE
acǎúéOóǔNDsNrJaaaaaa	TRUE
apùaaaarNFaaaJJnǔDwT	TRUE
aùAùáaaaaakdRaàYKJDá	FALSE
éaǒWaaaaaarGQhXùrddUO	FALSE
aHaKlVěabaaaaFSXcBèv	FALSE
aQmdèaaLaaaaEMbwEǒǔǎk	FALSE
aaǔYaaaajNèvdúǒayǎmW	FALSE
aaARúUOKaaaòaaDTǔLTkd	FALSE
aaLǎUGutfmkdaPaaaNkm	FALSE
zaVHvaaaaaowoaLǔNWèy	FALSE
aadaèaaaaeXdNHXWnGJóò	FALSE
aAaaEkózǔlaaaaùKmǎgIQ	FALSE
aaaOfTRyùhSRěǔáEaaaY	FALSE
aaaZVaaaHòipéjLUlQèé	FALSE
aaaaúVàaakMtlLrússpè	FALSE
aaaaLQogǎlCseraavaSěǒ	FALSE
aaaaúaùòáswuaaptXáGWb	FALSE
aaaaBlnCLSákDUòWBaa	FALSE
aaaaHNGSàltVAhZTmraa	FALSE
aSaaaaaùěyncǎzúaHAssA	FALSE
aěaaaaàDAtàméjǒzeavW	FALSE
aaaaanékakRhsnnwYWCù	FALSE
OaaaaaòBǒnúXvLnOěVgf	FALSE
aaafaaaAEMqTùLtaeóèèé	FALSE
aaaaTaCxqijimáxSSVxZ	FALSE
paaaaaaFXnumsódSóCYMò	FALSE
aaLaaaaIHIpFéáwFiévGè	FALSE
aaTaaaaKpmQKuesRYABMs	FALSE
aaaaaéaNZHkpRFNǒpkUHS	FALSE
aaaaaKQěDkyESjiLMéáǒ	FALSE
aajaaaaTéQáéQèPYěwixò	FALSE
aaaaaiWVmBvUikVèVHoA	FALSE
aaaaaóZKǔAPXóVSYqIaK	FALSE
MaaaaaactùVXXxbúbKvdd	FALSE
aaaCaaafoǔǒsFSKpNbBmc	FALSE
TaaaaaaibbJúLhàèáRQLh	FALSE
aaaaXalHjkaJěOèǔiBǎC	FALSE
aaaaOaoèpǒzcǒEěǎhàěN	FALSE
aaasaaqIǎwǎúPEsuAxúO	FALSE
aaaaaùszNNBéeNǔaVVYW	FALSE
aCaaaaawGJǒREráDifIHá	FALSE
aanaaazCóCuwfyBxRdFZ	FALSE
MaaaalgErCuèCvaapBCZ	FALSE
aNaaaawXaaDèeVvtLqeWm	FALSE
aaaalMgWàwmaaoazvlDǔé	FALSE
aUaaayéABaaaFácFFltOj	FALSE
aavalBqhááǔèmoaaaaPJi	FALSE
aafawIvǎvaaaaǔTcjGJAJ	FALSE
aahdaaaaNwjéGtnzèàǒD	FALSE
aaraaòaaePMUàHuěPeJó	FALSE
éacǎúéOóǔNDsNrJaaaaaa	FALSE
apùaaaarNFaǎaJJnǔDwT	FALSE
aùěfaaaaaaòdKHáhǔòQtj	TRUE
aòesBNycaaaaaaQOUdZCZ	TRUE
aFaaaauKaaaFJQùmGkèEè	TRUE
aOuéjLaVèkPaaaaaaJXěU	TRUE
aXraitWěNzsófIaaaaaaI	TRUE
aaéTRFQwDaaaaaáLIGxJà	TRUE
aaEsPYaaaaaTbxypeòRGú	TRUE
aaMsùaaaaBéHaaǎǒBYSǎz	TRUE
aaWcQCMNXTLlnpvTaaaaa	TRUE
aaaěbaaaaǔàèlúImiFiùz	TRUE
aaaGwánfgYaaaaJXKgǒBl	TRUE
aaaSBèuǔRèFéDcHaaaaUI	TRUE
aaaaèNùRbPHPaaaDCEvQà	TRUE
aaaaHzplgINaaaCKIeǎlY	TRUE
aaaaWèúKzuéúltleyaaaq	TRUE
aaaaaòDaauxIfWóápynqě	TRUE
aaaaaHxlnOkJunaaBYAòB	TRUE
aaaaaTwéwDWtgtaaúúOyD	TRUE
aaaaaaǔVBévbItUiVEiàǎ	TRUE
aaaaaaǎòxmjúdIèqùAUGě	TRUE
aaaaaaèrněYtèptgwgáWk	TRUE
aaaaaaǒàANxOfhjNmoXVw	TRUE
aaaaaaAlUfǔTiwuaxvvcj	TRUE
aaaaaaDnoMKaThmvXghyP	TRUE
aaaaaaGZkHYbJcbsbqQGM	TRUE
aaaaaaJgùOjxpHBYyWàJu	TRUE
aaaaaaMMWwzgbwmEUZOZp	TRUE
aaaaaaPvHvǒsgDgFgFǒgV	TRUE
aaaaaaSqnGótYewIQVPeT	TRUE
aaaaaaVkámnotXEòUjéRN	TRUE
aaaaaaYtfesOKDkjkwIjM	TRUE
aaaaaacTWICnDvrQzZQUr	TRUE
aaaaaafUbKcBlǎQVcosǔm	TRUE
aaaaaaifúCQiSyAbxQSMo	TRUE
aaaaaallcPnANàěóGZWsr	TRUE
aaaaaaocWRuàǎVòwěéhkD	TRUE
aaaaaarkviQvxPXCyTLUO	TRUE
aaaaaaukzfǎNSǔYóUtYěH	TRUE
aaaaaaxSeAJjrEmmEiJWk	TRUE
aaaaadhflHcyQdaaZObxQ	TRUE
aaaaaqxtLvràlǎuaaPRDo	TRUE
aaaaejrOIbmLgfSaaaLfL	TRUE
aaaapgSaaahagèfFcRtsà	TRUE
aaadGWRaaaaoDiXREPRPs	TRUE
aaaoWOkiuVaaoddGaaaQC	TRUE
aabóGexQaaaafaaqgOjdm	TRUE
aakTBlYaaaaakPLǔwòjbB	TRUE
aavǎoLùǒcraaablBxWaaa	TRUE
agOèǎeaaaaaaRGOCěǒJmd	TRUE
apòaMèěRegNǒGnaaaaaaP	TRUE
aùěfaaaaaraòdKHáhǔòQtj	FALSE
aòesBNycaaaaarQOUdZCZ	FALSE
aFqaaauKaaaFJQùmGkèEè	FALSE
QOuéjLaVèkPaaaaaaJXěU	FALSE
aXraitWěNzsófIaaaaauaI	FALSE
aaéTRFQwDaaàaaaáLIGxJà	FALSE
aaEsPYaaaOaTbxypeòRGú	FALSE
aaMsùaPaaaBéHaaǎǒBYSǎz	FALSE
aaWcQCMNXTLlnpvTPaaaa	FALSE
aúaěbaaaaǔàèlúImiFiùz	FALSE
aaaGwánfgYadaaJXKgǒBl	FALSE
aaaSBèuǔRèFéDcHaaIaUI	FALSE
aaáaèNùRbPHPaaaDCEvQà	FALSE
aaaěaHzplgINaaaCKIeǎlY	FALSE
aaaaWèúKzuéúltleyaaùq	FALSE
aaaaaòDaPuxIfWóápynqě	FALSE
aaaaFHxlnOkJunaaBYAòB	FALSE
saaaaaTwéwDWtgtaaúúOyD	FALSE
aaahaaǔVBévbItUiVEiàǎ	FALSE
aYaaaaǎòxmjúdIèqùAUGě	FALSE
DaaaaaèrněYtèptgwgáWk	FALSE
aaaěaaaǒàANxOfhjNmoXVw	FALSE
HaaaaaaAlUfǔTiwuaxvvcj	FALSE
aaúaaaDnoMKaThmvXghyP	FALSE
aaaaaHaGZkHYbJcbsbqQGM	FALSE
aaaaaYJgùOjxpHBYyWàJu	FALSE
aazaaaaMMWwzgbwmEUZOZp	FALSE
aaaúaaPvHvǒsgDgFgFǒgV	FALSE
aaùaaaSqnGótYewIQVPeT	FALSE
aaazaaaVkámnotXEòUjéRN	FALSE
aaaaQaYtfesOKDkjkwIjM	FALSE
aGaaaacTWICnDvrQzZQUr	FALSE
aaWaaaafUbKcBlǎQVcosǔm	FALSE
aaajaaifúCQiSyAbxQSMo	FALSE
aaaasallcPnANàěóGZWsr	FALSE
aaaaMaaocWRuàǎVòwěéhkD	FALSE
aaaaxarkviQvxPXCyTLUO	FALSE
gaaaaaukzfǎNSǔYóUtYěH	FALSE
aaaaoaxSeAJjrEmmEiJWk	FALSE
ataaaadhflHcyQdaaZObxQ	FALSE
aaadaqxtLvràlǎuaaPRDo	FALSE
adaaejrOIbmLgfSaaaLfL	FALSE
aaaBpgSaaahagèfFcRtsà	FALSE
aaadGWRaaaGoDiXREPRPs	FALSE
aaaoWOkiuVaaoddGaYaQC	FALSE
aabóGexQaahafaaqgOjdm	FALSE
aakTBlYaaacakPLǔwòjbB	FALSE
ahavǎoLùǒcraaablBxWaaa	FALSE
zgOèǎeaaaaaaRGOCěǒJmd	FALSE
apòaMèěRegNǒGnaaaáaaaP	FALSE
aùùáquVFGaaaaaxKmaaáěl	TRUE
aòHKRAóJaOaaafXZSaaaaS	TRUE
aGRaaalUTuaaaacèǎXVùEN	TRUE
aPQkVaaaaaaáEUxTNbǔHVD	TRUE
aYměsfTàODgéXaèaaaaaaǎ	TRUE
aaójxpǒUméyKaaaaaUYyol	TRUE
aaEqinWXeléGJkVeaaaaaP	TRUE
aaOfMaaaaěPYFéLoòMsaaf	TRUE
aaYǔmxVmhpWIZaaaaaoúDL	TRUE
aaaěsvIǒaaaavoSNWmmfàM	TRUE
aaaGmàaaaaábrúpǒdokkùc	TRUE
aaaQdnaaaNáeUvaaèóMTAR	TRUE
aaaaǔǒCSécQzFbtgSaaaLM	TRUE
aaaaCfpeBVmlFeBGOaaazò	TRUE
aaaaMUaaaflozèoéuoéyàE	TRUE
aaaaXgRhOtJuóaaaJIAuKQ	TRUE
aaaaaózOijnTaaómWáUNǔv	TRUE
aaaaaJdòaaLTHmBǎǔNeèAd	TRUE
aaaaaUmSArbGRmsOaaFjhe	TRUE
aaaaaaǔOQxRDKLzESyrOzs	TRUE
aaaaaaǎFCzhcgCqNTPPéhU	TRUE
aaaaaaěǎúMèérWdzèFàguR	TRUE
aaaaaaòoLǒiqUsIfùiuGfB	TRUE
aaaaaaBàsDagpèihěéǎòRC	TRUE
aaaaaaETqzléhgóojnáiQD	TRUE
aaaaaaHyyOjǎdéǒjzOxqTè	TRUE
aaaaaaKyzlZkWEǔUóòwQLk	TRUE
aaaaaaNqJJfámJYvBMQdúǎ	TRUE
aaaaaaQrLRDvogovUMmǎgM	TRUE
aaaaaaUXVjBPxVsúunGzqò	TRUE
aaaaaaYTUypzTǒsUAISàPo	TRUE
aaaaaacRBRàEǒhzòUcGbǒl	TRUE
aaaaaafóOǒYXéàPEǔUdwMg	TRUE
aaaaaaiǔòAgNULáJěǔtpǒp	TRUE
aaaaaakvdAEbDZJCóǒTOhF	TRUE
aaaaaaooOáóXmpAqShbNvS	TRUE
aaaaaarqNǔùhXFéoWúěStq	TRUE
aaaaaauqKmcHUáǎRelbbCú	TRUE
aaaaaayAjQyxPgnǒXVrjùA	TRUE
aaaaagaaYeZkùpèépcbIěě	TRUE
aaaaateKJáJàFxjSExaaEf	TRUE
aaaaipǔaaaóGThóqwTwzhL	TRUE
aaaaunPxueùùzNaaarmJnY	TRUE
aaagǎNgsnaaaQFàQNaaZEb	TRUE
aaarDaacCqejpQhaaaquOA	TRUE
aacdòglSNFèRJaaaaaTJwk	TRUE
aaoWèàwRěaanBaaaapcShB	TRUE
aaxxYsgěbVnuuuMaaaaaZd	TRUE
ahaaaaaPédzqBòaajLùúao	TRUE
aràGFnheCTBXtaaaaPaaac	TRUE
maùùáquVFGaaaaaxKmaaáěl	FALSE
aòHKRAóJaOCaafXZSaaaaS	FALSE
aGRaaalUTuaaXacèǎXVùEN	FALSE
aPQkVaaǎaaaaáEUxTNbǔHVD	FALSE
aYměsfTàODgéXaèaaaaavǎ	FALSE
aaójxpǒUméyKaaacaUYyol	FALSE
aaEqinWXeléGJkVeaaacaP	FALSE
aaOfMaaTaěPYFéLoòMsaaf	FALSE
aaYǔmxVmhpWIZuaaaaoúDL	FALSE
aaaěsvIǒataavoSNWmmfàM	FALSE
ùaaGmàaaaaábrúpǒdokkùc	FALSE
aaaQdnRaaNáeUvaaèóMTAR	FALSE
xaaaaǔǒCSécQzFbtgSaaaLM	FALSE
aaaaCfpeBVmlFeBGOaáazò	FALSE
aaaJaMUaaaflozèoéuoéyàE	FALSE
laaaXgRhOtJuóaaaJIAuKQ	FALSE
aaaamaózOijnTaaómWáUNǔv	FALSE
aaaaaJdòaáaLTHmBǎǔNeèAd	FALSE
aaúaaUmSArbGRmsOaaFjhe	FALSE
agaaaaǔOQxRDKLzESyrOzs	FALSE
aaaYaaaǎFCzhcgCqNTPPéhU	FALSE
aaaaaèěǎúMèérWdzèFàguR	FALSE
aHaaaaòoLǒiqUsIfùiuGfB	FALSE
aaéaaaaBàsDagpèihěéǎòRC	FALSE
AaaaaaETqzléhgóojnáiQD	FALSE
aaaFaaaHyyOjǎdéǒjzOxqTè	FALSE
aaaaaBKyzlZkWEǔUóòwQLk	FALSE
aaaaaJaNqJJfámJYvBMQdúǎ	FALSE
aaaaapQrLRDvogovUMmǎgM	FALSE
aaaaagaUXVjBPxVsúunGzqò	FALSE
aaaaùaaYTUypzTǒsUAISàPo	FALSE
aaaaaqacRBRàEǒhzòUcGbǒl	FALSE
aaóaaafóOǒYXéàPEǔUdwMg	FALSE
aaataaiǔòAgNULáJěǔtpǒp	FALSE
aaEaaaakvdAEbDZJCóǒTOhF	FALSE
aaNaaaooOáóXmpAqShbNvS	FALSE
aaalaaarqNǔùhXFéoWúěStq	FALSE
àaaaaaauqKmcHUáǎRelbbCú	FALSE
aaaeaaayAjQyxPgnǒXVrjùA	FALSE
agaaaagaaYeZkùpèépcbIěě	FALSE
aiaaateKJáJàFxjSExaaEf	FALSE
aaaaipǔaaNóGThóqwTwzhL	FALSE
aaaaunPxueùùzNaaéarmJnY	FALSE
aaagǎNgsnAaaQFàQNaaZEb	FALSE
aaarDaacCqejpQhagaquOA	FALSE
aacdòglSNFèRJaaaaéTJwk	FALSE
zaoWèàwRěaanBaaaapcShB	FALSE
aaxxYsgěbVnuuuMóaaaaZd	FALSE
ahaaaaaPédzqBòaOajLùúao	FALSE
aràGFnheCTBXtaaaPaaac	FALSE
aùǎtAOrǒaaaaaajDàQěwVxò	TRUE
aóBmAeKYoàJSòrǒJaaaaaaY	TRUE
aEǔFúěVGpWaaaaaatQmdRhc	TRUE
aLbaàVlěFHaaaaaaEěOǔkáq	TRUE
aUòǔSpVaaaaDYSéqaaaǒlWv	TRUE
aaálaaaaaáěǒEMdàxvtWjmS	TRUE
aaAIIhaèYrURoúaaaaaféqL	TRUE
aaKyhWQàjqQpǔaaaaanwǒEk	TRUE
aaUOndóMRMǎHQyWbaaaaaLc	TRUE
aaaǎIátAěaaaabbUXuhbPUd	TRUE
aaaBsaaaaàETúKhBmFúyHCC	TRUE
aaaMqǎNVaaaaFTfFYáSZǎNI	TRUE
aaaWCaaawlUKVaatasNElBj	TRUE
aaaaèoàZmoúmSMúKgkaaaRY	TRUE
aaaaEIaihdQPqIFaaaLrRkS	TRUE
aaaaQHnNěxRaaaVfRekoymL	TRUE
aaaaaùsWAwùiwUNaaqLbxnV	TRUE
aaaaaBAèGvwzSEcsBùEaapA	TRUE
aaaaaLODbsiaawKVpIcbgqG	TRUE
aaaaaVZhThácúeNYdaafEox	TRUE
aaaaaaàCòRVYRódiTáwgáóB	TRUE
aaaaaaěàtALnkàevkPvNFbE	TRUE
aaaaaaǒHrrcQzrèúGQqOWHi	TRUE
aaaaaaBKévhDòPDGcCAěRàj	TRUE
aaaaaaEbàuàTóxyQěBUQYTd	TRUE
aaaaaaHZcDmǔNǔèòóavsKNj	TRUE
aaaaaaLúuEògùbǒuZěLbJZO	TRUE
aaaaaaOcHXsVòcǒfaáVpHúT	TRUE
aaaaaaRuBLmǎEXUfCtǎMEWj	TRUE
aaaaaaVGPhgjùPáǔPcoREDr	TRUE
aaaaaaZBzqvALkPDvfǔBiug	TRUE
aaaaaacoQySmuSqcUslOHjB	TRUE
aaaaaafwájvugoCGLcCHwDA	TRUE
aaaaaajTfeMoHaXdáPLǔTkq	TRUE
aaaaaamtéCycòaUTǎpjfdnS	TRUE
aaaaaaqFyVǎIúqeèikHVèxH	TRUE
aaaaaatrmNàbfDcKoOGDlqB	TRUE
aaaaaaxngcòtetǒangZuoéY	TRUE
aaaaafgdwPaahěATivjòIěx	TRUE
aaaaauěǎbKGǔaaǒlvàUWpòQ	TRUE
aaaagURZiáGwǎaaaǔOzwsàu	TRUE
aaaasáWjúzǎáúǒNnaaawYFB	TRUE
aaacdltjfaaaajGiXlvèIAé	TRUE
aaamsaaaaMùYAáSHDDpOPeǒ	TRUE
aaawóqgJúxaaaaùěpPpnsvǎ	TRUE
aaggèIdxwièraaaaaSHJúzǒ	TRUE
aaprcZmJaLNaaéaaaaQdùfa	TRUE
aayaaaaalFZkfkNǒfǔótoUk	TRUE
ahxUMàikǔǒXoutaaaaaaòVH	TRUE
aqgzKQEUEslaaaaaaaGXzNm	TRUE
aùǎtAOrǒGaaaaajDàQěwVxò	FALSE
aóBmAeKYoàJSòrǒJaaaaalY	FALSE
aEǔFúěVGpWaaaaaVatQmdRhc	FALSE
aLbaàVlěFHKaaaaaEěOǔkáq	FALSE
aUòǔSpVaaaaDYSéqaaNǒlWv	FALSE
WaaálaaaaaáěǒEMdàxvtWjmS	FALSE
aaAIIhaèYrURoúaaoaaaféqL	FALSE
aaKyhWQàjqQpǔaaIaaanwǒEk	FALSE
aaUOndóMRMǎHQyWbaaxaaLc	FALSE
aaaǎIátAědaaabbUXuhbPUd	FALSE
avaaBsaaaaàETúKhBmFúyHCC	FALSE
aaaMqǎNVmaaaFTfFYáSZǎNI	FALSE
aaUWCaaawlUKVaatasNElBj	FALSE
aaLaaèoàZmoúmSMúKgkaaaRY	FALSE
ataaaEIaihdQPqIFaaaLrRkS	FALSE
aaaaQHnNěxRaaEaVfRekoymL	FALSE
aaǔaaaùsWAwùiwUNaaqLbxnV	FALSE
MaaaaBAèGvwzSEcsBùEaapA	FALSE
ajaaaaLODbsiaawKVpIcbgqG	FALSE
aaaaUVZhThácúeNYdaafEox	FALSE
aaaavaaàCòRVYRódiTáwgáóB	FALSE
aaaRaaaěàtALnkàevkPvNFbE	FALSE
aaàaaaǒHrrcQzrèúGQqOWHi	FALSE
aabaaaBKévhDòPDGcCAěRàj	FALSE
aaaaaxaEbàuàTóxyQěBUQYTd	FALSE
aaaǔaaHZcDmǔNǔèòóavsKNj	FALSE
aqaaaaLúuEògùbǒuZěLbJZO	FALSE
aaǔaaaaOcHXsVòcǒfaáVpHúT	FALSE
aaxaaaRuBLmǎEXUfCtǎMEWj	FALSE
aaaaFaaVGPhgjùPáǔPcoREDr	FALSE
aauaaaZBzqvALkPDvfǔBiug	FALSE
acaaaaacoQySmuSqcUslOHjB	FALSE
aaaaGaafwájvugoCGLcCHwDA	FALSE
aaaaǔajTfeMoHaXdáPLǔTkq	FALSE
aaasaamtéCycòaUTǎpjfdnS	FALSE
aaaaaúaqFyVǎIúqeèikHVèxH	FALSE
aanaaaatrmNàbfDcKoOGDlqB	FALSE
aaaaaoxngcòtetǒangZuoéY	FALSE
aaaaMafgdwPaahěATivjòIěx	FALSE
aPaaaauěǎbKGǔaaǒlvàUWpòQ	FALSE
aaaPagURZiáGwǎaaaǔOzwsàu	FALSE
aaaasáWjúzǎáúǒNnaRaawYFB	FALSE
aaacdltjfaaFajGiXlvèIAé	FALSE
aTaamsaaaaMùYAáSHDDpOPeǒ	FALSE
laaawóqgJúxaaaaùěpPpnsvǎ	FALSE
aaggèIdxwièraajaaaSHJúzǒ	FALSE
aaprcZmJaLNSaéaaaaQdùfa	FALSE
aqayaaaaalFZkfkNǒfǔótoUk	FALSE
ahxUMàikǔǒXoutaaaaaròVH	FALSE
kqgzKQEUEslaaaaaaaGXzNm	FALSE
aùǔAaaaaaaeubIòzOJálBfcj	TRUE
aǒaaaSiqEAaaaaAFmtdǒǎLTg	TRUE
aFxazCOpéQmiVRàaaaaaaIkx	TRUE
aOvQaaaFZAèFOaaaacJóáběú	TRUE
aXBAUanlùLpdaaaaaTQbaaàǔ	TRUE
aaèDáúaaaaabKKùKoKJLDLaù	TRUE
aaDdZúhlaatfkUbQEDKaaaaj	TRUE
aaNdVèBuàyaaaaaeERàxNmmY	TRUE
aaXlvcpHǒPaaaaoúaarsZóiJ	TRUE
aaaóAOFCDAksEvúiWzaaaaAr	TRUE
aaaFkJrBtDIaaaùáxuǎjaaèn	TRUE
aaaPlVfvwFpUqWwZIaaaanUf	TRUE
aaaaùMěǒWFXhZMKTwmtAqaaa	TRUE
aaaaúiXpGaaaǒPǔǒAxhRlnWO	TRUE
aaaaKQàhwdóeǎǒèRaaaLfbwn	TRUE
aaaaTùJǎVaaajcYxQrBpOERf	TRUE
aaaaaǎqèpaaALMéèmFǔIéBiǎ	TRUE
aaaaaDXòáODhFRaaTEvKKcLv	TRUE
aaaaaOHIèMèiJCǎInqKaaVqO	TRUE
aaaaaZaaWǔIawǎébèFsEèYǔà	TRUE
aaaaaaàǔpQJǎiSJkwbǎPdKbO	TRUE
aaaaaaèXóJVAaVVóZSLzmJZK	TRUE
aaaaaaǒǎèwcpmPHyéZxUDeLú	TRUE
aaaaaaApòúRaùZtAJsèwlCúc	TRUE
aaaaaaEWiNKldǔxqDoypDèLg	TRUE
aaaaaaIFǒJoèuYàvxnGWPPóX	TRUE
aaaaaaLtuúPmTǔUéǎàTYRnOp	TRUE
aaaaaaPMcóúxkRéGHógTrJes	TRUE
aaaaaaTfbrDSUOzáLVOLrLǒm	TRUE
aaaaaaWtCNBonvFECweèAYpw	TRUE
aaaaaabMXiAfújàHqikMzzúZ	TRUE
aaaaaaeúUezwoDHQNeSMHboá	TRUE
aaaaaahòbUVóòǎFdòbQèUQTe	TRUE
aaaaaalBòpǎybjWzdkǎǒYRgó	TRUE
aaaaaaoWfRjOYmtpgPqkzBNx	TRUE
aaaaaasǔǒGExAhlGOzfchIàu	TRUE
aaaaaavdsRgàjuǔWhwGúòoDi	TRUE
aaaaaazDOwiMoLFxACQBQMzá	TRUE
aaaaakIQxhAeeAaaTKqPKDǒj	TRUE
aaaaauaausxZOdlùZǒGéGéFà	TRUE
aaaahGéèadfqNúzVgGǎvaaaJ	TRUE
aaaasúSádǎRaaaqjǔǔRǎGycB	TRUE
aaacjAaaaatyAZTOHkǒGNàzE	TRUE
aaamQDaaaahGbEZóiartLòNL	TRUE
aaaxúTugpPěúpJfaaaafmgWy	TRUE
aaiAPpxWvódSxaaaaaMtCùpw	TRUE
aarhXyEaaaaaRùóDFlfǔDèjǒ	TRUE
absIúHMlHaavkIUtGZaaaaaO	TRUE
ajwfMxSuJkgJXrùLaaaaaaQS	TRUE
asKTItúRǔaaaCPùaaaZpòLaa	TRUE
aùǔAaaaaéaaeubIòzOJálBfcj	FALSE
aǒaaaSiqEAaawaaAFmtdǒǎLTg	FALSE
aFxazCOpéQmiVRàaaaaasaIkx	FALSE
aOvQmaaFZAèFOaaaacJóáběú	FALSE
aXBAUanlùLpdlaaaaTQbaaàǔ	FALSE
aHaèDáúaaaaabKKùKoKJLDLaù	FALSE
ǎaDdZúhlaatfkUbQEDKaaaaj	FALSE
aaNdVèBuàyaacaaaeERàxNmmY	FALSE
aaXlvcpHǒPaJaaaoúaarsZóiJ	FALSE
aaaóAOFCDAksEvúiWzaxaaaAr	FALSE
aaaFkJrBtDIaaaùáxuǎjalaèn	FALSE
faaPlVfvwFpUqWwZIaaaanUf	FALSE
aataaùMěǒWFXhZMKTwmtAqaaa	FALSE
aaóaaúiXpGaaaǒPǔǒAxhRlnWO	FALSE
aaaaKQàhwdóeǎǒèRaaLfbwn	FALSE
aaaaTùJǎVaaYajcYxQrBpOERf	FALSE
uaaaaǎqèpaaALMéèmFǔIéBiǎ	FALSE
aaUaaDXòáODhFRaaTEvKKcLv	FALSE
vaaaaOHIèMèiJCǎInqKaaVqO	FALSE
aaaahZaaWǔIawǎébèFsEèYǔà	FALSE
aaaaaàǔpQJǎiSJkwbǎPdKbO	FALSE
aaWaaaèXóJVAaVVóZSLzmJZK	FALSE
aahaaaaǒǎèwcpmPHyéZxUDeLú	FALSE
aaaèaaApòúRaùZtAJsèwlCúc	FALSE
aaaacaEWiNKldǔxqDoypDèLg	FALSE
aaaǎaaIFǒJoèuYàvxnGWPPóX	FALSE
aaaaeaLtuúPmTǔUéǎàTYRnOp	FALSE
aLaaaaPMcóúxkRéGHógTrJes	FALSE
aúaaaaaTfbrDSUOzáLVOLrLǒm	FALSE
apaaaaaWtCNBonvFECweèAYpw	FALSE
aaMaaabMXiAfújàHqikMzzúZ	FALSE
aǒaaaaeúUezwoDHQNeSMHboá	FALSE
aaaaǒaahòbUVóòǎFdòbQèUQTe	FALSE
aazaaaalBòpǎybjWzdkǎǒYRgó	FALSE
aaqaaaoWfRjOYmtpgPqkzBNx	FALSE
PaaaaaasǔǒGExAhlGOzfchIàu	FALSE
FaaaaavdsRgàjuǔWhwGúòoDi	FALSE
ajaaaazDOwiMoLFxACQBQMzá	FALSE
aaaaQakIQxhAeeAaaTKqPKDǒj	FALSE
aaáaaauaausxZOdlùZǒGéGéFà	FALSE
aaPaahGéèadfqNúzVgGǎvaaaJ	FALSE
aaaasúSádǎRAaaqjǔǔRǎGycB	FALSE
aaacjAaTaaatyAZTOHkǒGNàzE	FALSE
aaamQDaaaPahGbEZóiartLòNL	FALSE
ataxúTugpPěúpJfaaaafmgWy	FALSE
aaiAPpxWvódSxGaaaaMtCùpw	FALSE
raarhXyEaaaaaRùóDFlfǔDèjǒ	FALSE
absIúHMlHaavkIUtGZaaaAaO	FALSE
ajwfMxSuJkgJXrùLaaaaaCQS	FALSE
xasKTItúRǔaaaCPùaaaZpòLaa	FALSE
aùéQǎkWzqtZWěaaaaaahfuItǔ	TRUE
aěàùPfqgvckBpaaaaaajhǔGǒm	TRUE
aCzaaaaaaǎGXkdyIYóxGbCCxE	TRUE
aLXqGlfOsWwGvéMrRtZaaaaaa	TRUE
aTaaaaaaWrAFYàslrCTYLZIlV	TRUE
aaáòéùMzaaauaaatlVsrPáúYX	TRUE
aaúJXyemaaaaaWǒèsowtBBbAU	TRUE
aaIòhQvqItaaaagráǒǒnFaaHd	TRUE
aaQǎOaaaaaIOnqKǎSNjfCAsYm	TRUE
aaYLJòEroqyaaaaaWYvBùXMMN	TRUE
aaaóTzImvúǒKRáJVràavaaaaN	TRUE
aaaGdaalsaaaLamnQGdTMvEah	TRUE
aaaRFòDbEǒuaaaaǎàEkhZǎVqé	TRUE
aaaaǔJqùBxKJzTXpkSrZqaaae	TRUE
aaaaǒSKnSéóàKaaayúkJqQutx	TRUE
aaaaJYTLNPDXèaaaèoFOxRXLw	TRUE
aaaaTǒvISǔCXyhqaaaNmXZOVǔ	TRUE
aaaaaéùdqpáWmgXaaCxJnaàJù	TRUE
aaaaaEuAckicòBóaaOCǎclVIC	TRUE
aaaaaRǎNtěNMVǎàaaèěyxCYǔH	TRUE
aaaaaaùflBnAEuKdàhHfKtEMè	TRUE
aaaaaaǎzNGnrMIDKéJmEwYKmn	TRUE
aaaaaaóvóRàGqCúqGKmfYzuDǔ	TRUE
aaaaaaúnGEIFHmOIMmBpCPCqh	TRUE
aaaaaaDMèààgXksewpqdqVvòJ	TRUE
aaaaaaGkKQěxEbFlfohtJxóúó	TRUE
aaaaaaKòǒQcCtúcTòBDhXTSYO	TRUE
aaaaaaNhrǎpǒSNZYxplKòjqbú	TRUE
aaaaaaRKěRpVhCjCPVdOLúhàr	TRUE
aaaaaaUqvEàXZffNOjhamWèJt	TRUE
aaaaaaYMǒEaTaNmUCmoQúUqdX	TRUE
aaaaaacNzáXLZXùDěnrěwǔénB	TRUE
aaaaaagkSscInbmQapuPùvWCi	TRUE
aaaaaakǔqěNǎcLJvwDDQǎFnGZ	TRUE
aaaaaaoIxáRMAcgrgQZeajgPq	TRUE
aaaaaaryMMZfXpEehǔjǎthlVX	TRUE
aaaaaavYyùnDLOnVszkeóKǔvP	TRUE
aaaaaayxDRDǒscèVvùkrKfvRù	TRUE
aaaaamVhwjEOàcalaaúAUDSoǎ	TRUE
aaaaawuzPGěùòZénULMéZòaag	TRUE
aaaajǒuOǒaaaGxsùjàfNBrǒqě	TRUE
aaaatJěaaiaaáHQRjJYvhmqrA	TRUE
aaaeIidKéXAjEiaaaaáàéyZAo	TRUE
aaanfgEpAvMpRsPsSaaaaXpfu	TRUE
aaaxěAáùqkFèswáaaaaIGXTéQ	TRUE
aahLvQdaaaaaZOMZvaààihzéù	TRUE
aaqTiUBQěFDsaaaaaHòFúZYVY	TRUE
aazBaaaaaRMbWcdQNàZDCOBjz	TRUE
aiKǔwudaaaSàtéNmwDOcaaaat	TRUE
aqkmRZjIgórAtaaaaairJwGaa	TRUE
aùéQǎkWzqtZWěaaaaanahfuItǔ	FALSE
aěàùPfqgvckBpaafaaajhǔGǒm	FALSE
aCzaEaaaaǎGXkdyIYóxGbCCxE	FALSE
aLXqGlfOsWwGvéMrRtZaaTaaa	FALSE
aTaaaaiaWrAFYàslrCTYLZIlV	FALSE
aaáòéùMzaaCuaaatlVsrPáúYX	FALSE
aaúJXyemaaaáaaWǒèsowtBBbAU	FALSE
aaIòhQvqItaaahgráǒǒnFaaHd	FALSE
aaQǎOaaaaGIOnqKǎSNjfCAsYm	FALSE
aaYLJòEroqyaaNaaWYvBùXMMN	FALSE
aaaóTzImvúǒKRáJVràavaaaǎN	FALSE
úaaGdaalsaaaLamnQGdTMvEah	FALSE
aaaRFòDbEǒuaaaxaǎàEkhZǎVqé	FALSE
paaaǔJqùBxKJzTXpkSrZqaaae	FALSE
aUaaaǒSKnSéóàKaaayúkJqQutx	FALSE
aGaaaJYTLNPDXèaaaèoFOxRXLw	FALSE
aaaaTǒvISǔCXyhqaaàaNmXZOVǔ	FALSE
aayaaaéùdqpáWmgXaaCxJnaàJù	FALSE
aaaaaEuAckicòBóCaOCǎclVIC	FALSE
aǎaaaaRǎNtěNMVǎàaaèěyxCYǔH	FALSE
aaaXaaaùflBnAEuKdàhHfKtEMè	FALSE
aahaaaaǎzNGnrMIDKéJmEwYKmn	FALSE
aaéaaaaóvóRàGqCúqGKmfYzuDǔ	FALSE
aaaaIaúnGEIFHmOIMmBpCPCqh	FALSE
aVaaaaDMèààgXksewpqdqVvòJ	FALSE
aaaaaěaGkKQěxEbFlfohtJxóúó	FALSE
aaaàaaKòǒQcCtúcTòBDhXTSYO	FALSE
aQaaaaNhrǎpǒSNZYxplKòjqbú	FALSE
aaaaabRKěRpVhCjCPVdOLúhàr	FALSE
XaaaaaUqvEàXZffNOjhamWèJt	FALSE
aaaaǎaaYMǒEaTaNmUCmoQúUqdX	FALSE
áaaaaaacNzáXLZXùDěnrěwǔénB	FALSE
aaaòaagkSscInbmQapuPùvWCi	FALSE
aaaaěaakǔqěNǎcLJvwDDQǎFnGZ	FALSE
aaǔaaaoIxáRMAcgrgQZeajgPq	FALSE
aǒaaaaaryMMZfXpEehǔjǎthlVX	FALSE
ěaaaaaavYyùnDLOnVszkeóKǔvP	FALSE
aEaaaayxDRDǒscèVvùkrKfvRù	FALSE
aaaaǒmVhwjEOàcalaaúAUDSoǎ	FALSE
aaTaawuzPGěùòZénULMéZòaag	FALSE
aóaaajǒuOǒaaaGxsùjàfNBrǒqě	FALSE
óaaaatJěaaiaaáHQRjJYvhmqrA	FALSE
aaaeIidKéXAjEiaaasaáàéyZAo	FALSE
aaùnfgEpAvMpRsPsSaaaaXpfu	FALSE
aMaxěAáùqkFèswáaaaaIGXTéQ	FALSE
aahLvQdataaaaZOMZvaààihzéù	FALSE
aaqTiUBQěFDsagaaaaHòFúZYVY	FALSE
aazBaaaoaaRMbWcdQNàZDCOBjz	FALSE
aiKǔwudaaaSàtéNmwDOcaaaUt	FALSE
laqkmRZjIgórAtaaaaairJwGaa	FALSE
aùǔxaaaaaaQgBoàoDYQBwWBaMǎ	TRUE
aěYèaaaaaaǒóZáAèéXAMmnZLPM	TRUE
aBdpdMLMǒsfiaaaaaaiZsměyěà	TRUE
aJHIǒǔPJSpqnǒEaaaaaaǎKargV	TRUE
aRFDaaaaaaAnjIhUǔpěFhèlǎlX	TRUE
aYQnmaaàlyǔCJYBpHHaaaaaPNá	TRUE
aaèfsJěmòkiGeBKlZjiaaaaaló	TRUE
aaDdqxóeaaaaayqYHiúhèXzqmE	TRUE
aaNFHafvǎaaKvxGòKaaaarLPèn	TRUE
aaWceUáJóòaamxtYOjkntsaaaa	TRUE
aaaéNJfúEzdiMhaaaaOQeǒzeSC	TRUE
aaaDIbZwKLZNzuaaaaORǎQWrIù	TRUE
aaaMóNsaaaxjvéRJaaeJvQrmpP	TRUE
aaaVǔǔxěuaaaatèvCqnRbvěkmU	TRUE
aaaaéaaaǔPYqaUkOnBhaJovPkk	TRUE
aaaaDZiSNXDSCroJIàaaahShga	TRUE
aaaaQAivUaaaǎFdOTúOanXPKRb	TRUE
aaaaZRXzbIrèjqIaaacUylqHLV	TRUE
aaaaaAGjTyǒùAǒQIáKdfCóaadX	TRUE
aaaaaNZkàZIRKfoúOaaàèzcXyf	TRUE
aaaaaYáùhnjaaegIXHwèoQSCèò	TRUE
aaaaaaàWEBùiOòRWYPuèEjPPhf	TRUE
aaaaaaěHéuònrIygéàORádIéOǎ	TRUE
aaaaaaúSAGgXLvaWúcjǔbqDeěj	TRUE
aaaaaaDJóěqwpògkòùRoevxlrZ	TRUE
aaaaaaHhVàWrAfTóáaěùwòFHTH	TRUE
aaaaaaLOXSiExqWicEZjǎǔúvEV	TRUE
aaaaaaPOǎwntZàWcRRwhKsuàkA	TRUE
aaaaaaTǎipRAfrRxZhéugxtéBS	TRUE
aaaaaaXòWDGhikrrcNCàHBAéml	TRUE
aaaaaabRěǔoùuvJuRATHùgeWEW	TRUE
aaaaaafTLùǒòUhǎBDóDúJcdhěA	TRUE
aaaaaajEǒgAyoeRàMuBDlrcETm	TRUE
aaaaaamoGQbizvǔKéuhFoFRTFR	TRUE
aaaaaaqaáJYSyZQěvLcaùǒFDpǒ	TRUE
aaaaaaulòGQjZVàrMlkUzIqOay	TRUE
aaaaaayHmQkyPàúsqGdknvFGKú	TRUE
aaaaahplkaaúRLCdUMdéDǒKmQé	TRUE
aaaaasBLgfHaajIQmlFráqZSzC	TRUE
aaaaeùmdKèzjDDgcaaaJOLPǔVè	TRUE
aaaapsYǔaQzDaOzaaOǒaaèLIUǒ	TRUE
aaacQrOsaaaaRhzùúuWǒuNvrHo	TRUE
aaalèdWHùǒjbǎzèDRLSfxaaaaǎ	TRUE
aaataaaaJJéUvYslèǔPQtzfBVn	TRUE
aadyObTVofaaaaacóHRtHyirǎu	TRUE
aamGMBxgjéNǎèZǔaaaaakáTPro	TRUE
aauznwaacóMvnaaaaǎBgQKǒyti	TRUE
acVxFǒyInmgniYppaaaaEaaaPX	TRUE
akeǒjYòFQMiNFfaaaaaaBEvúěE	TRUE
asaaaHRòtbNUbBQKiòěaaaazáh	TRUE
nùǔxaaaaaaQgBoàoDYQBwWBaMǎ	FALSE
aěYèacaaaaǒóZáAèéXAMmnZLPM	FALSE
aBdpdMLMǒsfiaaaIaaaiZsměyěà	FALSE
aJHIǒǔPJSpqnǒEaaalaaaǎKargV	FALSE
raRFDaaaaaaAnjIhUǔpěFhèlǎlX	FALSE
aYQnmUaàlyǔCJYBpHHaaaaaPNá	FALSE
aaèfsJěmòkiGeBKlZjiaaaaàaló	FALSE
aFaDdqxóeaaaaayqYHiúhèXzqmE	FALSE
faaNFHafvǎaaKvxGòKaaaarLPèn	FALSE
aaWceUáJóòafmxtYOjkntsaaaa	FALSE
aaaéNJfúEzdiMhaanaaOQeǒzeSC	FALSE
aaaDIbZwKLZNzusaaaORǎQWrIù	FALSE
aaaMóNsaaǎxjvéRJaaeJvQrmpP	FALSE
aaaVǔǔxěuaaLaatèvCqnRbvěkmU	FALSE
aaaaéaAaǔPYqaUkOnBhaJovPkk	FALSE
aaǎaaDZiSNXDSCroJIàaaahShga	FALSE
aaaaQAivUaóaǎFdOTúOanXPKRb	FALSE
NaaaaZRXzbIrèjqIaaacUylqHLV	FALSE
aaèaaAGjTyǒùAǒQIáKdfCóaadX	FALSE
aaaaaNZkàZIRKfoúOaéàèzcXyf	FALSE
aanaaYáùhnjaaegIXHwèoQSCèò	FALSE
avaaaaaàWEBùiOòRWYPuèEjPPhf	FALSE
caaaaaaěHéuònrIygéàORádIéOǎ	FALSE
aaabaaaúSAGgXLvaWúcjǔbqDeěj	FALSE
aaaaatDJóěqwpògkòùRoevxlrZ	FALSE
aaǔaaaaHhVàWrAfTóáaěùwòFHTH	FALSE
aaaaaěLOXSiExqWicEZjǎǔúvEV	FALSE
aaaěaaaPOǎwntZàWcRRwhKsuàkA	FALSE
aaaapaaTǎipRAfrRxZhéugxtéBS	FALSE
aàaaaaXòWDGhikrrcNCàHBAéml	FALSE
aaaaambRěǔoùuvJuRATHùgeWEW	FALSE
aaaaRafTLùǒòUhǎBDóDúJcdhěA	FALSE
aoaaaajEǒgAyoeRàMuBDlrcETm	FALSE
aaaauamoGQbizvǔKéuhFoFRTFR	FALSE
aaamaaqaáJYSyZQěvLcaùǒFDpǒ	FALSE
aaacaaulòGQjZVàrMlkUzIqOay	FALSE
aaaaaDayHmQkyPàúsqGdknvFGKú	FALSE
aaaOaahplkaaúRLCdUMdéDǒKmQé	FALSE
aaaaasBLgfHaQajIQmlFráqZSzC	FALSE
úaaaeùmdKèzjDDgcaaaJOLPǔVè	FALSE
aNaapsYǔaQzDaOzaaOǒaaèLIUǒ	FALSE
aaacQrOsaadaRhzùúuWǒuNvrHo	FALSE
uaaalèdWHùǒjbǎzèDRLSfxaaaaǎ	FALSE
aaataúaaaJJéUvYslèǔPQtzfBVn	FALSE
TadyObTVofaaaaacóHRtHyirǎu	FALSE
aamGMBxgjéNǎèZǔaaaaKkáTPro	FALSE
aauznwVacóMvnaaaaǎBgQKǒyti	FALSE
acVxFǒyInmgniYppaaaaEcaaPX	FALSE
akeǒjYòFQMiNFfaoaaaaBEvúěE	FALSE
asaabaHRòtbNUbBQKiòěaaaazáh	FALSE
aùǔveaauroYsVCqIaaaaadjGYTd	TRUE
aóXAaaaaxRZBwYRpjrSsùJFiaaa	TRUE
aCyaaaaaanéROYASLàvHoLsiZsu	TRUE
aKCceMIKnvWánaaaaaaItjTǎOVǒ	TRUE
aRárgEwKjraaaaaaIólUNIHùIDm	TRUE
aZhgTéiEvKzQaaaaaaQfóFènjtt	TRUE
aaěadàMèGuaagirěaaaaCJugGFR	TRUE
aaEoaaaaaSEùCěkJpRHěéTYMzBU	TRUE
aaMwODTaaaaaiqjZrǔúXdgcèIrf	TRUE
aaVáMBOCOdzCIǔúFjNǒvaaaaaCy	TRUE
aaaàéAǒXùEaaaaXCúeAwdhMúGRà	TRUE
aaaAnSàpTENYtDXaèóuaaaaNàFǒ	TRUE
aaaJsIUDaaaakgdgǒPcpùzZwhLl	TRUE
aaaTKòaaaaùjpJsRoJtàsùyAǔSR	TRUE
aaaaǔkDǒLSVPAPtdWaaaIbPòGAà	TRUE
aaaaAǒdJOiaaǎIúQaRALaaMQynǎ	TRUE
aaaaKGSěákǒJkSúMSuttJNHaaaf	TRUE
aaaaTaaaLtǎehxRYJybGZkGNěùw	TRUE
aaaaaéKléaasǔhWsxNáksAZèěǒA	TRUE
aaaaaHRtHóRemSěwiGhNLdéoaaO	TRUE
aaaaaSRPàoouAfVtxVAèrbaayCY	TRUE
aaaaaaǔBbNěpwváiTiDjMnxYslU	TRUE
aaaaaaéhDóOkrZóǔhhJèTePPbqǎ	TRUE
aaaaaaòSleFPCxvGuFLcáwowGSó	TRUE
aaaaaaCùrérZYácDFIQqǔeBèPzR	TRUE
aaaaaaGAHLDIéylmAYRcǎZèàznǒ	TRUE
aaaaaaKwDmókKmjěUuèCjxqdguM	TRUE
aaaaaaPàDcGvúóMáNQQlépnQvCe	TRUE
aaaaaaSRéaMhObUGxirhyXùoàhE	TRUE
aaaaaaWEYǒvázùRrFbǒmùùqadWǎ	TRUE
aaaaaabUIqtnsMáIHWúyTZTNJoǒ	TRUE
aaaaaafZULCGàěbRMcbjòòDáEPé	TRUE
aaaaaajIAZOáFFzǒZOvhrWòQóqr	TRUE
aaaaaanèOègmAqsgjXxéjJóNBFO	TRUE
aaaaaaqfjPUCYúbYqEfùǎVRrgxù	TRUE
aaaaaauònánǎúxgozGZuoNYGKBj	TRUE
aaaaaayǎfLóiHsámXFfzImbèúyl	TRUE
aaaaahAgfǔTKnpGADVzXRhSaaJL	TRUE
aaaaasèòGaaNUwZmOěSoIsOIMQs	TRUE
aaaaeákWZyncRTiLnAslQaaakPǒ	TRUE
aaaaqnzKpěgNxvaǔaaaTeVzUsLk	TRUE
aaabmǔBzàèiBoaaaaFKEUPmbYéU	TRUE
aaajwaaacOslJRAPhǒhwvǒKMaah	TRUE
aaauIjNelTǔaaaavlRCǎDxòFRhs	TRUE
aadOfkóDTyrdVuǔfAwWrLaaaaar	TRUE
aakaaaaoáXèhséJáKHaafexZzfa	TRUE
aatqzrgzóaaaaalěOǎJoóǎiCOVA	TRUE
aeCéunaaaaóSDóòàùiDHaaaYzúG	TRUE
alǒChtǎVéFaOGfHsSaaaaaaEúěN	TRUE
atǔkaaaaaaTzǎXxHfeQAàùZBèeP	TRUE
aùǔveaauroYsVCqIaafaadjGYTd	FALSE
aóXAaaaaxRZBwYRpjrSsùJFiaaùa	FALSE
aCyDaaaaanéROYASLàvHoLsiZsu	FALSE
aKCceMIKnvWánbaaaaaItjTǎOVǒ	FALSE
aRárgEwKjrMaaaaaIólUNIHùIDm	FALSE
aZhgTéiEvKzQaaaaaáaQfóFènjtt	FALSE
aaěadàMèGuaagirěaRaaCJugGFR	FALSE
aaEoǔaaaaSEùCěkJpRHěéTYMzBU	FALSE
aaMwODTaaAaaaiqjZrǔúXdgcèIrf	FALSE
laaVáMBOCOdzCIǔúFjNǒvaaaaaCy	FALSE
amaàéAǒXùEaaaaXCúeAwdhMúGRà	FALSE
aaaAnSàpTENYtDXaèóuazaaNàFǒ	FALSE
aaiJsIUDaaaakgdgǒPcpùzZwhLl	FALSE
iaaTKòaaaaùjpJsRoJtàsùyAǔSR	FALSE
aaaaǔkDǒLSVPAPtdWlaaIbPòGAà	FALSE
aaaaAǒdJOiuaǎIúQaRALaaMQynǎ	FALSE
BaaaaKGSěákǒJkSúMSuttJNHaaaf	FALSE
aaaPTaaaLtǎehxRYJybGZkGNěùw	FALSE
aaTaaaéKléaasǔhWsxNáksAZèěǒA	FALSE
aaaYaaHRtHóRemSěwiGhNLdéoaaO	FALSE
aaaaRaSRPàoouAfVtxVAèrbaayCY	FALSE
aaaaaFaǔBbNěpwváiTiDjMnxYslU	FALSE
èaaaaaaéhDóOkrZóǔhhJèTePPbqǎ	FALSE
aaaapaòSleFPCxvGuFLcáwowGSó	FALSE
áaaaaaCùrérZYácDFIQqǔeBèPzR	FALSE
aaaayaGAHLDIéylmAYRcǎZèàznǒ	FALSE
IaaaaaKwDmókKmjěUuèCjxqdguM	FALSE
agaaaaaPàDcGvúóMáNQQlépnQvCe	FALSE
aaAaaaSRéaMhObUGxirhyXùoàhE	FALSE
aaaaeaWEYǒvázùRrFbǒmùùqadWǎ	FALSE
aOaaaaabUIqtnsMáIHWúyTZTNJoǒ	FALSE
aaáaaaafZULCGàěbRMcbjòòDáEPé	FALSE
MaaaaaajIAZOáFFzǒZOvhrWòQóqr	FALSE
aaaaaOanèOègmAqsgjXxéjJóNBFO	FALSE
aaaaRaaqfjPUCYúbYqEfùǎVRrgxù	FALSE
aaaWaaauònánǎúxgozGZuoNYGKBj	FALSE
aaakaaayǎfLóiHsámXFfzImbèúyl	FALSE
OaaaahAgfǔTKnpGADVzXRhSaaJL	FALSE
aaeaaasèòGaaNUwZmOěSoIsOIMQs	FALSE
aaGaaeákWZyncRTiLnAslQaaakPǒ	FALSE
araaaqnzKpěgNxvaǔaaaTeVzUsLk	FALSE
aaabmǔBzàèiBoaùaaFKEUPmbYéU	FALSE
aaajwaaXcOslJRAPhǒhwvǒKMaah	FALSE
aauIjNelTǔaaaavlRCǎDxòFRhs	FALSE
atdOfkóDTyrdVuǔfAwWrLaaaaar	FALSE
ZakaaaaoáXèhséJáKHaafexZzfa	FALSE
FatqzrgzóaaaaalěOǎJoóǎiCOVA	FALSE
aeCéunaaaaóSDóòàùiDHaǎaYzúG	FALSE
alǒChtǎVéFaOGfHsSaaaaawEúěN	FALSE
atǔkaèaaaaTzǎXxHfeQAàùZBèeP	FALSE
aùǔloszáDrPaaaaaaoUaiwúnmnáy	TRUE
aěaaaaaaYCXPWúcHPzópbévzǔRùF	TRUE
aBoPYHùPòCfǔóTTzaaaaaawéoYǎV	TRUE
aHuLIěIvOKsJLiYùúNAaaaaaaóúǔ	TRUE
aOaaaaaaRGúùCóáVVNgǔoAljòǎěx	TRUE
aWbCRaaaaaafWHCrjúupxòQwceéǔ	TRUE
aaǎgILsaaaaaděiFGHóóáúúnRnzW	TRUE
aaAPòùCáhnéfTMUaaaaaGcCkgfbf	TRUE
aaIPobEbúaaaaaCqvéXZgxǔQoJAz	TRUE
aaRóYDzuDaaaaavyvduLeBgCbBLr	TRUE
aaZeùbEaaaaaasótftILiěázFRRa	TRUE
aaaòFKeucǎaaaayhcEeBWAtèfOóV	TRUE
aaaGhèúChBaaaamáóCLàdWmMTBpA	TRUE
aaaOǔYKaaaaxDùéaGòQZRpoláDtV	TRUE
aaaXCiTnètADAaaaiJáNaaWEěGuE	TRUE
aaaaěǒǔsmúBòùpNVwzaaaùEAaWNú	TRUE
aaaaGdlùhVDápaBnoàOòyKúǔaaaU	TRUE
aaaaPVXExuuǔaaaNòlěhOeWCuRII	TRUE
aaaaaùZcaQDcCmYèǎtbBTABaaRAR	TRUE
aaaaaúgKJdSgaanyèòhVZǒhodCjf	TRUE
aaaaaLyDhfaGáǔkǔWFTAaaVvpwVm	TRUE
aaaaaXkjlnzRnwrkZmháFbaajryk	TRUE
aaaaaaázUXcybLGóYzpbIbǔLwwiá	TRUE
aaaaaaèoDNHcúJXǒeàqtǒSǒmòOlw	TRUE
aaaaaaǒVxrqISGéTètúǎltXWflxH	TRUE
aaaaaaCzǎiǎmàGMěPwpEDFúěcryh	TRUE
aaaaaaGuuVSQòHéLǒkjuCfNOàVBE	TRUE
aaaaaaLOǎnsyxaSlmXtPTLHoYQáY	TRUE
aaaaaaPNiǒdSòCHólěpbyRPhUdúZ	TRUE
aaaaaaTEJcàòàfetwslFaxòwDZtv	TRUE
aaaaaaWuwpVRryěYBPLvòKèLohOv	TRUE
aaaaaaauSaúFéèweaplulúkáGCBk	TRUE
aaaaaaeqáóLIǒhFùiǔShEBóFrUfa	TRUE
aaaaaajNqlnDdclYóWBEVufoBnéC	TRUE
aaaaaanePoǔnoKfKvWBuXHtYùwek	TRUE
aaaaaaroqCYsaǎtNYWttuAxRRFnT	TRUE
aaaaaavvǒoàZúRWǔUGóùéDnyPéYo	TRUE
aaaaadúlQcsaaulúáeùùJátLyepZ	TRUE
aaaaapbAVǒǒKqSaaqmùxeaIHYIEh	TRUE
aaaabSYèWAǔOaaáTJVǎúCèpaanUE	TRUE
aaaalsàYúBROAZqfTEGNàKaaagWi	TRUE
aaaaxVaaaDozzZXVjyJùàyúOqWLK	TRUE
aaaiFHBeBfGzlGELfHàxòaaaaBBS	TRUE
aaarrǎaaaaKgQáJXYwlaqKdCvcFg	TRUE
aadBPaaaaDNúAQQoáǒaanCOgQLqt	TRUE
aalkǒayuùaWǒHùOaaaaaLwXPáméN	TRUE
aavOéFhzaaaaPMsLYcaaměǎCIYYá	TRUE
adTétaaaaaausONflEcfyqCNRěph	TRUE
amUQZoDgéiáàòBcKPHáaaaaaaXùK	TRUE
asmlómPaaaaaaiFkǒRXmZcLùIlJT	TRUE
aùǔloszáDrPaaaaXaaoUaiwúnmnáy	FALSE
XěaaaaaaYCXPWúcHPzópbévzǔRùF	FALSE
aBoPYHùPòCfǔóTTzaaaAaawéoYǎV	FALSE
aHuLIěIvOKsJLiYùúNAanaaaaaóúǔ	FALSE
zaOaaaaaaRGúùCóáVVNgǔoAljòǎěx	FALSE
aWbCRaaajaaafWHCrjúupxòQwceéǔ	FALSE
aMaǎgILsaaaaaděiFGHóóáúúnRnzW	FALSE
aaAPòùCáhnéfTMUaasaaaGcCkgfbf	FALSE
aaIPobEbúaataaaCqvéXZgxǔQoJAz	FALSE
ayaRóYDzuDaaaaavyvduLeBgCbBLr	FALSE
haaZeùbEaaaaaasótftILiěázFRRa	FALSE
aaaòFKeucǎaaBayhcEeBWAtèfOóV	FALSE
aaaGhèúChBaaeamáóCLàdWmMTBpA	FALSE
aaaOǔYKaQaaxDùéaGòQZRpoláDtV	FALSE
aaaXCiTnètADAaaaiJáNaéaWEěGuE	FALSE
MaaaaěǒǔsmúBòùpNVwzaaaùEAaWNú	FALSE
aaaaGdlùhVDápaBnoàOòyKúǔaaéaU	FALSE
aaaaPVXExuuǔaXaNòlěhOeWCuRII	FALSE
faaaaaùZcaQDcCmYèǎtbBTABaaRAR	FALSE
aaaaaúgKJdSgaùanyèòhVZǒhodCjf	FALSE
aaaaaLyDhfaGáǔkǔWFTAahVvpwVm	FALSE
aTaaaXkjlnzRnwrkZmháFbaajryk	FALSE
aaaaasázUXcybLGóYzpbIbǔLwwiá	FALSE
aaaaaóèoDNHcúJXǒeàqtǒSǒmòOlw	FALSE
aaaUaaaǒVxrqISGéTètúǎltXWflxH	FALSE
anaaaaCzǎiǎmàGMěPwpEDFúěcryh	FALSE
aaaanaaGuuVSQòHéLǒkjuCfNOàVBE	FALSE
aaaOaaaLOǎnsyxaSlmXtPTLHoYQáY	FALSE
aaaaUaPNiǒdSòCHólěpbyRPhUdúZ	FALSE
aaaPaaaTEJcàòàfetwslFaxòwDZtv	FALSE
ahaaaaaWuwpVRryěYBPLvòKèLohOv	FALSE
aaaAaaauSaúFéèweaplulúkáGCBk	FALSE
aWaaaaeqáóLIǒhFùiǔShEBóFrUfa	FALSE
aaaamaajNqlnDdclYóWBEVufoBnéC	FALSE
aaòaaanePoǔnoKfKvWBuXHtYùwek	FALSE
aaaaavroqCYsaǎtNYWttuAxRRFnT	FALSE
EaaaaaavvǒoàZúRWǔUGóùéDnyPéYo	FALSE
aaaaadúlQcsaǎulúáeùùJátLyepZ	FALSE
aaHaapbAVǒǒKqSaaqmùxeaIHYIEh	FALSE
aaqaabSYèWAǔOaaáTJVǎúCèpaanUE	FALSE
aaialsàYúBROAZqfTEGNàKaaagWi	FALSE
aaaaxVaaěaDozzZXVjyJùàyúOqWLK	FALSE
axaaiFHBeBfGzlGELfHàxòaaaaBBS	FALSE
aaarrǎaaadaKgQáJXYwlaqKdCvcFg	FALSE
aadBPaakaaDNúAQQoáǒaanCOgQLqt	FALSE
aalkǒayuùaWǒHùOpaaaaLwXPáméN	FALSE
aavOéFhzaaNaaPMsLYcaaměǎCIYYá	FALSE
adTétagaaaaausONflEcfyqCNRěph	FALSE
amUQZoDgéiáàòBcKPHáaaaraaaXùK	FALSE
asmlómPaaaaQaiFkǒRXmZcLùIlJT	FALSE
aùóaaabeiAùèaQWěoHBáaaaaVVClC	TRUE
aěaaaaaaiKcGQbpúEbwénUgsjmSǎǔ	TRUE
aDFyRgaaaaxwMWBsLaaaBeuImOoQB	TRUE
aJfaaaàqéktKkMkOUSaaaaSděAkNK	TRUE
aPaaaaaamàǒKUěàXpgYabjrZégtCy	TRUE
aXWQYpaaaaaajzòBLǒVeBhbǒEUEhú	TRUE
aaǎcxSvlPBùwJiXYaPǎèùaaaaawǎú	TRUE
aaAdSHaaǒMQbòǒrjGDhwJOhwúaaaa	TRUE
aaIsHcnúSóQLhaaaaaǔKupLjGMěYk	TRUE
aaPiábǒTěòúBǒtèáSebrmvEBaaaaa	TRUE
aaXaaaPeKaaatSiIHxeréèGuMJpwn	TRUE
aaaéXkěbYgdFwúHeoUéǒAxmcèaaaa	TRUE
aaaCnTúKuVgLNPYuDGWaaaaacoGky	TRUE
aaaKaeéaaNAmWUaaahZǔMcoaúwBNK	TRUE
aaaUiuGwúěsèòfUdXlpvLfaaaaICo	TRUE
aaaaéOLVUvǎdONderamRUútòaaaǔb	TRUE
aaaaEZxààPOucRGZJaaauǎwXrbkxv	TRUE
aaaaPmYǎúNéGQGlPeěGǔjtCaaaXgm	TRUE
aaaaaùMéǔéaaFMkqazJùcGěQaCDiá	TRUE
aaaaaBěWzsEFclgpaauJàNMqèkJhR	TRUE
aaaaaMaEODFǒvlIjèwhvBjIjáaahò	TRUE
aaaaaaùCòqwWmKaUbRyěrDIPKxErR	TRUE
aaaaaaàytǔbtvigFóǒDàVsqqPJyJj	TRUE
aaaaaaóGqrJaBCLefSohǒIDǒlKnDǒ	TRUE
aaaaaaAoònáffvWaojMBfBvǔiSNùJ	TRUE
aaaaaaFYéccZvMSoBéjqlVeRlOakz	TRUE
aaaaaaJqeQrHeóùyPqroUBǒXúgaAo	TRUE
aaaaaaNdEDZpwXéoHbEyeòémWLějD	TRUE
aaaaaaSLXYWǒdFctMPùQCngúáTákǎ	TRUE
aaaaaaWlPòLfsQǔHmbriRAGúyhQJI	TRUE
aaaaaaaéèúnUhoǔFzvyZrKAgKAWKD	TRUE
aaaaaaecxOyjǎnzBYOnHLYooDORZm	TRUE
aaaaaajMágrijúyěfBZWoumPMwNxn	TRUE
aaaaaaoóhKsicpgqPQyKéHFtFJIJě	TRUE
aaaaaasòLGǒatYTuEjVekzeCcDNiw	TRUE
aaaaaawEúUwzMbQqGPXǔsVGtáxǒpé	TRUE
aaaaaaznQTxNhamAùMMúǒóùváùxeò	TRUE
aaaaaoUaaZvVahJogFZiMBzTFuéyb	TRUE
aaaaazdlóXoHéFCwǒOERwaSzaaxmK	TRUE
aaaaksaaaCGDBEzcqéòcwYòNùǒǎEp	TRUE
aaaatZzǎiaXiǔyInVqMLxKpaaaMFG	TRUE
aaadUTjAoJaaaaQJqQrfhyWfǎZǒèv	TRUE
aaanǎloJjraaaaPlWxvcDUAǒGbéèy	TRUE
aaaxàòNhbFófDùaaěpaaalWrVcfzT	TRUE
aahpsaaavrUǔúFQCaaaxNwiPhǒBbJ	TRUE
aapbǎófùàaaltǔaaaaeǒpigéXrEFc	TRUE
aaxHlYúùaaaaaSǎdùmòQyàsxEOúQG	TRUE
aeàHjgaaaaaaGkěoUEPéNDzEGJYLU	TRUE
alǎùDZáeGXéYvfěǎfEúEaaaaaaBpD	TRUE
asAǒaaaaaaOXTiGkPǎiQwjtuUMdóJ	TRUE
aùóaaabeiAùèaQWěoHBáaaDaVVClC	FALSE
taěaaaaaaiKcGQbpúEbwénUgsjmSǎǔ	FALSE
ZaDFyRgaaaaxwMWBsLaaaBeuImOoQB	FALSE
pJfaaaàqéktKkMkOUSaaaaSděAkNK	FALSE
aPagaaaamàǒKUěàXpgYabjrZégtCy	FALSE
XXWQYpaaaaaajzòBLǒVeBhbǒEUEhú	FALSE
aaǎcxSvlPBùwJiXYaPǎèùaaaarwǎú	FALSE
aaAdSHaaǒMQbòǒrjGDhwJOhwúaaVa	FALSE
éaIsHcnúSóQLhaaaaaǔKupLjGMěYk	FALSE
aaPiábǒTěòúBǒtèáSebrmvEBaagaaa	FALSE
aaXaaúaPeKaaatSiIHxeréèGuMJpwn	FALSE
aaaéXkěbYgdFwúHeoUéǒAxmcèaaaSa	FALSE
aaaCnTúKuVgLNPYuDGWaáaaacoGky	FALSE
aaAaKaeéaaNAmWUaaahZǔMcoaúwBNK	FALSE
aawUiuGwúěsèòfUdXlpvLfaaaaICo	FALSE
aaaaéOLVUvǎdONderamRUútòaatǔb	FALSE
aaaaEZxààPOucRGZJaaèuǎwXrbkxv	FALSE
aaaPmYǎúNéGQGlPeěGǔjtCaaaXgm	FALSE
aaaaaùMéǔéaǒFMkqazJùcGěQaCDiá	FALSE
akaaaaBěWzsEFclgpaauJàNMqèkJhR	FALSE
aaaaaMaEODFǒvlIjèwhvBjIjáaHhò	FALSE
aaaaaùCòqwWmKaUbRyěrDIPKxErR	FALSE
XaaaaaàytǔbtvigFóǒDàVsqqPJyJj	FALSE
DaaaaaóGqrJaBCLefSohǒIDǒlKnDǒ	FALSE
aaèaaaaAoònáffvWaojMBfBvǔiSNùJ	FALSE
aLaaaaFYéccZvMSoBéjqlVeRlOakz	FALSE
oaaaaaJqeQrHeóùyPqroUBǒXúgaAo	FALSE
aAaaaaaNdEDZpwXéoHbEyeòémWLějD	FALSE
aaaaaWSLXYWǒdFctMPùQCngúáTákǎ	FALSE
aaaaaHaWlPòLfsQǔHmbriRAGúyhQJI	FALSE
NaaaaaaaéèúnUhoǔFzvyZrKAgKAWKD	FALSE
aaUaaaecxOyjǎnzBYOnHLYooDORZm	FALSE
oaaaaaajMágrijúyěfBZWoumPMwNxn	FALSE
aaaaaPaoóhKsicpgqPQyKéHFtFJIJě	FALSE
aaaaSaasòLGǒatYTuEjVekzeCcDNiw	FALSE
aaaěaawEúUwzMbQqGPXǔsVGtáxǒpé	FALSE
vaaaaaznQTxNhamAùMMúǒóùváùxeò	FALSE
èaaaaoUaaZvVahJogFZiMBzTFuéyb	FALSE
aaaaazdlóXoHéFCwǒOERwaSzauaxmK	FALSE
xaaaksaaaCGDBEzcqéòcwYòNùǒǎEp	FALSE
aaKatZzǎiaXiǔyInVqMLxKpaaaMFG	FALSE
aaàadUTjAoJaaaaQJqQrfhyWfǎZǒèv	FALSE
aaanǎloJjraAaaPlWxvcDUAǒGbéèy	FALSE
aakaxàòNhbFófDùaaěpaaalWrVcfzT	FALSE
aáhpsaaavrUǔúFQCaaaxNwiPhǒBbJ	FALSE
aapbǎófùàataltǔaaaaeǒpigéXrEFc	FALSE
SaxHlYúùaaaaaSǎdùmòQyàsxEOúQG	FALSE
aeàHjgaaaaQaGkěoUEPéNDzEGJYLU	FALSE
alǎùDZáeGXéYvfěǎfEúEaaaakaaBpD	FALSE
asAǒaaaCaaaOXTiGkPǎiQwjtuUMdóJ	FALSE
