ùùfqPVéhjnǎǔǒboùNwJE	FALSE
ǔYTóúYúùèábImXNeǎYPD	FALSE
ádBJCOǔEòOgLDlzIǔMGX	FALSE
àwJitRuRZáRPvPdfHgtS	FALSE
éFCóvQCáègFgIQfOVdép	FALSE
èIaógyPLLdGGǎEHàesPU	FALSE
ějERKOlSènùáěǔYFuxnF	FALSE
óyúFBěòoùIKòJUywLkóv	FALSE
ǒHFúFùǔkòDUrXzbpòòqé	FALSE
úcLWúmknTZUhaIúDfGòE	FALSE
ArzEumǒòHovZIRùmEèKO	FALSE
CǒGúáqwǔLwWèYXmdEoXV	FALSE
DMdklěppáStIIAtCXZlZ	FALSE
EtFBòsǒàvjHDPLqBùqVb	FALSE
GǎáaklCǎTPECùmbYsvxó	FALSE
HǒdòfytǒMICàhLBMécPC	FALSE
IYrhrWsAěVjdǒiVLóXlr	FALSE
JsBUèvGplLúLàqPGQhEN	FALSE
LǒéqùDòjCcwzǔnIrCUkc	FALSE
MYycWǒKbOfáWyuújnáQh	FALSE
NjESmijEwzehNKěpUULJ	FALSE
PàCcJThàóóUarǎùpfoǒP	FALSE
QOaJàAgODyxjǎOUǎoJǔq	FALSE
RZwawueRjdxxjoQǎéded	FALSE
SrPjoXbQBpxCòJǒZcYǒV	FALSE
UájPJǒhòfLaǎKhptaALM	FALSE
VIixygCiGàbéiIFěppZD	FALSE
WWqysNútbnDPYLbEèHMA	FALSE
XkbcnVKóǔmaDuàTJIEBz	FALSE
ZǔégǔIFYjbxǒlAòójúkd	FALSE
aIeiTrNrézaBVkBZuǔǔú	FALSE
bTBvZgNěyoYǎUhteǎbǎG	FALSE
clGiǒǔmIǎxUNiMǒMPOak	FALSE
eáGodqOWǎXikGKJYJfóL	FALSE
fTZBiCàfLjyjIfgwhdHM	FALSE
gdiaqòHxfxHFJsxéYnDq	FALSE
hryyqeigEruZMYmgDmǎS	FALSE
jéǎjFòJYguLXSLRnMfdT	FALSE
kRGséaJtdcctěQǎǔBiNZ	FALSE
lměsǒpdYeNùrhbOsftLU	FALSE
nǎLAúdzpzměgGKUBsyuN	FALSE
oRCVǔǒtuMOúhtrǒxsǔvu	FALSE
pZgYAdHJégLmwhAóUgpR	FALSE
qmLFXòPSJútlvóBjzecé	FALSE
sǒVMòDJfHèSrpKCǒúSgó	FALSE
tLJZùrSvixYéáPfInQǔè	FALSE
uvXwCdèǔwvcRhècBGòpT	FALSE
wúTAěùOmsJQǒsyvEzCèè	FALSE
xKCgoOZRnNSgCNedàsow	FALSE
ymtEyDUYzúNòéójNfhfú	FALSE
ùǔùWémǔojabababVènDě	TRUE
ǔYZYcdcdcdsghUwzLěFc	TRUE
ààcEXefefefIaRdóFèwQ	TRUE
ǎIEINTkcdcdcdóDmQòaV	TRUE
éiéBUOOoéHtLàcdcdcdn	TRUE
ěEefefefEěúUZOdHtfEl	TRUE
óOGlEabababzopEPdTjá	TRUE
ònzCsEěLésacdcdcdǔqB	TRUE
úězvòfXǔYrhpcdcdcdóǔ	TRUE
AJSFbcdcdcdcAúàEArug	TRUE
BWxzuòMRNERéefefefpl	TRUE
ChqgyWnByXlàǒicdcdcd	TRUE
EIùKYEPàKtwCodababab	TRUE
FefefefanfZDzěLàcSòè	TRUE
GncdcdcdASafióoOmTNǒ	TRUE
IBBShùǎúUaabababùěPn	TRUE
JegefefefywpMàTJǎrVó	TRUE
KuWefefefjDllùgCbVǎá	TRUE
MEfefefefgtRgRjǔéJgs	TRUE
NabababCgJLhcrJéDths	TRUE
OyJhRShxróngefefefcy	TRUE
QTJxpabababmFvòxSNvf	TRUE
RtOgváòabababIhtObbs	TRUE
TSXéXefefefYGYóApFlǒ	TRUE
UmKèDNcàTabababóqUEF	TRUE
WJRiefefefgùCàXEWúúq	TRUE
XefefefǎCRNsǒSvEGCoó	TRUE
YzGwzabababTfèmSǒpBx	TRUE
abababǔavZsaLPWbbCNw	TRUE
abababzltZèWBLIPnòSǒ	TRUE
céJáDpbAYcùTěabababX	TRUE
cdcdcdXbQKJgtèNqgǒXU	TRUE
dèaMefefefxúonyjjvHl	TRUE
eabababRXlwàrěúCecFk	TRUE
efefefnXRWVaRNwúFPéR	TRUE
fbXuiéjZfUcdcdcdénǎX	TRUE
hàièJEacdcdcdelKeORy	TRUE
iWGefefefKóXkǔzYVèòl	TRUE
jeyPabababDyDzQZrpwb	TRUE
lǔLxZvGJNLfqabababCǎ	TRUE
mRáùSefefefcsMòàDlAy	TRUE
nabababZXIGMEDrgsoáǔ	TRUE
póxkkCacdcdcdJjpIaYǎ	TRUE
qRlldxuIuàcdcdcdAobm	TRUE
refefefEáZZHzyNwěsèB	TRUE
tCówǎETRvBGeefefefPU	TRUE
uaúpaggabababOǒàZrAf	TRUE
vqLMMàvcdcdcdgZxkéóǒ	TRUE
xMefefefǔQDjwFXùLhSJ	TRUE
ycdcdcduRBeVXyaáAemO	TRUE
ùùùPXásdUMèVIRSqvguzǒ	FALSE
ǔMwWǒùúQúeKǎriàégJQév	FALSE
ájkRTDakeXPòǔTéKJmmMj	FALSE
àotéyiuùáAFUěaDhcuXdR	FALSE
ǎznǔXlUgLIoBKòùgLóNmN	FALSE
èǒrgpfVmbVKqfDKoYITXL	FALSE
ěGCàùuyěMsfuzhòCVgvùz	FALSE
ócùOasnrǒvéArDToScTHz	FALSE
òvTFfGeWòànxrtaěèhqNf	FALSE
úúlálmauPBTNmXDálrOAl	FALSE
AeKXHòfzǎpbasvǎOvptǒR	FALSE
BjvteǎliòVaOúxMèWMǒfd	FALSE
CxFchxieouwXXèUPUNSuò	FALSE
EQDEóéiIóěDóbfhgěsGJY	FALSE
FeZiàYjúJrbUhbǎRǎrPEW	FALSE
GytnrnhtPuLhgDǒUóljdD	FALSE
IóvYEnuěmèGóoTKKyàuZU	FALSE
JVeNPyěteIxeézǎIscKyé	FALSE
KmǒGAfoSéInWQWiúljzuB	FALSE
MáǎěéAjdòǒxoEǎkqXàdDj	FALSE
NJAcHLZdGěGsmLXyXKEji	FALSE
OSSwúàúUáqǔRgYTzeòFsD	FALSE
PlzmùsRáéùqěòùpnòǔúXm	FALSE
RǒoYVsùvùěGxJnQsbUWěò	FALSE
SEnHqwPlYbhMMjewòHéǔF	FALSE
TTwòIJkòXJáyòàGaǔtDKv	FALSE
VùmNcOYYfJyǎLBzzMénkc	FALSE
WóBfVáDFIùUyèěBjRCMEx	FALSE
XUACKdWqDrdIùǔpǔQGlGV	FALSE
YkoHqyFwqqǒOKlhQóRqbq	FALSE
ZsJsKǎndWtJLPBkǔJuNap	FALSE
bóQUiéXiQǎèiMnJTààmiN	FALSE
cHMpCgCèIòzrEGpVyyPac	FALSE
dXàvHfriwúgéiQsAXèsmH	FALSE
etQǒhEǒlVKxVhDòjXljGR	FALSE
fxbJZNJMZpěATwǒáùJaùc	FALSE
hIgaHvyǎBtbKhCZDǒBjgi	FALSE
ieZQfxFFDOáCyQXNZEjxe	FALSE
jpOúdBVuxHnBWscFrwyCT	FALSE
lLVtlLéibnáOozKlDǒkdm	FALSE
mwǔWjPQpréhǎiHUBeEHoI	FALSE
oLàEnfeěSèRǎRZyIkVvtr	FALSE
pdQJLSdTùúuéIèqNFWeLq	FALSE
qhCFHMiRHsfLsǔóxMSeWv	FALSE
sóTfvWVdaaKóélHlfwLOI	FALSE
tKytéjIMèVSèFèěxroBmó	FALSE
uWJvaAzVěQtKgiěRSkhàW	FALSE
wàAMWFNvMájZCbuYoòEùp	FALSE
xIQúǔǔUMaWCDeuGpjSIgé	FALSE
ygxLrjDIiááiUntóNǒRfn	FALSE
ùǔVcIxjtǔKKòQácdcdcdě	TRUE
ǔabababèoIidExQnálvvB	TRUE
áldNéòoǒvǔosmjdcdcdcd	TRUE
ǎǒqefefefùWáMjòtAzétY	TRUE
éYKPIùmAùIlòrXrababab	TRUE
èeádaZzPqEcdcdcdcfWMy	TRUE
óéfZKabababwHáTiTySSq	TRUE
òQfabababdDIRVeGduPáo	TRUE
ǒeabababQKkkàgDVSMltS	TRUE
útúóaFWVBtCqòercdcdcd	TRUE
BESméóǎZUnqefefeffHóD	TRUE
COlNcSmnIiigǔvcdcdcdI	TRUE
DkúécdcdcdPIbBmèGZeBú	TRUE
FOFúuJeòTláeGNcdcdcdd	TRUE
GdEthefefefELtǎadúLXy	TRUE
HxhfTLpùSùgqefefefuèX	TRUE
JúabababTbUYEèǔéZBvqE	TRUE
KJYRKVVMVVabababsààPi	TRUE
LkMDvèécLòztNabababjl	TRUE
NádyPhabababVADAméǔèě	TRUE
OabababsópAkitVtKkKúG	TRUE
PtltùCmabababacòRcèjó	TRUE
RLmypéFfIyJsHkabababt	TRUE
SoFXcdcdcdeMmmbsuEzBé	TRUE
UǒBabababèéwjEcaPjáeQ	TRUE
VcéUkèéJJcdcdcdNojyxZ	TRUE
WzcdcdcdZuPMMSSjVegyò	TRUE
YWùǔefefefàKǒoiUrpdlò	TRUE
ZsuyǒùúmXDùefefefnVgn	TRUE
abababKUpHZTJjyOùěcZè	TRUE
bǔabababYlTùhCiàzòúMú	TRUE
cGòCòVeGlPwxCefefefta	TRUE
cdcdcdjǎLxvbKLIòtvwEK	TRUE
dgoNmpězjBabababVUòVè	TRUE
efefefDcQhUùTrNBCOoNs	TRUE
ezpòǒóbXTCHHiUabababP	TRUE
gMhóǎBQeEOěcDMCcdcdcd	TRUE
hpLrefefefòvmsJWbTúvH	TRUE
jáèPefefefUpEoMkTlQwl	TRUE
kFoQnPěéGWtcdcdcdxáǔo	TRUE
lcdcdcdtMxevNHxKóscNg	TRUE
nǔlnggefefefUiùGGKXNL	TRUE
oYdùzHcòefefefhdAǎòǔv	TRUE
pvtJcdcdcdYzèskáaJOUà	TRUE
rMoNefefefWpJOěhuRwKh	TRUE
sfASHZSnKáYktefefefau	TRUE
uàpzǎzàKefefefexvRéqg	TRUE
veYfYNéXufUetcdcdcdòQ	TRUE
wsómrIGbNfóREácdcdcdA	TRUE
yNěbtPfxPFVAàabababfy	TRUE
ùùfBBTIVqsjùVyuHzùùHhg	FALSE
ǔQlUCEmUyéSotmftkwúrxM	FALSE
áeMEWuGácPVXLCyngKoWyj	FALSE
àugwKttWiěpljvbNxGjvIú	FALSE
éúVémoRgUDUmIcwáJYKgFn	FALSE
èWWQNǎcIDpwěsLBěgVfZpN	FALSE
ěrRecAREUǔnjoòfSèmàUvě	FALSE
òófùTǎiYFáOěéJBlrKcǒvH	FALSE
ǒLIFxjècqKaStpZAdrUěàV	FALSE
únnòOQvIhucUcYRldhDkhr	FALSE
BúSǎòEtxKUuyKdKzpàpděu	FALSE
CZWjóywòLNsàǔáoóleBIBC	FALSE
DldèèhcPvLwDaéDéTGnTIǔ	FALSE
FFgCtQJPjàFdZǒzzJárdèq	FALSE
GUCLúAFfkěelyǎèǔeJMDlc	FALSE
HprzHTKHIfgRJgIFkWDǎRf	FALSE
JHóRgeEmptDdBnàOOCfCwC	FALSE
KWssULùCrjszǎSTàXciVSM	FALSE
LohtMaJǎeFzLgòOùoAéAmd	FALSE
NòQyéMbBxqxYYWKQóTwòye	FALSE
OKǒHpkièOmfHoZǒIFòǎwRt	FALSE
PfaQEHKòRùLóIYYYIVwEVf	FALSE
RǎujvǎUéoEkjdCǎmdAgóbǎ	FALSE
SǒwáaSaǎtǔGEbEgwbtMnGé	FALSE
TEfMVGJqǒpAáiènqiòNVói	FALSE
UTxáǒǔFygǔóJùuomjéveCj	FALSE
VkdWúqhqiXǒlLùoyǎwLèòY	FALSE
XégHvBpWáqtosguǒùRSOCM	FALSE
YIGàUùTVjWmgIZEjnfuDtě	FALSE
ZaqKmYéNxDALxMDuFùVVQR	FALSE
aYMOPMwJwIùoSsICjfùfrF	FALSE
cǔaxaKRRLapRoNóvuònròé	FALSE
dGPMèpAlTWòJSELfxǒIsom	FALSE
eaUWùnWqviKfUóǔwùVhlUa	FALSE
fZdlsLpKJéRMYMCosKVáRD	FALSE
gjrPIncbAXyXyFeyjnGhMX	FALSE
hsZécǒzhózdcWsiOVwqQèú	FALSE
jǒkyuWúùPjHdǔtpfRVsGùL	FALSE
kVixGwNTsUYsiTNtiWmbwǎ	FALSE
méJOnéizYgoYvmùrUòúǒwS	FALSE
nDbsOLúSbcfouSxfkàZfDQ	FALSE
oWgDòyǔvùXafǔGziRrQygz	FALSE
phCǎèTuógglEùQLrNeèJYD	FALSE
rǎyéGpAèyuéEGmTònCZǒOǒ	FALSE
sPěuiFpVvEmxkbeèáèéYKw	FALSE
teEjHOLpqqjHWǔiWSAèeóy	FALSE
uwCWmEǒǔójBputcùksVùqp	FALSE
wAhCèZbitLeáWǔOSlPBeóà	FALSE
xEHGYwémàOáàCowbáCòaHn	FALSE
ybfqhtZfáNMnwTqǒsòhyeě	FALSE
ùùròkǎcPcdcdcdsBppèhya	TRUE
ǔYbScdcdcdIEWáGhXějIxv	TRUE
áxGréESwDGqCúabababtǔE	TRUE
ǎúUòOdGabababyépǔZhhbV	TRUE
éGwbgéTqǎguldszYababab	TRUE
èhSUěAyHZHnabababmfLAq	TRUE
ěsqmDcdcdcdnINEǎwUIHij	TRUE
òDKivCcdcdcdCárKNPPksá	TRUE
ǒabababdvWóěVAbZxBèWJy	TRUE
úcdcdcdzáóáǎsfWóLSewrv	TRUE
AxUnnIkFMvLRRbcdcdcdéǔ	TRUE
CDáefefefWikSiGTVQdFsǎ	TRUE
DfQJBGVRtúǔQRXEabababD	TRUE
FǒabababIVVúcóeógNAdTj	TRUE
GYuǔgdKzPUabababúwzJsǒ	TRUE
HxuAúSqIYówólZbcdcdcdm	TRUE
JLOXEázasmXcdcdcdSǔnqY	TRUE
KqOMòdáOaLjzFeefefefǔY	TRUE
MúmbLmpáǔVNabababnGEJW	TRUE
NOotsnàáaúRgzcdcdcdxxv	TRUE
OaprerLGkefefefhKOèbǔh	TRUE
PxpQWoHcdcdcdFàyàònhPf	TRUE
RMnCKhDFAúàabababODPHc	TRUE
ScdcdcdHkgqLreQZákbZtE	TRUE
UùSǒcdcdcdIsfqCèjHdWlN	TRUE
VKDigefefefǎHàKJXBáùtM	TRUE
WdsIvàòǎcpabababPumNZS	TRUE
XpcdcdcdSFyQmfXNuljězr	TRUE
ZFgaúzgjǔhabababQxkWRj	TRUE
aQSYùzùPrRfabababQsdKN	TRUE
abababoVZdòFaHágMPwèoě	TRUE
bwBythEbcdcdcdpazkLVvS	TRUE
cdcdcdbGIǔwdJYYNJàROFx	TRUE
dcdcdcdHIYWǎmaǎJinlwjé	TRUE
efefefQSmgmJlBcwQKluyp	TRUE
fLQilGxEúaIBYZùabababY	TRUE
gccdcdcdwaIPǎcoIǔuIòoè	TRUE
hrWCènxǔOrabababǒáydói	TRUE
jHcdcdcdOkúǎáúéáBUKATM	TRUE
kfònQZMJQabababMkgCGLà	TRUE
ltoùOúDRUPiYcdcdcdbZTw	TRUE
nLgzájZCabababhàkqfJYL	TRUE
oiBebbPnǔabababhRcfSDr	TRUE
qJUPcuLKàVuMRrkefefefU	TRUE
rjyabababGnàgxaaédRJMO	TRUE
tàEkpXcwcváobèKácdcdcd	TRUE
uQYhjQVQPSǔYGvabababwh	TRUE
vwcdcdcdOeVàsmsxòDdAèW	TRUE
xJnWefefefSeVKkWcxOùrW	TRUE
yeLQjqfqJsIbúàùefefefU	TRUE
ùáxJqClégFPuaJòdYonXWBY	FALSE
ǔRqiJzOǔWBHéùgógiáǔlhvi	FALSE
ánvLPMàmwWyNrbMjhaRyGBg	FALSE
ǎǎRánYPSUCkZbpVeSQFǎfEG	FALSE
éòAqeUqFiZKZvLlBVLáyúCl	FALSE
èEbBéKUYiWluaúIusxYeobB	FALSE
ěWǒěǎHaèlévIGnělhlFfoUS	FALSE
ótùFFpAǒpYFLPxzcQlKǔLjV	FALSE
ǒDzóúdtjxòVrnǎǎèTPWlTkT	FALSE
úCWóǒQelòàǎàylLQRbvsncS	FALSE
APgjòXǔGKbhVaědiARTqBKf	FALSE
BVvpnFeIqǒǒnOJDúàoqIěYà	FALSE
CyzòDuBòIdilzǒVVptùzǔèG	FALSE
EIBlběkoàvfCALofQǎUwuhW	FALSE
FLROIlmsDókóùǒQùGrkYùXl	FALSE
GgùaàYVùuXhCiUsgéDOǎlúw	FALSE
HiaGiokYǒdòóùPuEMZksWJf	FALSE
JěgiOáèwpàZRjDeSǒsjYLóZ	FALSE
KMCSLnDdCtàdǎAyXLXOHZoY	FALSE
LUiǒopQhQkxTmoǒNlgwàDUp	FALSE
MeóWódleLCXúǔHǒCàYmEozs	FALSE
OéKdmgdnáyYllbIgFhfèpGN	FALSE
PQBzTaěùékfDvCwAQHoósèL	FALSE
QZòMlfjrqóBjDfpěàODdpàè	FALSE
RxUXXnpCvFVmWlYeéóúGyGT	FALSE
TDbQFASyiásAáCkǒRidsvzu	FALSE
UceòǎDZEApMOzJMemHzkMOò	FALSE
VtxkTěǔǎúeVNrAvqúVmccUO	FALSE
XGùOáOúgEuOWǎxhRPdáoOòò	FALSE
YXěuqIWKěáúefùcXùpùPThE	FALSE
ZnPǔFbúrzTarKóáàxRgxbóú	FALSE
bGsMWjùěǎQdǔèixmCoKǔlmP	FALSE
cXchděUBwRcǎENVGFOǎòsLc	FALSE
dnWvTNeǒZSfslkZMOàqDdzw	FALSE
fǎkdwóKnRKVNpTòTYzpgùAě	FALSE
gGJpbBEyeètIAcskQCtmóuF	FALSE
heGzdPQhózkIòimzUgRBRYB	FALSE
ipNcRǒáCYoauàFTqúDcyǎóD	FALSE
kEǔéNQLwUXfǒTèWKcFIèCCp	FALSE
lasNBsběsjfábjdCúeàxhǎf	FALSE
nǎAXZlkWMXZIzvbRLuèKDov	FALSE
oHAoEHlehěJDQlcòànvaIHL	FALSE
pUjwPěeúoKPzWyAěéYàbóoǔ	FALSE
qneǔOvAItúAǒcTaúlXjmHVk	FALSE
séklǒYeréǎèCWfgǎmèEndtF	FALSE
tWUYúPhévoZJiMaIJSXSpWM	FALSE
uxěIQcRǎmFeDùùIvGxnòzUF	FALSE
wélMáZgJjXCéifLMttádhVS	FALSE
xOOOevzóZpJóněaBSùBAhaA	FALSE
yiCáAaIaKpzRvQGàraòxòPp	FALSE
ùùofwéPwsEgEXtáYBcdcdcd	TRUE
ǔRhXrèǔrFjIZùxùcdcdcdMZ	TRUE
ágefefefRvóiSJTòQLBcVwM	TRUE
ǎXǎàkùYVDiHvyEaFhcdcdcd	TRUE
éurUzaxaeQMszgcdcdcdpxK	TRUE
ěRTXIgOwMtZabababIFJBgz	TRUE
óvabababLfBfUlǒlàaZZùJc	TRUE
ǒKNAáscdcdcdEWVMAhKèfmw	TRUE
úroWóUWvHzikAiAnbababab	TRUE
BBáBèHECǔgxǎFcdcdcdjbIJ	TRUE
CYUTècdcdcdlimǒFacéoWyX	TRUE
DsóièTncdcdcdEZFECRmhxF	TRUE
FúiUuzitàQawúKefefefKǔà	TRUE
GQUMqGcdcdcducRǒUpmyOJè	TRUE
HcdcdcdWeHldQArKkXoòsǎO	TRUE
JFbabababègdMGKAèSáMǒnT	TRUE
KanIjǔnuQefefefHuùnqWGT	TRUE
LláèYUcdcdcdóyzpUDúuǔAé	TRUE
NěǒyPQWpeiKSrSVefefefaI	TRUE
ONAěáPúRADfXvèxQàefefef	TRUE
PefefeftFHùWaósngoGxmzú	TRUE
RǔZkèEHiwùjcdcdcdsKAFhf	TRUE
SNStNtheácdcdcdWUJYěpYM	TRUE
TiCeEYNqJàefefefyfXráAn	TRUE
UxabababáfAAǎiFWpaSseAj	TRUE
WKáiǎYmCIAòSjónmabababy	TRUE
XabababjlcJskJRqgDUcNjd	TRUE
YpfAǎIgàWécdcdcdpcNSUGě	TRUE
aONǎTCkúcEylgvkOYababab	TRUE
abababqHúnkuyZhCzsloròù	TRUE
bzàuBàúNpabababWFhFGwdU	TRUE
cdcdcdYékòǎǒsdtYIRexKòp	TRUE
dNIoǔAhYbúbKabababèěóúj	TRUE
efefefDrcQóZWSěHéUFfttt	TRUE
fǎjIIbómCKefefefóòagMDI	TRUE
gKsàBǔJnLbyFáxdabababéy	TRUE
hdRohYSMéeècdcdcdpNùEóm	TRUE
jòiùMDSzhPHgGVBjefefefǔ	TRUE
kWóùabababAaoTIPDhkóZRǎ	TRUE
lhleúLvxZùǒócdcdcdOTbXp	TRUE
nǎciěIixUtddefefefúòaCB	TRUE
oQǔYTJwWǔáLNQabababDvsn	TRUE
pnBéefefefóóTpOùúyYSkJa	TRUE
qzLòivEóOdeoabababqTǎnè	TRUE
sBWzǔpEkYuVWOZJaHefefef	TRUE
tWQpYHTǎcdcdcdWZhOǔEyOT	TRUE
upoabababtybQOuòonbXPXQ	TRUE
wIWJvabababjLJEAùFbkgpu	TRUE
xQwǒwSBaúZprefefefTǒǎUj	TRUE
yeefefefèòrNkúMàùeVxútú	TRUE
ùùùHtMBúulpáLvòVyCXXkzSè	FALSE
ǔóyàGpúPJvwówROjǔbóvSwaV	FALSE
áZVYCEdmlsóNBOàbnǎLUǔeCà	FALSE
ǎáwúYcLvXPaqyHfwKTòǔoǔvu	FALSE
éMéWJzEeRùàWfUěxiéèyacèi	FALSE
èRGMVFWXěDěFniWǔǎrvNnjRǒ	FALSE
ějGOEaqěúèùiBOwVOFfǒùphj	FALSE
òóyǒmkúfcáóHeKwUòǎCKaGuh	FALSE
ǒaHTWWMráTJlUútQVQQYòLfd	FALSE
úwwDóéTwVNnùQwGTjBcqzDAE	FALSE
BúbLOàdnàZeFbJmZèvnYMKJù	FALSE
CVǒCXgsààDVnnpòǒórkvsRùn	FALSE
DjxDsǒúzSZBǔIǎáPKXěWnotw	FALSE
FǔLMzJépěXSnDKóFshǒVUZjI	FALSE
GOHélOǒNWRVSOPgùèǔVoVhOa	FALSE
HgóbnEùǎrMNgǎXúncRllNxwC	FALSE
JèǒTkáScrsVvGnTVOnóòqXǒb	FALSE
KBSXZKáFiHóBgOWOuǔbeNàLr	FALSE
LMPǎgEwqKDKGOLcRGlěǔaMyé	FALSE
MiòlxtFóUHGwsQFDewMǔjLdi	FALSE
NtQAXzEdXutmBPóORkqéěgúJ	FALSE
PósGmbIAyDàKCNtbàNrcyAùx	FALSE
QSclyUWsàjGónZfbùqmyDoOj	FALSE
RozèODéQǒVKSjkzcoóprELtX	FALSE
TBQSBxNPmfhONtpMěBǒZsqjB	FALSE
UVvXàvǎúRwYxáQhOObAqDBne	FALSE
VmBzNcLùoUXKxhzgOYKHhLoó	FALSE
WzAZájdWkCéRvMPlǒàPSczjD	FALSE
YEjAúiyqIFxzRXedNZPJWsfě	FALSE
ZEHBúQsúPpvdoMrTáěUdóuás	FALSE
aWvwàhZNBPèCylEòxUùMyúàX	FALSE
biòoyQypPJnsólOUéIúPnáúO	FALSE
déàLuIéTUdkùGDàYsrFmiRFp	FALSE
eNfROrófèEKIJsérSRLxhIlS	FALSE
fedpjVUrVhklZetvògDxTǎkě	FALSE
hǒkbYóQsHPgMúRHqDpHZyèFX	FALSE
iNcrájGPznuGudztWPIiHǔlp	FALSE
jblBiSWbMqHòhGSMúócTǔEGU	FALSE
làěkkQCdǒóBěuutVPútbWòtw	FALSE
mAaèeUNùUFáZpmtááziLgqQw	FALSE
nLfccùYéJúqrMǒEeHzBGhQwù	FALSE
oZPóTSyCwEXEéǔFòNKrúǔǒds	FALSE
pcHSSeDTQKIGjSECésùzYQEj	FALSE
qmGzàDěhZezWàRTǒCVZLtDàZ	FALSE
sǒǎPXRagNǒGaclméoyáHgEòK	FALSE
tKNMgWhoqMNOfǔéúUbXwxěPǎ	FALSE
ukWrjsiZYFROOlěxRWYDbàǒJ	FALSE
vxHùQZfMzrǎRMrzǒXáqBFlóv	FALSE
xNafFgoREtPXlNcFWTFvRjDM	FALSE
yaSǒsWJEáogpYěcoGFvxgxlǎ	FALSE
ùùVrIrZkPabababEihFUuKǒà	TRUE
ǔWKeáǎqefefefevjggHtxvOI	TRUE
ájaSBPSEAèrcdcdcdwxbsWCF	TRUE
ǎAbocdcdcdjphàQsSBIZsBkz	TRUE
éSòOGolǔLcdcdcdǎǒQnǔóJěD	TRUE
èwLněsLNTARvqabababèzIvb	TRUE
óǒKAHDxIaNXsvZZeioefefef	TRUE
òYgVáDaSojuhcdcdcdULiKGu	TRUE
ǒefefefZREHenQqsvMEzayiI	TRUE
AúefefefcGfLèAwGHBFcěúeh	TRUE
BRMRǒgXywhcHéNabababisùr	TRUE
ChCHQzǔEMefefefùTGMǒQzéT	TRUE
EóSobjfdAOrěASFojefefefc	TRUE
FMPGǔglòǎVabababxhwqksmt	TRUE
GlhqgbXDéTlIuefefeffhrbE	TRUE
IRùúDjǎTtǔYhcyòXZcdcdcdu	TRUE
JiùefefefAUúAKànKhJfmdIò	TRUE
LěǔúòBcdcdcdáLxGyEygpiúe	TRUE
MòtòBfCèáFàTabababWiOzvx	TRUE
NPcLKNoeJicktEpkQefefefě	TRUE
OabababrǒnzraeiCǎěIúsqGd	TRUE
QóFòàvOsWèZpefefefBǒòcgA	TRUE
RQbEJrsJXiQǒPGAFYabababz	TRUE
ScuTóàFùMbefefefCgǒURAjP	TRUE
TxtKFmGJabababJEgKHIteut	TRUE
VImDabababùnljdyfbǔlmMWX	TRUE
WcdcdcdiùnYvVzDúIUOQǒUǔK	TRUE
YùMVnXZxDaeabababpJnvJUs	TRUE
ZHDyOpbhùdabababNùwǒójdv	TRUE
abababàwYztPaRZMSsjmHejt	TRUE
apBaabababòjuwvNcáéYewol	TRUE
cùWOyeJéWIBfQabababSHrqY	TRUE
cdcdcdbóAPóěBNZyuPhàqObJ	TRUE
dabababyEnewEǒmuànEqkZtD	TRUE
efefefCpótěpOfQThZǔxIǔuá	TRUE
fYmBGBsdacdcdcdsscgkXIǒW	TRUE
gmefefefèùròoǒàebeRZhkoT	TRUE
iKFzzbJIVfùVBCNrEcdcdcdǒ	TRUE
jdUFǎweiBVPefefefKTefLcb	TRUE
kxbabababpvBfdJrXQcuóLlZ	TRUE
mOèYcdcdcdrCEXBèKQYvCèòE	TRUE
njgfgàòKhFZuTyiAgcdcdcdù	TRUE
pǒwYtòlXǎFǒefefefenhǔrly	TRUE
qLPsicdcdcdifjCddwRcSLhS	TRUE
ruptanùZòǒITDqucdcdcdiyS	TRUE
tHwúAabababnWCùILSwcAuǔj	TRUE
udzwúfPViEDòòiqPJabababs	TRUE
vvrèEgMWXKkAYTIefefefàoA	TRUE
xAvSHnfKzGǎhaúlcdcdcdwzT	TRUE
ybVàZněsIBDknáQabababoOt	TRUE
ùùiSóVvěUmScújTmhVsǎáqòBó	FALSE
ǔòhQskHjaěmùEnGěǔHèDPuǒvz	FALSE
áGYùQúBěsmsAgppgEcHEWjěiA	FALSE
àbòdyIFdsSǎlYmHjVJtzbLmvR	FALSE
ǎnfkIaWygsaawmaèùdhUfoLzǎ	FALSE
èéCTyQkǒkOàIDvLnCjmvkxEel	FALSE
ěFTEyáOPRYúDljRúQXěcǒOJdà	FALSE
óRAǒxcUsEXryUKtMEflXVèxól	FALSE
òefFfnKPǒòhMúáwáAFOcFbMTT	FALSE
ǒsgàméDyOscǔvǒúMsNSgdqpHC	FALSE
AázxcHǔKChNdWMǔúDFIbVUJOU	FALSE
BòaàǒTòséǒHrhbàhFtCddTiàj	FALSE
CVyRcbQǔcISǔcIéVayeSFoexb	FALSE
DfzUóTeúéRnyFGjPǔoAuòoiEU	FALSE
FòGSuWLcGYOsitYPèàDǎòDqFě	FALSE
GZǔGBSsmRBYGifSXQckeěǒrně	FALSE
HsfèVaYgWDUARnvzrvmSpZdWZ	FALSE
JàEiǔěoiYxUqhhOjZdNóréEmw	FALSE
KVlGIyùDǎoDoYZXpqsǔVZHLmq	FALSE
LmhchifFééěábLEcàUmJòhéAX	FALSE
MwpTeupekPSBpáGǔáplNcMIAn	FALSE
OVWLoCjězhfZuèGzmCmyráCèz	FALSE
PbgVIUUDóynJTěòWWuQEPVlqN	FALSE
QbzhtWQGèZhTIfYTNVWSSZiry	FALSE
SǔófWSUsòogNeěVèDǔVXXǔǒDB	FALSE
TBpUkDuúósTěWkMaěùǒoWǒenq	FALSE
UbaLIlcCdphàěááeèGqwtudòf	FALSE
VrIòDcXFWéùáàazǒfiomzcpóL	FALSE
XEXNvqTnùǒúweybwreóRYbGǔH	FALSE
YREOúmYààjJJFvLXEǎěShfAǒr	FALSE
aàSáVónYòDFpCCKúnPHXréeǎu	FALSE
bLòiòBpxYlcoTNXuéhDàhmdǎb	FALSE
cbǔtjlXiSèHqodLiaàrmǒenPò	FALSE
dxzàáiWbPúldGiZedGAzJSSiZ	FALSE
fJOXěubèWtPOuaTQǎélcPYgóv	FALSE
ggzblycLjyFwbdxfSjnzáSJHò	FALSE
hséóAEòdiKmugébwwBbuUecnE	FALSE
jOgějNùǎámNoàsDMKèáiXqHǎR	FALSE
kXuuhIBfǒUwNBúàRWJiLfǎIOI	FALSE
lxTIVMdzvKFVAWěGnYǔúeóGèj	FALSE
nùgzrcFfázEcùqòùiěTùKBzPr	FALSE
oHómèQJàdKvJCúXkqǔorrZùGc	FALSE
pQěIùběhfròjòèQWgSAhmXaéL	FALSE
qqsrdLhnFxǎFEZEKxVbiǒIòUx	FALSE
sǎěSKcwNJóMèdDǒZdxppRbetC	FALSE
tJQwdCgmiěyOJoDMaEǔòùPCUC	FALSE
ufutYjDgbtHrJBvěRqeGXxdAr	FALSE
vrjUOóxZNypVHpzsqmxhòtòbS	FALSE
xIbKDlgAcMàYTàělěfǎPrUúFè	FALSE
yXsVěHunUEIptxáYQVdhIKzZó	FALSE
ùùJdèvAJbAǔRabababofòEkóg	TRUE
ǔòcdcdcduàiFwqFhuYsǔHàZEò	TRUE
áQnZPRyKvlǒNhabababàOkLMt	TRUE
àefefefkkyqyùHPhazsnzXDěN	TRUE
ǎxzkLzóHzabababKeècěUoǎxr	TRUE
èMAFkòabababGùGZonèxTǎFèo	TRUE
ěfabababhèfcèQòJàoVyEDEVó	TRUE
òěAùXLBkùèKOòcdcdcdrTèǔbk	TRUE
ǒYefefefwXGǔSYDǔIChBEěUói	TRUE
úefefefRiIokGTmLJàXuOpàMD	TRUE
BERòtòudefefefzJTóFpùjxuA	TRUE
CiBávǎzGyzúrěhabababGQWRF	TRUE
DrMOúwMǎwZabababdǔKdoFoěU	TRUE
FCIómSiLtGTTfefefefeEWcCv	TRUE
GVRROmabababòHJdòfkfHpBRm	TRUE
HoǒěhúvpcdcdcdòEǒrkòZvHfZ	TRUE
JBWocdcdcdidǒùfTxàùqirǔòn	TRUE
KTpòbpTnBabababPvdTmmMTnI	TRUE
LsuHUVBcdcdcdktěFùCBzhTúm	TRUE
NáZéGgefefefRzjoMAúYxpěHC	TRUE
OOnflJQhlFVNfQPsjóEefefef	TRUE
PqgBcdcdcdWsYYhkiqMTrfDBZ	TRUE
RXVcMxcdcdcdǒúXyMrogRSQee	TRUE
SycdcdcdIfmAPvWTFUǔNhwǎLQ	TRUE
UKqPPGPhǔǔcLLImefefefDLqB	TRUE
VcuNzúllabababvVdVlXLeQUg	TRUE
XáShcdcdcdNBèrZIpPoNòffzj	TRUE
YNxúBdcMòUdHaàabababPméod	TRUE
ZewcdcdcdgfZinWUiOoAúDACK	TRUE
abababKoǒnXùrYEàpǎaǔicRnw	TRUE
bFhTGiHXabbefefefPzQpRIVg	TRUE
cLěDòbQBKOǔWkacdcdcdLZbDm	TRUE
cmflEsJVGgKCabababqnǔalòá	TRUE
eěefefefèǎuTǎdjWjmeokxeNp	TRUE
efefeflSEsSMJVUvjěGwhǎLQv	TRUE
gáSTQnibYcdcdcdiEkǒoXeyyo	TRUE
hPhyErKLjKDefefefFáwlàáVa	TRUE
icdcdcdLPVbóhHqpBnAFěThWà	TRUE
kǔùvBZFGNrSjqùWIcdcdcdEks	TRUE
ldbNyUYlUEEDAZabababvúEYè	TRUE
mpqabababzavěizmfhòlgáobc	TRUE
oEzǔBJabababěéODWùxmnnùNJ	TRUE
pTZéùGRefefefàǒèvZElcBubk	TRUE
ràúpxHlKúzMKwrcdcdcdǒPúói	TRUE
sMvàhcdcdcdzYfHDypDpuaUAú	TRUE
tbafnIgabababétHunBsXwùAò	TRUE
uoǒtnDftkàabababxKAFèǒqVv	TRUE
wIlQěsmxRaaKKGcdcdcdZùhpE	TRUE
xXǔMefefefùoNXdgóHmsùkhtV	TRUE
yleCobbUabababcplqxeDuaǎú	TRUE
ùǔrQbǔkNaàuBIBéPqhòxlèlZut	FALSE
ǔJésuàlTpcòxGùRXYDééǔyaIZé	FALSE
áaèAeXENùPPNGètMàAtǎàúUócs	FALSE
àyTǎlMǔEJrJQXOyRLJWàInCOkv	FALSE
éàLEXHfRmsOtqOPáùzOLVǔYLàG	FALSE
èGòHPlfXKRěgBZTǎMnpLèEqVǎw	FALSE
ěFuydràguzMěLóvCMsBjfgèěùè	FALSE
óTLJgIeVIǒPěQCfRHbgqyKémèY	FALSE
òZIJǔWáékvEmEXaRTkzǎZTvIaX	FALSE
ǒuGBKvvóOsàvfxcUcDHfòúúFtr	FALSE
AǔhIKrlèwFQZěXoqGúCèjqHǔKH	FALSE
BPòkEuRmzMátaiMXldPzyQyPNt	FALSE
CeVOAtXfórIOvQoǔvOamèèSlǒy	FALSE
DqvXmJúyZfHòDjZoYSTEǔNCJvV	FALSE
FǔúKZǔVQdoqsùpyqbgpáJvWènk	FALSE
GUIXFaniéNAHTEWRJTjmSMcuvB	FALSE
HmǎRwxàèùFXBǎyǎǒtgSeòTRhǔV	FALSE
JàasNalBkPùfoITnUnǔàABDUga	FALSE
KYQWkCSTSuIàPNujBkGyPRúòVC	FALSE
MěQioaǔHwóZVèVYRAAǒEHHZNWL	FALSE
NVéxLèzyaHvvxGvgòùhRRèSEVd	FALSE
OpòkUiWaPuHhyBlIDéémDpEièW	FALSE
QBFeàEYlròyACGGǔoNǒlddwRpA	FALSE
RabJNRláaoiúTVáuDǔplpóéXPs	FALSE
SunǎBáhdMǒZmbMúǒjTzǒIǎòTZR	FALSE
UúLWIiAǒtCvZACwBihlhògeYPI	FALSE
VXicoVjVDamiTrJxLeQSZxiùuY	FALSE
WuáyAiXWjěèuWDwIDNmòIwqfXh	FALSE
YDùXivmYáǎVJóAzHmwxEjěfdDP	FALSE
ZXVàNenOVòòJǔEwqNAIàfbàizw	FALSE
aaěvKSòuHǔdMkdXeóvZDIOUGYǒ	FALSE
btvǔwkFuvXLKmèoTFAèióBjǔYc	FALSE
dǎKubèJhgKěiJSǎmNULAQcèaFc	FALSE
eGQéaóYypàIrPYAisKZUòzVǎrá	FALSE
fMúzCpXQwmoTSèǎVThaSOitPZù	FALSE
gYwcYFǒHǔkAGQwtvějèNtáMǒER	FALSE
hrVFPECJWKBxgUrnDùtnDKTxúB	FALSE
jHdmxXúěvjChgYorkǎxsFEzgex	FALSE
kYdDUVxJzǒEHǔbYiQqxFWPZGǒh	FALSE
llMRMWǒQbǒnpwgBuǒVfnhUECùs	FALSE
nCOwUZdrCǔMOJurnoNeQAslGVK	FALSE
oOZZpPùóEIrnSEtBCwHAIOKAòǔ	FALSE
pmǎqúTùJpùHUCVjùAǒwLmJeCǒy	FALSE
ráblQpenúNbRSúTSWZǎsnJǔaàr	FALSE
sCIIGgTVOkFxyYMòOùSdòYPLwá	FALSE
tGZJùzUúXKRǒKoIéQvWgJHIWàh	FALSE
uNúěéshDIhdVpaěOWgáúIhcRUS	FALSE
vqlpQXERUjSWfBYyHuBUuùewúz	FALSE
xTèJyǒrIWWbBxUáǔQèMOiqhóIb	FALSE
yjiZwpMgEMjòIHúIneǔEéboUqǎ	FALSE
ùùKafLbmlhcùQǔěWrAéabababV	TRUE
ǔfNBXfYǔéPǔBǎBabababtUWOBǎ	TRUE
àùCRVXioPyAabababjXfKZMsáT	TRUE
ǎNDAgcéùCcdcdcdJHsPvuuQLnN	TRUE
éwàCagGWGenCEǎǒQóAabababVe	TRUE
ěJuQBéGZKjIabababCsiFǔDlWò	TRUE
ójféúóGxatsiáveùtòefefefNL	TRUE
ǒéXóTpOǒàNYáaBXàefefefǎULn	TRUE
úFYSHeKGnXmGcTYòWOòXcdcdcd	TRUE
ANXNSOcYúraJYQúdHeGIefefef	TRUE
BhxààYoVmégcdcdcdYéěàváCNz	TRUE
CvǒUàrRyiǒèněRXNgabababuzA	TRUE
EabababkGFvzuUbmǒfYQlORáúh	TRUE
FvǒNgǒOzPMDabababbvùEyRDLf	TRUE
HMǔúcdcdcdAWhYàhYoJSbiOgèl	TRUE
IcdcdcdfǎaWGóVppAFyNwAIòmz	TRUE
JunúgAUeUjcdcdcdOssèjScBuD	TRUE
LErSWeùAjddFvgMScdcdcdKnqE	TRUE
MccdcdcdCqǔxxBPDRpKOǎáèEǒj	TRUE
NkcdcdcdòMqǎAWoKòXVCUǔKòtW	TRUE
PòHKVwOǎtwLIáoǔFomefefefGá	TRUE
QUsLMJDǎZJdfCàefefefNQùMcn	TRUE
RlOǒETabababeúgPKLpSùnTúǎl	TRUE
TáKKLGzcLSIJvòxcdcdcdúǎùJU	TRUE
UabababaúqyUgXIcějCsǒQGouH	TRUE
WǔpDMǒoěúaUdǔnPZěefefeflóG	TRUE
XPekèùǎLPXHxVabababRùǎAXàe	TRUE
YpGyZzPPabababLáeuWxǒzěvúú	TRUE
aHròǔàuPWIcdcdcdYmxǒbfCpFC	TRUE
abababrUúgjvHXgtNEvbZzLFwG	TRUE
blIǒhgNlèIurFefefefJRqclùQ	TRUE
cdcdcdGNHiKěeEùsHóǒèeWszǒK	TRUE
dFFóCKYJiùVbhefefefYNáeòǒó	TRUE
eXsmabababcrTIOeqyXiǎoJoyS	TRUE
ekOcdcdcdóeQJKǎrzzhhPCRCtK	TRUE
gǒùdmfěcdcdcdLùǔpuvǔdYFQSě	TRUE
hOnefefefoèDBòizáVUCqǎtéPá	TRUE
iifoǔRkPvúèAPWzWtwjefefefg	TRUE
kúsjoùuNKUovdràvuScdcdcdak	TRUE
lPKabababjHyRfqBWSPXGDgrPB	TRUE
mkVsUVáNzVrmWoeNefefefdGHI	TRUE
nsInpksáAùǒPefefefoQTPáOǎF	TRUE
pPhùKUEpbYweyoqefefefòuǎdn	TRUE
qoZefefefqjGrBǎóǔjàEuCXGcg	TRUE
sǔhpGcdcdcdǔcPeUPYMǎyǔISuD	TRUE
tBEnEǒqèhévDQdùtòcdcdcdròw	TRUE
uPFAQcdcdcdxkrsORvGbWúúǔYǒ	TRUE
wèèrovmTPKcPǔBucdcdcdhKeLu	TRUE
xúTsOskògtIbISwefefefsAHLu	TRUE
ycdcdcdLǒabRSHVùRQHXbwǎjRR	TRUE
ùùhsóBNAJMjnkFcùéFZzOàuòLSP	FALSE
ǔCapúiOOFAQDOòoLGèàZǔNcqNJl	FALSE
áZRrPshCùùàIPzóOáqqOZzeǎVjr	FALSE
ǎǔPcVBFěDNfLǒCHúúvTSúNhxMeǒ	FALSE
éAàKmUOqkMUPkRUǒhFDxGKfZJft	FALSE
èbEqUkFwFiGFUcǔMgbRLMúsvlyě	FALSE
ětcěgKMEPúEPtUPIRPZtJdSRzNo	FALSE
òBlxxMaSUtmhQLVZAǔByMclxjMY	FALSE
ǒfGCERRfǒtOjFòèYRPCensécèBQ	FALSE
úleyUOTǔCJǔBeXbGrBoIXhdVqnt	FALSE
BFòúáXràNxkěnmdǔoepoáAFBaǎK	FALSE
CjDlvpùTGfFòYIvlOAYuboMQóSà	FALSE
DwooeQgèoódHnCqGCHkfLcXPlěv	FALSE
FCǔWNFZsxRVàYapáxHCGAbDAHdM	FALSE
GNUuhEiUxgòùwPmRdOWùǔeàYǔBW	FALSE
HhèúuUIqAXòlùnYtbáǒOǔódBǔHJ	FALSE
JámijVprěPTTZHusQiěazOǒnòUG	FALSE
KószyXěsnMTAwOQujrBbJdXucLx	FALSE
LJENGnòǒDhwǒyLfNxIeLlDHagrN	FALSE
MaěETtèongYLGaKyABúámùhFáVP	FALSE
OǒèhBhǔAsJlXTuqLbVèBQhDèóMó	FALSE
PGeBAóùnIyJHǎhFoQěbnQDaòrPz	FALSE
QsǎóěéXTpaěèúFcfElXǔhmvbèBi	FALSE
SDPáfHkCéàIHiòiHlpsédàBltwH	FALSE
TgiOépCChimnùEàtQùZrqFNVlGG	FALSE
VáoZHBUǎáGBǒmrtǔbúMOYWCYJIo	FALSE
WDhAXòPúTàiCòLVǒrNzpǒáoúPfh	FALSE
XSGaǒrvóTngvCyéàKVVwtùdEfWò	FALSE
YsǒAxBJVBTéDsǒgaLzCbqhrtoeA	FALSE
aǎqàázàkiSòhIVAkkUnWkùayúǎK	FALSE
bTxtJhOáNqyòěyesjkóùúWMúLvT	FALSE
ckJAmyhèáèéěOcnfIǎzqEièjrvM	FALSE
eEbHàónSvúsdXCùhpYJLnCTJmuT	FALSE
fZfDǔBDùRmEéRǎkěWgǒoUTLmáiǔ	FALSE
gqúbtBóuhpJVOhbàOWùǔNHYCàdú	FALSE
iùkfscNòZèRǔOtWnmSmòàWzOeGM	FALSE
jFRdáMèNueCDBDVLYùùbòUwLSin	FALSE
kTbVWBCabvAtùyúmfKjVKógvVMm	FALSE
lkèsvNXYbCéǎmjGWzkRqlGIqXki	FALSE
mqHèuèmjaǒUóěSúkěàrAIpNknPy	FALSE
oDUyqjZUgrvlěbvFImǒwǎòùiTSZ	FALSE
pUHlzvéoVyHhyèúMéPUSEǎěmNfá	FALSE
qdnánúSFgSvisPáIUIéwWeymEfà	FALSE
rlUbBtIWnZVKYGajrQmBeràKuBt	FALSE
téQmaXúxVWeQWgqEbLbMGFEYyGq	FALSE
uCěYZéCiqmMhfNEsLógMhǔRLtZǒ	FALSE
vWFEetàǒmúubhOKzpóNajvcǒWèk	FALSE
wgYzějKMykiǒLnokvGLgQNDGyRU	FALSE
xizRBGJiqiRóUMòNFhWZBúSbHèé	FALSE
yltMéPǎMtéúúCmZóRhEOoǒóBkàl	FALSE
ùùěòsRkqmPuhPIXqWxOcdcdcdki	TRUE
ǔFXeOéJZHNLFztYHcdcdcdinSFo	TRUE
áUcdcdcdEtASúndgǔěǒKèrgKáai	TRUE
àmpxBùiRáGmIQuHcoWcdcdcdmtl	TRUE
éCIBHBcdcdcdgmPLKcFmeèVYyúu	TRUE
èPZpǒYedBSTtCwěwcpefefefrOh	TRUE
ěWgMLbYúfGEaéIcdcdcdoLBudqS	TRUE
ózóXfJZCabababyDjqkIàFiUáTz	TRUE
ǒBBHVnKkijǎcvWTPfcdcdcdzàèT	TRUE
úVàDtzěTHnǔǎUzàGèòNAcdcdcdé	TRUE
AhFcrPómkàDPwNméCěkabababèě	TRUE
COzYóabababmàCiócéúùlàogvtu	TRUE
DsGefefefZHglZdèěaxwpruRRzY	TRUE
FǒGàiáúATceefefefZWǔieDWSsG	TRUE
GQPIewxeKǔjǎiykshcdcdcdbMNS	TRUE
HvQKqgIGCèùùKRvhVTkabababbg	TRUE
JDQBalEèefefefhVpUPqǒǔrǒsǔX	TRUE
KlAbonigeefefefHǔChdViCuHxM	TRUE
MúěJiéanZByMúabababvéGPkQVK	TRUE
NQDEUǔqbFDxOefefefEgWǎGAOYǔ	TRUE
OyaPǒFéURaabababHIsǒFxfgéRá	TRUE
QUáUòuIvDHLXZTobEAYpGababab	TRUE
RiOwGefefefLnoUCòWLpIhzEdjW	TRUE
TELcdcdcduMoéojdwTáàòCóPJvh	TRUE
UabababjbOHRMsùzmónjStLaabU	TRUE
VwxefefefèVsǒfbLǎeUqgsnQǒQj	TRUE
XNtQRMgZvxěRabababZèpTmwLQi	TRUE
YZWbHZǔùrrxZiKQoinPLfababab	TRUE
ZrPoUrZáAXDUàanàERcdcdcdPǔU	TRUE
abababUGVéLGBrSòkYncWLldǎpf	TRUE
bVSòDkàEAMèèUDZctMtWabababb	TRUE
cdcdcdǎkWBFZagǒIKSéSWlFRtIù	TRUE
cyIEkefefefluFSRimgqVCYGBWj	TRUE
eEěBwèOuǔabababxKEmIéJNXPée	TRUE
efefefhjpFIGUorpáěAHVdOOFZO	TRUE
foWmóLyRǎBǒXQhZJrefefefibék	TRUE
hèzùVIxèǎbLcdcdcdlLpXiCsxVM	TRUE
iSRRlészsCFucdcdcdùcǔXúIǔóK	TRUE
jběHZfksóòBúQIaúcdcdcdnWZUy	TRUE
kyujgLHXjefefefpbóvPúQǒUcùn	TRUE
mJáuBNòBQàsabababryWAmuvoòm	TRUE
nhBnTztBGǒxWLDzFùabababhcwC	TRUE
póBmyQfQamqSdxvtHéfwcdcdcdǒ	TRUE
qZabababLuNjUTalègfwlwQnefV	TRUE
rodǎNaOSAèPěgMeIabababáaLvf	TRUE
tECewEJbMNsǔacdcdcdHyhlYaHb	TRUE
uefefeffOqéáxFǔàiàQYKxoELvè	TRUE
vuQóusuKBmRàceěbǎefefefèéFr	TRUE
xMkimóàAGzfèlJzeǒcdcdcdjùZR	TRUE
yabababiLaèvpQxǒqNlǒuVTDěPw	TRUE
ùùùbRrpdBmZwbáGǒěwJtéyáqFěWe	FALSE
ǔInozǔCUjMèAkYgbqěuxèǔgèoZJǎ	FALSE
ánxèWrpèLCMyxgOuOhoewPzLHàMC	FALSE
ǎáHjYIbjetbDrjllXxBKXyXqUaCK	FALSE
éúpàNHczbǔEdcLRdùúCLjMuAayqǎ	FALSE
èIZxdoèZHcFnlVjRVAyrLTwFVuOU	FALSE
ěbYprlWVséKiLaOěCOwEùtFPOMěq	FALSE
ómUSrsunjèkLtOtkěgsgsYXúěScg	FALSE
ǒǔZqgwòjxcMWpFfAGwMapBMSSnUL	FALSE
úRgzIRduggKrèNMàxFhvàuDóFGuN	FALSE
AjInnqpónwgVieèZbjebwdJVEàTE	FALSE
CGcObMQioRBgYùFěHrbDzdrXSdMu	FALSE
DVfUDmTSEhGǎTtBEVùúgàqóòekCi	FALSE
EjmUxPcewKzVnoFNkǎǔLjěXXlkcb	FALSE
GófěwófbSàVtJSSntiǔWlPhZǒWUM	FALSE
HEǎǎǎbděépǒrvlǒKvvASlJjlMNjé	FALSE
ILfQRQObòláINMúkrrmcvGóèòéěX	FALSE
JXENWTtoàTgIùdWJèLVEQyvúkaMc	FALSE
KnDgEpWXbàvAǒGàCkRQaàivYáOUO	FALSE
LscRùgòXPdoUpwChDfWCroèUǒQOè	FALSE
NGOYDdsúgtuIafbúBgYIoúeScpET	FALSE
OOóGYPiXQyùDWIaNúxXGàFRáYqeQ	FALSE
PjeoinIcUMaqmǔǎmStMVPVksHxoK	FALSE
RǎàǒéHwndIèlIDjFHěTèóéwQucwP	FALSE
SYzrSjáùFXAfLiZfknZùIèzQwoǔP	FALSE
TlHdOdKáVóDCfWCSmlZUJxěajtRK	FALSE
UuhǔJKwDàZMuxbgvRnáxdoGiARBN	FALSE
WILzěDIFaěBókEvzxulXeúCNQLSN	FALSE
XQwyaBbmXvIEPǔěoQAILgqdpěǎbS	FALSE
YRǔòEúcùegYOGfwPlimvoVbkNVwM	FALSE
ZqdRPllǎDàXAòzrucǔpXmofrwàXz	FALSE
bùěwqKàcqGQCàSàMxKwclZLóǒúèV	FALSE
cAdfkNigDEvkFakMvXeMadàGOěYC	FALSE
dSjóRShAQKibéòbaèpaèGHnUvgaǔ	FALSE
ebqsRrLBVXjNuàRDlNǔIězwOukúS	FALSE
gDrAbBèSǎómVóufDwJhOMYkvNOSh	FALSE
hUbòyoommǒzúBGqNYiSàtǒiexGcy	FALSE
ihUǎZDvbGiAmSgmUwTtZoNiPiEmA	FALSE
kǔkjegYyWALOEFoJyHTIáRěKouóú	FALSE
lMvKSDXlzHIdWquVhYmàùIbQàébl	FALSE
moùDlzIGKjIǔdzNxqNùděLiClksó	FALSE
oúKmjCBàsaNCvPiXàònAPooSbSXS	FALSE
pWuPDáèòWvgàWǔLjdsBMYPǎfyJJc	FALSE
qfbCyfnCqDǎKèyàXHKrNLwPéǎǒJB	FALSE
sègzxùiljRCǎfJXCèNZqLNCJiONV	FALSE
tUQǎyGárNsmMlXóèitlZBxowzEKQ	FALSE
ueqgITumoWsAXLègWòòàpIQǒěhBó	FALSE
wàAQQóVNRměwwòegoArEéàFlpCǎX	FALSE
xHùGnAjtVzaBAàxfpúáfvěùhMYuo	FALSE
yZKZnZwKPasTDEjRkNgfWCáúFDǔv	FALSE
ùǔgRjnksJCTcQmAǎocdcdcdFOóùU	TRUE
ǔAIdǔWùZǎvààòxfjPVúǎdScdcdcd	TRUE
áRIvcSfabababéCèttòwKUYCóFsb	TRUE
àrtkóBdEéNuqzěèaebSYCcdcdcdt	TRUE
éóYtgvlěqěócdcdcdqrFAKNpjèTZ	TRUE
èEúòcdcdcdaPPIzUǎVftcgTzxNep	TRUE
ěefefefhjHòVAStPáZùGXǔKèyWSD	TRUE
óvòcěhrǒefefefawGàgEuáQzVtNN	TRUE
ǒNwKGtcsqNòOIùtZBKjQǔMcdcdcd	TRUE
úkúwiBtǔmfJIMwefefefùòNxSfkě	TRUE
BápqsnefefefaqPQùBaJjJvUZPXa	TRUE
CIqoCefefefǎyCvwFfHpMHdǔuTvj	TRUE
DTOùVDhncdcdcdXWiJQZzBEPJZèá	TRUE
ExqzróUjIPDXòùèiánbababablef	TRUE
GóPjtpléǔMjQefefefǒxVOàOérmJ	TRUE
HemRaVfǎvúkvBcdcdcduNyHrDOtě	TRUE
IszXhefefefvaúJzxTXǒAcjGiǒǎǒ	TRUE
KAwKLZACefefefwútqttJOGKàFǎm	TRUE
LTEwefefefSVNOTrěnpèěBBILwAS	TRUE
MdǎNwIòZtzbBYRsbSefefefvǔwTK	TRUE
NuDáefefefébmEěLsSúxIǒRZyTbj	TRUE
PBSGIyiwKǒEMefefefapvlěPrMUf	TRUE
QcdcdcdseǒmvPTYmQyAowúVàKhnH	TRUE
SùNTǎaefefefSfZrszOoKgYǒèSyx	TRUE
TZkYeQáDljabababtdXcQpNSoòěU	TRUE
VéFjGSpfòoúacdcdcdDfFylWòǔrg	TRUE
WKvbYHKyJáDefefefùùàgàexAbKH	TRUE
XdéBéCXUòMwEtXòjDccdcdcdxeùf	TRUE
YyefefefkoJSùsmFǒéeáMSQěySUd	TRUE
aNEǎkabababSěAúǒǎòtKFúáFěgzM	TRUE
acCtúmuRcQZWFRǔefefefYuXéMlU	TRUE
cègnkMěgMǒfRMéTExlècabababNU	TRUE
cdcdcdmSPAteufjIOzmOtSùdèbxz	TRUE
dvabababòYwǎYTKpApoGwCVoxTǒh	TRUE
efefeftOcKVgKkúgEXòòPPuvknòE	TRUE
foZXsnMLàYdabababèQeálvLJptR	TRUE
hèěQmméabababòàEYyQKWKTùgNUs	TRUE
ieYycdcdcdYúGúKCzCQSFAKjAnèH	TRUE
juefefefgInwVOódEvàpuLgUtvkl	TRUE
lQGyDQpǔFCcdcdcdtúVXKjcRgXVb	TRUE
mRAyéúynkàabababóVòPBUGYoiHJ	TRUE
nkGefefefagNWTaOǔejWHǒgǎlávV	TRUE
pBèǒYzòbYnuǒRmAxOefefefwàIùv	TRUE
qSxlèabababVOSPǔNTChqáYéyPgQ	TRUE
rfCDQIKJbefefefMomeěktVkzEmJ	TRUE
tágaUnucsǔlZefefefzMDèXeOQEp	TRUE
uHPabababàhtAzcǔpgǒǎPèYǔLJxG	TRUE
vkǎnáóiaIJLydǎhNeIěuUrefefef	TRUE
xàwOJhzPéfkPOKscdcdcdéPbWosh	TRUE
yPàefefeféztRlráhOZeóAtMRqKz	TRUE
ùùǔǒGHCùtbJWFěéjyNGbatsqwwBǎY	FALSE
ǔDòMGCazsyóKwKeaòtEBHatxioQJA	FALSE
áLUéǔRnMdCTxqJùwpeáMpEavúytáX	FALSE
àSnóéJTKéQkLLǒhURTèRDqQlKvNKj	FALSE
ǎlXMTaròěáexxiKszsBrVIbǎBéǎěG	FALSE
èúúZPrOHěéZYmgKUéPYNAfCfmóàfP	FALSE
ěCDsWòàgCěQBUuGqPSgPgjǎjǔSJyt	FALSE
óOóVèùtrnPQaogKPaAUvshNhSjéùw	FALSE
òqDGGǒRFcoYlAqvplKBQzSǎèèdàmf	FALSE
ǒwPRPTLImeIGHDàérFvyétébuwsèW	FALSE
APmzmúuXjétNéjfwRDoJxmLcùgPpé	FALSE
BqàésibxpRègaVubvnrCCHtnvtfHE	FALSE
CzWméegtaǎjòMXHqdùùcENaJEjnyA	FALSE
EQqiFrFFnPuaErVKOHzoyIùpBCǎLà	FALSE
FefěrAiqHéiJjxIqxENZwWqéByùùd	FALSE
GmzYyqCúJWDzKNàióqjpmǎeCUSjLǔ	FALSE
IéǎncJalXERNZXètEnWqWYjyxòěEf	FALSE
JEgěhaWòcOùAJKZXKEJQòjtàcjòěW	FALSE
KSfUCPiólXUkJKmrèáàwFDùPuJoúe	FALSE
LtcqmqjèENlxHneFAèQHXàptPvVxx	FALSE
MtéòFoTàuáJyXwtáQǎRfmwǎuLáFyQ	FALSE
OAtxlLOAnágpěáxocIyoáyVvmLnǎv	FALSE
PUFOhěoJáRlóhXǎWshHqpáabàvQGá	FALSE
QkXknEùpEiVrmXhLeZhWPétwCoWui	FALSE
SARUFGuxjscqIwSVěàSHBóiòùPRZH	FALSE
TGuAkWhRToùbùoYPěrNAkMEeEplps	FALSE
USjùIRcVóMoròAEaúEbEfZPúFúòòó	FALSE
VfǒMtMYéqáHULIwxDkAèjǒYNQěpBA	FALSE
XǔWRwtosqéJCǒúFémCindePCèHoDg	FALSE
YSGSùcewJòPěigpóoIékEǒOqubxFA	FALSE
ZeUápjSeùIZykǒXpnScUsjyNNFàǒr	FALSE
báIhIYxjXIKZpAUOuxyvKòběkáLèF	FALSE
cIHtMPozdkfSlègRabSeElQxnUCXJ	FALSE
dazZYèrxLzDcqlDàKpǒXPIfkSèiZC	FALSE
fǔGiuUNóěRwyǔLkmwEvyDNátqSRyU	FALSE
gPlWǎwWdOUTFxyTZujNSsxkIdQeYx	FALSE
hhyiAGúrǒǔHbqhjOQobSóěBbToyXL	FALSE
iyàhGBǔTwuBèzJWceǎuzaǎéJZTLaè	FALSE
kFàphcvYrdéSqZlacfbùPmnvJPǒòá	FALSE
lfLnegǒlèǔamǒIYPmdmǎxHKnQESVc	FALSE
mveCNGKaeòpfOvTmVAáaYáXhHLéěo	FALSE
oSymfmSfbófOaèàáǒěqeGgSYCeRǎj	FALSE
ppESHEpsnRǔWxRúffagèCKcdOWkYI	FALSE
rDgfeòáRSnǒwqQYvxoEZSMójccgéf	FALSE
sOOéěOòòMyBcygmémyuKOsěkǎaHèp	FALSE
tRggdYWqjCióoúoDWKiWjrěNdXyPY	FALSE
uyAóAúHámWNTǎǔoVEcqVXhJùOUUJǔ	FALSE
wòXynunǎTtyqAjǎTSòEnGfVvEGOyO	FALSE
xPQjFyNhnQlTkEvwèysyXBYPSbùYe	FALSE
yajǔQúǎRBCwvIǒstKoeòuúPWówAox	FALSE
ùǔáSáMScdcdcdéhóOUCvgKASáǔěFw	TRUE
ǔaRMBthYqvMcdcdcdvǔnZùááqKsIB	TRUE
ápdwOeAefefefiéTùenésErFDiàjK	TRUE
ǎEcNJMEkácǎThEeAmVLefefefeIkr	TRUE
éSYHefefefHVKòRdyùjkRabXáeWRe	TRUE
èhǔBzRyKěNWefefefxwJèFZauPTǔt	TRUE
óúòyWuHuàefefefPxWésyHLdèSpcz	TRUE
òLǎfqLUefefefXùDúoscRXYKGiwkX	TRUE
ǒQzHPbTefefefáQǎeZiuěDbIHbwVH	TRUE
údnogkQPàHnHzuicOsuabababBèMy	TRUE
AsFeBgCàyuJǒzTkRkvtcdcdcdeLéw	TRUE
CúHAǔúwefefefChfAJDASráJwWpQH	TRUE
DZvààbPSFVmMěésnvRqRabababqoP	TRUE
EvfTUcéRecdcdcdvklBMyIXéOHRtE	TRUE
GHzlKUyvMWtkposúabababéqǒlNQM	TRUE
HlcdcdcdéfWNóUpèpVHhHuqurpèTè	TRUE
JèèèQwóklGdLefefefjqúèIǎryàvd	TRUE
KCkyěHcdcdcdǎJTvwPsCǎékUùdǒRP	TRUE
LHàLKjVyLabababoádNcòvQFéygJQ	TRUE
MabababěáEExsJWRwàSXFǔLOFOxlR	TRUE
NwLrěYǔxKdcdcdcdktVáěmCrFTiNǎ	TRUE
PLWQWPGàǔùLàQQVVJUóJfoefefefè	TRUE
QiJlsǒóúèxwaUabababǒiFéáěAXCv	TRUE
SǎhSjóqhKúsIHKnèzkOáabababjLZ	TRUE
TKahǔNIzětǎMCYabababMFbMuAxǎK	TRUE
UmǒbcWùabababáěDCóLNKlbJFKZJù	TRUE
WǔaBèlKlùǎQboáhùúiabababúwAIF	TRUE
XInvNNùyHzodèabababátjushjùòx	TRUE
YcdcdcdZepaáàluèddpkAWDyzADáL	TRUE
ZyWpoEcnabababMzFnetgǒBězaèjǎ	TRUE
abababPmóNùnZVFxoQMúáeAVLaIwL	TRUE
babababUAQaDdFHUàQtDIùZoùhASM	TRUE
cdcdcdWǔànàécúEJWxáyNsTloelzǔ	TRUE
dQLsIhGUěbútéaUekěabababINyGZ	TRUE
efefefQǒpàvbpaYHǔacòOúéRepQBE	TRUE
fRaùCeeqqqàWSvóNéǔnefefefYpxp	TRUE
gjdpdRKǔIAyluefefefQEòáfxGèǎV	TRUE
iùAHyQkvBIsOyqJnězrlNabababNé	TRUE
jRtVabababèaixǔéTěIUlZèvVsYxé	TRUE
kjáhKNyémjjQocdcdcdlHLWsqkJqE	TRUE
mǒFUCZwsHòějabababsùóilzJùvdú	TRUE
nMIifYVQefefefěAKzdpVemFǔmnCS	TRUE
oiHcefefefYiHPàKjǒaǒipsǎgFǔlR	TRUE
pxkWdùXpfMàSODXUxǔfabababWCRù	TRUE
rMcdcdcdiěxǒǎtFoFTUFúOóùFSvwj	TRUE
sdéQrBòRAwabababúVfTcIxtocRHC	TRUE
uóSzxcdcdcdGJxàMáNráùqWfàRzMn	TRUE
vpxiheRlcdcdcdtZFFFrKJZTsOHyy	TRUE
xGTwYcdcdcdMtvvèyEQAroosùóRnu	TRUE
yaEIIàlPVSZrpBvNxèMǎPTefefefZ	TRUE
