ùáfPǒgWftiójvaSkUAVRóozàWěWmSHd	TRUE
áTOkòUNrvòQUcJǒBNaaANrqiáèOqLùh	TRUE
ǎnPBaěòzFCRsVòkqGZKvsUgówACǔHDV	TRUE
ěǔròQIsNOSFèimǔuàbiCOkǔězvSěnTh	TRUE
òágoúufOábunQéǎAaRMVéxrúòpPxòOK	TRUE
úVrMuCàPnQaóZBdehàkuùelóZcKKRáé	TRUE
CBAGvtéAúEMrnjbOPéGěQóioódEoRǒB	TRUE
EeFuhNWyàpJéFlxKxJoXǎMgùoaAzónC	TRUE
HǒZNzMPkQXCěDBsAXttdLjùaZvQlkúT	TRUE
JcJúeááuRbáSNUggPSLDIZtěrkrXwóO	TRUE
LoASTOYǔóDSFOkkybmrRARrjTfsáPOL	TRUE
OXDáXDwbjMovzGKsPqlúenFKAqZjcúO	TRUE
RRJKUWòKOěèqǒovUtǒSbBbqǔmpeBRCd	TRUE
UfèkEhàiNanNrèúBicjmzNKǒBuVnZúa	TRUE
XEfZCRFàcBRzEpbnXǔRyótkúBVGQVIè	TRUE
ZfwúTǔèSZéǎuúAVKVyǒyKoéQvzóRzfl	TRUE
chèFIpjFmRAXEàoRZFèàǔuLmsúpXEzL	TRUE
fPóǎOusdIRpuWoYfCTJGuxMRpqhInMǎ	TRUE
iěùSěvǎlmHNěwkězajoRPVBXggoVvmC	TRUE
kLeiSDcBLPvbéǒobQúCǔrUCYeAèwkpO	TRUE
mvàrthZkXFáeJHdwqóreQqólqmWèzKò	TRUE
pWVòaaúmQéKLEnCkmqwRRmDOǒvJPáGF	TRUE
ryRǔJyZnLeoyxnsGPreaXpNIaReKwXK	TRUE
uoǎrAgFvCzrwAylPbExCJjùttzuXFKW	TRUE
xFùfCvMNeToFfHoXCSbSóěfRDYJrcòS	TRUE
ùǔQpptXJaYáaèóúNbnYeZGRdPàjzJéò	FALSE
àúǒwaoPGczěàtpOéRtRTAtbOèLzUóQX	FALSE
éaazniqXbrSkVáGNQbAUúèuIóDOFǔPj	FALSE
óèksJSlěJeLóTvxaIXQoeòmgBèmějbV	FALSE
ǒjSáXwràZTfVRXarzvzwúVAbeRóǎMtT	FALSE
BaqombtPnVmùfòHxPǔrEǒàClkúèKǔZi	FALSE
EóedwaàsyQèóqbéPhmúpěMzNHǒéjběě	FALSE
GRtúvoJhǒMaMbuèXěIèilXyQiFfǒzěS	FALSE
JCùlwahFóPnéFouDǎCǒbIPpsoxèzòqo	FALSE
MóqhHRǔàkSòaiolsJlónXxKEfByubǔr	FALSE
OjaxItnigGXQdhnerjCqběèǒjWJFOEH	FALSE
QzrFeúSsòNagExOPDùjèZQKfMdYdbCx	FALSE
TaHxjèamWuqěiXlpIZMàóPTioAxibqK	FALSE
WArKgnnaUávYJKEkfKEMKLàfnzbjXJǒ	FALSE
YpCùěNdqNUǔpQZxOxNpavábClEQEèuX	FALSE
aIWhàTGpqYlòDCeècIJěPokBhóbSDjU	FALSE
asǔAMkKbJODxdiJNhuǎzNZyGbgáAMVǒ	FALSE
eǎjdwKIělaúébbóeólwxúóNlOWòJHFy	FALSE
gaZFááhQwOóEPQHDEeymvbDbóVǒLkJv	FALSE
jUaEcWOnóúMwǔaCsIzloQDáYUsYpbjǒ	FALSE
mFcsúáQvǎTrWiLqzAnYPQOaRmmybShw	FALSE
ozxpkéwpQQKrpaùqyàbPpvoPèrPuemi	FALSE
rNWxWWóMzásámuǎXeQaKsěmbZvěJZǔT	FALSE
uKXkMGhMàaOhscFòvxxXàKùPMàVOǔbǒ	FALSE
xFaLlfFúěziNǒǔèdbpěUbàQhZTrCIWǎ	FALSE
ùàDczpbEHèWùeHSnIzTYéúhLǔdbxèOòu	TRUE
áPRǒJHolYjkMQòFWGmZědcHtvLBczBKx	TRUE
ǎgàtBqóváEoGbXEèaNnlAVUujHIAZgvy	TRUE
ěEYdnWqwtǎdzGóúvtvYYOAgyFfóJcxuè	TRUE
òUZYFseFdRLgǒlFQsǒátWwMTódǔaFeSi	TRUE
úwòWúúdkqcékěkuBBRBsEwcèbPúZklFù	TRUE
CPěawGbaLùǒXaOBúZLeáymǔxXGzáròps	TRUE
FǎuFXièwAnAKúMTEéúcàulFvWmátlbxá	TRUE
HolPbPMbNJEǔǒMQàKézáàxnqWEěùIDGF	TRUE
KMèEnKJQfBáqZaYywTHěViùBCǔtdiymX	TRUE
NèptFùGXohikùAlRYhtiHhvǒFAkàvjǔX	TRUE
QùMnǎAfqJtWdHUCIUoYBKgwMnDVùǔsEK	TRUE
SPweIEEHSHWonEBǎkYyWǒQèjDvUoYeCH	TRUE
VáèsǔókjStbrAKchdiqmllVqHLóWxera	TRUE
YDJLYkAbOMQRDSSjètVFHFQnúNtDeebF	TRUE
alasdMóǔrlfòZjèdWJQtOwdAgviNEegà	TRUE
dDjáJvmlNécANLgNiěQWnǎǔgpdiòMlLà	TRUE
fzLEsúǒiǔyAPówágàAgDéxCGkOEnúpóè	TRUE
iGZyGràoǎRrJèkcVfnGǒèxúOKkápNUUL	TRUE
kORèxFyàrOYǎqVòMCHIcǒKqqIwHMǔQUV	TRUE
nCwCTáJxxěqGsiiATGcàNiYPúhPéAgCè	TRUE
pzZúpZoFLLèáHPdrěGkǎòOzEWECGjYVù	TRUE
sGTrěkAPSMgvPièóSXfUWYApQmUǔùmGo	TRUE
ueOJSHòZsErěiotUOǒUORXYNmCsRQvXN	TRUE
xJFbFayvaAhUǎkJěfJHNMUJáKpIàBHYá	TRUE
ùùiIUyRLBǒèfàqjfTKVVxSqaozJmóúbL	FALSE
ásdRukdǔdHRóigDlearBòetUbnyǎSqki	FALSE
éUwSnniarMěKoMǎYcáTǎNPuraoXEWbǔS	FALSE
óóyáIéBGWJVaǔtzǒznGKbdVjQADLLzoè	FALSE
ǒUApRàpdKMlVtCǒaPmWBǔoǔFyeHǒexbI	FALSE
BDOYwFxáeNaHjsAòDHéQMHoVXIGwbWCà	FALSE
EǒPHǔlfeměnpLkVLéaWFláUúVbfóWyWó	FALSE
HBddTftQfNwaǎVeélebòFovpkYuóITěW	FALSE
JxpJzéSNwgùyFiPaBèLHinoVLOuldboe	FALSE
MSdǔUaóxkèRàrfǒNYáRTǎráAIktabBqW	FALSE
OpPYèuaqeKáZSEAǔHZRúPHffnObuùxAd	FALSE
RniqLóafgvópwUrpGcfGyeYrFáabDYtw	FALSE
UTóFúPúyIaòVIbwCoLZDǔeéǒlOtWfvǔA	FALSE
WyòuxaǎópéGVMoOQKwdfiǔAǎBDYǎbGět	FALSE
ZaopLáMrFósRiZěQúbeòfGKGbYKLUkiú	FALSE
aSVckqjxúkjonbtlRèzCélkfuMtòNtFV	FALSE
crXqòuYpàCùmpàóUsPIKǒèáSgasmTrCb	FALSE
fKaóVDHurHúfZlàdEicbQRIHǎLóéBUvs	FALSE
hNwhkaIBlFLMHGkzVhèWYKspěsJbXXWy	FALSE
jqtegěBymDBréamAsFǔodbfDǎKtKuéCN	FALSE
mQJodǔaàHPJǎYbkrèILIZúhCáǒUQvALè	FALSE
ouúGILěJOtěaěvHJwtgQUbdJoZDBkZMh	FALSE
rjwWèàxFBlabEtùVZJkeMWkTpEpJxàDX	FALSE
uMQiBGItZlPaVCvǎXúnKZuCfòpeǎHébp	FALSE
xózdtWGCXRGPèèóuthVFèoaOzǔóXUbzS	FALSE
ùǔZAovTSOóbaYNIZèSzaèPvXtRRlVàbéh	TRUE
áXZùCyXYévxeǔěaCDkgTNipJsúkIQàhfp	TRUE
éěèùǔùmòbesóclòwAkUwiSMǔDSZqèùspo	TRUE
ěTrbHàRCrěqgTbAlywwfzáefOuCfwùymq	TRUE
ǒLTǎzNófddVdwieQòMHèXzJYYXFápsAqA	TRUE
BěncsǎGǎKwYJpzqTZòYknǒWpvúSJiIjěf	TRUE
DxZSFFHtThZqbckCpFxmnLEněǔMxǔuěof	TRUE
GHfquwmlWMBZěǔncoyrVybIUKnèǒwEùhT	TRUE
IknEiGǔCgbaYDRMgoZXZtrtóEhuUoBagà	TRUE
LHùOsǎdPǒlIpqosvfyMeǒráúZPCdbóágv	TRUE
NgtXLsqlsNěaqDIDǒQpěBcBSpKéXqóyéx	TRUE
QGJBVmóAVyRòákvgmCcòǔEKújRáJcNàóI	TRUE
SnQǔOfǒCagùǒwfuwòéùznSyxicxèunYYr	TRUE
VXěIMNPkKfTóaHPàNbǒuESGnáraQěWérc	TRUE
YěǔgVRěwDNOPduMsaKJEAGjfèORuzOPgW	TRUE
aQblEKIFxwMkawkmáaòZijUqèéKxVOYvE	TRUE
ccwHèTbGVSúfOvcEKYVnóúhqǎHCbyNgMI	TRUE
fOhpMXěufǒkLgSlrQIcoMpBHǔCoUjejqu	TRUE
iǔDzéRVbDpoǔjbqbgóàǎMiQéSaKWxǎfBù	TRUE
lòqFcǎxKFLqlúqóǒDnRwuOYùáxnZrǔPgV	TRUE
nTuáwkrQèCvmtrtXIedRvCoCzLáxǔxKbm	TRUE
qúEatCoiSUXáEěoODVèsǒzUǔBǔLttLINo	TRUE
siúeWvGGiCwUmGAWcèóVMSIcXhéYbécUù	TRUE
vCjpFáoǎluKsǒOǎQNbzànWeFBAKSqòggh	TRUE
xXnSiHtèBJCHyàufǔhFiLpipKsnglháDY	TRUE
ùéUJFGYFnEpUMaxKVwAifáǒcwxhGbqEZy	FALSE
ájqaPYGDàHbSVXqXDdjRfIepáKpgniGDW	FALSE
éYéQJaBbàhXUkgGhHTZòQjHǎxlyyjLǎDS	FALSE
óDǔXxTZQiáwacqEeǎYENěótcQZBbjrnúu	FALSE
ǒZOTweITEalCysùǔQwnAHSJèzlBkUpámb	FALSE
BPǒkdUlQJaZaZèěvENóoNbásPǔTxIòámG	FALSE
EáórAFiaqXpbèlmúòOMdfǔFJrfgǎòǔfǎd	FALSE
GUaQziFgVGQúyhěZàpuIqbMódéDyǔqèiù	FALSE
JTúaZàASstáhúeàoHéajzbǎoǎmvòNMUèG	FALSE
LpMvǒOnnJpdělxaUOejáěGLnGbIMkZǔúp	FALSE
ONOamǎzudEEfPlǒaUsTJaúmPCacmqNbXP	FALSE
RókQxóoaùàéebCOOTěbVòkSòCòòǎévàDǎ	FALSE
TaALuunjúdNúXAvěòXUIbRǔBJPKTsCèkP	FALSE
WòoǒnIoròJFPLěOEaVzRǎúLáOhùaAvbjù	FALSE
YaIIRCqǒeuGěviJQéàǎUòXoDKdybDBěvM	FALSE
aGAkLXOqUeubVhǔYFmjbéréHéeIVělJfo	FALSE
auwMXEtRdbkWYuPòàuòějWPViGEywěàèǔ	FALSE
erěgJysùQBlqpHGoLapèmHVWPuybQhwwH	FALSE
hGǔvěprohGRjVXOIapVUdMPbògùOzPytg	FALSE
kǎaOuúBWǒbwǒSIhrmEjjéXwzHxKàǔyhPd	FALSE
névhoFaYsòyPTǎGBDòǒgvRXéóbsTnFbge	FALSE
pVjaHfěIdóQfùUJNigIbgdútFNoùbCZqá	FALSE
sǎóxcvcyeJxoaURjbKVJqYAóěBRBùjMIQ	FALSE
uPapOyfMrpMLùjQhOCǎNBóoLIMVbYòPmW	FALSE
xIONLLyyQmuWKyHféEómazěvǒCsòBùObá	FALSE
ùǔDùHoaSSzaLQbrfaavúZǒZLǔrWRJúGeec	TRUE
áVrsVJcTRgMxmóvuEaDAàòTlHJZàRěFyjL	TRUE
éOiǔjJJQvJECMysWsZXJbzVéLSgǒYKTěmL	TRUE
ěiAtlèaVGWmaUhhjǔSLydOCOùeóOóVnxdá	TRUE
òrpcmǔúeoèAOZUDezcèněójOqOxYXàDclǎ	TRUE
AhDGòzòěcùnAóXóèdSwIdWPMghnRbViZNù	TRUE
DLTgáUGmLkéjéESRúNǔcPUUOENFRRtpfES	TRUE
FnoRórJHJHFuVoOLqnycǎJYoMTSZRěMCéV	TRUE
IgfǔLúIfFEǔjáéBǎGbáhuMjwKRèqǎAMavT	TRUE
LóhVHAuATCmSèHIMcNygùOQQnZEvuièXkg	TRUE
NfWlPézmjěBVFàFmbvǎùaJGFIUQxJgaMǒH	TRUE
QxúvjmaǔVTfPqqésXIKcVIIcòěAHZGZJFù	TRUE
TRàEqúMtpJsekiDjCFBcǎděvYúUkAóáeut	TRUE
VsJUéǒǒxqDèBTEùqbwǎcOùXQWJcnWWPExM	TRUE
YóQdZgCoDòrIòǒJSkèYvéuIrmFBǔTYFOlR	TRUE
auòaouPoIDǒMLpxqweùNnDqxPfIàGoraCù	TRUE
dXǔèxeiLVPXqòxicqěBvzǎXAnmFeEnItJK	TRUE
gCNgóCRàBWSIpiKdJkòTéYKTXwgGUAKWóe	TRUE
iduNòǎEDjmqBǒyGmèsIRFǔùwhěAéSWeIHk	TRUE
kzJùCBéVtOǔbPwGrZoúècAnSjlWmEmRwmá	TRUE
nTKòyǔhIYUKgWWkèLGèBCBROpsóùáNéNMV	TRUE
qósětDuERǔbEjVavGhYěPòzsfeQqtcàljB	TRUE
slrsXGxnJwatGBǒQvXYkùPaYPAAǔGiáǔzR	TRUE
vESèNJVMpHgJJkqQlscěNǔzzPaqKgGkkFH	TRUE
xbǔEsáùULCóùdedRrLèEgceZCǎJěxèqgZò	TRUE
ùùúMxaséùfùGGòhàtóloàyMBfNwkNbZàCf	FALSE
áQsQnQKòzAèOabèjYEKóYAkQVSIEzyèSVU	FALSE
énQGúNjameǎivlVLaZOElFUjbòǔgPYǒTáB	FALSE
óarWjxHpfwpHAELOhFZSWòEnXbHZOYàCMT	FALSE
úKétQqajTiUIVzLAKfKèphKpNEbkóUsGzú	FALSE
BmèrpnQcXLJrHDiaQAHjBxJáPQpfbàtèyg	FALSE
ERòSprmhawiàalDéREkyFbVǒXoKèdoRChe	FALSE
GsqLxpdAèePjLBNǎKxqàvnzzòxsDabZgYr	FALSE
JRKPQwùéXóǎmVMpWǔGcVNiaǒrqFúǔbXwrú	FALSE
LauuibZulJáhHpVBmdèǔáqùryǒPKrOEBeú	FALSE
OAáTtqrqVwJAyaZbntPyLxǒBfSdILBfóBR	FALSE
QHXIQaRyúPfBJgáoLxSDàbJZJxLIBOCwéj	FALSE
SeúKéNwapojLzàSScúymAǒDmJuBCnèùvbH	FALSE
VěKvzáTiéTAsaWsSPtVefTnsbxUSvxTHáM	FALSE
YCzGǒuǎaLZszNWKXSrWXLùibIndpěHběúE	FALSE
aǒHǒiZoNWvǎLkrxáQFQnKWpbréěFPSDQFD	FALSE
arZùyěèAZMqRgěǔbzrYiúUJiXOkFěZQǔQR	FALSE
eSúVVmǒjEGabLùhjlGmqěvkQuVnvkjfZsl	FALSE
hSJHEFcVcXEZAveùaXzmKbKlrTOpàěAěkJ	FALSE
jaLkóSúèpǎEYHǔěuRǔxéHpiQzMVrChTbDě	FALSE
mkěpghBpatkeKoqwWbIXpFjJYxznbyMCěC	FALSE
pǒhJfDLDóàQPKfSdkùPBaJsqBbIMlóéǔyr	FALSE
sǒJGBhnDazábDpékASKhnùuEBuQiàxǒiwq	FALSE
uianVsqRRUáTóǎòHvqèbWjQRmàxkGǎUhvú	FALSE
xǔjFQVòBóGGJTéPVàHaaAkuòfgOfbGéJOZ	FALSE
ùùQIRLGGpèbǔùRjlffcGwcriMTfvzlxyhRu	TRUE
àóoǒnCCBTmUUuyyhRDqwNAòZùyUázmàeiYó	TRUE
éYwDlsCGkJàWwǔSqmóéBcPoRtàDKLòLtùAo	TRUE
óáljúkPCaxMMIsǒUYóWMTOògfyǒóYRUòáJn	TRUE
ǒMuhgmroXjúrJWQAuSxLWábUàwàdùAoqOAJ	TRUE
BHǒeNwigimfOPedxOèceFibxkRcěuUXVlvk	TRUE
DxEFxtèOǒàqhǔCuájRcávYdǔDeúoNxmùXùě	TRUE
GJTcùHqyǎnáqǒxěpZúTICEPDAIqRvrǎǒóoh	TRUE
IsgóoJcàXFizEqDúyczIóXiórqtoěZsUAWH	TRUE
LNljèHěǒnězSUTBmAhCtúAyrǒěoùyAKlMàP	TRUE
OèǎZtjTnějLRóIǔǎnwmkáiémwǔKjúHùcěeǎ	TRUE
QWlTarqJbZdcqjǒuAmSTFprCèDáòěEzpmzy	TRUE
TBZfzwxédáInGOgbBpKaúgéAòwqǒcZYOzlè	TRUE
VqQpPqHkaàǔYSùOWvùMnNuLrùZuàǎMhtSià	TRUE
YúgxGmǒóWàDKYZmTuàsùěèùXLéAsiWdóKǒP	TRUE
báXXùRYTpZhǔBHOǔIVóLufTSMAùkczgùeKè	TRUE
dFáHCǒǎbàǒbzsTóvIIáòHKPéhGXNLPáIAǎm	TRUE
fesQQscfNǒfGrcúùnkybZPkFHZóFǎNJXgǔL	TRUE
iǔóeàúJrmsHfBùbHBJèùdbziCAcmHCcFěeU	TRUE
kWǒOZYQulPUóEgvrsvZeeúrtmnKàkrXTtDg	TRUE
nCoRtHCààfALuVOHQiXXltnEBGgwGéhvnlu	TRUE
pfmWdcRlěTHrdOUddqsUiǎXbLwNPkkvǔMJH	TRUE
sQězótwECnoJtPCfèqsiqǒěXcQǒòàqbTǒNB	TRUE
uvScTLèNgxzǔáGRèOaaXúLHtHáhdsMwMbàm	TRUE
xAQNbHhPélWáyPtwTvplprkóCěimlěqGòiI	TRUE
ùùngmǎúqoNLZǔRǎeUáaGIéVàiùcWGxmOxbi	FALSE
áavTùéamiébǎézdázúpORVLKéXǒùMéRPXCz	FALSE
éěUEaRkgFNwXàfZJoYFàYUNXssetávbZIXG	FALSE
ěomaFXQnoěqEàòXzXeIagOǔGàfzTOgOObMv	FALSE
ǒMfèIiEpKTrhLOéZaNlLùIǒáSwhbOǔuóTiL	FALSE
AsvuvtvKǎauEIsbbylAbáBuQúYBlSHdsngP	FALSE
DLkvADólOáévavAVxYeNYWlPFhbzdiǎǒJěú	FALSE
FgsùgfdjZàǎkNrqcUmBKǔùónhaǒvsǔiDbbY	FALSE
IsjzzJBaóMtZQkUOeHrgdOdcUébiěCgàrUG	FALSE
LCOQaóáCGzufqsDbnILTvǔúhVJuLZBlKeKC	FALSE
OèGAnptèaQpDTCGjQapéVQcùvbRǒgàQjfzC	FALSE
QKlafTǔocStgMCéCǔESYǔbnLQyPZùVUUHVq	FALSE
TáuSOgaóCENCàoscóèXbPQmMǎǎPKmpùxònX	FALSE
VtFGZGavrDWenvTTKoNbNIjǎCúhbDPCtUxO	FALSE
YDóiVsLGkèRwHtMDoSúoDdsǎqnAabóUsSeù	FALSE
aCKfwohéIYAlqjǒoóhXCIbáLMotjětnóYFV	FALSE
aqUFězWnseWKtTFáǎrVPdfCTzuAKbEZdGSl	FALSE
eOCémaCHéJKPèNzǎMbVHlXóǒKuNWěǒgkNOU	FALSE
gzyIwLOicYLSúwMFtayjUvmòJOyùFuùLGMb	FALSE
jxàtzYcZOcLohěxCahǔǒbyvWyèGQvDúgNkm	FALSE
mhvICRSCnOqKáaSmmtCMLòàbóQkBǒLrjliù	FALSE
pèmoétdBncfAǎXàfqjKTaèéhbáofnǔGkQUw	FALSE
ruóPcQONXkXKǎnyOaèJszBZpNgGbWyjXXKn	FALSE
vǔsGòsLàxnpiVTrǔTtytEqókqcjǎsaVbRVJ	FALSE
xapeFWàyǔùlFághIkrNofbQáGYIPlztVIBP	FALSE
ùùnJgOtòùúUSǎèaòǒóFǔAZǎjměrRPOsmcffp	TRUE
ààDIWEyǔǔudòáWWtNxRwCDpPmtwqsrPGGTjR	TRUE
éTZhKjfóSWǎphbCDWfǔfǎqQCEYOhástcǒMZù	TRUE
óUǒpeGLFzNxIAgǔúFJDFòemònóEXuqǎièkly	TRUE
úásNpòLbUVildèdvAopǔrbèacAqNeFǎaQMmM	TRUE
BnaZóùLěěRqWcMGllúuMVUtccǒhukǒhNwLáò	TRUE
EaIRdNxàóéAòphlzDKHNǔaěIóéDZgwjRLtUj	TRUE
HAéuFEWàòMwUTiVTQóReèjhóUóxhmtaYúKnù	TRUE
JrXjaBpǒWhóXNòKáBěmhěèáFFslBreMIlúUP	TRUE
MBbOJIImPùGMVGtèWǒxqcGQěPIoHAèǎIúSèK	TRUE
OmvLBAXGrascKmjAxòáIǔúFjàqWXAncqviáI	TRUE
SBèkàEMHfOCVjevrmIúmQToǎlráNVCEwZWxe	TRUE
VǔjzúDǎùǎùDFVǔásòFùLéBJdvJYIoQngéàěg	TRUE
XdiGIYQúEúùzèCnfWpuuLéqǎWXpBjHXpMEsW	TRUE
aGàyzOEóQéynúONzZEVDljóSxTèqIJixTǔGè	TRUE
cOyvDGSnzyAàxYzàPCxpOHnRaGǒDLYúàuxUù	TRUE
fázéLzCPǔmrèhIrTwWdQBSRbSNUùěQJHàqnL	TRUE
hCqUaSàùáIdbffùRlJáZàdRmóXOěáúKZǔJac	TRUE
jIfLOJnCsWsVòduòùkHjXfTTǒéNnbǎayFUhv	TRUE
lfyèBZěKXdPǔRuùhǎZáJgàQcǎéFoKbdNsǎly	TRUE
oǎmHTFuFPiUifzFUExPàQzéòóHúHòMkěcdiD	TRUE
qHvNégúIjérAZDFúwkbusuǒèxeeWzlIěeùVá	TRUE
srsúrǔòavjJGòUpjòtgBdiuxéqRhZwpRméàY	TRUE
váOrJoPláóàhOivmopéEěWmZbáDjjùBéMNNO	TRUE
xIBlHèaKUKǎzrUEsCEdMǒuSOjCfDpǒtǒKèWf	TRUE
ùǎlzrztUpSBErFaDVssddDjèGèaUsqmbnǔOt	FALSE
álCAúáBùZipLéCTQòdyáemTvnTaMxùbXXrCǒ	FALSE
égòCBAVhaBZslqòYqutBpMqyoAFUYYUboJrl	FALSE
ójNuidnoklZdlXàLQsǎaDuufuoVAókeTFúvb	FALSE
úcAGaDKárbàgQCVeèWukAwYpHúórFSùjùúǔp	FALSE
BqèEKDGpLoLTSAyòyNdCmLKxaúEoǒjicQbWO	FALSE
EBaódJǎáfrSLUaáǒRCabMLMdtEMkzrkàrBDW	FALSE
GUoltMǎprcsǒERFHYEWiMaiǒaPéSitóbSKpY	FALSE
JNRZǔCmkǔZkqAéLTpvJeúWáaXjQFqZpqubèé	FALSE
LssJLfoópgòaěùUeCnkTrmóáájzGQHipsvbá	FALSE
OZwgVXKUyǔúCòpáQxaSgdNPaéOnWTHxGóbxN	FALSE
RFǔmrpQPamǎyàWKCNpéLaiJDqTTbòttuSúgE	FALSE
TeDzWèJYěsóMKǔKéjàUèaJdPZxCbqMjCfCNi	FALSE
WSUeàoèekFnLycàùeyizeòǔaGbPHfXUwòpIO	FALSE
ZFGǔHkOnjcMnàORúpěeEAgaybéTANǒkèTQJS	FALSE
aUéilUAèyZǔúTobǔHVonnwpùpzOJlhQwdEBx	FALSE
cFylsPǎnwPeIuMǒaBSTMèáùbxXxózeiKEIlH	FALSE
fóòòQundZkIDóDùOTWéupèaRLvVUbǒóuměiq	FALSE
hijoQLǔSOCyXJěTǎavnèyǒNrGRhbeQpFYWHQ	FALSE
kKhTPáùkGDjWBejfáRLQGsucaLiQěgéèTnbk	FALSE
mZpjxiSloaLSuYrSCěqFznGàQèOqběempQFù	FALSE
pòahéuIYlXbEIlòKxMwHRQxZZgkóèpYěvěùE	FALSE
rWGúQdCaóRDMǒIPUSvvvOyǔTěEHkQqmnǔijb	FALSE
uUuOJlhBěNIqqxǎòaFIèqpsQfnǎVùlrbfèEǒ	FALSE
xàtajǒLroǔévzOrDbèXeújóprtQWùfǎóyhni	FALSE
ùùPDjùNOgNSswàǔVTlNqWéóWòyLqYaZMěNEyF	TRUE
áxaiRKoKRiPNapǒMmofDHúiLXktgoNùǎUTaèY	TRUE
éDúùQCEtrDóMpOòrbóEwIclpQapbRǎUvhOPMě	TRUE
ěodsfGfxgGYNYǔoélttykbòwSXakCUNESúNNf	TRUE
ǒLFdrmOIúMkSǎUDuěJàrYTbjXúQkyOMptbAQè	TRUE
AwqboèXùIdUǔvpGSPsKeOYǔrNCMóèBTUèòBKě	TRUE
DbDwmdNérǒǔzǒRGéáǔèùYǔLpsFòèGJbMDǒnòI	TRUE
FpWXFRdzrVRNafcmcaǔdúǎyqǒkhVMtdrydImZ	TRUE
IFXèMXǒUcvǔhbFpyàgqmLóOWkRUmoihEPeTNW	TRUE
LúWZaiVSRyUùjFVqhvgphúmCjZgvSggoRúRkO	TRUE
NWjLtwbùLáXnèlǎéTuópBaǒTwlOauUWAòogfi	TRUE
QǎùwùqIipZeàztksQHàjXMOùCpyávféCWSiàE	TRUE
SDbppjKPhgsQVǒYàéWǎNplSkyfNelCúolfYùò	TRUE
UxtqWuwjBHǔqkYryjějyCrKnihǎcgxùKYúòQù	TRUE
XIYqReóRájWJMHUǒaquohqNWǔlwgǎLYQvLyOQ	TRUE
aINyáfyMYotymYnGúrGǔnàCTúOQnǎoEEMgDpF	TRUE
dǔsFlgrwqóTihfGZNzGBosgXpSNBLxgiǔMWId	TRUE
fgmǎùsARGUpǒakDMàIvIóKySHUkYQZDUtdewu	TRUE
ixaálZknQHfOErxdqIěOklhPohsFrǎwkoCnpK	TRUE
lLkFǔnkvUUǔǎúLvlaQWHèǎoéjàkNzoKǒULjtB	TRUE
oúKcJDáMyxbopxrYMBúJòfAAòVfqSbNFDSkKt	TRUE
qfwIUzsuvFdAddKymgCtEHASqRècXqětéIdVr	TRUE
sjèèxQvJTHbOhhELxOcvZǎéSFGJDaáKbgcóòT	TRUE
věDmúboDǎBòáóyBMzpèǔtsaLXJmeHkVDěCRAq	TRUE
xXyXvèxqàQèONKěOLzRuNkBOQIZNèRènhPéhZ	TRUE
ùǔJWcQGávBòógùNJDsèhoěěcaYrPǒLPVuèbVǎ	FALSE
áǒavdùjkáTTsYczWzRAyǎPkbóKsàXnFtOrSoD	FALSE
ǎmesSTWYvNreNCcyárSmòVHáasbHIàFqSmǎòm	FALSE
ěrLZKkYxTgjlǎǎaTROOltqizǎxàpòólǔmuNjb	FALSE
ǒièàCLúlGàtágRHFqwWBòQaǒwynbmzLRAóUhD	FALSE
BjWsZTQoHFYAòácqoěMDpCaóNfmàiWxpHáBbf	FALSE
EiQkjCùǎkǔnVònjaHFrbmllqWFvMQwuLeázef	FALSE
HSsóvYMjǎzHúdgpmgglnVěSIaTyTFáǒnLbKyS	FALSE
JwHhLéDfWPǒWCCKaylubMùiǒsòlKIbHXjúTǒW	FALSE
MwWNjWKaipUèVKoVGbgXlkfgzóxZKVéMrKLèW	FALSE
PZcLuWùaEbtHàkrCooùùjǒMhWěǎITlyèQGjjK	FALSE
SctimòéDzJǎBǔHxàeeùMiěoqvPfQVkAcRabqL	FALSE
VJZVCmBòvdDǔoràrúgéLèOǎpazUizBmbMDZRǎ	FALSE
XqcvǔwQaJfàqzuYkòbuǎfFqóNWpHDVVQJéEHM	FALSE
aèJěsózVúdgjUswBZǒaáFVvGEeěǒCybVDòCNb	FALSE
aebOLNCwàDIfǒbLkǔVEGKyIáxspeáUlUUeGěz	FALSE
dTáhtwaWěùpPmàǎnVétjùáMwospPYbráúKmài	FALSE
fssKdDRWfLTGǔNǒJTAnBkOǒkplaIùMObBùzER	FALSE
iKvHGáSoWJagòZazǒHIPCByóuRǒGznfzTgFbI	FALSE
kjLVYùoRxOsEóEěGǔùwègqFéaèzCndBgEbZoA	FALSE
nCkhByTfnǎVxòDCǒKBjarúmùNnHZLTucebkxR	FALSE
qáeDvgenKRPNZEPWVYpVtgHVavZZKKPǔbOésx	FALSE
sfWrtZayKhoònZèSàBsoiuPIGOMùPbòglùàpé	FALSE
vúiCènQxǎRRǔmayǒJaòǔrwEǔiFuBòCměbJthb	FALSE
xGNòzsjqJtéSpVTKXyPǒatHpúòmsěmJúUábPé	FALSE
ùùKmèNàJmBGoVcǒXbòǒISáGǎLeTuěPrNcPKùxl	TRUE
ácLDǒgcsqSIGPěXàětBòhǎwsjkúoěóSǎZpcvzò	TRUE
ǎxQǎAcNKBNnLDkǔvjòiIDyJaǔVkCGzlěěOóPǔF	TRUE
ědRTBGvrèwOOWkSJdWvPpuAAsnkSěQǒámfPbWà	TRUE
ǒHoLúKToapYyCHDBYDgMEdluúùDeTcOTǒyZcdL	TRUE
ALWISSǔěWgbwhzHZWEwléCgóukXúhNOsFIòWsV	TRUE
DǔuFIXxzdJAYVznxááQKYKpvCWDwVVMRVbǔVuL	TRUE
FzqnBpSbAHòYqèèIyVóAucpgóvoQùjhMZXMRye	TRUE
IwsdpùkWndvAdZMNpThCtèlqdóáQIDjjMFéMsù	TRUE
LgxBCzǒvVLzKTHikqálóbFXúMqVSYoZTUBSBGx	TRUE
OòPMhpǒHovsyBXòǒMQǔEULfcTfětmsSàTòdTET	TRUE
QNǒhPéǔlěNPnòluebCENDtǒcofWúilpèǎOqàai	TRUE
ShZTkssǎàèsúecKkuxzrpUGáDquArNCRǒMUlYJ	TRUE
VǎOiZqitàvvwJopETúlUjuhTBcáGYoùZǔIVlDp	TRUE
XSklVGrgfVxsǔéTAáóyykOùWgàwWZBYùǒWfxxǔ	TRUE
auxhLlódQxéZcùRlZaóAOaYTbhJcIkjiaFwéFK	TRUE
dIxěZdǔtNxFbUcAǎiWyJǎCcyWBXaěNJicDcwcV	TRUE
fdyFGájEgráyOYvzFùézcNyTYSúBYqtIAdùpmk	TRUE
iǔJlRéKufMjJbPjkyikúxòzKptápXBXSVOóGyY	TRUE
kzvMsKOSROoǎùnyHDgèLsróěAEGKRVNWIùortV	TRUE
nSěfúèIOYpANCKOUmUéYHgpáóyxGJZBhZúZWSu	TRUE
ptnxVSbbKeATJXLúgHjwKXLHwjkeTójDXrvràQ	TRUE
sXXenbfRGZrěQoTLQcntpmDPhgOZhùAPLàúBwù	TRUE
ukKJzmJGáYzóxknótǎgMccóFmIvEeLEwPuYLMK	TRUE
xdMirKEòpujrIcaAǎfùoSmwgúeǒhIdOáǔǔLHKR	TRUE
ùùáFVrúóxNoIQHRaJeKpIǒoǔelwtAOdLQfovèb	FALSE
ánIwRFiědCzOróòaqsXFhbunpCsDiWNèJǒLǔvǒ	FALSE
éjxfqdjùéTèpDITapSPqTVQaùàkěyGvFQhTgrb	FALSE
óJTcWxùapBbIVèJNTfyhpoZLIffFvPLwwWEQLg	FALSE
úònFóptúExZorWúapqbùpBsIQhùúxóIéèǎIrYO	FALSE
BaLEANXSWbZIkAéDèwféJOrWKqFóRkyNjqLGZJ	FALSE
DvPnEBnióZúUhmiasvXZěàóyòFbQNòFóhxfòfǎ	FALSE
GGnMawmrgQàRèsrXéJhsJáésSúbLpéáfFRAExǒ	FALSE
IwarJBǒyKpWHLJqùQsIPwèáLpbYWqěYXèSdeVw	FALSE
LVVtòoGsiédaUwěToiIwFúkONYbujlUWòRNNCo	FALSE
ORǎXEfIJǔáxareQLIiPOǔcTOIURrNoèhfǔbvàT	FALSE
QfzmAkanǒrPdqHXOuǔnIKLhùVvùOojeuSlHRGb	FALSE
TYěpifnhEPAuaAdkGkuǔQaáRNlUTbpznjJlFnu	FALSE
WIgOIùaixěgXrVQǒkaBiCVCQPXcTNuXMbMfDùú	FALSE
YvéUDZUdLǔkhcNSjùsLhpaayiHXMcupbzòiSze	FALSE
aLebfgrXùùNSyòǔùWZGWfěùqáAúTuǎqQAVlàkǒ	FALSE
azeúmabPxqvváCKBéúQzSùòYMeLùǎèǎDMznwSy	FALSE
fVXpICéAdlksTLAqOZàhrǔDKAOaXENybLyOzHK	FALSE
hpTzTǎkèilNSAóxǒaùOǒMqZbèrAiTDfgǒhèZUú	FALSE
kAjGùúfjQUValVtvúbHánóCóVǒxuqIoeGóSPgD	FALSE
maqChatRJYàumQhǎQbMǎoHXPáLEóywXuPǔóAdL	FALSE
pghxMavPsDfAéUmbmèWJóHèEájéuvCáBNúnRáT	FALSE
sJèsHàjaaMǔwoTyIMòǒoáveúNLQGàAslbRzBúS	FALSE
uarNǎprfBkúLjZzxhTvjúǔJkEkCuWKTBluàbDo	FALSE
xDEaJfqkGebwyúLHDpǎXdéésfEWǎǎMCjòǔIàCV	FALSE
ùǔxédXáùnèQxWGǎkCzZokhqXǒURccoYYEúirCDm	TRUE
áTpIHQOnóztfMásXiběFUVmBhpèZémTAFCDnoDg	TRUE
éMMbvPKkǔáfYjwQoǒINEěiUVyEuqchLTěgmùNnǎ	TRUE
ěQKPWXBWǎkěórKàxalBwúCTCěEǎRúdlnhpDMtkW	TRUE
ǒúǒEnYVRrkZrMjWQqfszkWVJPmǎXCMogLjèGWzé	TRUE
BDomDaWvǔZNKIXMRkYǔoWéěěJsBjèSmóFzmKGúc	TRUE
DbgDJMEppHKRkeDóNBúXésLgàwFWetPféTItTWM	TRUE
GOáàeèkùGOJcǒfTBAlǒàsqócǒjKNéiwoSbǎàòyé	TRUE
ITeàOsmInpqKòWPutcǔQPrDmrSjWIIctHNAunkM	TRUE
KudCemcěyòqzhepwkAuùgRqndrévYVQùOaluoRY	TRUE
NCqbmzyXdjIxNTbqózNKJéǒgMòóègjòwyóLdpIE	TRUE
QùKfBCDclHDzèATǎújwěwGzqBPUěfcFCEipdòAó	TRUE
SFòùàěvYMEuHBhfqnNèPjmXépUSěeaNnkiFjúIv	TRUE
VéSBYQIùxYùGRnHfalNuépSRyoqMùExAhAóXrkf	TRUE
XtLàPSnDpqPlmNQéOYàMEùPTkiùǒEkǎkàBTúJwL	TRUE
aMùddqááóFěClLeczrKfKDièXáèxZwWwsUNMdAg	TRUE
dTùSiTMbANvtmǒwCúcùAhěQqAMOivǔSUǎVúyWzn	TRUE
fsczMǎyQYOSSDVIAǔàTWPáGngěSmfpQùěǎàyvǔW	TRUE
iNsMóYéosLtfqeilGěácYdsGTěLuSǔuEaàxlóRX	TRUE
lówBzfGǎJVáXaJdGúECXTbdcmaPpBóLSzbGERǒZ	TRUE
nHXAnLPajjpǒmzèǒFCHDFbXNcjhPòIjfǔWuypwj	TRUE
phaJGRCǔSzFnúòbZǔNYXǒlBWfáúLpǔzykùeAIcH	TRUE
sSvúbHTéòHèúzvXUFSjXLHlfzvQweUPaYpoòraC	TRUE
vàcQulàCǎHéJTYaúGkúeacWNaHùZFUjfbaéReYC	TRUE
xOǔfmWiSbZQhqrybeAoubXtSǒjǔàxgzupqCQoph	TRUE
ùùMQéOàLCtTAděáVnefǎáPěuǎabǔRúàdTBhiBǎǎ	FALSE
áWmWuwòǔaDGLfáToórwVBhvLfěvATjbésáFlUGK	FALSE
ǎmUXVMvKrXJFXaCvBWHuáAMSCSGQCcnMòCHNblH	FALSE
ěǒjDEangùRcDJbemxIJvwqmtbòúiEJEvrIoùyFe	FALSE
òjlúAYhèpnákdePOaBpZbLnJEtPjpNáǒZiǎùIJù	FALSE
úmWpZúTaeHVòèbtJLǎjEGUéMětUVněJMCZqJinó	FALSE
CXOMtazàOBiCewěyTǒEyàqGWùèbXèhjpzFRnJhE	FALSE
FézdahynǔEsJcJohúZhQMfěWPóbbeHLLwrPUuǔó	FALSE
HkyLséanéJpbsHZQěwágpskWGVZdqIQóxHàápnE	FALSE
KPòǔIIaRáǔaGwKGgyxbRKástADpEHSfzuSHEoWá	FALSE
NǎèRàKqǎcEóDaùòJKgfYěKécqpHàRóobPùMjOěk	FALSE
PsyòZěUǔffzgmXyonuoQDjBazéaúyèWyUUdZbMù	FALSE
SSpWEFtZBThSSòwYQfwèmóEǔdóǔuoaèRPwxUbúy	FALSE
VLiMFEaZUPflgéEzYèuYáǒvàhPkgWjbOSòùEYmH	FALSE
YAúSsSRajMgcnDyòWtbuwgSEInHrbDrrUGIuǎvg	FALSE
aDxyRSNKèátǔéNBòhaImyGéTYVuLqBBbnmtbPOs	FALSE
avǒgbMnwěxRuREǒhtǎDbòXǎyrpiàlZzěusCzNiv	FALSE
eOFPfyuěFnAQPhTàóXXDpòUSBEQayqdamǔtjjbF	FALSE
hùjtqhaAElfófRMMwjSùVbXgúYGmòShWTéMvYJf	FALSE
jjFsqaOàExàqbWáuRAòòHěbuvàfVáAljvùvolJs	FALSE
mOúòCCsFIAUúBáǒjóKNiDidEXtKcGaPPǎKoeCjb	FALSE
pDóktěSyGUsEVZǔqRasèPSéDWagòjZuǒápEBMbP	FALSE
séBègMlasBxfPxLcZWgǔUòòègàǎǎaAgEoYZepbv	FALSE
uWpXZOXúHosòwakcgDbWFóEòMNèZPvqǔomZopPf	FALSE
xBSTFXCwXfkSaùRWtnròxFJúaEZrèbvQllzAXǒT	FALSE
ùǎLǒájgtGKpVXlHlvVdteRreRěsàjNLǔHBEáqúlu	TRUE
áSZeCahifónCOOóùXèdDqàKBQhxCkZgqOVàsqbGa	TRUE
éǔAAoezkfoǎHPzPěIZSIǔIbòkótúcImdGvhulxbP	TRUE
èyOsǒávZqJSErTOúóbyQYdóxieNzMKveóRqúGkcǔ	TRUE
òfòdùtòBséDbqxUǔpuáwFóOtoówǒěbǎHYkúzEGěǒ	TRUE
AGLJohuCDHCkaQEcZcPcǔmNXnxmGDmǎàyeDàuXQE	TRUE
DúVBQzxAPUfcSYBpqSxzewpvgNIEàYEFECJeuSéě	TRUE
FSMZrěIóGqPèlwdAfògCwúpùCtXwáBóǎMqwXIqin	TRUE
IMEěYPrFDkǎIqVmMTgbtqszXròǎLfTèDZSùèQCòh	TRUE
LIKábMldLoLómùòtxUJzgmESAGǔdrQCHjoaYZlmD	TRUE
NbdǔeAJYbǎǒágCpDXkmiǎGbLFqévCájCfguIdcAa	TRUE
QHCdMǒtòoPuFGrǒVZaóòUxnOSJJlkUkeùhPrěkRP	TRUE
SxwQdtGDSéghwJbcGGSǒeIxgáZzFPssVCLǒjamùú	TRUE
VgzaùòzTwGgòsěcJOzMsùUàHUNecgdmyeècéoFZH	TRUE
YágXǎǔuxPkqeácZngvKrIXABǔWjjzdGWqéǒzLUMV	TRUE
anvPsFtCTzUPFiGàbòZvpǒDoNACBBfáfXaUsNXgl	TRUE
dCIrùRòinIVvenwgbZQěpQKéhyLàzWVVrǎěwHXéF	TRUE
fYòanOtǒòaESoSxyIcTvymzXYǔMfHbnèOkEhDdeE	TRUE
hqmNbtXXfěúBbàLOWTEfàBmiěiLayMMqUsBóHúOv	TRUE
kYuYlteJǒEPiháXFGzNSágèzòidiPsvmPBWCRRyy	TRUE
néyGgxhMBcVBysixmYppLéFoQcLbǔúUOzgàumèùp	TRUE
pMOUHwnéúIbRMvuèsTaqrcpgelúTàbljLdǒvsdOH	TRUE
rlǎvǔfYómstgxcLHQaiVéjNhtIisUZFoZPPNSyiU	TRUE
uNmzZILmdekMJQyòHómúHGgFhvàyójVlòFEYKXuK	TRUE
xéóiúǎtYqbRSùJozALoòuàqGCxMTxvfLJbRxWTFl	TRUE
ùǔèqfrǎPyvzóáHúDsIQyLlǎèWZaúGCQěhévbOlEI	FALSE
áséhngKhTvXěěPadǎáydMVFpárǎDrYzbǔnuHIuDd	FALSE
éikHVlyWnODǎpoXaEoQlaiIabgCsBIyiTbszGjOL	FALSE
ěwnGòxFBǒMCciCauéKùǒyzZjQǎVǒoèRòvaóLmVbǒ	FALSE
ǒgaEOlxjěeětkXBòTHbClUèERvjxKtpǎVLYMAbnó	FALSE
BDAPHGLDóaáNYTibiAIěǒOHFǎFTIJjAAMZJǎújBQ	FALSE
DyénPnkXLWcàòQUiMKtDMHhtZiBǒkabyVAehnbǒI	FALSE
GYcvaRDmPzOǒBjCsBmùaeèRGSUKJUDlpbǎnǎDfSǒ	FALSE
JòuOamcUtzVběóFáuěBǎWZòWGiJrFoùKAogúUIBl	FALSE
MònAaúuǎavaèGcNǎsaTěIwègùbásùSBkHúàùHsěú	FALSE
OQgYBHhFǒFNoxaICúEohlúDbwJHLpòYèvxDhóěFh	FALSE
RèsikvòùjOmòBLTóTAnBěáhafNtbxusXJvWSéJEá	FALSE
TYkDagbOYIióuqshNYVjpúfDuerqǎóhYnéYoRièǒ	FALSE
VkyPNflúLFàScwZQSDéuXYZzěapRtéMsNkzJbUvD	FALSE
XuDxuúǒAKISèémMvxylrúqiLùzǔzqiàqóEvqabfq	FALSE
aùsKegóZTqmKeaǔáSnWwěZbQposDuHBóǎOXKLqtn	FALSE
afeEHSXfIxbGYKnúósigóǎěQiMpIdpǒBZmrGEèUǒ	FALSE
dMvctyàDtxkóǒéèWzǔqftYxVDUaKSqàJqCKbMKné	FALSE
gGaàaHhAjsOfèáHfNCjNgàóbuèXùIàqFdDHemkez	FALSE
ipéPOSrNOwaOKAZlWbǒsHBfAwFzCJúúbèIpiWùKI	FALSE
lRIAorJNfògpHaHEQpùAAapDAjYYEǔkóihXjDCbR	FALSE
oAPBkǒxPBaKhMPxgvubSkVáhZPòUExèrkjhEbáòP	FALSE
qszKopXTǒYǔcLéRrXigwKmqjóúáabuAoozmqGámé	FALSE
tkXjzyBgsTXpQòUifaliWDJyyǒtidfKvvWKbitlP	FALSE
wQPaMhIiwELESYUwFKuVXPUigyYúoǎéloGbfěRóD	FALSE
ùùKoDNAwUěěZmRdupǒWùèNNZvǔrTcCzwnMúúTrqcè	TRUE
àDǔǒqZúòipKKJóiǎuimIdUòOMTYDGqémXùQXeHrLù	TRUE
élMPFTvWjfěVwYCkrCScKeKvyQàiyqpZèXcMSòějV	TRUE
óJWRòNbXRSEHHXDMFDZBjGWmEidnkCvHsdQBqIVwg	TRUE
ǒdqOIlǔBTEBYàHùAIQDAFIXkPhWmsVěúFeèehóTMD	TRUE
AlxltJébékgLhJóùǎLwxàNoFBWlKǎèǒIIǒJqixmCá	TRUE
EùoEjilQMoWUnéYúvniTnhBmTtDKSIgeótlèDAQeo	TRUE
GaùYùUǔXhOsóAhxùùódChVóǒOTěNANéYIéjNZYoúx	TRUE
IncbQòldgàèzWzapIórAQSěStPéhmRóFmOxkpVVsU	TRUE
LJqITUCXòBogOgVppAIMjxhógKófgjwZNkDvujCKt	TRUE
NfǒòùwáYègFdoYOěùoPjIVfèXctuKFkéMsobáFXfm	TRUE
QQLèzuEáBáégJfBǎaGRAIgweàWáǎkGLAGgOcAUěcO	TRUE
SqeoCQgNuòèǔlóSuLsFèBIRSàKJǎnsUhěfwZkúNáx	TRUE
VZóGǎBswúbiáeMúGkéLKjXKOgEoUfzbQvtáuRúPJx	TRUE
YěMtBHwfǔbMFAioèóXàMzPkfKTWmeQhpXmbǒkJRKu	TRUE
aYnYQàXVHjZdóEbéLtǒhIgwiǔoòjóPuDgtagséànM	TRUE
dEKeavuxǎyáxCbóQJNLlpcùǒsxZmǎZZMgúJHJércD	TRUE
fcáwcAYùyFumVtěWUgǔòbnxEǔóVyvLGLvxMWIHqěa	TRUE
hvuYèklQóhcEúǒòRdtERùaCIóodOéXjioOOilCǎzǔ	TRUE
kcáFbkFěApejVúChpFwltDBúXtywsGAǒDsugNctbé	TRUE
nǒuqXEnnpyIvjbxWèùězoAùbǎxlXDòKěéagSèruùS	TRUE
qòlUKèǔzúeuǎóOKqIawDFRndfkrczIzOwAáòGúyál	TRUE
sWaZlOHáSOMZùFviyùjxóNljǒáhghdlNóOjQpZRKN	TRUE
ubákxkězúyǔzóGtIàRBdZmHgSZǔCdggErwMrkLpmě	TRUE
xéLèGùǔGGELnCmzpǔhùréTbYpDkaViUthFǒwǔIImz	TRUE
ùáǒTLhtSCYJKkvLtlLvDǎadQbEIǔnAǒGYHWYgLupC	FALSE
àéaóèvxǎkIWZáSXTmotsuhJqnSàYóyoúMnQJabdóu	FALSE
éJlàvZXzaedCLKyNjRtRWEùsbGyMEáprèRóKXFzSS	FALSE
óCàhaǔEJmavXònHAoápnWlbbTǒTúOjGteWàRoPiuF	FALSE
ǒwTdiaòahxéCsUvǒwJVbsOtiOwUHmZsRlPJǒZěImr	FALSE
BLápZǎiXdǎXùXKwKaòèPQzUDkaèteUTbdpNZvwàHi	FALSE
DiaáGgvZfLNLVQóRlmgǔASbLávVtlmYnyóDZqhQqz	FALSE
FxPHóGKuZPMFNyéKaVVěhFèhéHabsròUàeOeYCZhá	FALSE
JùùùaoǒjZvǔǔaéěaFOBVěàpBQgNLblOwUsyiExKvd	FALSE
LLojsZaBmHàaGAfXIàáǔNTybwúqATSùJěVbuplGoy	FALSE
OGóětRnmBMlYkúméChKaWTbòúwGHǒóJOùUmvbàtěV	FALSE
QfLjLǔIáxwrJTdhMzmQSaxeǎQqQpytáǒBǎTxNhCbr	FALSE
TdMaSxqOěNéǔěrJQpǔbswUuzbVkǔKǔTQNIǒAǒXùii	FALSE
VzNaóFsZRbJByRIfQKqGěZlòVDewǎNySǔPAǒátànd	FALSE
YNǎpsDàsCOPǒTNInajiHTǔcbSuǒUeAHGmhByiFxgZ	FALSE
aǒWFMujǒzyǒózòLzwtáyǎǎMtuzXgòúbUzeYKǎhkVI	FALSE
avInERXMJdDdúXjaExDVHVàtBoxHgCGcrGbófěCtM	FALSE
fKǒésUnfSKQèiwǔcǒuéGKLnMaxxǎZbiFàrsóKùQMC	FALSE
hZàBězNaZTYyjBéjěOgOQkJTǎiXIǔDǎzzDYbQwmke	FALSE
kNěxeGFFkROHǒxFùdkvFQáèòmFǔzPǎzhhQlanXbòs	FALSE
mYeFànrraàjtDěgǒHfSéKúúbódvxQSxZbOtPCǒztY	FALSE
pUufaoLEyùIgKJUhWHévXorkmysaàQQáXnùbfWáǒX	FALSE
sCnVjxmàJnéQGljéèoTaRbòóghBTěsàòMdLzOygxR	FALSE
vùàQaZǒmjXòUIěZwěmàZLgUjQANRdxmwbAxSàHǔFé	FALSE
xaRǎDKaWfGaghtbgbvSóBbizáhsóúèBIéHxBFUdés	FALSE
ùùLUaFYQdoMòyùhVhdǒNuVAgòaYóàoYEIZjTyGRiáH	TRUE
ámAèGéOnáYnǒěvjóJLhkROFJYmxNBqǎjtwpAěóòMgú	TRUE
éHckànCBnwjtèLoPěXóQqGRBAèQHEúKcFàTwǎékǎóǎ	TRUE
ěhSTàQJúVéòóàPZhwoHOTdùófòbffdyWámTbàǔǎkWU	TRUE
ǒFQbAòqlWbAaFrkNDnDáfIShǒmxǔtepǔgvKáCmYeIU	TRUE
BAùRIlBkoVùCDXeWywáeéWùútGjnQyPúàQALáěBCèà	TRUE
DzhgtxXtqginURPMàjFCùBFgrccRéGòHskóWJLAuDA	TRUE
GYbZávwgLIòlǎGróuNGvccǒYUúáèOmAJKjXòoéBáfS	TRUE
IaǒwSYucTSUbǔYěgSVJYcwǒaNMdTuǔUUděYúhlusǒt	TRUE
LKsGHGoáPVLiicNSkáCpwaaZhHIGèáPqnHDwYúNǔlò	TRUE
NoeSSKlàyLpéXàKTMKDáǔACǒúMVTYpNwǎàuúDdáFùt	TRUE
QpsAuItSHěgMeocǔújiZzdrzWflRéKvSCLKSěgéPqg	TRUE
TEqNqgHòùmcedǒzmùERUXlUzHkáxhàǎWséfTggǒkBU	TRUE
VLSGlfáiZòǎVwLIoeùUdlFéOTHèbúěòoaySjqFùuQú	TRUE
YFlyhTNèyEKròpEAYSzsITNVPuépZtFNYxdwǒmUgdù	TRUE
bDòrWZxRBUFTyRiQèPYNOIszzKpNdhrHzhdOMmlQRC	TRUE
dQOjoǒáASǎóěVwMdyXZùmOáaMǎjpUéwllcSúCzhROě	TRUE
gěDFreuáEqTèǎYXbrfMCNkEdMoDOuǔEXdAeDábggMc	TRUE
iónIdZwAjǒAuwNUeioǎxOěǔYQNsǔplGdnQlTRǔYnEà	TRUE
kfIiáYlfVǎQiěhckóSUtPèLlPzWCGUrùóǔHGgalòhL	TRUE
mxǎbMDáCgAIvRoBatyNVUAwbǒBOTQǒsOféVěYrPWòQ	TRUE
pXúfwǔYngLzbRTèyǒjiǒKjdJEpRtAWynVóBcktzMcG	TRUE
snOgmYUPsSMgyDUòTTFNpZéNáBólondPpMQKEoéWXk	TRUE
vdpxéiFyrHbhOLFRQYhlOǔpirTdǒrgxOKbZOdGBdáà	TRUE
xbmUàEJIiHcBsPbhjESLGúàáDdùgSRteJàcBQóxvRǔ	TRUE
ùàBeWcKǎyǒaxFTOSmEKFRIcbwCDBsxǎyLhGuàUunMS	FALSE
álDPShUěigPwlpqxzjáHtSǒùǔIaǎgPáǎTEZbAiòTEX	FALSE
ééǎvsCBGPaXòQóùKgSGOǒqLbVzRòeylxàOwXmZFShd	FALSE
ěEDOCMtòavǎoqéUàdrTzbfmCSFuWǔmQtXjMkFJRAgP	FALSE
òhJvkCúmNàùeLPainOàǔWPCRcMQwJklxbLARBDiáXN	FALSE
AàgydAóòVyBUmàyVdiěděmOAFiZVWúaYèSFRGbTGév	FALSE
CNFSDgDitcáòeaLxOUoJǎKpLXowxsùpCǒVwbpluozà	FALSE
EnMCEXzdpEaùǎPuVIòDkwjZCzhùpbiemphěěIKNǒóy	FALSE
HTszMòéaǔNáIéqbeqsěǔoòuúróHinúrmmvògViudày	FALSE
KòsVhroVséGzLQéaLXHréJKSXPgnbnùlQxumělǎrmq	FALSE
MaǔTkvdptfNWeùXfǔQoAějToTkUèúpfucFfNakEQbà	FALSE
OoZgxúèVcECZréGSeètMkEEFvWafòbJbBYyáWBzTZò	FALSE
RaGBpocGJJllAúNKwǒxIèJmteǔCàvAHěbneOFAgBqT	FALSE
UGsyLúYNCtAUMcVolYazhLuVyUQVbkěUǎvǒXGgplpǔ	FALSE
XǒPféwWCSěHMqCnaWmblftYIáTǎdrDHxzzSèTbUěYG	FALSE
ZrypIwaSǔúdUújáòuOQIQùtwFTUSRDráUAǎtfGdlcb	FALSE
ahwvwUtNXpenbPDbCHqzYǔZYHbúDvórRFOUBgluěXz	FALSE
dcUaeěsWeǔmMéyOUǒZioBUěJàXynwèroHgùyKbvpóC	FALSE
gXFPSEMxIQleaqàyyTfoVEàHeeYlèAVJbWèOvwèòqq	FALSE
jPYàǔèkǒGNXásǔLCécBàUúěJagSFcrùbGàXKòLLHUG	FALSE
méUykaBrběxuèpběLLnǎbTnéxZBnBSNpHNYPRVlǔmN	FALSE
oxAaTshIèùKYáOTroHcTjěFààáWěúrmSAèàpCZàAòb	FALSE
rZLOLjdPèǒoqgwévnfzaMmùPJàùDZsxSAxǔúAubWùf	FALSE
uBdYUtqwvaǎVěúufJFmǒèúJNkvGWhSyùHùòóSdlàbD	FALSE
xBaùězSdlFPòcZCIběbiLtgpǔYwYkTBKVǔǒwCgiéii	FALSE
ùùáòLtYklEIkěLglCmlGǔwgàLBaukLSHqáeSFòcpzBo	TRUE
áXVúgóhGDáxLXzàLgSpiàebMDJkQMpfVWóqXǔWcAzJO	TRUE
ǎsTěUrybuGlKqGhAfúěxGiTǒGIǎsàrPěǎbIoqěiMQòX	TRUE
óǒNǎwzoVcTiqASIyrkxGWEGèmàEQdeòòHcPqaFjǒàvw	TRUE
ǒeKURghAPYXjHebhHǎHlpácbǔczBmSǒUòWSèaBsǔIHf	TRUE
BQAvfèqkzGRDpVsSwmFǔUMTfáxrlPAFIbbkTnGěésFn	TRUE
DuàRiRVsaryIZAMbLèLjVòVcádúùKéhMBgǒàèMcutil	TRUE
GEevKHlJtCǒxlDxQzmeGwàǎgàOxvpRdDùUpácDùěúfǒ	TRUE
IoyUóiqlmbjhScgRkóǔPYéaoDaěfòxesglvsóǒHKVZq	TRUE
LERDtMXVdFwWDóozfèèǒIRhHǒLRINùBéTtKSTrgǎDǒZ	TRUE
NfYhAftJInAlXAcWBBVnoátnZrrCxAGlèVKTlǔzcIGh	TRUE
QZbSOLàmiYsHèúáéEqEǒyFǎQCrmècIAdǎěltzTBWdJs	TRUE
TúaǒhMjHhVBlěDǔdwaùhvDIlùyatǔyFǒěYhfnVTRmXó	TRUE
VfnMXxvǎfiàaosWěǔúnYiNoéwǔpPENàléǎǎQeěcǔcKp	TRUE
XxtěèkvǎNsètémǎhJwWyǒUlWěVAǔBscOdFzógWǔAGBǔ	TRUE
akǔZwùCCéǒnǎEǔTǒcJWPJheáúúVyjrSVAIòwoěCVBYǒ	TRUE
dFEOǒPmINETnwcYDHkàAǎóyFǔkSCRItSyúKYVbàNZwl	TRUE
fWJǒhLěUYIMvIǔEBLLslExuoVUòMWPzZwfSqeǒRvVkS	TRUE
htggFBYurxbAbEofàobizupemTtJbREěécsgJDEUǔbm	TRUE
kyáOIiXpláIúGJNHvwVáPcokǒxjYdpùWmǎVoOFSèézJ	TRUE
nRèAeǎLkXtDEFuòAèldTbùèvFhUjtwPrxnéAjixǒgǎE	TRUE
qàlHzùàuMJcbmWbbQeàdejòFwcHKěoVPgWaóCQujèhǔ	TRUE
sLAisqeGmǒnTOSóUIHOjNjZèBqXDdleReéYjkòGTBrJ	TRUE
uZǔYPkAJRjèKGNUNMěmGxálIxqViswpaěapjtxLǎaLO	TRUE
xèèWeFúTsjbfAgStlǔNrbKFgóZqDJZTótslEGǒWasúd	TRUE
ùǔusgmWfrJfùOBAaAuMlMuokiXNIiZqXéyárWIOJbǒd	FALSE
áaYúpLynMbMAKěqqěmòQsóvhùNgèIwòveàmzsVójyGT	FALSE
éaòhyoQyfUvoeóxgòjZqéUǎbáYePoàáELwYóLJotèlp	FALSE
óADUclFatùSaGòCqwUgENyBcFiyIJòbYwSAhsOeYVGj	FALSE
ǒUKBàěuDyAoewWpVkszFrMGxnǒǒáSAyòěWBXùlǒjaUb	FALSE
BùUéáIpYKèUshOYlGpOQkǔqeRyahzMAMóANPxHbáòfó	FALSE
EEaecǒéZTgPfpáèǎúelǎqFpǎbKZQiOèQTKEúOóVfEùU	FALSE
GvúRlzwófJOoHgátBaúkzpaòDǔlMnǔbwUyHYloekWbà	FALSE
JXhPrpHrXriRjóvǎòaKàMlOnaGOBDemrQzhmVQObxvn	FALSE
MǎYdfAǒǎdéyǔAuètBKwaáEKtXWWQùbqètúsmqgFLYZu	FALSE
OkDǔǎgZqNsPòaMnfěKbCèDqùBOYpAmtOǎHULXUóàMuN	FALSE
RǔéàffBdjBGKoZHnfǎvWùanaNMBVèXCMǒzGPWMQCGFb	FALSE
TsplQagtlzkXnúsTDOzCOeEtnóěKoúrvzVòbMCEòjee	FALSE
WDdaCpuqxrIeoGiKiSHYhnàIbUHjOǎenMǒwóPètVJzP	FALSE
YaxòwzSLNjhYéJéJuùrfIZUgMEéǔcHúzáǎéWkXKlUbL	FALSE
aLMsbmhOonlTRmNxHWNuuvZrqǒSyeEóhgQPPhkNJsEn	FALSE
cEUhHzQUVhqoarxoDOJYVBboróYteěErjvLàNixmFFt	FALSE
fèFOXèǎRUWIeàcgnèěLJfgnaHvkzèoǎUyaàáéGnsOǒb	FALSE
hdNCzaTkNGPbMNPCAzdOhótQděMEvwowfPPéKTgqWWǎ	FALSE
jkIPzòSéERBèDNòWuZEpòOǔEnBéyOwMKUhtvaOǎbyQp	FALSE
luoNguxPytRùaùKàFhIálSTKpòNjbEDgVlǎAJTbǎSóǒ	FALSE
pǔmnlOaYréBczHuéXQIbAzWlǔoAkòbUàBòJRRèápvMG	FALSE
rYǔkJJeúaáRzHòirsóǔbwěBUvòoOIuMfpTsSlěěbǒèH	FALSE
ugTXaLQúuiLMsogáaNUtòòIghěéeRcKéRàǔWbàIJéwi	FALSE
xMMmyzaWóKbpYpNFǒlwyǔMoóoóbNsBqVLCuPvqgfǔún	FALSE
ùùKSYoààqókDKRàncéHIsnSuNlbécoPéǔhbǒZnLQLRǎY	TRUE
áDtéjNdjtáóávTTHáèlSdRmaGǒKIZppésvrexCCǔhEDB	TRUE
ǎwpDIJhstQgBOGKùqtóMOQkwUěgbKfNTUlMQùmNAéóUó	TRUE
èvwceVgǔnhoSMzYYecLDmUGùuGèYòhuONGsóYvdnzwwJ	TRUE
òESQtuèóǎvwaóZJbnCèhcBikcaKSspLTEUQDRjJaitiǎ	TRUE
úmróiùGznhDCIRSkRFWOlDmiOàhěYbRǔkhKtKWcáúVnn	TRUE
CMVcJNdulótrdgccprmAěZzsúxǔJzHchrHcaWóZěáFGn	TRUE
EgzdwEecHXSwpCOfznàKGúVEaMpǔòYLdbǔwóǔFYmvVRè	TRUE
HLákOiXXYěbéJZóIsùDiàyǒhllòufOlTǒJdAèEePvNwN	TRUE
JdCYMwbòspjFenCpjmǎyǎSosrcréázevWéleIǔhKěBTs	TRUE
MúSHǒFSJexYjfhréVQUànǎǎbZFsVilOgsIoǎEúlǎsUWá	TRUE
OctPúQdCxVéGjóNaHKPaGGJeJghpéNQSFRiVéèátsiWl	TRUE
RSúòáewěeTàDùGZgSdAUBeJkAwkthWAjAEpBmǔXùzVRǔ	TRUE
ToYkvoóHjSUěěrOdjInCCBdKkYAúzrAQAxfàjvdOVLJj	TRUE
WSKgèòJcrrzHGLǔwGOǎyhǒNMévHPEfHeǎDWRǎHjěvrLO	TRUE
ZúVmGsuxbXàIPùAEQWHmnlRúTuhSPEtYLJYLpèúFpǔóC	TRUE
brVwYAǔúǎaHDeǎTJmiNàélLcQoěùdlWRhMtVgpěǎSRYù	TRUE
eòYdzLVmNǒndJLMPbǒpTsdExyéhGwUotpkYàWùeDrsYJ	TRUE
ggIKáSDzǒǔRkmHGCvrǒxVAǔKkTfxMXavfEVwUcjFceJi	TRUE
joeRgtcLgwǔmérkǔiGùěeRDADóbfSlPbHùùǒOMAědiǔw	TRUE
mháRmuSIMPRMBáhHatdXhǔqfCBiuPěSuFUjBHJcwUaoL	TRUE
pNvxlkàAvécǎónCeuIttzgsǔfvvdysàaUòpuUKwàJlQò	TRUE
rrěLfpLlzóěkóhùnweRvǎpeóQSVPTGnvěyOLaùǒiTháp	TRUE
ujlSXCMGaěǎhòaJaFǎdFAjdúlfmCféMeùZApóxzǒzóZV	TRUE
xhàáFGBwpLéiàeòAòaùBxpKhiEùYdYZXóJCnQzwGJuǔt	TRUE
ùǔùěvMdǎáMèaaagovóorivcèèNtYaAFhcbVEWèPJUmZS	FALSE
áZrUixKHàfnnaJUklbZWKbJCpbHLQmuùuèFYsàqruWMH	FALSE
ǎjǔgměuGniyDkZéuEIwBaxkNxJeJáZhOWQMWósfTANbi	FALSE
ěPSAPEVrXVpǔǔeòTnǎtěvqsǒaòDDǔzǔreǔMùIoEbSilǎ	FALSE
òpqHvPRóéǎyVBěfáMGZUaDsFKgǎJvWěfIWgmQHScébJP	FALSE
AQèNǎauasAòDCwPsxréZaXOtCxTqTLóKDZFéGYzLabrJ	FALSE
CqTúaǔNěfzbJyEkáAlGǎěMlPpOYNfUǔbèǎhPěQeXěPFv	FALSE
FSUFàoLaJZfCYawagFGǒuLLpgùzVbbrGCMèáJwuObreǎ	FALSE
IúàJRMCdxrOwSangzbkeǎqInuújKODOJLIIèBzTOèOéò	FALSE
KgnfSòXoJǔnǔòAaXàqǒráNlOPIaPEEMBqKJpéBzPděeb	FALSE
NòpǎKóxKǔáFJGNPTvàóNgBAEùvkaUSqsWáǔbFCGYAXLB	FALSE
PtiZUVGAùaòEǔgbáXTdnvKòBGpPNdiRJIPtlKèRKòGàá	FALSE
SPěkWòcgRpèBáòrétCyHgVUQulhTDFxyoèZBihahboZě	FALSE
UsurfáòěǒOkóchnVUouǎHcàǒmaIOMsǒPǔapǔàGàóbkrj	FALSE
XYqDZóúdSKPaIEvlkuqgàRTbrǎnàXqěIutYYZuBjfqlě	FALSE
aǎAEbJXoyYùzRoYCutzdBHVTèVRXeBǎYGLmXGzàtbáEX	FALSE
apWcPgpooYSǔúgltIEAvQxiǒNùofDòOsxtobùCDEFmAj	FALSE
eDVafyjòGwnǔEvYrJlǒOQaǔùdSnàZèǔVyHaobAldxàqò	FALSE
gkhTàvaCàjbkosHbliRONLXxZxèjnMJùIlǎěiòwKXkáE	FALSE
jiDuPXxòCaxòWQoygòezHkEHDibxIGGbJáCùèOykowyL	FALSE
maSLaHFùlBgXaDgéNFuGyfkKZbFBmdlúOùEùǔoGqévKà	FALSE
ospXZDáaǒHNQZreáfGSyjbLqbuuzSmCfDqKéMbenNéMW	FALSE
rlSeaùJTáDpàQBVlǔYékáUúOXáúnMlPlèbMKRgVGuúTs	FALSE
uúEYěhyǒǎFmDèIEHcRàVabsòEOCěěǔntMiAMGèqTkTúB	FALSE
wpAIáhiqGǎàyvVmICgBDCfyMdRZEáKaPfbGmtǒjáiXúz	FALSE
ùǔuRéóltdQEiQbsYUOpfQúHfyVjkYIhǎáùáxZrKtkmiDl	TRUE
áòòěmpbnSdEHTSfǎùàFSGpPiùXbtgǔBfYǔFDPVnXAQzDú	TRUE
ǎYFPpǒhTaHHmMFallvHévHèifělCǒLtvàúLtoPPqYWiZU	TRUE
èjXOBVvVckàóRPxjeTòaàóéfkOgǔhMdúGhSàMoXAWgbSG	TRUE
òDNiihézETOMASGBǎdCéPClZhTTóòeWYáBDThfmèGAtlg	TRUE
úpJKpFpWǔǔGáMMlèěNJzpǔUNXTyáAuqPjúètXUaǔmǔtrM	TRUE
CIjZVoNhNFsòǔjàcvgáxKrDHězPzáFDúNkCDICxUfWfoè	TRUE
EZsccVǒceiHNBúQjZfCqǔéHIlèRSBJdfPFIogplòMaAQs	TRUE
GuQzRòǒnSxěkgXFYùónEuHaOépNǒKúGApgsRaoúDOéBNk	TRUE
JgAqfexngZDǔbóòSZàYbGálbéXátǒgPaPxxnVǔeaHsYyb	TRUE
LqBbkáqLnYdMAvwyLmhělLEXùàóězEěKwLǔzágWèivYkě	TRUE
OgFeekyySàHOpTjQRvfǒMnànYàLQòùGéwùrwáAǔěeuCǎw	TRUE
RSǎeCJKqOCMǒYUcǔiběmIvXGlOàYAgVUJtěúELymToeéa	TRUE
UàǒBYfYoYHJUlIgUNOòeóxjkHRneRqRpiùNDváieAUHcj	TRUE
WZjFěqBQàuCwADulvifótáQYJhvifàRVVvMqoSHzAdLDQ	TRUE
ZózSHCèaàáàBóckwòěòFUDWxqLúdùvúIJòdYhYodJeyěh	TRUE
bpSùòJóLSPrINVuòPvIAupEǒsáfiSóvǒxRgqvǔěópùmjX	TRUE
egXGYXújVmHKJSCNázěXgBuZESNTcMCBVgvuwMěCZaOrI	TRUE
hózZeaZCóěKpBnGRzòjSCumYUTkǒzInjTfànKkúǔscxvo	TRUE
jWǒǎerQRslòhǔBWhwǔePWpUéèwóNEtzwuoGAhAPPóórQP	TRUE
mókUuEzZgdYKùMAHxózXùRuààCgOiMSyCiCúxFYZyxKyQ	TRUE
pEpCéěTéhOùměvùhqEIlKzlhUUQSiEǔǔEDZtKégmùlDóG	TRUE
rpUózTòFeǒǎHWiHzPmMiòneàBjRqFáěZlWTtHúugYcOWF	TRUE
uLěpcRwágRMvtTvQáúzMFRGGGOùVshǎvoQoDPEqXFTnJv	TRUE
xóěEBòywáPVNiNjBònBUQPydRUCWCóRAuiúkcYVoBòOuù	TRUE
ùǔQuqEaZzlGZfQVovozjLrRggzvoJJichDGYRObǔǎMQLe	FALSE
áwóAuAVpQhaEZpKPzEWKTizUǎiUzEfiYùUFPbǔWúGiLtE	FALSE
éVYkàaVHyzSajamNvMPmUEWézXNàèvLFLvWWHXVùUbfdQ	FALSE
óFvajCmRjúHàpbpágQwJBCCǎOVBèHEfkYěǔezsxDnYgui	FALSE
ǒgfwmadWNGwBnFDSópbáóebmsMwFRRBúùYuoúeUDUeúnF	FALSE
BaMJBwnxúevrOSèbUzfCKLtóBlFóráófqHSNǒVěEwáwlǔ	FALSE
EXòzXzZTJúEsaGtvǎùUkàWdǒóvpJiǒHVDZzǔóàsUVXxib	FALSE
HJvNHùVahQHgawYCGDTudPGShFAòěnkVKqbPUkpdzIAGó	FALSE
JqaMwSmǎiMHyvtZnèàbCJxáZNàRoLmèUTmbCEKUMGǎMON	FALSE
MOIǔfCǎaNYLxèhVQzAQèyTǎuàmEMEbYoUPǎCKàDòHvpTj	FALSE
PéKIuBTěxpTLMjaJùòxGExfKBIkaǔǎKARXszCběhNMKSp	FALSE
RxtxaóxǔxUCRqéXoBǒODkJRpALtèKObóERsFeǎsǔjóòwù	FALSE
UaAplúHǒǔJǒibedéáQZfGùANàMADVRmJoISěIIIzáfùsC	FALSE
XǒRTHáRwsRázaZùLTbwbBRKwCměOEuKvódLHilsèxuQsn	FALSE
ZXEqlwupIRedfàfiáVnafBOáěRAkUwédIKbéúákEèéVXt	FALSE
adrěNkHUABtǒzòLoxásAIIgroùzúèrNlǒGrWIGaysblFq	FALSE
datbzBRPyáèǎQzWDpCvIòáéRsMtyLmvdRVrxǎXybùKXpg	FALSE
gCgMFHBITqSèBSlATCdYaDyHèǔbèpxlyIHǎYǎPáTNwvYú	FALSE
iPPIaRutjfQéǒkCúàzXaFáRcVOGnbǒLJvOqDrálDhsDhó	FALSE
kUrǒOFHtMCIBcBòlACelLLáRǔkOIatyápCngǔATpAKEbè	FALSE
mZUèaMJòMěvòZtOdrBYfxfpddRZNRPAnybOǒJwFOǒhnsǎ	FALSE
paàVkjGtCáOEPVMtjWizOòtǒaZSòeòàhèrùbYllQǔNoeA	FALSE
sèDmxjmAsIfaáAPlmoiTènòFoyàFNXósWOALsOóSótóeb	FALSE
usITIǒóEóLqZZaZjààúwAHOcAbSHnEoEphǎYLUMivǔuBQ	FALSE
xQNNDGSeDxǔěKKUpBǒNHTCòMsGǔaDmoUbsYǔòdBOTZWOg	FALSE
ùùǔNwéUgDpTIxYaqùMSkéfhQWdcftǔlMQNàOimKèvLiJWw	TRUE
áYǎEQúnrHTHfréJsBuqSáiGHRàeFxxQtBuRǔǔwIigèrwGC	TRUE
ǎxebNbTzUWeZJZáyòKZypièélpǎBǔòZlBQQǔtYJzSCmzMf	TRUE
ěLqvyIpúIxúTjwNàGdécjanCdptǒhHTeJYRFOHqNúTàVMK	TRUE
òOxkGóKvòěrLònxexMvSUWMuZókǎXhvǎxtXQsLquvLtWAG	TRUE
únrèDuyivòDzPGfIUEofiEzNpDQázXúUsfúǒǎiXXIJhcLǎ	TRUE
CQtbhhNwmSTFjZsKtGZupgǔsòApYóDpfrějJáEiexetúRr	TRUE
FEújHEstlxQlvǔBPáobéFiqdúWBMbEvoheagHbBxFdWCVV	TRUE
IǔùBVDnFpbWfúwjgEcmUTǎbòRTMonzFbUgSMyábWaHluxó	TRUE
KJtRHmèáFVdzQPnwIòéMLjpqwJUéKImCáSHyEMOvYJèylu	TRUE
NòTpZVbégUNcNrveěVeǎlcòuMóIPCqdWRhhEjpNděNpCáá	TRUE
QòccIihHLòNKYěoRěOrBNáCSUxúcqPhgSùDFXMrǔsNiǔAT	TRUE
ShrPpsxfǔNFscxVBaǒfdoěoTgéávWXééUPRèówSYěCéRxW	TRUE
VEshiYCfIrqùIKiCDJWsàFNDVeMNúRfGxjwnLoXIGSóKnp	TRUE
XXCrǎewqctCSGmVJSXékWáXLtóiCtdèǔwKvqJCKUrétLWQ	TRUE
aZOèTnHeEstvxcjáynCSgHnzvúCzóóùUKOwáyDIIywRFás	TRUE
dǒBGwǔgTExrBwòTZrúàAPǒhoòzNSěGóǒNQèDWKCfmòQSqE	TRUE
fUvéUJpsERfQějnLǒrrǒPsjemyrbóOFYDGVǔúEVRnájàyi	TRUE
iCcSlǒHsSáMUHjùfàLkYsNNtúnsaùLqǎEvùúFúòCMVswka	TRUE
kQXSUNgùpěBqGókfVèvIòákErqnǎàDgIMVOuADnPàQiCrx	TRUE
nEUeFRglrRqOWAáAvǒRfiècáqdTpIBCoMroRnHbOQuRuèQ	TRUE
pUKǔHQSErILRxZKCgGáPOUbFtQOoVLédèzúXtHnwáuiTéX	TRUE
sèèvwIebupqrhlúoréQkDWicStcùbzfǔGaótbpVHEUvFmo	TRUE
urKǒéPmwWXlrbáXXOpóurdZěOIuNPDǎnvèaujiaùQhvqXI	TRUE
xQbQóSTběFcWnfdwhWrǒKhNGxQvLaZèrUdrAmCafILIsHw	TRUE
ùáWúiJBCWuaèedTmIeEYarAWkWMRYdlpUsuòTAApvlběDb	FALSE
ǔxQaTlOKCkáNEùRUmúLǒǎvRQFaQiòmeqbLgtRbRfKOfYáC	FALSE
ééwrhsyYòùpgsMBBèoNyarivKFRWábGùúòWǒnǒóYqDòjyú	FALSE
ěpàóyěoyLCuSùqMRàrǎDVáhòwǎǒòaElXpùaLbeuIǒMbeùp	FALSE
ǒvèYyáaKóEcǒIjPeNUhooLzùábjqHWUKOWgoibmKGCiNqt	FALSE
BYlPRYàXgahHYYàyPpbpIǒQWJEpGIvMHòIGǎǔpéǔáyTòdd	FALSE
DcjKyaèsEHZYQóbAkKúéMvěxùiUEtOAtkjWgmnǎrQFùMoy	FALSE
GBqzjVJàaBZòhnúgOGcCNUDQNuRTěAhèsQěIPWBàlBqpbè	FALSE
ItEVQǎórTdFBaTpèǒbGwFóHOQQHERttpòPvǎédShWHRDàG	FALSE
LkǒnUEHYSwWqaqéòPSoiJuNMéěXùèwZLtgWǔshsSOKEběu	FALSE
OQěNYǒtABBěCSkavTǔuEǒQFdǎDějmùapaCrǔoCoSbkgrZd	FALSE
QycǒaWKoBthùǒǒyrvèNvjǎaKǔkVXMKsmsPanPSpSeóKàeb	FALSE
ToqalFYènyhRmuAlfPóyjDézikòCyMeCIóIsúnQYmùbuwú	FALSE
WaRMpMMaSiYNjDEèXCuZRBkHXsLxcCěKSimBztgàáubFti	FALSE
ZFOJèOIDUezabkBHFzùDPzVrktDǒèeyǎRfpWSEzqvàxlfX	FALSE
aUúófuYdTTǎLycǔjǎhKWAaOOYngVjùàONnuFKJbyRPèǒZà	FALSE
dúgTXrMjaJiàGNǒpZcFlěǔěKǎqZaSawbutEJlRKákwMoTe	FALSE
fLHNugHIaplYlyKǔGúMMyǒúIáóWvEbhfjEòUGnCǒùishlú	FALSE
iUKnHàctiWEFuEòEjKyavsáHopTòiDèCIMQPzCóFzyhtsb	FALSE
klHtWóiZǒEtIAětúkFufJKSúQròJCIvaJbmCFkVOvLeopB	FALSE
motVòéWrQmRXByaòHxiGěǒáWUzWYàǎAfFzǒAGTéOgtLǒkb	FALSE
pTnPPeJHwirgéAJaǎwILeiOgYpqrpěTlbnlBgSGhVnRxfZ	FALSE
rtCáDYAwóáwczOyězaàǎǒjEǒtòHvqAwéhRNbXMZǎTwòUOj	FALSE
uXqmaěwéQqZDOxJàěwGSzúádKmbeěǎvETHnDfPYRymkVxP	FALSE
xěǒòwèNèmIFaùdTVWftzAmVCScOǎàJoMéUKoWQáiniěbPK	FALSE
ùǔǒUéǔEWlndǎLèǒLTgnWVZTXQHqhZxǎyboUCTqànlvǎèscg	TRUE
áYnǎnPeóJTfbFdbwǒvWvgsbsRNUysùGǒwwfXǔùúǒXLóSělx	TRUE
éRVAJHIsOtYsòvǒNknKǎLAKverDfrifgXMnwRuǎEUhXYnQě	TRUE
ěvSVDqrvoǎrNkCfcnnMàFQZrMDFkSfReAǔWdǎpMNgZyǒUJq	TRUE
ǒxOdǒIàyzPKbFzásùówplOYóVEngYbcrlmiansSnyeǔawwN	TRUE
BYiyRoHǎloócǎǒàǒNnrhǒǔùùrǒùěqjBǎéGhéiQyáNnTgchs	TRUE
EòzkPbwNpoǎoTMkKIRzháUǔYzCAhxIazZèVǒóKcPèKkIJrR	TRUE
GROLUàSáDHRfYpWLwOmoznCTùADPHázǒbxúsizZFáchVùEU	TRUE
IffnáèUFCKVzhEvgèfvCǔyQLiǎKoláXJRàsdéXczXànGPùY	TRUE
LQàdgǒUàBsRóxFUCjysúùeěgECěéěJóúEwfNRáǎuUMéóTUJ	TRUE
NyZàQDKUPGaJzZikcǔqSzfúsVFzJěJPòàèYgfcòéEòéHEFV	TRUE
QVxBLǒbwéleSUqexHXWiYágHxeééSnéTábAVěurXEFxwUXè	TRUE
TUXFBLKceImVyYsmxrzECǒtǔǔidjǔYOJfZbHǎVUnděGǒtWN	TRUE
VryJXòTXèùCTpbèèpqCǒCaXODjaúlKàDRáYpxipxzDéQnkI	TRUE
YócěFwdUQmuBómdixnqoKAmNiZTuǔZfVpjpFaOORjKUPmqb	TRUE
alKǒYěWPlwgXRbCcWnfsèoWQgjeúDúbòWlkcfFoDǔAbgKvo	TRUE
dávZéDùaóQAtǎefRtGtlèTmsUwNVàVEcUǒwfùAgwnEúqpUH	TRUE
fZCnǒMéWóòjXOvWělVbmLǎQfWKuJpEUEdxáóééèTRfGzTpk	TRUE
hzAGYVrròùZAbYQGcpKtVkWRojgVBCAPǎǔJuoFèUiIewKsc	TRUE
kfǔRmvèkxměASYAéEFjeóúóizlIfkqHǒbguwJénVáQnèùEh	TRUE
mcǎwYsògwGàArsùJǎùDefREepXrjaaZòELàocLfaoMTwǎzX	TRUE
pQějUlkmóZuǒǎnGxeDugoDkCkUKtPtAèdvmAVRáUwtNDRRL	TRUE
rygtúALpAvcSCkéVkmàuNěZIqòkMiǎVhnVkJWdwXzNAUqKE	TRUE
ugMWyJPLiOmzNeYkXúOfmOTPKPǎUbMúnsyOTnnSQzmVHWMz	TRUE
xEbPDlRéJxEvTuxXpMAqiDFdèǔrNfǎETuèGòǔQuěNrRMrWV	TRUE
ùámKǔSTsfǔgdnǒQmázoBaxTwwQivGVchPyxoěTǔRLFbDOVl	FALSE
áMémmwàZTPTYGrxreùěSxFgOUuoaBzdbNIIYEEVpúnygJuU	FALSE
éGituCnQXFaèpsyLoWPbǔúZWrZkrhxwěyTWpGzsJkMWEóvy	FALSE
ězPaOWoyvEUyUBYjMvvhhNwSWEUtpqpCbeáMǎEfjNNstbXà	FALSE
ǒeǔHNseXMapéFveOQAjTsNnpftHDNSbiiBèGǎuèIBáYmdUT	FALSE
AvóùVhàVtzàiUVǎaFlWKusqNLègGSXàcxFěòIAòWbàJvBjt	FALSE
CyzOějùèaWgNáHjkǔIǔqéUMjSWqNóěojJECnOǎyCNplǎDbi	FALSE
FIaaFNOǎKòázáUEcròELZKKTòRWvcjǒèlayYPhNIaèòbMmq	FALSE
IWLaoòOFTHǎǔdydiFèFáhZvhlLMěqibigTQeWUSSsTEémúR	FALSE
LIHyaYOOVvněSDkJpzySjlppKbIvúdXVqBfsGXyuàòuSláH	FALSE
NtáwdeòěqgheUkPaǎZiEWmhtbòěCAGéQiweYnJlRFGXáHxE	FALSE
QuAúaZócǎcrkIéǔǒLDWODòáěThnrJLóoMvZbúxtOěCjWfvL	FALSE
TIZYóqUùXPKzUgKfdǎèdtXBSeaǔLùZUuPěFLzLibiIVmfmL	FALSE
WDlǎWnǔòvaFgTěfFoéDdhmhòQEJlǎrzAqnvóZáNǔbèyCmjE	FALSE
YnàxàXtfòInWèqKZXVaBUZGAlaúDúnOmpWbmGSKbBòoékXO	FALSE
aLubtsěqDCPYQMiǎLòěgsDhNuVQBOǔLAàPnPěBKbQIRCiFF	FALSE
dJháNǒPèJdVqhòdHáikykòsJaěVuzbbLǒnùELrVYeFyDQXt	FALSE
frZhSéOjoGhCtmKópHǎxfxtclopaUwUèbxgQNéDCuQéNFGx	FALSE
iMsHNDrBaXDPMWAawàluwEǎPptFQmzbwmAéwúúVIpfiYObh	FALSE
kvaKAǎjLKXRQNedMágHOZSǎàIxúeNòúòMMàèNfóMbLFnMhK	FALSE
ngfòlxsakěDSèVnúUCtvWWbdgxYrbbYnáNiKǎLjWúhXrvRf	FALSE
qOkàneMrhjOodǔátCúQKjméKFǒStAàòTvapǒpROUuběùlvU	FALSE
sabAkónǎáTúSEéBeLòNRhDátFànFPràZGǎhuWDémtmdHSLM	FALSE
vOQYVaxwZùpxPPèftCVyErSFǎUámùNWPkMeggaJmTkórblY	FALSE
xXvpKmOzjvpyěoamOKzǔmoKTpiǒǎJTLvbqzDǔPRòAlmùhúá	FALSE
ùéVóDEVdZtsèFgwǎNmMPqpgQjàmrcMǔpnqkzǎVLYkDǒDměèS	TRUE
áUyJDZWaxaXumLVmmdUZaRǒzfYxúkQHǒézEHZQeTǒIHhfómg	TRUE
ǎjbrICóDUSemJbàCěosǎPrWJLckhèWkyvpcúOIókéDhmNiFk	TRUE
ěkDvrxVAòǒúDàoMKrǒbZwèSǒOamàièhRpzMJQQOnQIEDkkkj	TRUE
ǒQpjAfòBKNǒéjǎIOKZLNKXLLBéeqrèjqYqFOásTrPqjQKúUl	TRUE
BúáùKòXèaMRLóFGEòVSpWHwvIúreZaqhMRLVzécQsftLidvh	TRUE
DNhEUàcqHSJryòtsǎdioWǒkkQlMLùfHYdpfiXEfáKNaùbáxT	TRUE
FwQnLcSdvvgCxGBdwBǎyAǒzórQQCCKǔLǔmYUmSjTeQùYvkKú	TRUE
IETùǒdugsklmAEǎPflóTURuTBmècqaNnùLPVDMIFoǒǎèqpCó	TRUE
KbGFArMtUPpHéncZtSGwáxnǎzVǎǒytAFǒRIILǒwVèóCvuFqJ	TRUE
NcKSNcVIkeZnjwIpMGòrǒgXqáfuhǎDoàQWmNZoeGéryVòVWT	TRUE
QCxzǔJqǎrbxsWRjMgZǎǎǒQdQǔNicòGultYINTqJǔiBúiDniF	TRUE
SqJóhZEǒtAgznAoWsxeVMvLDIBoáfDKnNXjndǒúùkòxujcJn	TRUE
VeéFJKwIJǔxaLbkdulxbTdSaxPoqLecPòVCXTDlKRFCjjpáW	TRUE
XuúRCóòcuNAéJIvmUbǎvoěXEPkáUTCLqrINjBJwábcoPnAZB	TRUE
axfmnùVSéMtxhTvJǔúfLSQgUCLcfWWYTKKqcǔwWZfúZǔgTěX	TRUE
dNjrbǒrfháxezGClIuujVgTnèévHOUònulěúòNfYDeNbczNu	TRUE
fpnnǎòFZOVrvǒEǎtékyvwQjvóMURAPàǎytJhLJtèHhnfQéuǎ	TRUE
ifpMAFurùSRqqQZvHWsmZMGMrAhùèBMySyòvdBvySMGWLoOe	TRUE
kzyZòàyàoIfáRJúIiPzéZèmlJzGPRJRcKuéMgadTxVptHQla	TRUE
nAǎágJYFJǔrmkRRázozIClCzqefuEbáOóXoadqtfiUTFsvWó	TRUE
púpeXcáAúIEzyFeJǔxópdjgwàMkmcVXágèQeěsèěAqMHnetě	TRUE
rwóǎùzEoZèCcCpyùàOòPǎCámùXodgáWXkcYPGTgkBxùtGèOv	TRUE
uqZYZlǒvxòsǒFaXBRGeRkjJvahTèBáDWVYTdèZǎwrgAWDpeN	TRUE
xYFWeáěVEaIWeYrgflǔDfrsàGsúLěAhspoIJgYnqMZddDwǒe	TRUE
ùàgzàèAgùGMèémVEéeeóDxraeNnMǒMqTFfCǎtccAcéLuXbbx	FALSE
ájqèsfaRáVipiCóAzCǎsrnohYCoMǔǎzèGséDCsqvyJhTǔEbU	FALSE
ééYòòméXNCWjNaVgkGáěóàtoncGòúrTǒèuvǎmbàRBǒgǒXiNv	FALSE
ěxwsóQSgapòvèSxáǎvSNnáfdqPèddBeILJǔAQlaěXúiKiXFb	FALSE
ǒQnaDédoWJùWmPkwEJyhpǎǒodXSgbhGlieqóTiIóZNQRXěnN	FALSE
AnyaàRGGCQlQFrKfLǎRèiNHRBBYùwgsaěnVATAEàmuúbSteJ	FALSE
DabFádVvMǎLilxtVoywDeBmeóòKàěúCNekóWVGbMBbjbUDQǔ	FALSE
GùǒZDRQàùZJINOhlvoNnUùhèZaòǎbnIlpjneObéǎòióùúeYě	FALSE
IZoCFfhLOhàzfhIkfáHMKBxcrymaBcGùWnKbóUjQMgjGHSòr	FALSE
LǔkVgǎTZIaoEéǒSPKkkWJKkNjmPCTyZYbtWnpmDxysǔDòdkú	FALSE
NYxvèpùzanNteOǔcmLǒSXKPqlRQfCZgNěsJYgxnyKbéúOzxá	FALSE
PmwaIDaJxUǒfDTQNguǎvXǎókEězbKTvxHJUgGeNhtnXòYZNò	FALSE
SHyqCLPaévòxExHYmmTSvZIfeFpHWèQrjZǔbWMNàkroLfpYB	FALSE
USXWmGGWLúfHtefGCjgCHFòspaviGpàLzǒuèvWǎprDěYqEqb	FALSE
WvrxèQqGTEgRuXOuNMQéǒéávuIaiǒFXMsǔsdbùxuqekVúZNr	FALSE
ZaSězjJmzTaNABkvrIùbgXuyVzáLMVQmUOneàVǎGzoCCǔBvU	FALSE
amqàǔojàǔPAxVNPnǔSGAAUqSbbHZòWQODBGàoúskeXùùěDDP	FALSE
eězǎYPánhWpayFzoipcWlcqQóBvEJòhbSJOopQǒZVDBwFèàh	FALSE
hKaáOpHhMFUièúǒpèSKkuǔǒNNàweoLTOfècpwlaFóxgPqbVP	FALSE
jsXWIǎEèZFTàZFKUMQpYvgUuápBépNùGaqbùáqUiuǒhAAHǎé	FALSE
mgòárzTǒLBmvjzjXSeaèKúNhLqúBBàěOkVdběázdQCHléXǎl	FALSE
páfaSzàWSaúZùZNuLfěWbKCYXqRHBòpNNbEAuVǒdVMvyXReU	FALSE
raúoFDbDěGKǎXdVèWéHCoskpòéqBdFSTKuǔèjqYmblYuhtFǔ	FALSE
uMAǎlnWqLPǎlaPjCèLlqqùYYkTOjgQkjóèǒbòEqúùUvQfOTǒ	FALSE
xLKóxevóUyFGAnGéoBóYEWépǎMtBKQěǎCOysMaCaiaOvvpàb	FALSE
ùùRPoEJItfjièZeBFUPěsezKjheHxJlnǎlfjFhpNtGZySRqUo	TRUE
áEBkSLlsfqzJRZFlnǒYCovnMkòǎMOǎlFLùJOqwtácKBiOaOEy	TRUE
ǎoFhqqHHhoSSKzcSTlFDHNtrMpèQoKbyNǎyBqèǒQUàOpúGRyC	TRUE
ěaXIDPxrònqzpWoòGXkéjhaěIwGlZVxǎòWùjwFeOIHuěòNIěC	TRUE
òkHHiNPkEǔoIGXQlúeYgúàKcyǎóàéIhklVtEThDyFOtfókòZH	TRUE
BójCQvIjyàǔNuYúLabcAniTcVYúXRVMNǔaǔVBwǔAjQDěhyBaf	TRUE
DceGoxSDtNgáqcoqhLpjiNABPRùǎVGDeWùNaSGGùrOlǎJPtaY	TRUE
FxWyǔxchqffnKárytàSGuáxòáèlcZyùFcoUKnoEXmKXkxTRùT	TRUE
ILHEcfěmòFsǎdfMUukzslxTJdGrCDSèWfwaJGRTwFRobMúyxd	TRUE
KyQwOUFroáPòDFúúLKvSgǎIWecéLFItQXqCEázzUwHéESstòú	TRUE
NJVéǒcjRKúROrQAǎRNlRàǎwèNóGYyolvecgIQPgsEèNAiWVvf	TRUE
QújQJGèpYUJúqYEglAǒXHpkvedòVsPCájWǎgDygjkuwrLpnmé	TRUE
SzcúSgyEZOeúyàdElTéyméSiKùXeSúcJFměxòpAqéeqWULúèH	TRUE
VJcPPMZCKmLùKpAěGǎRyBXUJeYQVùèatSnVyyvféǎYzáJYUlK	TRUE
XTpRrIéMLGFWèSàǒCDuXaUpàFXàsgpZjSáǒdaEóeJzmZRgǒwM	TRUE
aFEùbtiqJIdoOOQfQoBklbámUjBoXOàalNLZVdvBaúpAqQBkr	TRUE
dǔéóěSóRfRǔùkEZmJNtěóJúlrwBtǎiYWdMXòUODofwUDhGJhà	TRUE
flEQUTáAǒuzóNdwDgZuxěRéWXòtdwEàjsPCúvKWZEmwhqQuxw	TRUE
iZxǎlllwKONRDVPǒěòdàúólRIwtjIOVáWLèfǔCnSAuòéhYhHǒ	TRUE
kvBGtyKBgsKěPXKbBsǎéǒúǎxGrúalJnSsàDòSěKMMPunzùZBy	TRUE
nvgqBGtVMewPULrMvSóFǎúxFOcEASěFXMǒtfRykwDéfteqXOP	TRUE
qaABuùSQqdEèFGònVqnvSdXAúbòàjYjpMIaPQlaLGèóbrǒqMX	TRUE
soXOtálWheDfuOEàcàRfpèóězMódNgQpZoEyùPLgǎKúMòawòZ	TRUE
vFdsúDǎWChGpwUnùsèWvéqwǒPpWǎǎéjgǒǎDOIgfhǔwxARNǎvi	TRUE
xgwèZGvuúBRoyqRclBuOèaáTǒDpiǔǔWmJSrLBTòSúPúCGMKvé	TRUE
ùùZǒějHpXanwJSqVǔèTVUBUábWTuoNOlBzIbyDóefhRVgkhIl	FALSE
áXxVaqFXcwLbrEKSNógjQhnVVZqTJouSeABtOsQCUáwXpjykg	FALSE
ééáéWfunvutnvEkdwěcvCvayMubRquéeMlMoqòǒrfsbójèkǒX	FALSE
ěeBOuQLHuUèaFěCèhSQuéeiCXKbzXágZjeUiOXCCVtùyuòěkX	FALSE
ǒpCpnUoùymJaUPnUBLGgNBrZUafwèJvaFbSjDHMèqǒjLèDCóo	FALSE
BjAgǎLkJǒgGVOglvmTěéIOVèQevXvBǎaADbFEvóYávsqEiàdB	FALSE
ESKTZNufgOazRcòúXHqyiZlnǎFbXuhgnAbpFòSbbmrBJCFYUD	FALSE
HIaESYqWéofǒurpiMuqdaǎǒKòBYvzvXúwMwflùbNsSgjfòáLk	FALSE
JjóJOOégISàrSRergTOJǒRFǔRělakZKfgmǎYRMqbJěMMyhwqg	FALSE
MǒNòAQséóRaXfkxéxàgpohAEAoUqzHsófqBóbRálBjùNidǔáW	FALSE
OXHBuTszavFMqàUousèǎyArZiFznvéQjùIPvkcUZZàhNpSwDb	FALSE
RCQknǒiapIRKhVAOtǔnpnxYBtrZZbOǎSuefQAYXopXěyROfbu	FALSE
ThCFBdjZaFxebBTKhàvuGèlFyzkTGhGAxPsDIGMSTdJCùěpěR	FALSE
WèúǔGAǒrmKOJáPKNTUǒXMEXRUaVGOAAhNzSvgxOxCFbbeqONA	FALSE
YfgycQRfUáǔóyaòtrǎǎabBIpógQOqúWWiLNǒjzeEmVòpòXfSw	FALSE
aMùesáoùDAZkdéHMOúèozxWbFàoGqfGshěànkǒǒUdmòhCàèsi	FALSE
cXsSaPBPLjRorjtNTzHàgámEOèGFPPNbùéáMfǎújéCbQBéSAR	FALSE
fItJuTéqHxJòJgraPtOěuEpjtbǒnwyéúlFEFJHdsyáRjvtyOF	FALSE
haygirVYxJhédǒèLúáiDòwoRUIǒUISecmǎUCkcmáJvrbMbMCh	FALSE
kàhDhiǔaTxèksaèáarnMjxMbWgRIbNyumrmvYBZóEyJkMpàBé	FALSE
mdEdYZnDaailhnóVicwqfQvǎcùRVUEkBxLZLnbéyèCáPZelǔJ	FALSE
pGHsrtCafǒnJlPuLYhóqòZóoUuěqyyeddWěyedMstapnyxgbt	FALSE
sIMiONGlùwGhDllgNUNzvjmjzuwuaMvXXáǔxgSxdnpòALòùSb	FALSE
umWGEHoelKakXǔKògRèàIUrplCRGúERrKdTMpáwóObúrǎQDFX	FALSE
xSJǒKVMdBPòdEfEiaàziáATRamHUJáJDDUZwǒKkJéHòǒdnlbk	FALSE
ùǔwòěHMqófjSnDwòMlvErcgVmrvCǒnFeqbhǒsdóPGáèsrcyùlq	TRUE
áYOoKCòòèElqbbMRájCUqOfszocòIITzCgFéfqócLFzxZòaěaB	TRUE
éóáYDLEXgǒdcéJYRDǔjQVFOXqJvdAPCǎfqěOcSDQEAYwdPNdáS	TRUE
ěxvOMVxDáYvQKLwnAOXKaJGCòmyuǒfxRKèjliJMcOpxMrSQMwE	TRUE
ǒěáLdòédOèpYvPùYDqáELszéGěbgǎbpmbMWJùMóDWqǎéIfdfgB	TRUE
ARykXúepAonléùdSoIEvúIaàPrQùCióuUVxERRYBAzgPjiupkù	TRUE
DCkfóraěMúZèqKpxLèNpqéjiNORfTrvXCógKfoèaOjzǒúPòLrI	TRUE
FujNaAjWùCnHWfùSBlZWaVWtàkcGHTCqjéfǒCJLGhnDRYXWepZ	TRUE
IDcòúfádEIFYKSǎMSòfyLLSAoucckàvóvzaéiQOQěéZCetYlvǒ	TRUE
KjéLUAfrQqgypKDMtKǔKǎIzWVèrHJFmmspǔdmqcWbNénosFèAú	TRUE
NRxYěifTbPvSKZènéékHǎSIFpàCsěiDoUYDùvnlfOǎàUGFIzcI	TRUE
QLcZSRNěBJàRQMQIdWXLwTKWétZǎTYCNǒDěimMeAjeótsClǒzq	TRUE
SvNTjǔWáYǎsǒèHAsEEùěúuóAPUvkǎmnùfFsXFCWOécJjapǒNME	TRUE
VSǒfaǔXkòóYKèKyǎdhViNujRdjXUúàpXávòPVwgjǒiaSáFKWPò	TRUE
XRIcIVàHPAvxBIvSyéVqomhymcjkóóùHGǎètBsmWǔkàQRRZGsf	TRUE
aABVàrIéRzyàSnǒpMpdafifvòNlkáZkúBYkJklyóAkcqéxESgJ	TRUE
cesadGdWIPjkòTpEbrfWSáNKPJIOQGFějRùAbòAóPXHOúMèdiY	TRUE
fTbúOcaTCGáMEUvóGilYvWLhoáxDǎzBexOèpbNRàFàěNUàYúXI	TRUE
htTǎMèNèúèàúǒúéwFAyuRǎùààizbzxáLzóóudWpSiàùSfaHnqr	TRUE
kSyfuTějgGVǒuǒslTzcsnsèJFnrOòGsYUjhZghzvóǒzeùPcPyO	TRUE
nèiKQaóLySVSxǔWfyJANXvBǎèKPǒxǔRaoùzkgTcYmKCóVáǒJjù	TRUE
qùRlvXBóùúyiXLòQBuMùCnCqQǔjǔòHhúAbXBWMjjnvxcèyIúHf	TRUE
sqVeIAǎZǔdzqvXěVǔTyrPHGwlDLqgyáYoǔáYkààZYegNòdZEZǔ	TRUE
vIVYpcdzktbFVaágtóEěXDxǎArZKfeEmǔOGoòosèyZǒGǎěCGWt	TRUE
xefgǎxSYcZiCǔzèGYhǔxYVyoWGáǎLùwTvznwRzGfèvirègPOof	TRUE
ùáóloéóLySBadòKnVUbfàCoběǒQKPMFèxoTtuxfofbmCLhVDèǔ	FALSE
árqYHSùWnFnEQVHDvaAIHBCpgydpksMOJkáYUàbLUzxlsYòJVr	FALSE
éYfùswaTYEǔqWAlMgJydqxWiàjQǒgèjAxGUóǔòòjděbOzONRGé	FALSE
ěxáNiàsKgaLxfXMxOfEápzYYlrzdDNXziqdǎbyǔmzdsòóEeojp	FALSE
ǒWáqzOrFzpPQRGLRjKaVACogàmGdàjlVxeǎèWAbpóFpqAhxJep	FALSE
ArtIIUVhéěáCnoaSèùěyudRUfrikOMZmrexnúKmUKCbylegYSO	FALSE
DOǔslHònùMPěsaVhZtotàzdZEnKRMǒdKCIweuTTsLáWhTnbKdU	FALSE
FdǎXxOYSLKCAlZáKHtNqjJKLèzitzvXawiUěUXdVǔfyèDbTjoD	FALSE
HwiPěauqèsdoIéGWájXyèwbhJyLSùbQMtUZEIRfGvbpsdXFǒRF	FALSE
KúèèmkiBhHmJFěQBaMndPTlsImbjBiMAUVZxHǒièiLvDqǎǔVkj	FALSE
MkNElKGarYfǎTelJápúAYoQéjzJdeBèXmbiAMdDqXJózQjvzRf	FALSE
PcváaaéOUvpkiSUǎoqèègCKkósawěmYúVMmONKbgrMPǒmyFVàr	FALSE
SáSMBHInhVòQPFfLIèwNkEfqTaoWJóǔQáQLtbJhtiCàXóQWAUǔ	FALSE
UGaDeiUàFSFlQxúHabyKtǎǔòǎIFǔSfdnMxDoghàuógeeàxEHfH	FALSE
WuhákpxkKlRróvxyxǔúifMkGyalKbRzòdUyòúkWdWzJEjkHátó	FALSE
ZMPpVIZèVgExmáTESzoùMGgIaiviQbùěIwAQYJěàsluǎmoàhOJ	FALSE
aYRZéUléfkkjTòWxaǎLàDrJùbsùlOTUUSRàfyǒBxwlHezmlFóu	FALSE
drgàELfUéodqqovSǒzOaófQGzěPRrIamDMYKYbqhutYtěFNěKe	FALSE
hàDyǒEvzPuEcvnUvQhYagyqbJolOOmEúWXǔzExJMJSjShiuPUǔ	FALSE
jlaRmBLhBFBnzeWUTzTrqSFlòXùójpSudùHiǔpbáCBngLsSBzl	FALSE
mLGHIějUvylcOcmyQèáxOGCSJUnalCěknOZbúèébfáQKvóeDqB	FALSE
pàaaǒǒǒjlòǒAbtWòálRAGZIvówámǔxfkRsǎbSuhèmQònpjSeáw	FALSE
reEaNápeEmNqběGIpBèPMEEEnvjpyRkòtVeZgexqgOVywVHLjC	FALSE
uéáMxWaIQyCǒǒALJeTHàDèxàgáToqdsDAxèVbGnixWKULTQórY	FALSE
wkóGáǎriǔMlaNgNrǎDJùGPCLJeGIQvcVlUkTcYlǒyboZàkvXWW	FALSE
