ùáǎcMǒPdfěwěfdxYUZlUǎeydeǒwflpd	FALSE
àùcrJwULzjSdZVxUQocSWLméXfPmIqq	FALSE
éhcáYfdJckaPuWóèLhapRMGlwYKIǔSl	FALSE
óbXPDzVeLIwmáevbǔMnhWAzáhnPòyrc	FALSE
úEMpuOdutPmhàěcwèuzTuZxecdEooQo	FALSE
CóEcKVNwydPgòCwèeHkQIqnèMhXndlj	FALSE
ErUàKCùáóǔludfnIpZxCYCbwòQGLaób	FALSE
HeATvqaZlcbOPVǒFCúòdbHèòZyfCdGN	FALSE
KmygaMHěpqcsSnrnmUeZhUcFedgCUAT	FALSE
NVvǎtCymWmHOǎqěIoGuóDCMcibéWabu	FALSE
QPxTlèEaǔICSebúòùKukqbTFFpLGRqr	FALSE
TBmFmCgIoFZǎHòaIFcWckLRQdfěrdáT	FALSE
WèjzUcgAùnARgmùZvtCscdiéùGUùpzU	FALSE
ZégáyhmqǎIǎBPsòKUvbTCùdBabacnJD	FALSE
ahZùtiéCdocuOdǎZJàzLSucVěXVZmLl	FALSE
bZOhDUxbǎNnfTqGGATaTIbczzéVNNòG	FALSE
cKceeáGdkkWjyZéGOǎViBCcYXTVlèIb	FALSE
dyFUTbzJkòvJhrcSNyozéHWUgBfcJac	FALSE
gxJfdJfcZybaǒèùHěpcKàòTldryxrǒf	FALSE
jpMfDkàWóiúHkvLdXòúànFeáMàtcùda	FALSE
mbpúǒLzaáùlzkXàéwǎaeccudèlXJKQb	FALSE
pěcBFSrokXǔjDáěXGvháGYéàDgUXcdF	FALSE
rdáàMSjyGygěGrOcLVbbaXfbjFShètH	FALSE
uFupAcctúgHkhWFZhgtbaSiěMSěbkcf	FALSE
xùyFTcWrwáúYbáWhfiěòBócADVdhghm	FALSE
ùáǎcMǒPdfěwěfdxYUcZlUǎeydeǒwflpd	TRUE
àùcrJwULzjSdZVxUQocSWLméXfPmIqqd	TRUE
éhcáYfdJckaPuWóèdhapRMGlwYKIǔSl	TRUE
óbXPDzVeLIcwmáevbǔMnhWAzáhnPòyrc	TRUE
úEMpuOdutPmhàěcwèuzTuZxedcdEooQo	TRUE
CóEcKVNwydPgòCwèeckQIqnèMhXndlj	TRUE
ErUàKCùáóǔludfnIpaxCYCbwòQGLaób	TRUE
HeATvqaZlcbOPVaFCúòdbHèòZyfCdGN	TRUE
KmygaMHěpqcsSndrnmUeZhUcFedgCUAT	TRUE
NVvǎtCymWmHOǎqěIoGauóDCMcibéWabu	TRUE
QPxTlèEaǔICSebúòaùKukqbTFFpLGRqr	TRUE
TBmFmCgIoFZǎHòaIFcWckLRQdfcrdáT	TRUE
WèjzUcgAùnARdgmùZvtCscdiéùGUùpzU	TRUE
ZégáyhmqǎIǎBPsòKUvbTcCùdBabacnJD	TRUE
ahZùtiéCdocuOdǎZJàzLSucVěXdVZmLl	TRUE
bZOhDUxbǎNnfTqGcATaTIbczzéVNNòG	TRUE
cKceeáGdkkWjyZéGOǎViBCcYXTVlèdb	TRUE
dyFUTbzJkòvJhrcSNyozéHWbgBfcJac	TRUE
gbJfdJfcZybaǒèùHěpcKàòTldryxrǒf	TRUE
jpMfDkcWóiúHkvLdXòúànFeáMàtcùda	TRUE
mbpúǒLzaáùlbkXàéwǎaeccudèlXJKQb	TRUE
pěcBFSrokXǔjDáěXGvháGYéàDgUdXcdF	TRUE
rdáàMajyGygěGrOcLVbbaXfbjFShètH	TRUE
uFupAcctúgHkhWFZhgtbaSiěMcěbkcf	TRUE
xùyFTcWrwáúYbáWhfděòBócADVdhghm	TRUE
ùáVěPdJǔjǎcgbXJKZxóRnYǎWZóvHrdkc	FALSE
áhlNBWfpúvèOXcaoKyǒYWjaběpjmGGRs	FALSE
éCTaNMbNapEQmócgvaHlWZLyǔveZddNt	FALSE
óǔtGciDVVTBFIgExMpBpKcoqǔràHKděó	FALSE
úèdxmokWGNZhYǎcNhbFùeòaěRwhedècò	FALSE
BcwpbjGjUúQzyěbiàXicMaWójèRwIvnC	FALSE
EUQYCFVrNàPVbjUJyáKffyrrUeBBhawb	FALSE
HbKwhquOblHGFwamZbváYtěqMyRǎǎkvG	FALSE
JeulwǔQAyáfdúFhbvWkRayvAzbSěutfr	FALSE
MěmujeXbRMPBsdváUiczéusébBwmFrVL	FALSE
PInǔwLkVbjfNTjWySoVaejTqxebéúNǔB	FALSE
SAXcWéwYaWsǔmàwIǔbJsCcènkfóqfjdó	FALSE
UtOaBOxaYnfxhGbàIsVvǔteFěoxPhRbB	FALSE
XcxPDyMYCAueWpǎcóbpupUNěqedWǔLPL	FALSE
aAòádtywéMVaǒfdsrǎtQkěBbBélǒbknx	FALSE
bědeǒúBkxèpbJrCrfBFndPuwècHxazot	FALSE
cGLdSTnóANàILxdArlóIàIéHOGPqqtǎq	FALSE
dWáwúǒrészouJcmáXcǒvXéQkqdIfNiUé	FALSE
gBeDZVǒcàSUbúúcajSejdèabyDTtDjik	FALSE
jBsapGsXvèjupTpbaOàěuDauMwáPèéòj	FALSE
mTaCAaNLmgUXMfuMèhaěǎeáǒUJsTbWla	FALSE
pDéyeaóHúcqBAKǒǒwóaCExLóaúGjyKbm	FALSE
sHábOaYYvivETrǒsěqùCèyHKcěOběfVz	FALSE
udfwAdUIAxSbábbòélóApěóǔǎJcgGcTb	FALSE
wvSMMnghBhbMieYǒKǔHtIRJEaáJbYjFH	FALSE
ùáVěPdJǔjbcgbXJKZxóRnYǎWZóvHrdkc	TRUE
áhlNBWfpúvèOXcaoKybǒYWjaběpjmGGRs	TRUE
éCTaNMbNapEbmócgvaHlWZLyǔveZddNt	TRUE
óǔtGciDVVdTBFIgExMpBpKcoqǔràHKděó	TRUE
úèdxbmokWGNZhYǎcNhbFùeòaěRwhedècò	TRUE
BcwpbjGjUcúQzyěbiàXicMaWójèRwIvnC	TRUE
EUQYCFVrNaPVbjUJyáKffyrrUeBBhawb	TRUE
HbKwahquOblHGFwamZbváYtěqMyRǎǎkvG	TRUE
JeulwǔQAyáfadúFhbvWkRayvAzbSěutfr	TRUE
MěmujeXbRMPBsdváUiczéusébBwmFrVLc	TRUE
PInǔwLkabjfNTjWySoVaejTqxebéúNǔB	TRUE
bSAXcWéwYaWsǔmàwIǔbJsCcènkfóqfjdó	TRUE
UtOaBOxaYnfxhGbàIsVvaǔteFěoxPhRbB	TRUE
XcxPdDyMYCAueWpǎcóbpupUNěqedWǔLPL	TRUE
aAòádtywébVaǒfdsrǎtQkěBbBélǒbknx	TRUE
běcdeǒúBkxèpbJrCrfBFndPuwècHxazot	TRUE
cGLdSTnóAcàILxdArlóIàIéHOGPqqtǎq	TRUE
dWáwúǒrészouJcdmáXcǒvXéQkqdIfNiUé	TRUE
gBeDZVǒcàSUbúúcabSejdèabyDTtDjik	TRUE
jBsapGsXvèjupTpbabàěuDauMwáPèéòj	TRUE
mTaCAaNLmgUXMfubèhaěǎeáǒUJsTbWla	TRUE
pDéyeaóHúcqBAKǒbwóaCExLóaúGjyKbm	TRUE
sHábOaYYvivETrǒsěqùCèyHKcěOběcfVz	TRUE
udfwAdUIAxSbábbòélóApěóǔǎJcgGbcTb	TRUE
wvSMMnghaBhbMieYǒKǔHtIRJEaáJbYjFH	TRUE
ùùhQNBTqWbayWqIytGPvOòyUTbZzdPEdW	FALSE
àéjsòhqùKduDécIábXovkǎáCacàtwGBYw	FALSE
èBxhUKbstáDcrNvTpiúáǔLbǒMzbwànrhI	FALSE
òBqǒyJczùlàánǎdcowOòèOvEóèhMzEnPá	FALSE
úhaBrgHOjGsGàkysBbsǎZYytboCTyPIEX	FALSE
CIFTDúuNmhbYXbZHùjydGcrDNLsRXéwqL	FALSE
EtqwbóHdrBEǒVobneCfFcPYǒNGjǔNsòeh	FALSE
HgTszalhhQBmSALqPVMYvaNAuNEcbqFiD	FALSE
KFFOVrKǎjǒsùàzDwdKlòrdjǔóTùcdéMxZ	FALSE
NDmnfjoáEthTlòMgWhóGudvDcgěLěbxdX	FALSE
PqjkěúsaǔpapaCQIǎuWòǎwGFudgzVèébg	FALSE
TùgKusecLMVRfwRoSefbcumszAojdIimI	FALSE
WèbcbSDAǎYuyjQNzMòOyèWopYbEóUXyǎV	FALSE
YkòqòhoMòlQYZǒúDfélveLbaLVBPPpybh	FALSE
aRaeOaPSEàLùùòGWdhSàzcIHvaPPdoeòP	FALSE
bQrcsUèdfBHztBirZǎVeczWuUubàEQkUO	FALSE
cAzbCywònwěèènàxvUcCVuúZDèùSiudǔR	FALSE
dhWTDóuyeFQǔptfvǎebPaVwbǒfIQGúXRp	FALSE
gQDISrSbSǔGOHǎmúztYodcHWěoubhebUX	FALSE
jPsóHcnzMyDpzfqMVèHxZOIlDàdaLUJck	FALSE
maylyznYDubvHèESHbtWZǒlKiIboòWrów	FALSE
pOMqNSrbvEoYmUbmBóBZěXxdoméclǎTgs	FALSE
sùǔǒèPKWOlbéiwéǒbvzócAsqzcYPAaóGP	FALSE
ukzbjóúIIhSbǔjǒcigùUxgGYWSIicóùVH	FALSE
xGkrrjvJzqǎEcéAkudiQRàòYMYrbòJàci	FALSE
ùùhQNBTqaWbayWqIytGPvOòyUTbZzdPEdW	TRUE
àéjsòbqùKduDécIábXovkǎáCacàtwGBYw	TRUE
èBxhUKbstáDcrNvTpiúáǔLbǒMzbwànrhIc	TRUE
òBqǒyJczùlàánǎdcowOòdOvEóèhMzEnPá	TRUE
úhaBrgHOjGsGàkysBbsǎZYyaboCTyPIEX	TRUE
CIFTDúuNmhbYcbZHùjydGcrDNLsRXéwqL	TRUE
EtqwbóHcdrBEǒVobneCfFcPYǒNGjǔNsòeh	TRUE
HgTszalhhQBmSALqPVMYbvaNAuNEcbqFiD	TRUE
cFFOVrKǎjǒsùàzDwdKlòrdjǔóTùcdéMxZ	TRUE
NDmnfjoáEthTlòMgWchóGudvDcgěLěbxdX	TRUE
PqjkěúsaǔbapaCQIǎuWòǎwGFudgzVèébg	TRUE
TùgKusecLMVRfwRoSefdcumszAojdIimI	TRUE
WèbcbSDAǎYuyjQNzMòOyèWopYbEóUXyǎc	TRUE
YkòqòhaMòlQYZǒúDfélveLbaLVBPPpybh	TRUE
aRacOaPSEàLùùòGWdhSàzcIHvaPPdoeòP	TRUE
bQrcsUèdfBHztbirZǎVeczWuUubàEQkUO	TRUE
cAzdCywònwěèènàxvUcCVuúZDèùSiudǔR	TRUE
dhWTDóuyeFQǔatfvǎebPaVwbǒfIQGúXRp	TRUE
gQDISrSbSǔGOHǎmúztYodcHWěoubhecbUX	TRUE
jPsóHcnzMyDpzfqMVèHxZOIlDàdaLUJckd	TRUE
maylyznYDubvHèESHbtWZǒlKaiIboòWrów	TRUE
pOMqNSrbvEoYmcbmBóBZěXxdoméclǎTgs	TRUE
sùǔǒèPKWOlbéciwéǒbvzócAsqzcYPAaóGP	TRUE
ukzbcjóúIIhSbǔjǒcigùUxgGYWSIicóùVH	TRUE
xGkrrjvJzqǎbcéAkudiQRàòYMYrbòJàci	TRUE
ùèEOcbucElèYwyèvzlrTazMlLbgQlHǒólS	FALSE
árféaccáòǎCheGyKYGDwàsdáácWLúHeLtm	FALSE
éSùWWjěAOtNǎTgúnEgNàqyelPqidiecadj	FALSE
óHóNbWHQDbWNuWòoYNwEZGpDèAhédBxcTC	FALSE
úLzEyiòUeJdcdmǎggVgGZBWjěógeivBúsi	FALSE
CěàUuCciaYáRóAltzzqKǎóGtLeDěusěaNb	FALSE
EyòaijFmazPnswDXMJrWMEézvbWYóiòsǒx	FALSE
HacqYtbNIXYBIHVcoévvtVGcAǎPWLTbWsM	FALSE
KDLóvGUxsǔjzuDDkdknALicYàfVStaèdcA	FALSE
McǒnnEcyǔóNúzEbZHjsRdpqèTLuYRáJeFB	FALSE
PbtsoyPhKaCúVùóTòǒIiAVaǔsethbniuáF	FALSE
SúpěùmxlaYkyeRLiQXTUIdwWOaTǔbFgàVǔ	FALSE
VòcLNoǎOXUǒAbGCcgMxUAUZXeRàyzfoohc	FALSE
YóMwnéáMcúmmcqVnMààdjfálǒéàLBJtBKǒ	FALSE
aHGàLQrQHCòǒěgǔYPyLzabgǎúéuvàmAàAX	FALSE
bNMVcàáòyAvbgyàsKogKháùYPoFPjxràáY	FALSE
cRKTqdBAmacBKcfǔctqfKPqEbáYàjemLmh	FALSE
drrsztpvciLyéAdpDACguuSèdcǎǒIuYáGz	FALSE
gUjrzdsrupcOEmóSMràcùudKèòZǎlLXáxǎ	FALSE
jéEqbéǎèidfédbmòRSbcHrKicDbHděXYWw	FALSE
lbliéMSUtFBlénMaúwàWSKbjWBMkhCvGhě	FALSE
onúttvMúhNǒZBZàaSyXcorcxǔaFYHCAybǎ	FALSE
rzQgghUwpéóDábwmISZRcNTuBLTjscCéòS	FALSE
uaǔgCkCóOiMǒdàHQiXPfLzVvúaWGbpDǔùW	FALSE
xùǎhrpWwVǒpviévbyBóKbSácPFùcǒnAHug	FALSE
ùèbOcbucElèYwyèvzlrTazMlLbgQlHǒólS	TRUE
árféaccáòǎCheGyKYGDwàsdáácWLúdHeLtm	TRUE
éSùWWjěAOtNǎcgúnEgNàqyelPqidiecadj	TRUE
óHóNbWHQDcbWNuWòoYNwEZGpDèAhédBxcTC	TRUE
úLzEyiòUecdcdmǎggVgGZBWjěógeivBúsi	TRUE
CěàUuCciaYáRóAltzzqKǎbGtLeDěusěaNb	TRUE
EyòaijFbazPnswDXMJrWMEézvbWYóiòsǒx	TRUE
HacqYtbNIXYaBIHVcoévvtVGcAǎPWLTbWsM	TRUE
KDLóvGUxsǔjzuDcDkdknALicYàfVStaèdcA	TRUE
McǒnndcyǔóNúzEbZHjsRdpqèTLuYRáJeFB	TRUE
PbtsoyPhKaCbúVùóTòǒIiAVaǔsethbniuáF	TRUE
SúpěùmxlaYkyeRLiQXTUIdbwWOaTǔbFgàVǔ	TRUE
VòcLNoǎOXUǒAbGCcgMxUAUZbXeRàyzfoohc	TRUE
YóMwnéáMcdúmmcqVnMààdjfálǒéàLBJtBKǒ	TRUE
abHGàLQrQHCòǒěgǔYPyLzabgǎúéuvàmAàAX	TRUE
bNMVcàáòyAvbgyàsKogKháùcPoFPjxràáY	TRUE
cRKTqdBAmacBKcfǔctqfKPqEbáYàjemLmhd	TRUE
drrsztpvciLyéAdpcACguuSèdcǎǒIuYáGz	TRUE
gUjrzdsrupcOEmdóSMràcùudKèòZǎlLXáxǎ	TRUE
jéEqbéǎèidfédbmòRSbcHrKbcDbHděXYWw	TRUE
abliéMSUtFBlénMaúwàWSKbjWBMkhCvGhě	TRUE
onúttvMúhNǒZBZàaSbXcorcxǔaFYHCAybǎ	TRUE
rzQgghUwpéóDábwmISZRcNTuBLTbjscCéòS	TRUE
uaǔgbCkCóOiMǒdàHQiXPfLzVvúaWGbpDǔùW	TRUE
xùǎhrpWwVǒpviévbyBcóKbSácPFùcǒnAHug	TRUE
ùǔctISAfùTtóTCdpcoǔHYnJsKějWtHRbǒrg	FALSE
áycvYSxfǔgxjhjeRwGukùAhcnYǒWvnhdQNE	FALSE
éomBùkMpIgecòùSqyǔCEbspǔPvUeYcFrJrz	FALSE
òǔLbZOWbTwGjoèffWVǎmbHgkNXógcQUVtqr	FALSE
úSCGbédQllepccHwDMXKlǒèAbFYEtPxézěr	FALSE
BuNfIcjEQúMclMxǔCmpLdGMěxBFNòZHqDǎQ	FALSE
EZtaùzRvtGncdiFúáTZHGTgnáLdzmJeBzSě	FALSE
HAHXVQgAQNcEèpdKBicLSěcLHfCSoaJHǔBN	FALSE
KKpZjBQJbǎWcǎTiLéOěóòQbǎfVzbiBVnLěi	FALSE
MlxqHǎcóúMòqjUòcQAKùnppUgBoGúcydXdv	FALSE
PsnǎbFXEěxSzRdJèlGcWéěVPjòcbGeǔSyeZ	FALSE
TPPgvqGàMyXBcbègAHIGhVómUǔoZcIèegVc	FALSE
WòUgbIAqEfjǒtbmcGXIáSěuwQgTeVUPàòéò	FALSE
ZèVekZqPEElFpiócfteTVZúisoGbaBclmsl	FALSE
aRùaCJOáqYfnébZGszXǒcǎuXJirǒCSòyKǒǎ	FALSE
bSAOgSxùxfǔjcZyMqaǎúTTSBoaDYeGcUtsa	FALSE
cUcnbKKrǔacùIéyBDénǔúgǒcǎfkèméKwòNó	FALSE
eNnVabvaǔiWAòoólPTvYkoKAóUyUqNMúwáq	FALSE
hANNubBRcdbMèYeiKaqèrWrpoNitmfùvWyt	FALSE
kgáUaawPYobZZHdbplLkǒjèBsyPSáwkǒdbc	FALSE
nòFpIuPUpZpLnóěhHeyǎbèàvjcWiBQRǎXcn	FALSE
pJJSbWIgLàBznvǎqkgdànfbcJaBIàěQkOUg	FALSE
rnnlEtZsvyDTǎbuLRIkvaPabwéěNBPXbrVB	FALSE
uLmBǎěCPKzfVǔQDDWQbVmXZHEKXckcHkNjd	FALSE
xJXdaFiVvbroojNRLbZZHXsúchTzyǔbGOek	FALSE
ùǔctISAfùTtóTCdpcoǔHYnJsKějdtHRbǒrg	TRUE
áycvYSxfǔgxjhjdeRwGukùAhcnYǒWvnhdQNE	TRUE
éomBùkMpIbecòùSqyǔCEbspǔPvUeYcFrJrz	TRUE
òǔLbZOWcTwGjoèffWVǎmbHgkNXógcQUVtqr	TRUE
úSCGbédQllepccHwDMXKlǒèAbFYEtPxézěrc	TRUE
BuNfIcdEQúMclMxǔCmpLdGMěxBFNòZHqDǎQ	TRUE
EZtaùzRvtGncdiFúáTZHGTcgnáLdzmJeBzSě	TRUE
HAHXVQgAQNcEèpdKBicLSěcLdHfCSoaJHǔBN	TRUE
KKpZjBQJbǎWcǎTiLéOěóòQbǎfVzbiBVcLěi	TRUE
MlxqHǎcóúMòqjUòcQAKùnppUgBoGúcydcdv	TRUE
PsnǎbFXEěxSzRdJèlGcWéěVPjòcbGeǔcyeZ	TRUE
TbPgvqGàMyXBcbègAHIGhVómUǔoZcIèegVc	TRUE
WòUgbIAcEfjǒtbmcGXIáSěuwQgTeVUPàòéò	TRUE
ZèVekZbqPEElFpiócfteTVZúisoGbaBclmsl	TRUE
aRbaCJOáqYfnébZGszXǒcǎuXJirǒCSòyKǒǎ	TRUE
bSAOgSxùxfǔjcZyMqaǎúTTSBoaDYbeGcUtsa	TRUE
cUcnbKKrǔacùIéyBDénǔúbgǒcǎfkèméKwòNó	TRUE
eNnVabvaǔiWAòoólPTbvYkoKAóUyUqNMúwáq	TRUE
hANNubBRcdbMèYeciKaqèrWrpoNitmfùvWyt	TRUE
kgáUaawPYobZZHdbplLkǒjèBsyPSáwkǒdabc	TRUE
nòFpIuPUpZpLnóěhHeyǎbèàvjcbiBQRǎXcn	TRUE
pJJSbWIgLcàBznvǎqkgdànfbcJaBIàěQkOUg	TRUE
rnnlEtZsvyDTaǎbuLRIkvaPabwéěNBPXbrVB	TRUE
uLmBǎěCPKzfVǔQDDWQbVmXZHEKXckdcHkNjd	TRUE
xJXdaFiVvbroojNRLbZZHXsúchTzaǔbGOek	TRUE
ùǔiǔcusKrcGǎěqBYdwjPeèfCGpRDàUùAradM	FALSE
áoXPenCIKQúqZéCvtjGbKJRǎrxaǔHèGPcdbA	FALSE
éTauwXcwzonihǒaèxMpQbǎYǎqéadzJBòHdnw	FALSE
óhvBúTúyJaLTúbPZLzjzkdamóqcfòOwnCAòd	FALSE
úqsǎlvPLětǔSSJrrDjXrhǒcètvyilKbwHdac	FALSE
CFdrLéOǔánwmFùFGpdǒéGrVIpckRsvàdEǒyú	FALSE
FCiAxúúswYobúZmùBèbòmùèNabqùxGWéǒdyú	FALSE
HucLQKwǒǔecǎěZjsNbzjDlǎppOnNQVXdCesJ	FALSE
KmvǔtabladnèIqPEòàxwxòLèFUQmùUsùIfsǎ	FALSE
NagJKOěěXziJdoókyqaKusJCPbcDǔTDǒqTJj	FALSE
QěyòSjJúOmcAáPmUfèwáfWTxFIvtǒcEjOWdó	FALSE
SrGTCapclèaSǎatgFFáuvLJrxkKjHòùEolbr	FALSE
VèNOBWnqàRlkfmxBcWtfCczeYLqIqKdNCCǔd	FALSE
XkvcbqfhgEXcCvMúiNéTmEzáNméyǒJěCecHz	FALSE
aJSnLáISDyùgpEdsèùAKotawclgáúLKzAobá	FALSE
bfgMJvmKqoOlAcJwdqPEmbǒyqTéóBUwANTda	FALSE
cfdFAěiǎDlYLúBiXnTsNFhXEdsrFsYbqINvó	FALSE
fDRcGěǎUzxéanaòWbVexgsàaSúwcfqLOdáuF	FALSE
hZkHTWǒǔJhTPěbsěDeaOCièWWtTJvgwVPcjb	FALSE
kòeùóěKtcIdYlzHpwǒJRFIflRDxòmcauDxAl	FALSE
nǎyDLMasjùPNtdUmyFMEWNmEKZaGEEùèvobV	FALSE
pkusbPzeDpZQKiuǒGsKcbtXǔEuHxnJliMdBL	FALSE
scdVoéxpSXRxHǒWvdǔfùMhúKTéMIAFJPYUAP	FALSE
uiSùXZkmGrxèvCxYXáQǎcdyDóaGOOkQóYUdr	FALSE
xPDpeYzyvdLcZbWviiVMnèZAékHUGELwdǒaò	FALSE
ùǔiǔcusKrcGǎěqBYdcjPeèfCGpRDàUùAradM	TRUE
áoXPenCIKQúqZéCvtjGbKJRǎrxaǔHèGPcdbc	TRUE
éTauwXcwzonihǒaèxMpQbǎYǎqéadzJBòHdnwb	TRUE
óhvBúTúyJaLTúbPZLzjzkdabóqcfòOwnCAòd	TRUE
úqsǎlvPLětǔSSJrrDjXrhǒbcètvyilKbwHdac	TRUE
CFcrLéOǔánwmFùFGpdǒéGrVIpckRsvàdEǒyú	TRUE
FaiAxúúswYobúZmùBèbòmùèNabqùxGWéǒdyú	TRUE
HucLQKwdǔecǎěZjsNbzjDlǎppOnNQVXdCesJ	TRUE
KmvǔtabladnèIqPEòàxwxòLèFUQmùUsùbIfsǎ	TRUE
NagJKOěěXziJdoóbkyqaKusJCPbcDǔTDǒqTJj	TRUE
QěyòSjJúOmcAáPmUfèwáfWTxFIvtdcEjOWdó	TRUE
SrGTCabclèaSǎatgFFáuvLJrxkKjHòùEolbr	TRUE
VèNOBWnqàRlkfmxBcWtfCczeYLqIqKdNCCcǔd	TRUE
XkvcbqfhgEXcCvMúiNéTmEzáNméyǒJěCbcHz	TRUE
aJSnLáISDyùgpEdsèùAKbtawclgáúLKzAobá	TRUE
bfgMJvmKqoOlAcJwdqPEcbǒyqTéóBUwANTda	TRUE
cfdFAěiǎDlYLúBiXnTsNFcXEdsrFsYbqINvó	TRUE
fDRcGěǎUzxéanaòWbVedgsàaSúwcfqLOdáuF	TRUE
hZkHTWǒǔJhaPěbsěDeaOCièWWtTJvgwVPcjb	TRUE
kòeùóěKtcIdYlzHpwǒJRFIflRDxòmcdauDxAl	TRUE
nǎyDLMasjùPNtbdUmyFMEWNmEKZaGEEùèvobV	TRUE
pkusbPzeDpZQKiuǒGsKcbtXcǔEuHxnJliMdBL	TRUE
scdVoéxpSXRcxHǒWvdǔfùMhúKTéMIAFJPYUAP	TRUE
uiSùXZkmGrxèvCxYXáQǎcdyDóacOOkQóYUdr	TRUE
xPDpeYzcvdLcZbWviiVMnèZAékHUGELwdǒaò	TRUE
ùùBEmxbéXpQcǎcaZHEgùcApNbJhVBoHkZMkWA	FALSE
áSzzuzlmbPyóZIiùóáWěéajvUúUMMUbGcjǔte	FALSE
éWcSDàFkqcNrFVZSDbObLNRceDufDrǎSeǎkBc	FALSE
ěqVPěnSvdQCaDròotSzqpúdEbèihcVDEfivnd	FALSE
úMǔWòèSóSnQǎùfJàGZiIgcHoWbIǎvéuyMbcys	FALSE
CbGaǎlàxgróééMUMFKJùbwCàKVhkUcàSPOivé	FALSE
FNTáiphbPAǔrXaǒMiaCudgJSqVghùDqálVWbK	FALSE
HplbZaǎEBúFIAuXcalòTILdYIiégCbUúKrivE	FALSE
KpǔjayCLsoOkSeBúúWurěHUbtébUěvCOFZTcǒ	FALSE
NaóJukbygUMBbUTvpiHbfKzySaòègsThFSasP	FALSE
PlaVnráǔcbǒGbFúUcùYéTaTóBGiykXgùǒXOèk	FALSE
SPèFGOáEěéDPJCYàKoanBpnhLBVnVVLbaòèhé	FALSE
UwPcCoFRhaaǎúHCAcHCbNoUVáBúEeúqéINJVD	FALSE
XIHcòDǒgviòùMǎóLpmPévFdpLKǔSePpcpbKCT	FALSE
ZdDépbǎwzNXCsuRJùQulzlbiéXStNèècqBáUi	FALSE
bùtRfCLtdMXGjsYjRòHbkcǔěYnceeIORǎEàQh	FALSE
cCBGdOóqXwIQhàabàuVYmiěUNmsKdHYBXCáIx	FALSE
dHqHoAbERxPGJóDeàdabPbǔdáazRTQfQUvdtA	FALSE
gáAUzfbCDUpóóǒWyéěIhBDtMEbyYvcEQgIASO	FALSE
iQNmzazqbsZpXòggsWMPjfODEéOhVòbQóYGgd	FALSE
lèvdvUéMAǒúNmqCfbiwmaPyTKaójnmIáyBbep	FALSE
oèFbFmRHVMǔyeKBUabemvEqXBWcrKWmGrMcTh	FALSE
qqaTbDYJvNSKoFhBCCwNVYǔSbFNomHQaMTTQW	FALSE
twcòdOǔGwaSjnnkóJúVǎdónvXeAspkXkuGèeá	FALSE
xFpDYLLZujCdikJǒtPNxǎllhJcRǒduISDcBPM	FALSE
ùùBEmabéXpQcǎcaZHEgùcApNbJhVBoHkZMkWA	TRUE
áSzzuzlmbPyóZIiùóácWěéajvUúUMMUbGcjǔte	TRUE
bWcSDàFkqcNrFVZSDbObLNRceDufDrǎSeǎkBc	TRUE
ěqVPěnSvdQCaDrcòotSzqpúdEbèihcVDEfivnd	TRUE
úMǔWòèSóSnQǎùfJàGZiIbgcHoWbIǎvéuyMbcys	TRUE
aCbGaǎlàxgróééMUMFKJùbwCàKVhkUcàSPOivé	TRUE
FNTáaiphbPAǔrXaǒMiaCudgJSqVghùDqálVWbK	TRUE
HplbZaǎbEBúFIAuXcalòTILdYIiégCbUúKrivE	TRUE
KpǔjayCLsoOkSeBúúWurěHUbcébUěvCOFZTcǒ	TRUE
NaóJukbygUMBbUTapiHbfKzySaòègsThFSasP	TRUE
PlaVnráǔcbǒGbFúUcùYéTaTóBGiykXgùǒXObk	TRUE
SPèFGOáEěéDPJCYàKoanBpnhLBVnVVLbaòèhb	TRUE
UwPcCoFRhabaǎúHCAcHCbNoUVáBúEeúqéINJVD	TRUE
XIHcòDǒgviòùMǎóLpmPévFdpLKǔSePpcpbdKCT	TRUE
ZdDépbǎwzNcCsuRJùQulzlbiéXStNèècqBáUi	TRUE
bùtRfCctdMXGjsYjRòHbkcǔěYnceeIORǎEàQh	TRUE
cCBGdOóqXwIQhàabàuVYmiěUNmscdHYBXCáIx	TRUE
dHqHoAbERxPGJóDeàdabPbǔdáazRTQfQUvdtAb	TRUE
gáAUzfbcCDUpóóǒWyéěIhBDtMEbyYvcEQgIASO	TRUE
iQNmzazqbsZpXòggsaWMPjfODEéOhVòbQóYGgd	TRUE
lèvdvUéMAaǒúNmqCfbiwmaPyTKaójnmIáyBbep	TRUE
oèFbFmRHVMcyeKBUabemvEqXBWcrKWmGrMcTh	TRUE
qqaTbDYJvNSKoFhBCCwNVYǔSbFNomHQaMTTQbW	TRUE
twcòdcOǔGwaSjnnkóJúVǎdónvXeAspkXkuGèeá	TRUE
xFcpDYLLZujCdikJǒtPNxǎllhJcRǒduISDcBPM	TRUE
ùùkémòHrKaQàzQpvnIcZTObzcIfááàQmNQqCCU	FALSE
àùògECòCFyòěSASTcrXlcFlmIIǎdPXOWdLèRed	FALSE
éyPǒcoPbǔmiwfwbYgJqbIénáqděGbEùWúcéuwh	FALSE
óDiòaxàWxùFóeniquèútSiZvaěEOOJKbǒǔgǎAD	FALSE
ǒrOrnxybuxLocAcpúiJhqěSjTxPárěclGabKZv	FALSE
CòSUhdófziMěTvqgjcǔèyBhsgAYdJRHXòswèiE	FALSE
FáYAOxAcdGOMOhRtBtAqKdEoǒdáóǔfepTAvéQó	FALSE
HxnYJRrèLWFPEbBduwtiVJkVsxFvaùnkèaKLbU	FALSE
KVbrsMsaúiHZNGUpJxaéJúcXqéXgjYcOlMòYAJ	FALSE
MvòJyETNAóékwOdvmYúcMRqryqGfǎǔědwAéJfě	FALSE
PlbOInhckMcLǔSAGnjfkzbMSGGZQDàyùuKórzO	FALSE
SFhaAǎBbbzriTFrlyklyKwǔTstgJùaCqSlùfTR	FALSE
UOaUDzWéfOéeSbeBócLakHeěHkěyztkYXAJùsm	FALSE
XVDJRhHǔeJcxisRnbcóBBòkDWěOLxǒcáTnmaYz	FALSE
ZtZeězaǒzPyyLQNálǔLnáRaǔLdcmOcgbYzuǎwd	FALSE
bBMRRbXAàjKiMTáóeJvèúiccdáàTBawěvMgWCc	FALSE
cECǎéùccBYdNóTplIQěwfùFsghIòAóOméeNYfS	FALSE
dcVinùQGupǎùwTHQgáydciKrCFócRPmOCumrǔǒ	FALSE
gIKZtwdFMótaibmmZgzQnkarjwǎzǒsùKdsWKUA	FALSE
imàWrFIkGNcyùúXqADgaKvJIáSbmswjhkkfpbP	FALSE
ljKAlùcGGSènEMRnsǔfùbqLRScEJǒdcòwZyxnG	FALSE
oeVLElYnvuLèqJKXmVXmegZsòcBbèùJiLOtZcǔ	FALSE
rVhlóCǎdMqéXMosNQúwóQAxcpǔǒdkkaGòfhHLY	FALSE
uORRuzRISbPoxKǔHHáFxgGsbkAIáuMábOLyyic	FALSE
xáVgCwoXxtOdYqèmxǔExrOFZDbpmcùigThdIIǒ	FALSE
bùkémòHrKaQàzQpvnIcZTObzcIfááàQmNQqCCU	TRUE
àùògECòCFyòěSASTcrXlcFlmIIǎdPXOcdLèRed	TRUE
éyPǒcoPbǔmiwfwbYgJqbIénáqděGbEùWúcduwh	TRUE
óDiòaxàWxùFóeniquèútbiZvaěEOOJKbǒǔgǎAD	TRUE
ǒrOrnxybuxLocAcpúiJhqěSjTxPárěbclGabKZv	TRUE
CcSUhdófziMěTvqgjcǔèyBhsgAYdJRHXòswèiE	TRUE
FáYAOxAcdGOMOhRtBtAqKdEcǒdáóǔfepTAvéQó	TRUE
HxnYJRrèLWFPEbBduwtiVJkVsxFvaùnbèaKLbU	TRUE
KVbrsMsaúiHZNGUpJxaéJúcXqéXgbYcOlMòYAJ	TRUE
MvòJyETNAóékwcOdvmYúcMRqryqGfǎǔědwAéJfě	TRUE
PlbOInhckMcLǔSAGnjfkzbMSGGZQDàyùuKócrzO	TRUE
SFhaAǎBbbzriTFrlyklyKwǔTstgJùaCqSlùfTb	TRUE
UOaUDzWéfOéeSbeBócLakHeěHkěyztkYXAJbsm	TRUE
XVDJRhHǔeJcxisRnbcóBBòbDWěOLxǒcáTnmaYz	TRUE
ZtZeězaǒzPcyLQNálǔLnáRaǔLdcmOcgbYzuǎwd	TRUE
bBMRRbXAàjKiMTáóeJvèúiccdáàTbBawěvMgWCc	TRUE
cECǎdùccBYdNóTplIQěwfùFsghIòAóOméeNYfS	TRUE
dcVinùQGupǎùwTHQgáydciKrCFócRPmOCumrǔǒd	TRUE
gIKZtwdFMótaibmmZgzQnkarjwǎzǒsùbKdsWKUA	TRUE
imàWrFIkGNcyùúXqADgaKvJIáSbmswjhakkfpbP	TRUE
ljKAlùcGGSènEMRnsǔfùbqLRScEJǒdcòwZyxndG	TRUE
oebLElYnvuLèqJKXmVXmegZsòcBbèùJiLOtZcǔ	TRUE
rVhlóCǎcdMqéXMosNQúwóQAxcpǔǒdkkaGòfhHLY	TRUE
uORRuzRISbPoxKǔHHáFxgGsbkcAIáuMábOLyyic	TRUE
xcVgCwoXxtOdYqèmxǔExrOFZDbpmcùigThdIIǒ	TRUE
ùěbúòòkZBúblfdMLHABNézyǔroamGfqVsvPpwlc	FALSE
áoBfIaPWRěKEFPuvESbcpJUdtnXnXhúRGGòlbBǎ	FALSE
èAUdhLZLhVVBwYAsMDrYazrNcJrbLǒocnLǒGQěh	FALSE
óxéWtcbVvZsZYǎCqZdrWAVaéwPITfwbuǎflKrèx	FALSE
AǎlQtggaHěgěOPxWVDAGzlHmqúméepaúúvcèbNo	FALSE
CKeócIYsQéspòKArWsdUùmókéviAAdKTmkKWIwJ	FALSE
EvMgcdytqOruěugdVIZzéjjJZXcyOKJJCYSnDDg	FALSE
IèTJòDbTDóbCXpCXDcofcwUHáxjáYwnpXGVyJGě	FALSE
LòMQfěOkdkVHaWStbdLoprǒEyVcwBNxMlúNuOéb	FALSE
NLlxǎǎvThJmàGèYpvbQVuPěaàPúPiMuVcrùbZǔJ	FALSE
QJFPJInmǎyAlxSrTDtdGzdzyùǎckrktZXtdsqvǒ	FALSE
TěVǒFyLfXUEiibnǒcòyDmdKúOcèkEvbàJDzrLùL	FALSE
WRyWyiVqùFoFkanMbáěvùMTbógCdùCykgèǔjCèb	FALSE
ZQCaCbèNYTnCuTRcDácdjIǔúMáTnúCXQPwdMbEi	FALSE
arIǒǔénNWpGJXaǔbEàxǒLèrNnJǎunbVqazXicCD	FALSE
cùJbqalNdeYaPOfPnmgjoZǔwODcwJǎǎslaFEàTI	FALSE
dCpěMàUBbaGuBTTlMgydǔgHFTájXvcěrLPèásbJ	FALSE
flwAǔaéxèrMVuvybyHéycogùTRWxGKXjSGdmlcC	FALSE
iSdHiyBòlMèubóǒJcǔAZtQěuBKdoèKKZhúKámwG	FALSE
kiaǔESsUJYùàlWnIxòxǎXyXséòǔVgéqgNZarbàs	FALSE
mrZPgaOGbWIvlòtlpBBRyóbjAwáxqfptdNWǔLah	FALSE
pddiàùasnuDuSCaGéIWéóRǒéoqúǒLkSxFQnibcZ	FALSE
sAfxàqNAeOWetjYYWyLOǎwmèbwǎMOhsASiaXěbP	FALSE
uXywGbhqqǒvǔtkLxiWǔáIKQJbCyzcCFòhwuhzgi	FALSE
xógDBtaǎeOoeBsònwYmpaǔDaóNKábjvYóěVvHVD	FALSE
ùěbúòòkZcBúblfdMLHABNézyǔroamGfqVsvPpwlc	TRUE
áoBfIaPWRěKEFPuvESbcpJUdtnXnXhúRGaòlbBǎ	TRUE
èbAUdhLZLhVVBwYAsMDrYazrNcJrbLǒocnLǒGQěh	TRUE
óxéWacbVvZsZYǎCqZdrWAVaéwPITfwbuǎflKrèx	TRUE
AǎlQtggaHěgěOPxWVDAGzlHbmqúméepaúúvcèbNo	TRUE
CKeócIYsQéspòKArWsdUùmócéviAAdKTmkKWIwJ	TRUE
EvMgcdctqOruěugdVIZzéjjJZXcyOKJJCYSnDDg	TRUE
IèTJòDbTDócbCXpCXDcofcwUHáxjáYwnpXGVyJGě	TRUE
LòMQfěOkdkVHaWStbdLoprǒEyVawBNxMlúNuOéb	TRUE
NLlxǎǎvThJmàGèapvbQVuPěaàPúPiMuVcrùbZǔJ	TRUE
QJFPJInmǎyAlxSrTDctdGzdzyùǎckrktZXtdsqvǒ	TRUE
TěVǒFyLfXUEiibnǒcòyDmdKúOcèkdEvbàJDzrLùL	TRUE
WRyWyiVqùFoFkanMbáěvaMTbógCdùCykgèǔjCèb	TRUE
ZQCaCbèNYTnCuTRcDácdjIǔaúMáTnúCXQPwdMbEi	TRUE
arIǒǔénNWpGJbXaǔbEàxǒLèrNnJǎunbVqazXicCD	TRUE
cùJbqalNdeYaPOfPnmgjoZǔwODcwJdǎslaFEàTI	TRUE
dCpěMàUabaGuBTTlMgydǔgHFTájXvcěrLPèásbJ	TRUE
flwAǔaéxèrMVuvybyHéycogùTRWxGbXjSGdmlcC	TRUE
cSdHiyBòlMèubóǒJcǔAZtQěuBKdoèKKZhúKámwG	TRUE
kiaǔESsUJYùàlWnIxòxǎXyXséòǔVgéqbgNZarbàs	TRUE
mrZPgaOGbWIvlòtlpBBRyaóbjAwáxqfptdNWǔLah	TRUE
pddiàùasnuDubSCaGéIWéóRǒéoqúǒLkSxFQnibcZ	TRUE
sAfxàqNAeOWetajYYWyLOǎwmèbwǎMOhsASiaXěbP	TRUE
uXywGbhqqǒvǔtcLxiWǔáIKQJbCyzcCFòhwuhzgi	TRUE
xógDBtaǎeOoeBsòbnwYmpaǔDaóNKábjvYóěVvHVD	TRUE
ùùVaUEQlòyǎóyápúRáǒxvAjVběCcqUXReqHZdcgá	FALSE
álpYdkBòauGèTuFEèàcJWlWSgtCdsqGkvùLgaEóa	FALSE
éNěbWHvkLòGqbcAcǒRdkDYjYOǒúVǎjBóǒǒFgKǔta	FALSE
óAIOEdAXéFàxúdǔLǔSshcfLěwOWYàCéalbDTxUDc	FALSE
úàZEDKfiFnYfEZóIdxpNeDcúICMdROAYàEǎKZùzk	FALSE
BcaWásxawMIPoKjqcǎNàNxxJsBCwùòǒdBLQyòjoB	FALSE
ETIOoúebRtMwUIojlxàYáDfpàDáCwbmAcrIDIvLà	FALSE
HúmGcxkcrxddfcJHúcJivzCIèpoúeJmùmSGLoòùǎ	FALSE
JxCcGeZNkdQxpRcbByXváǒebStITǒalJfJczáJóL	FALSE
MmiSymMXQbTPTRcXkTbòTyQyvygǎQeǔHkPRHjoIt	FALSE
PUoLázFbEHJlóoùcbwhDàpUúOJDTTzJTwúMXsébǒ	FALSE
RrjqěǒUrbieúaùděámCwJěOcTpVaUbluQkBQVnna	FALSE
UFvRgaQNěbaqwhmlayfvèkQyInhhYWMdnnBHóUdY	FALSE
XóHHèPDòuGjaxSWHeHyòPHòSǎcRáWdecQjcRwúBZ	FALSE
ZdeàIhSúúPVèSPdcvdrǒǒéáTLKuBtjóèmhóKǎcWP	FALSE
bèybwSjYazeDDdHWVzPAZdcDHpJxZmmócgTsAmnd	FALSE
cLàXdGGǒEóóěcfKlSioòYRLwIqZEmpkéúFFGpXbi	FALSE
eBCJeqyqhmZiTYeésvmKaULkCǎutBKaàzrAiXrbS	FALSE
hAiVjGgHwAhdJuNúVwWbldBǒěZěaWMbyYvfǎIyfH	FALSE
jhsěmrsjSuǎTǒNáynggWwfToxikóaJPǔOiabObXR	FALSE
mTZOtkáFsqéUZhcIzěéhbyEMxsMcnQETLBEróYRW	FALSE
pGpIǔpoěézdPcdJCNNbVKJSzvFtfzèGxxVvgbMvó	FALSE
rtVOoqóáCpmXòviCaNǎLàJTqbǔwutlQùtCnXQòèb	FALSE
uTòskhWǎPrpYNIcQsYdyzockSqYbhscmèjMripDY	FALSE
xědCKyvWCAǔóBQtbǔSòbnycNRnWsIFàZuxJMJDcz	FALSE
ùùVaUEQlòyǎóyápúRáǒxvAjVběCcqbXReqHZdcgá	TRUE
álcYdkBòauGèTuFEèàcJWlWSgtCdsqGkvùLgaEóa	TRUE
éNěbWHvkcòGqbcAcǒRdkDYjYOǒúVǎjBóǒǒFgKǔta	TRUE
óAIOEdAXéFàxúbǔLǔSshcfLěwOWYàCéalbDTxUDc	TRUE
úàZEDKfiFnYfEZcIdxpNeDcúICMdROAYàEǎKZùzk	TRUE
BcaWásxawdIPoKjqcǎNàNxxJsBCwùòǒdBLQyòjoB	TRUE
ETIOoúebRtMwUIojlxàYácDfpàDáCwbmAcrIDIvLà	TRUE
HúmGcxkcrxddfcJHúcJivzCIèpoúedJmùmSGLoòùǎ	TRUE
JxCcGeZNkdQxpRcdByXváǒebStITǒalJfJczáJóL	TRUE
MmiSymMXQbTPTRcXkTbòTyQyvygǎQeǔHckPRHjoIt	TRUE
PUoLázFbEHJlóoùcbwhcàpUúOJDTTzJTwúMXsébǒ	TRUE
RrjqěǒUrbieúaùděámCwJěOcTpVaUbluQkBQVncna	TRUE
UFvRgaQNěbaqwhmlaybvèkQyInhhYWMdnnBHóUdY	TRUE
XóHHèPDòuGjaxSWHeHyòPHòSǎcRáWdecQjdRwúBZ	TRUE
cdeàIhSúúPVèSPdcvdrǒǒéáTLKuBtjóèmhóKǎcWP	TRUE
bèybwcSjYazeDDdHWVzPAZdcDHpJxZmmócgTsAmnd	TRUE
cLàXdGGǒEóóěcdKlSioòYRLwIqZEmpkéúFFGpXbi	TRUE
eBCJeqyqhmZiTYeésvmKaULkCǎutBbKaàzrAiXrbS	TRUE
hAiVjaGgHwAhdJuNúVwWbldBǒěZěaWMbyYvfǎIyfH	TRUE
jhsěmrsjSuǎTǒNáynggWwfToxikóaJbǔOiabObXR	TRUE
mTZOtbáFsqéUZhcIzěéhbyEMxsMcnQETLBEróYRW	TRUE
pGpIǔpcoěézdPcdJCNNbVKJSzvFtfzèGxxVvgbMvó	TRUE
rtVOoqóáCpmXòviCaNǎLàJTqbǔwutlaùtCnXQòèb	TRUE
uTòskhWǎPrpbYNIcQsYdyzockSqYbhscmèjMripDY	TRUE
xědCKyvWCAǔóBQtbǔSòbnycNRnWsIFàbuxJMJDcz	TRUE
ùáXǔmLgNQCàLàbóiTóFRTòUlbRáeèFScQéflgSéòǎ	FALSE
àǔdsaáZiLKGgNDzièxVáPNdsIajlOuskbqǎOKilMd	FALSE
éjxNRbpbáVGPAIEpHetykMCgLBRaòóHbKOvwěkeIy	FALSE
óYSHKrLLCkBaKèǒbhpbádédùǎvzGaUQjkJCfwizZě	FALSE
úLmKmcdjǒècyhXXòokViuHguUSQaaNǎNozGGSkGùW	FALSE
CèNDǔKUéXèmLǒjJèaFLbzPJqváqPlVHuGRvzbyZOr	FALSE
EúmFihàcmYxyBwRcDNxgcédWóvPOeECǒonYtùSéBT	FALSE
HPěHèmEInPbcNàrátaáoùsNciùxAQLEèéVěnzjǒym	FALSE
KóvKflGccyPaINóàJjděvcBěěOogVQfeGWǒAKKnǎG	FALSE
McRbJhvUvózJbetqrlBùpqmsWNcǎvLádKEottjákV	FALSE
OnjcáOlYJeéěrǒdMmyKNXèOwFlcoǎǔǔqRLWèèǒPLà	FALSE
RRfQRaáWTkgaarKYscQǎDAJtIiOtLKěàyAWxWbnQY	FALSE
TlěTùyEóznpHusmfsàwǎbcǎáiǒHTloǔxjBbNKòuǒz	FALSE
WwVěéVěeQGXOOúǎAlFwxcjpbuxàǎócsgrLJóBcrQS	FALSE
ZmhAAIoCòFPǎbúumpEqlHbókéàǎaMgCbGXVeZáSéM	FALSE
búèGaTdloefuZmmBevXubXeóLèdNMcbwklDENHYCV	FALSE
cQlfuOUWèUqGéyCbnúQinASèagFbbèVépXBqOUfHn	FALSE
dyFKsóucdSòvmoǎYqFKLǎQGvùuuúYdaYOQadwnNRJ	FALSE
gPfórTKmBlěJvǒQaàlròtvKǔFcùRbcleAèǔaHwóèY	FALSE
jHBNedǒéLWKoǔHqBòXZCgEHZNcPiKAYkóǒTyèěcdy	FALSE
lnǒáNELǎUeXèOěèOfěuctgěOóàxHdinRaǔxccSkgè	FALSE
oqceGildqKWWàbRXSélBzLFBSLQDàxXzGaasùBQZd	FALSE
rtCnBbótHUcoǒVCmVǎrUypBJNZFkpcTPOliOáXNHè	FALSE
uaǎxYwtSEbjěstZGèvxRkdmgǎéǒuaFFEenxLVèEsI	FALSE
xTweMpZqbuàYZtnHǎRdJyukqlglkwOHzbpLsaXcDe	FALSE
ùáXǔmLgNQCàLàbóicTóFRTòUlbRáeèFScQéflgSéòǎ	TRUE
àǔdsaábZiLKGgNDzièxVáPNdsIajlOuskbqǎOKilMd	TRUE
éjxNabpbáVGPAIEpHetykMCgLBRaòóHbKOvwěkeIy	TRUE
óYSHKrLLCkBaKèǒbhpbádédùǎvzGaUQjkbCfwizZě	TRUE
úLmKmcdjǒècyhXXòokViuHguUSQaaNǎNozGGSkGùWd	TRUE
CèNDǔKUéXèmLǒjJèaFLbzPJqváqPalVHuGRvzbyZOr	TRUE
EúmFihàcmYxyBdRcDNxgcédWóvPOeECǒonYtùSéBT	TRUE
HPěHèmEInPbcNàrátaáoùsNbciùxAQLEèéVěnzjǒym	TRUE
KóvKflGccyPaINóàJjděvcBěěOogdQfeGWǒAKKnǎG	TRUE
McRdbJhvUvózJbetqrlBùpqmsWNcǎvLádKEottjákV	TRUE
OnjcáOlYJeéěrǒdMmyKNXèOwFlcoǎǔǔqRLWdèèǒPLà	TRUE
RRfQRabáWTkgaarKYscQǎDAJtIiOtLKěàyAWxWbnQY	TRUE
TlěTùyEóznpHusmfsàwǎbcǎáiǒHTloǔxjBbNKòuǒzc	TRUE
WwVěéVěeQGXOOúǎAlFwxcjpbuxàǎócsgrLJóbBcrQS	TRUE
ZmhAAaIoCòFPǎbúumpEqlHbókéàǎaMgCbGXVeZáSéM	TRUE
búèGaTdloefuZmmBevXubXeóLèdNMacbwklDENHYCV	TRUE
cQlfuOUWèUaGéyCbnúQinASèagFbbèVépXBqOUfHn	TRUE
dyFKsóucdSòvcoǎYqFKLǎQGvùuuúYdaYOQadwnNRJ	TRUE
gPfórTKmBlěJvǒbQaàlròtvKǔFcùRbcleAèǔaHwóèY	TRUE
jHBNedǒéLWKoǔHqBòXZCgEHZNcPiKAYkódTyèěcdy	TRUE
lnǒáNELǎUeXèOěèOfěuctgěOóàxHdinRaǔxccdkgè	TRUE
oqceGildqKWWàbRXSélBzLFBSLQcàxXzGaasùBQZd	TRUE
rtCnBbótHUcoǒbCmVǎrUypBJNZFkpcTPOliOáXNHè	TRUE
uaǎxYwtSEbjěstZGèvxRkdmgǎéǒuaFbEenxLVèEsI	TRUE
xTweMpZqbuàYctnHǎRdJyukqlglkwOHzbpLsaXcDe	TRUE
ùùapěoánYcPFǎbkúAVcpuLLmwéStjOùOáSpvǒòSFwd	FALSE
áeěukúǎèJDGzbrTògùsQǒědZPcUwódBrIàaHWDtcas	FALSE
éJZLòfKxcyKkQjLsóWèRxbòYflàúUbnóLjGcsúbKGG	FALSE
óǎTecBàǎùKCEarFEvtQxdiaiTbiěEOYótAcpóteKvV	FALSE
ǒkehNèjaubàzGtkhcPezòděpzGUeáPdcHàètóreyoD	FALSE
BcEjaVHErsqeHfǒVtgJgèfYtboAFHJKkhnàvgémbǒm	FALSE
EfLaXNěHǔcsmdsWéàMùVNdJèěhimǎdzǔSHAScěUYPQ	FALSE
HGovCVbdsAprGBijcsrQǔLnLDVMUTòCIlScòTeGójo	FALSE
JcùqPXǔòùNúFnfZEóXòNàucsǒCǒédNAegzxEáàǒùIW	FALSE
MNKwòHVDWMhHGZElsHEZibzPNcuUZDòvdClUfèWcWú	FALSE
PCgHRcKYLELùOQrcdesiCKCaJBbYàyóúùvhcNIHvZv	FALSE
SěvùmXCéQSPrxceAuHrǔdwédzMǒòóULnqysdUVFgXj	FALSE
UojoVmnwVòbnrRRòyNbvrpDzXWcègtoeYGMJTkBlàà	FALSE
XYdGzWèyCaDèxppHwòèaDvbqúUuvjPaIGějQnEHòlx	FALSE
ZxBDbnbǒèQNTdIWocgPhsXUWbeGSfgěmxJCǔtViaTe	FALSE
bHBnWvbǔdǔnwkzúèbVYáYMEPuNCǔexGTAOwhBQcèHǒ	FALSE
cWrvLéNlHjRuIWǒNsoSdeUzGKájMcFtHykpsoCTyàD	FALSE
ekidKEeDDùUNsdcTbfagQbumncbáySQghwzúpgèhNǎ	FALSE
haǎnTǒsiRZbvěZGvějúDzóTeIEkMaòDǎvoIRyaiaYU	FALSE
kóúNZKNoIlèHEosóUóKxRiVcdbzNhVIPKècyHLDFaO	FALSE
msSjLfòrvXUGǒVXyIǔELèǒěomGcbùpècéóikUKOtNn	FALSE
pDcViajolDqZDNAbjpbEáQjPPJRǔèZFbGllòulnZDX	FALSE
rbjPYYTIǔǒómgRebBOuoMSZBaúmGDZlUáCbnXSGGtt	FALSE
uQnWrGrqFespQùPpKPGozUffxiàBNbàdjaùvNNMqby	FALSE
xǔgsEERrUSáBytDLJPytJscùǎǔdbSYcUàèòifzLACF	FALSE
ùùbpěoánYcPFǎbkúAVcpuLLmwéStjOùOáSpvǒòSFwd	TRUE
áeěukúǎèJDGzbrTògùsQǒědZPcUwódBrIàaHWbtcas	TRUE
bJZLòfKxcyKkQjLsóWèRxbòYflàúUbnóLjGcsúbKGG	TRUE
óǎTecBàǎùKCEarFEvtQxbdiaiTbiěEOYótAcpóteKvV	TRUE
ǒkehNèjaubàzGtkhcPezòděpcGUeáPdcHàètóreyoD	TRUE
BcEjaVHErsqeHfǒVtgJgèfYtboAFHaJKkhnàvgémbǒm	TRUE
EfLaXNěHǔcsmdsWéàMùVNdJèěhimcdzǔSHAScěUYPQ	TRUE
HGovCVbdsAprGBijcsrQǔLnLbDVMUTòCIlScòTeGójo	TRUE
JcùqPXǔòùNúFnfZdEóXòNàucsǒCǒédNAegzxEáàǒùIW	TRUE
MNKwòHVDWMhHGZElsHEZibzPNcbUZDòvdClUfèWcWú	TRUE
PCgHRcKYLELùOQrcdesiCKCaJBbYàyóúùvhcNIHvdZv	TRUE
SěvùmXCéQSPrxceAuHrǔdwéczMǒòóULnqysdUVFgXj	TRUE
UojoVmnwVòbcrRRòyNbvrpDzXWcègtoeYGMJTkBlàà	TRUE
XYdGzWèyCaDèxppHwòèaDvbqúUuvjPaIGějQnEHòlxb	TRUE
ZxBDbnbǒèQNTdIWocgPhsXUWbeGSfgěmxJCǔtViaTc	TRUE
bHBnWvbǔdǔnwkzúcbVYáYMEPuNCǔexGTAOwhBQcèHǒ	TRUE
cWrvLéNlHjRuIWǒNsoSdeUzGKájMcFtHykpsoCdTyàD	TRUE
ekidKEeDDùUNsdcTbfagQbumncbáySQghwzúcgèhNǎ	TRUE
haǎnTǒsiRZbvěZGvějúDzóTeIEkMaòbǎvoIRyaiaYU	TRUE
kóúNZKNoIlèHEosóUóKxbiVcdbzNhVIPKècyHLDFaO	TRUE
msSjLfòrvXbGǒVXyIǔELèǒěomGcbùpècéóikUKOtNn	TRUE
pDcViajolDqZDNAbjpbEáQjPPJRaèZFbGllòulnZDX	TRUE
rajPYYTIǔǒómgRebBOuoMSZBaúmGDZlUáCbnXSGGtt	TRUE
uQnWrGrqFaspQùPpKPGozUffxiàBNbàdjaùvNNMqby	TRUE
xǔgsEERrbSáBytDLJPytJscùǎǔdbSYcUàèòifzLACF	TRUE
ùùmZgùrbaiYùěVěLrbkEmàMlZCóFógǒeFdLZǔTJqaxZ	FALSE
áPǒKpOWGATaǎúLóZXqcvóZbnWxbcaFúZgyZUAèjěoéK	FALSE
éǒdzúzsfKauxRgHGeáRBSXayRXjèúHMTwnrěIbDQdǔD	FALSE
óǔLXrEtzDWèxtBMéUèǔrqKtIbGHpaóDiTtnLásAxbaz	FALSE
ǒceǎQczèùXscecéǒhsmbBjgùVShaGTQLbIjsǎJMKQqd	FALSE
BapxecOENFmàaǒEtQBGǒúwKHQyXqRGQǒfHǔqbòǒátQg	FALSE
EBoVòEaCFDmpONJJèfǎkYúuzǎMdHLpAPDoyOmabáfàZ	FALSE
GXcMXdTèRcESppqúAGyGYNgcnènlqyélěVfLUfALSBU	FALSE
JMúgéSIóxVdhIKèhǔyldtcWòNuExcZwWèàrXZúBhdWH	FALSE
LatvmTbóNNVóLveqEyWèSUzkXèCKmJmuUDgqòóbERuè	FALSE
OùWGHěigDUǔazeǒúddǒXybcjYVgiYapUhògádsqkzCg	FALSE
QKuWxáBkRCnOLlòwaBybèbwUwiàfcElóoecOXAlúRèb	FALSE
TǔHfǔPKizúUbQSolcGètcàóVcxkDZqqWěCvóEliajbj	FALSE
VvZIWQǔUfAèrTóǎuòàbSFwqmaBaqnUuShqyteùùapbC	FALSE
YYRbeMIRcǔFGwUPMYsópIYYUCVbòYvǒXYMóvIDjampI	FALSE
ahiSlcěXǎbHǒgLSpqhMUkXcFhjǔmTCbMOrdjTrǔCèxD	FALSE
céèRXǒQdbsksLTèYpMBpjfùJsdSǒcKoǒǔVCyúFjKZeR	FALSE
diakhvmdAHfWlYoqoObzKóPcèRKKkúJAócbHǎMBfzth	FALSE
gjUYSnuaDEcPbICPHǔHtSCjVJChHibCWTǔZscLdHjkj	FALSE
jJèùbdMkIiwhxOkkpòVczUfXotcXnǔEVUdyugxxǎEěc	FALSE
mCIQaWrwAAbLaǔzǎYGoTJLOUSěkhjsàSBnoSNNDHǎuM	FALSE
páGcúrǎPbZRcHǎvzjGtVGúòffsnmplwIecuNǎUábjSY	FALSE
roiHbPIxgmqóJcYPàZNpHDèǔywhdXQxúàldAQKWNFqN	FALSE
uIégWVyvcúKmRAvyCTlIlqPóiGjǎPiqncbvVcdvmwOS	FALSE
xáaWfTǎSSqsmNfòMNMQilGrBjEyàcbJhcKgúqóàflyk	FALSE
ùùmZgùabaiYùěVěLrbkEmàMlZCóFógǒeFdLZǔTJqaxZ	TRUE
áPǒKpObGATaǎúLóZXqcvóZbnWxbcaFúZgyZUAèjěoéK	TRUE
éǒdzúzsfKauxRgHGeáRBSXbayRXjèúHMTwnrěIbDQdǔD	TRUE
óǔLXrEatzDWèxtBMéUèǔrqKtIbGHpaóDiTtnLásAxbaz	TRUE
ǒceǎQczèdùXscecéǒhsmbBjgùVShaGTQLbIjsǎJMKQqd	TRUE
BapxecOENbmàaǒEtQBGǒúwKHQyXqRGQǒfHǔqbòǒátQg	TRUE
EBoVòEaCFDmpObJJèfǎkYúuzǎMdHLpAPDoyOmabáfàZ	TRUE
GXcMXdTèRcESppqúAGyGYNgcnèdlqyélěVfLUfALSBU	TRUE
JMúgéSIóxVchIKèhǔyldtcWòNuExcZwWèàrXZúBhdWH	TRUE
LatvmTbóNNVóLveqEyWèSUzkXèCKmJmuaUDgqòóbERuè	TRUE
OùWGHěigDUǔazeǒúddǒXybcjYVgiYapUhògádsqbzCg	TRUE
QKuWxáBkRCnOLlòwaBybèbaUwiàfcElóoecOXAlúRèb	TRUE
TǔHaǔPKizúUbQSolcGètcàóVcxkDZqqWěCvóEliajbj	TRUE
VvZIWQǔUfAèrTóǎuòàbSFwqmaBaqnUbShqyteùùapbC	TRUE
YYRbeMIRcǔFGwUPMYsópIYYUCVbòYvǒcYMóvIDjampI	TRUE
ahiSlcěXǎbHǒgLSdqhMUkXcFhjǔmTCbMOrdjTrǔCèxD	TRUE
céèRXǒQdbsksLTèYpMBpjfùJsdSǒcKodǒǔVCyúFjKZeR	TRUE
diakhvmdAHfWlYoqoObzKóPcèaKKkúJAócbHǎMBfzth	TRUE
gjUYSnuaDEcPbICPHcǔHtSCjVJChHibCWTǔZscLdHjkj	TRUE
jJèùbdMkIiwhxOkkpòVczbUfXotcXnǔEVUdyugxxǎEěc	TRUE
mCIQaWrwAAbLaǔzǎYGoTJLOUSěkhjsbSBnoSNNDHǎuM	TRUE
páGcúrǎPbZRcHǎvzjGtVGúòffsnmplwIebcuNǎUábjSY	TRUE
roiHbPIxgmqóJcYPàZNpHDèǔywhdXcxúàldAQKWNFqN	TRUE
uIégWVyvcúKmRAvyCTlIlqPóiGjbǎPiqncbvVcdvmwOS	TRUE
xáaWfTǎSSqsbNfòMNMQilGrBjEyàcbJhcKgúqóàflyk	TRUE
ùùIàEOzbùǎQmóBxkdtnkEqbxLDWbOOǔúǔYQǔvàcáODcz	FALSE
ámǎrkèxùakpWúyDgXHèàbdCmMEGrDqAcQoèǒDDZGdcúz	FALSE
éKftFòúeèhvapǒWisKnYWèOIAXfcǔómUPaǔVEbXǎKòùK	FALSE
óSaFtFctPcGirlóqATěěGxkLSACqaàcfyxVxkQxbxNaà	FALSE
úòKHAKzPúgDKyTwTifaSèzmbeRBXJMoUlkbcmòRZcYùm	FALSE
BowGJaccFàVùǒcVYTěhlNXeGnMǔUccuěVjàqdGSJBLQè	FALSE
EmqfFòNBcQXrǔMrHvgjRèòyNkPlěWbjabcwbyáiugnZH	FALSE
HaběwqkMveBJóJdxuboFInàBwlbqtǔáùMtUoǒAǔEMvǎn	FALSE
JjbHscYHnOQQjdHBuBwǎNbǎrLUiǒǒNBDzLxqTUyàiBZò	FALSE
MoùOěZǒTùàiCúYǎsvQgdSacBVègMsdYJNCJPWCTQtěCǎ	FALSE
PaòjYNLcRtAúuiUMDEMédlgKǎfbvGáùùǒnJTQoGdùèòV	FALSE
SSNèMaxDwxGWànwXVYsbúeoékXóǔòajKúrXEvsNgkěcu	FALSE
UtfùvúWuǒaiaAEóbóoXRcvùGSsiSèasòkszdóoxegaěW	FALSE
XsWPaigiMzRoéiydDRZLehóùoQryvVúTYǔYááaNcdPsǒ	FALSE
aǔpZFXKzUKUeyáVvèEèlUbduauDrùgoeeLnszàǒPěwpU	FALSE
bóYCdaùQGQEbMAbgáèéSǎQKhHgLVeZxSFuoUUrXcWsKF	FALSE
cQàGRǔtduySyzsGuGZvotxháǔǔvMVèegèIBjEdIǒpùrr	FALSE
eJòèSeSbáòxpWCaùIoJeUdLNJpPchéraYAdǎURúbFMCǔ	FALSE
gjPOǔTCchhUěxKǎěLylTLěCqúfxkwèJéMcóědmǒěJRKG	FALSE
jbOóaxěRcOtPNyiBóbòJvgPFQjgbdDǔVrAmKǔlktXqso	FALSE
mLIWKUHvSiiRBegmbzMLhxYǒxecFHǔúGwǎaSbTěhJuòK	FALSE
pǎENalsBèrbdudiùánlisrjKdHKùylwWJǎhOóúDbéYHK	FALSE
rSjOtiáNXoUǔkMwcádǒIBuǔamwjFéodIgQeCJnaUTAfǒ	FALSE
urYHbéncEVIooVxpojHòJnMéLDùZzwVlIhjcděyAéIgR	FALSE
xKtucUZpUòfàSpHSGciDMreWàszxǔrCǒmCMàgúDdCmNù	FALSE
ùùIàEOzbùǎQmóBxkdtckEqbxLDWbOOǔúǔYQǔvàcáODcz	TRUE
ámǎrkèxùakpWúyDgXHèàcdCmMEGrDqAcQoèǒDDZGdcúz	TRUE
éKftFòúeèhvapǒWisKnYWèOIAXfcǔómbUPaǔVEbXǎKòùK	TRUE
óSaFtFctPcGirlóqATěěbxkLSACqaàcfyxVxkQxbxNaà	TRUE
úòKHAKzPúgDKyTwTifaSèzmbeRBXJMoUlkbcmbRZcYùm	TRUE
BowGJaccFàVùǒcVYTěhlNXeGnMǔdccuěVjàqdGSJBLQè	TRUE
EmqfFòNacQXrǔMrHvgjRèòyNkPlěWbjabcwbyáiugnZH	TRUE
HaběwqkMveBJóJdxuaoFInàBwlbqtǔáùMtUoǒAǔEMvǎn	TRUE
JjbHscYHnOQQjdHBuBwǎNbǎrLUiǒǒNcBDzLxqTUyàiBZò	TRUE
MoùOěZǒTùàicCúYǎsvQgdSacBVègMsdYJNCJPWCTQtěCǎ	TRUE
PaòjYNLcRtAúuiUMDEMédlgKǎfbvGácùùǒnJTQoGdùèòV	TRUE
SSNèMaxDwxGWànwXVYsbúeoékXóǔòajKúrbXEvsNgkěcu	TRUE
UtfùvúWuǒaiaAEóbóoXRcvùGSsiSèasòkbzdóoxegaěW	TRUE
XsWPaigiMzRociydDRZLehóùoQryvVúTYǔYááaNcdPsǒ	TRUE
aǔpZFXKzUKUeyáVvèEèlUbduauDrùgoeeLnszàbǒPěwpU	TRUE
bóYCdaùQGQEbcAbgáèéSǎQKhHgLVeZxSFuoUUrXcWsKF	TRUE
cQàGRǔtduySczsGuGZvotxháǔǔvMVèegèIBjEdIǒpùrr	TRUE
eJòèSeSbáòxpWCcùIoJeUdLNJpPchéraYAdǎURúbFMCǔ	TRUE
gjPOǔTCchhUěxKǎěLylTLěCqúfxkwèJéMdcóědmǒěJRKG	TRUE
jbOóaxěRcOtPNyiBóbòJvgPFQjgbcdDǔVrAmKǔlktXqso	TRUE
mLIWKUHvSiiRBeambzMLhxYǒxecFHǔúGwǎaSbTěhJuòK	TRUE
pǎENalsBèrbdudiùánlisrjKdHKùylaWJǎhOóúDbéYHK	TRUE
rSjOtiáNXoUǔkMwcádǒcIBuǔamwjFéodIgQeCJnaUTAfǒ	TRUE
urYHbéncEVIooVxpojHòJnMébLDùZzwVlIhjcděyAéIgR	TRUE
xKtucUZpdUòfàSpHSGciDMreWàszxǔrCǒmCMàgúDdCmNù	TRUE
ùùèsxmFlBCGYhètyurWǔpfIacKxVtwLGnbèayXSiGRBle	FALSE
áeeyMUWǎwfMwjdUǎVfèsNLwINquZóàzAmcǔfdVvmQòàěk	FALSE
éaáǒkEúQOiXfloáwdAxGóěCughbhqeauLEǒndaàtfEWNM	FALSE
ětRhDtYCiRsěWBúciàxksedjmUPGáWLMbOadQQbWoJdIT	FALSE
ǒbYYèǎFOKxdmIěáwcqWlbèǒWhGǎpdmYBvxJzXrdSbrOrJ	FALSE
BUxFcHrkCgrXEwǒěHvbZéThDùuhéóYJòHǒáOCcDdTòoDS	FALSE
EáoóiFuuPbéúùóeBCLplcsioěvIBdhLbéyǎrDybsàkIàp	FALSE
GbélSyBèjbPanZYóYggmnúArLyFTNèmJǒEbCZacOXxVZz	FALSE
JóbIAácúáǔnàBácnsèqICyTgkǒoMzHOSrTCFxJòYǔjRTs	FALSE
MRótòqIpsXsGHXKuYdbyǎuSRǒmúSuùhVPGZtùVuNFObLc	FALSE
OsmecEkféEfàěéimòoXéNcIyXTixópQàYRjDJǒěCLubKc	FALSE
RpEmězàUkóLhlztiHcbeBzuIcIjCǎoFoEoUmYBVTHjúǒc	FALSE
VéFeeàúywXykKeétwKRdáuDlcyòXNyMǔǒcyldQéAjIuxv	FALSE
XkwBZrqHwZèàlIjòvzGévésRKoHCJòDYGFfècTrybScAy	FALSE
aIǎkěPbócKODòVICèhJMòEfjèOáfmǔnZDdéúxVǔtEbUPt	FALSE
bcxQHVPvMFJéǔCǒěǎaRmokNiòGcmábǎzyivoRCKzlYqtv	FALSE
cjicrDbONǎvěǔDzTFJJMstǎvDXXZpbyUtOàDècsyJRwzu	FALSE
fùTvpFzǎeuJeuèOazóKFICqTTraéZqvěeXqmbǔWyèeRYS	FALSE
hjsuFBbmcběPKǔéhTtǎòTvOLáknzPvbUóJLáóOuwGvqFg	FALSE
keQpelǎOMgjbzVixNFèmsNOlòIjpZFIàyFYǒabcmhfǔfò	FALSE
nEXpzOeCbjwòádWQTFnoSEuújěZrúIzóùùfFbobcESlLá	FALSE
pawtrGvoFdJǔcWZétTXJLxxIrHFàENUFEYhNqcàéyéILd	FALSE
sUrDqbpbTǔòtjepóODzèàZYòJDǒxEutcaFOwFcGádOQmc	FALSE
ucJmMgúdKJsdbErědBeBěǒMplyáLrUqCDoésdGǔGTAuXC	FALSE
xOkNgGaACWpkddèYXCQtáMdúàJclnufFajXikMbBAAmǔǒ	FALSE
ùùèsxmFlBCGYhètyurWǔpfIacKxVtwLGnbèayXSiGRBbe	TRUE
áeeyMUWǎwfMcjdUǎVfèsNLwINquZóàzAmcǔfdVvmQòàěk	TRUE
éaáǒkEúQOiXfloáwdAxGóěCughbhqeauLEǒnbaàtfEWNM	TRUE
ětRhDtYCiRsěWBúciàxksedjmUcPGáWLMbOadQQbWoJdIT	TRUE
ǒbcYYèǎFOKxdmIěáwcqWlbèǒWhGǎpdmYBvxJzXrdSbrOrJ	TRUE
BUxFcHrkCgrXEwǒěHvbZéThDùuhéóYJòdHǒáOCcDdTòoDS	TRUE
EáoóiFuuPbéúùóeBCLplcsioěvIBdhLbéycǎrDybsàkIàp	TRUE
GbélSyBèjbPacnZYóYggmnúArLyFTNèmJǒEbCZacOXxVZz	TRUE
JóbIAácúáǔnàBbcnsèqICyTgkǒoMzHOSrTCFxJòYǔjRTs	TRUE
MRótòqIpsXsGHXKuYdbyǎuSRǒmúSuùhVPGZtùVcNFObLc	TRUE
OsmecEkféEfàěéibmòoXéNcIyXTixópQàYRjDJǒěCLubKc	TRUE
RpEmězàUkóLhlztiHcbeBzuIcIjCǎoFoEoUmYBVbTHjúǒc	TRUE
VéFeeàúywXykKeétwKRdáuDlcyòXdyMǔǒcyldQéAjIuxv	TRUE
XkwBZrqHwZèàlIjòvzGévésRKoHCJbDYGFfècTrybScAy	TRUE
aIǎkěPbócaKODòVICèhJMòEfjèOáfmǔnZDdéúxVǔtEbUPt	TRUE
bcbQHVPvMFJéǔCǒěǎaRmokNiòGcmábǎzyivoRCKzlYqtv	TRUE
cjicrDbOcNǎvěǔDzTFJJMstǎvDXXZpbyUtOàDècsyJRwzu	TRUE
fùTvpFzǎeuJeuèOazóbFICqTTraéZqvěeXqmbǔWyèeRYS	TRUE
hjsuFBbmcběPKǔéhTtǎòTcvOLáknzPvbUóJLáóOuwGvqFg	TRUE
keQpelǎOMgjbzVixNFèmscNOlòIjpZFIàyFYǒabcmhfǔfò	TRUE
nEXpzOeCbjwcòádWQTFnoSEuújěZrúIzóùùfFbobcESlLá	TRUE
pawcrGvoFdJǔcWZétTXJLxxIrHFàENUFEYhNqcàéyéILd	TRUE
sUrDqbpbTǔòtjepóODzèàZYòJDǒxEutcaFOwFcGádbQmc	TRUE
ucJmMgúdKJsdbErědBeBěǒMplyáLrUqCcoésdGǔGTAuXC	TRUE
xOkNgGaACWpkddèYXbCQtáMdúàJclnufFajXikMbBAAmǔǒ	TRUE
ùáCVwjóNipéGdKgjójbqglCéyěyDXFbúoztKaEiAFyDcSj	FALSE
áweXKzlOuaxENndqzWàPOjRfqHUcJGbErGNúDétvqcMLCv	FALSE
éQpùphGǎzIOCGAaóǔraèyKàMoèsBwGOWOqvlǎoGxabFKúa	FALSE
óǒúESfǔqNtùovAdUcvǒdeDGPǔèswtǒeQmKKEúajcEmMókò	FALSE
ǒuiDùFOVòǔhvócRdòOvàRgbǎoBàsUHǒuècveiǒNAéVàóPL	FALSE
BdXxfóGdyMsWJEéóMSGCtCfhckbKSTehCuqOmTbpdómgkI	FALSE
EúRpvqǒcursqéièpàǔnvIBfGgrzoědTUysWòqayIAJdHcB	FALSE
HèdaPLlóěhDgBǒVùauǎǔCncóKéUdzAwbhàoóBwsBXèětIW	FALSE
KěoXNyràHWòKgsiFǔjUPyáNyFǎPCJTYzxaǒoTadbhmváGC	FALSE
MgUsǎǒCZúxbaUwcPQárTaYěWyjCWnáàǎNjInbYXmǔǔPojá	FALSE
PáYbjWOFmFeéLJYKácJgmnkVcFPméxǒGuGzEaYeiCrLolk	FALSE
ROSZúxdRěpiTòphwJàPlltXóóMgnNǒǔhrcǎùfèrbfljscè	FALSE
ThgyjUzchTybùǒBcLrǎZǒtAEGidANudNètqMYbǒEQSùsvC	FALSE
WKjyWcEMGqcPICQZàxPZiYòúthTdZbqoRzdzCdzTcQFáCL	FALSE
YqàMdácěAGVěheBpLcdhVgUscǎwBpwrFrBPGòúyèKfNslt	FALSE
ayzbtkExSùěvGWbělèoqpNkMVZLěyxjwmWcymVFgqaùàNǔ	FALSE
cTDfúúisxhtǎUjáukoyZZlWKgkOerwWKóVcěbytóCOǎdùs	FALSE
ebDǔèwcxeǔynSRyGEnBùDROCcaYMeYnxǎLaHUNUpvuJRlN	FALSE
hDtmLOQccfCuGQěqXfVpGMkhmlgnAěrfǒSnncbrmcèmǒrk	FALSE
jiLtKúFFcTqOKYhBhVjFòXNFRbYZxUaaǎvObáryDwljnFh	FALSE
mUCúbKǔSógUFvúcMiéBIDdéúèMoùnOytgDvoiCxAEuPVKc	FALSE
pLaJcUǎDAVkvtSlBàwGHzduVóxùABráúafVbKaIfAdLnǒK	FALSE
sèòěWXZvbulvIaPúHúFúbCMbUiTHsěVvlùéàxXóèVGPgnW	FALSE
ubúcuoWNqnfèBsPǒhéxěěPǒULZRǔntKOcááǔóFtSHúajhF	FALSE
xèvCvPSIFkHQCjmcdTǒJJKmóěòdPyibóURúxóGPecyWbvé	FALSE
ùáCVwjóNipéGdKgjójbqglCéyěyDXcbúoztKaEiAFyDcSj	TRUE
áweXKblOuaxENndqzWàPOjRfqHUcJGbErGNúDétvqcMLCv	TRUE
éQpùphGǎzIOCGAaóǔraèyKàMoèsBwGOWOqvlǎbGxabFKúa	TRUE
óǒúESfǔqNtùovAdUcvǒdeDGPǔèswtǒeQmKKEúajcEmMdkò	TRUE
ǒuiDùFbOVòǔhvócRdòOvàRgbǎoBàsUHǒuècveiǒNAéVàóPL	TRUE
BdXcxfóGdyMsWJEéóMSGCtCfhckbKSTehCuqOmTbpdómgkI	TRUE
EúRpvqǒcursqéièpàǔnvIBfGgrzoědTUyscòqayIAJdHcB	TRUE
HèdaPLlóěhDgBǒVbùauǎǔCncóKéUdzAwbhàoóBwsBXèětIW	TRUE
KěoXNyràHWòKgsiFǔjUPyáNyFǎPCJTYzxaǒboTadbhmváGC	TRUE
MgUsǎǒCZúabaUwcPQárTaYěWyjCWnáàǎNjInbYXmǔǔPojá	TRUE
PáYbjWOFmFeéLJYKácJgbnkVcFPméxǒGuGzEaYeiCrLolk	TRUE
ROSZúxdRěpiTòphwJàPlltXóóMbgnNǒǔhrcǎùfèrbfljscè	TRUE
ThgyjUzchdybùǒBcLrǎZǒtAEGidANudNètqMYbǒEQSùsvC	TRUE
WKjyWcEMGqcPICQZàxPZiYòúthTdZbqoRzdzCcdzTcQFáCL	TRUE
YqàMdácědGVěheBpLcdhVgUscǎwBpwrFrBPGòúyèKfNslt	TRUE
ayzbtakExSùěvGWbělèoqpNkMVZLěyxjwmWcymVFgqaùàNǔ	TRUE
cTDfúúisxhtǎUjáukoyZZlWKgkOerdWKóVcěbytóCOǎdùs	TRUE
ebDǔèwcxeǔynSRyGEnBùDRObCcaYMeYnxǎLaHUNUpvuJRlN	TRUE
bhDtmLOQccfCuGQěqXfVpGMkhmlgnAěrfǒSnncbrmcèmǒrk	TRUE
jiLtKúFFcTqOKYhBhVjFòXNFabYZxUaaǎvObáryDwljnFh	TRUE
mUCúbKǔSógUFvúcMiéBIDdéúbèMoùnOytgDvoiCxAEuPVKc	TRUE
pLaJcUǎDAVkvtSlBàwGHbduVóxùABráúafVbKaIfAdLnǒK	TRUE
saòěWXZvbulvIaPúHúFúbCMbUiTHsěVvlùéàxXóèVGPgnW	TRUE
ubúcbuoWNqnfèBsPǒhéxěěPǒULZRǔntKOcááǔóFtSHúajhF	TRUE
xèvCvPSIFkHQCjmcdTǒJJKmóěòdPyibóURúxóGPecyWbdvé	TRUE
ùùbsKwsàágyénpàévSHénaWRbàBkluqurnJèǎYBCBJpWmHG	FALSE
áRRbYěùccTqbmSOPRllJmxóéiòoúTVhzTòFIRéAùHèGnègH	FALSE
éJOTráxFxMàboMjxéZùěhHCHěBIxáJolZéěIGatbsmyhaRD	FALSE
ěsXEJéAccVDGrǎjéǔXázyǎWmfmdTerbbDvǒOCòòòZěúdgIM	FALSE
ǒZQKbcbiyFgéZěeièHisHDǎAWgAAnoǔvbIóùKgnZòftYvfq	FALSE
BayoBEǎyEFKǒsFhJòDbDaéNNYIhdmECDWxzAóVOcàqaOqES	FALSE
DxIwcGélǎàěUHivTuluHmYSěùZpdèYceiHaóbvvóTUétEcg	FALSE
GxEùQkzwàzEuéfGQOwyupVxlHfuKjxaějyTvwzNvkěǎóayb	FALSE
JoYaKkótTGùbǔgěNzBzbZtoúóctLGTNFzqLvFXóifOóbfkJ	FALSE
MKcACóféCZjcfǎGhlUvuějzBRnVYkbDakǎomhWlǒejHǔiáb	FALSE
PòùPCOěIéaFáùwLrjHJbnáESArAlfvUFSnaAOPTeóNnuónY	FALSE
SǒFaEèVJXǒgHNpOhfxCXRsNfkXáaLàmQUáòTbHxǒtmZXtnC	FALSE
UYmOzFWqeHécIbǎéKěRóúpǒtóchàúuFlrIRoYphàQIEUǎGU	FALSE
XǎfDlbǔacMDóéówHóslěmEǔNèpěJlhQvchònVctkqOVYBáz	FALSE
ZfOPQkǔiMnCcPǒwbyJlGmàwóEdqohqlakenjIkBbdWUQIBf	FALSE
bNáIdOUncrbExpvARxJztaTXùGoNyRXmTYTUpqRxzáEAgPx	FALSE
cRecOICblǔaóóEtIRxoUueTǒǒmbuyǒPjjibàYIsiǒHaTéòE	FALSE
eXekcóuSaětmGcgSdasenZyxiTgIaàJMěQbOVěsoòZZEémn	FALSE
gurJèbnǎSTXAbàdYSwèiVDwtUXHkwnbOhmZPcIXuQqjCòuZ	FALSE
jTxáSQPDFSnBbERNexQòdcZJYYǎSgloQjlBáǎtEzMTǎénnd	FALSE
mCǔabtJfOUfxYǎLcCNErfPněRPjmfèeSióPúHHáHteVbJBò	FALSE
owRIǔTaZùqDdHhctQrndkoǒTXeswoKaěèóRkTBBQGkdNjYZ	FALSE
rpPmWaàúIoyhbóxGFoEéěCBBJǔbSnfyǒoJùlJEoHuǔsUPcǔ	FALSE
uVFózUXqǔupDNóHFóPqAeEGbérayZTdKabuPAtCòdàpWyob	FALSE
xQRmSQaévsCáéKUàstátRáOLzXGtòZzIǒFXQQaTùTyǎMórb	FALSE
aùùbsKwsàágyénpàévSHénaWRbàBkluqurnJèǎYBCBJpWmHG	TRUE
áRRbYěùccTqbmSOPRllJmxóéiòocúTVhzTòFIRéAùHèGnègH	TRUE
éJOTráxFxMàaboMjxéZùěhHCHěBIxáJolZéěIGatbsmyhaRD	TRUE
ěsXEJéAccVDGrǎjéǔXázyǎWmfmdTerbbDvcOCòòòZěúdgIM	TRUE
ǒZQKbcbiyFgéZěeièHisHDǎAWgAAnoǔvbcIóùKgnZòftYvfq	TRUE
BayoBEǎyEFKǒsFhJòDbDaéNNYIhbdmECDWxzAóVOcàqaOqES	TRUE
DxIwcGélǎàěUHivTuluHmYSěùZpdèbceiHaóbvvóTUétEcg	TRUE
GxEùQkzwàzEuéfGQOwyupVxlHfuKjxaějyTvwzbvkěǎóayb	TRUE
JoYaKkótTGùbǔgěNzBzbZatoúóctLGTNFzqLvFXóifOóbfkJ	TRUE
MaKcACóféCZjcfǎGhlUvuějzBRnVYkbDakǎomhWlǒejHǔiáb	TRUE
PòùPCOěIéaFáùwLrjHJbnáESArAlfvUFSnabOPTeóNnuónY	TRUE
SǒFaEèVJXǒbgHNpOhfxCXRsNfkXáaLàmQUáòTbHxǒtmZXtnC	TRUE
UYmOzbWqeHécIbǎéKěRóúpǒtóchàúuFlrIRoYphàQIEUǎGU	TRUE
XǎfDlbǔacMDóéówHóslěmEǔNèpěJlhQbvchònVctkqOVYBáz	TRUE
ZfOPQkǔiMnCcPǒwbyJlGmàwóEdqohqlakenjIkBbcdWUQIBf	TRUE
bNáIdOUncrbExpvcARxJztaTXùGoNyRXmTYTUpqRxzáEAgPx	TRUE
cRecOICblǔaóóEtIRxoUueTǒǒmbayǒPjjibàYIsiǒHaTéòE	TRUE
eXekcóuSaětmGcgSbasenZyxiTgIaàJMěQbOVěsoòZZEémn	TRUE
gurJèbnǎSTXAbàdYSwèiVDwcUXHkwnbOhmZPcIXuQqjCòuZ	TRUE
jTxáSQPDFSnBbERNecxQòdcZJYYǎSgloQjlBáǎtEzMTǎénnd	TRUE
mCǔabtafOUfxYǎLcCNErfPněRPjmfèeSióPúHHáHteVbJBò	TRUE
owRIǔTaZùqcdHhctQrndkoǒTXeswoKaěèóRkTBBQGkdNjYZ	TRUE
rpPmWaàúIoyhbcxGFoEéěCBBJǔbSnfyǒoJùlJEoHuǔsUPcǔ	TRUE
uVFózUXqǔupDNaHFóPqAeEGbérayZTdKabuPAtCòdàpWyob	TRUE
xQRmSQaévsCáéKUàstátRáOLzXbtòZzIǒFXQQaTùTyǎMórb	TRUE
ùàǒzYzóhzěJmUbwRéQcòèlDàfǒlOGácdǔnQtǔúóTèTnWsPèù	FALSE
áqnàBawzRINNvBPdTeAccmèXoàmáZVLubògjdLwdXVwzuPNI	FALSE
énXZQùEòpùáYXIXVáééyMdmGvJeFMgUǎcZdwGòhbǒbyWěLxQ	FALSE
ócsMǒIjCHPQǎGFoXedrRyjèXAiEQdósGFVěxReǒqoszNZolF	FALSE
úDzOXqAJcdweàdJmmjàxgTvUMBtHóúlóYCaRFoIàèclZNERc	FALSE
CAǔèiǒgvcpùoVodǒOóǒZTcsOǔBKěéKǒvváAnàKWiLǎmUPizj	FALSE
FAmiaǎvnIpKKáaòvcǔeSJumZòdMǔbmTCAUIfzLTXWXIgTAby	FALSE
HVjLFòQCdoCcrdiBTqJcěǎqhwrBǔqàXBpNàHwiVPENFNwzèT	FALSE
KǒhIgǔeǔúiFPGyǒnúxBXGkjfaHǎtbQaWTòěnqPPúùdMAFòLH	FALSE
NóRzáaópáLZFZRVFěáRKaSAásBGqtosQrǎxòèGQFcrMrlbwF	FALSE
QúǒdǒhJUquǔvXcUGGkLCvmJIaTZfǒGMèmàwèZTáOZdMèOOcN	FALSE
SpèmFúbDbiRevhbcuEǔoúqwAvPUhVěOyTJzǎgéáhwKòQLàCD	FALSE
VCajeRfZvamogPàVzLxdWFXAXqsYdóyZfcUHdKKǔqmOqGCsH	FALSE
XcálGcPIXBǒkDGpYLTwiNǒvkcpgMfCeZXQJjvvqNdálAuGld	FALSE
aǒNqJóFkVúSěòMfáyqPENbysoěrúSsmMdXǎJTDlgzgAcfpBd	FALSE
bOqúáRfcòtBJAEǎSeeWcoPKdEjeXàXZPNgZxrewǒgyěMTyaQ	FALSE
cdOoàèGǔwéRZIHHdzSnJèGJkIWkěWHVdBOHTEWQrLqXvOflC	FALSE
eséCuEeXùòGEdàJOIěWǒsWàǒVAXòTykcTQwwiHúdmZIKCRsC	FALSE
hlTXVnǎǔǔúCàZNcpéjAzǔùGCurúùǒicamckòdJbtMùoòeWbi	FALSE
kTǒWHslAfDnúpBénMiScùYoxyùàáHtdòJTwMzùóKvkSDudúG	FALSE
nBǎhToAOǒPfGiefUGcdIàKkFWhbVVLgǒWBǎáMlTXzKgcWhoj	FALSE
pjMfiNmdKaqBHozUBFamXoqcqièxòYèFlbWGWtùmèdqúedHv	FALSE
sèPYTxeFLábAjwaxǔMJcKSWéMkaùPóxùZxUCǒècùbsCoéfEd	FALSE
ukafSsNTpDZǎpEyYmtiùqKXBdǔJúJgOvbkrzbWWzCJtYECwy	FALSE
xVcZFtùFjtZLǎzpUùúdYéZeqPgúvSǔcoFJcatIoùǒEuzYFLm	FALSE
ùàǒzYzóhzěJmUbwRéQcbòèlDàfǒlOGácdǔnQtǔúóTèTnWsPèù	TRUE
áqnàBawzRINcNvBPdTeAccmèXoàmáZVLubògjdLwdXVwzuPNI	TRUE
énXZQùEòpùáYXIXVáéécyMdmGvJeFMgUǎcZdwGòhbǒbyWěLxQ	TRUE
ócsMǒIjCHPQǎGFoXedrRyjèXAcEQdósGFVěxReǒqoszNZolF	TRUE
úDzOXqAJcdweàdJmmjàxgTvUMBtHóúlóYCaRFoIàèclZNdRc	TRUE
CAǔèiǒgvcpùoVodǒOóǒZTcsOǔBKěéKǒvváAnàKWdLǎmUPizj	TRUE
FAmiaǎvnIpKKáaòvcǔeSJumZòdMǔbmTCAUIfzLTXWaIgTAby	TRUE
HVjLFòQCdoCcrdiBTqJcěǎqhwrBǔqàXBpNàHwidVPENFNwzèT	TRUE
KǒhIgǔeǔúiFPGyǒnúxBXGkjfaHǎtbQaWTòěnqPPúùbMAFòLH	TRUE
NóRzáaópáLZFZRVFbáRKaSAásBGqtosQrǎxòèGQFcrMrlbwF	TRUE
QcúǒdǒhJUquǔvXcUGGkLCvmJIaTZfǒGMèmàwèZTáOZdMèOOcN	TRUE
SpèmFúbDbicRevhbcuEǔoúqwAvPUhVěOyTJzǎgéáhwKòQLàCD	TRUE
cVCajeRfZvamogPàVzLxdWFXAXqsYdóyZfcUHdKKǔqmOqGCsH	TRUE
XcálGcPIXBǒkDGpYLTwiNǒvkcpgMfCeZXQJjvvqNdclAuGld	TRUE
aǒNqJóFkVúSěòMfcyqPENbysoěrúSsmMdXǎJTDlgzgAcfpBd	TRUE
bOqúáRfcòdBJAEǎSeeWcoPKdEjeXàXZPNgZxrewǒgyěMTyaQ	TRUE
cdOoàèGǔwéRZIHHdzSnJèGJkIWkcěWHVdBOHTEWQrLqXvOflC	TRUE
eséCuEeXùcGEdàJOIěWǒsWàǒVAXòTykcTQwwiHúdmZIKCRsC	TRUE
hlTXVnǎǔǔúCàZNcpéjAzǔùGdurúùǒicamckòdJbtMùoòeWbi	TRUE
kTǒWHslAfDnúpBénMiScùYoxyùàáHtdòJTwMzùóKvckSDudúG	TRUE
nBǎhToAOǒPfGibefUGcdIàKkFWhbVVLgǒWBǎáMlTXzKgcWhoj	TRUE
pjMfiNmdKaqBHozUBFamXoqcqièxòYèFlbWGWtùmèdqúecdHv	TRUE
sèPYTxeFLábAjwaxǔMJcKSWéMkaùPóxùZxUCǒècùbsCoéfcd	TRUE
ukafSsNTpDZǎpEyYmtiùqKXBdǔJúJgOvbkrazbWWzCJtYECwy	TRUE
xVcZFtùFjtZLǎzpUùúdYéZeqPgúvSǔcoFJcadIoùǒEuzYFLm	TRUE
ùùèéCoUrǒǒdkǒnyTBibGuáKCsEvHRtcrJUfYBxdemècéeàEBb	FALSE
áZǎHVBqbpjoraRbVMxdDnZysáàAJGKXStXàBMaMlCQlwBMHZò	FALSE
ǎsMEnxiòbòTSkùiHEcMdúJSyqéHèzPYSéBrǔUxùLdLQBsVUBo	FALSE
ětvXXOMwòWFèlYlqhqWcáyRVǔypGXbLeESXLyScLoGodaDCuú	FALSE
ǒnYótmrCVmsdcCarpěrUSrzèEZjDǒIóHRLPdháPjAFAoJrPSù	FALSE
BàǎéjoNrDopyadmskWxtyaRrOǒkuWAaVǔRǎmYégCǒlǔbYFóbz	FALSE
DLbmèCHAuàTúQUòTcJqHlPáviBQPRZvòtfbMdJzJTùzYqybRV	FALSE
FVàFtBèKjěobǔIàváuZMúicFmSqǎròpmxSOMtcBaòZsxAèxúV	FALSE
HrCmaùvFàqEópMzàSQabwLGDTqfGuuùJáVTHktFTmsjHdsúKu	FALSE
KUcWěYoeaǔTèpwEùléebRhdeFbDJQfNjeUBJLMXgǎUfdrHzvú	FALSE
NáǔxeDvQgPoDIlEWǎaDecoàSDMěócFùLédkgLKcRCACáhMfǔó	FALSE
PzUcVǒnjbǎGQSFhyqǎOJFBàdZùGěSEǒLdǔWàáJwHKèFvHpEge	FALSE
ScèsmsYluiIkHHjmFiTVdgbdáǒMrnběGùtǎCFZaEIBTáJVKdB	FALSE
VbxTFǒòmBBBǎùDcopazLésujRzSpTqeOǔccudGǒcgurQQàCPb	FALSE
XulUcPDélOXiXqècUxMsCKEǒcLTbWjogwNUtzDlKZXGFárédù	FALSE
aEHnFXubxpǒRsváIihQěǎPLXàbZCkaàaúalvKCòMTMlNhWEPK	FALSE
bjjTCàoyMàhbygkMmFvraLǔǔàwrwtmkáEkXolǔNeXQclZtBOJ	FALSE
cyiàqFyCbTaKWCMScGàCntiǎXèkFdgǎDuAruTPdQtyAcQócau	FALSE
fgafwUdOamVYciPuvVPNzdgùgaPǒǔvGQKHeNjaǔeiéYlRUayP	FALSE
inHsLaXàknèáǎbǒmLeHXfyvBycwMvèZzFZDSJkolVQHawGddá	FALSE
lpDǔSéúlnpvnOSnwdFqcrAIZcyvózdóQnlòǒhRěsàylsótyIx	FALSE
obàmTèOkQcAyakéyxnUǒGAǔHiCDNééùjeXWSqPǒPYèLùEècnm	FALSE
rRdhèVyAǎbàVáDaBNSSfiSYjAdeAdPèWqèbhtrFlwoTOaèBěw	FALSE
uKIáMDRěiBǎdcESldpOxdùgKvKuóàDRLTOrmDàxOHavèóTRRH	FALSE
xúǔMcWjkRCQCYǔScDǔnOzwǒyMǒcGbpǒyYěuiXdúǎmfNrwRǎSo	FALSE
cùèéCoUrǒǒdkǒnyTBibGuáKCsEvHRtcrJUfYBxdemècéeàEBb	TRUE
áZǎHVBqbpjoraRbVMxdDnZysáàAJGKXStXàBMabMlCQlwBMHZò	TRUE
ǎsMEnxiòbòTSkùiHEcMdúJSyqéHèczPYSéBrǔUxùLdLQBsVUBo	TRUE
ětvXXOMwòWFèlYlqhqWcáyRVǔypdXbLeESXLyScLoGodaDCuú	TRUE
ǒnYótmrCVmscdcCarpěrUSrzèEZjDǒIóHRLPdháPjAFAoJrPSù	TRUE
BàǎéjoNrDopyadmskWxtyabrOǒkuWAaVǔRǎmYégCǒlǔbYFóbz	TRUE
DLbmèCHAuàTúQUòTcJqHlPáviBQPRZvòtfbMdJzJTùzYqybRVc	TRUE
FVàFtBèKjěobǔIàváuZMúicFmSqǎròpmbxSOMtcBaòZsxAèxúV	TRUE
HrCmaùvbFàqEópMzàSQabwLGDTqfGuuùJáVTHktFTmsjHdsúKu	TRUE
KUcWěYoeaǔTèpwEùléebRhdeFbDJQfcjeUBJLMXgǎUfdrHzvú	TRUE
NáǔxeDvQgPoDIlEWǎaDecoàSDMěócFùLédkgLKcRCACádhMfǔó	TRUE
PzUcVǒnjbǎGQSFhyqǎOJFBàdZùGěcEǒLdǔWàáJwHKèFvHpEge	TRUE
ScèsmsYluiIkHHjmFiTVdgbdáǒMrnběGùtǎCFZaEIcTáJVKdB	TRUE
VbxTFǒòmBBBǎùDcopazLésujRzSdpTqeOǔccudGǒcgurQQàCPb	TRUE
XulUcPDélOXiXqècUxMsCKEdcLTbWjogwNUtzDlKZXGFárédù	TRUE
aEHnFXubxpǒRsváIihQěǎPLaXàbZCkaàaúalvKCòMTMlNhWEPK	TRUE
bjjTCcoyMàhbygkMmFvraLǔǔàwrwtmkáEkXolǔNeXQclZtBOJ	TRUE
cyiàqFyCbTaKWCMScGàCntiǎXèkFdgǎDuAruTPdQtyAcQdcau	TRUE
fgcafwUdOamVYciPuvVPNzdgùgaPǒǔvGQKHeNjaǔeiéYlRUayP	TRUE
inHsLaXàknèáǎbǒmLeHXfyvBycwMvèZzFZDSJkolVQHawbGddá	TRUE
lpDǔSéclnpvnOSnwdFqcrAIZcyvózdóQnlòǒhRěsàylsótyIx	TRUE
obàmTèOkQcAyakéyxnUǒbGAǔHiCDNééùjeXWSqPǒPYèLùEècnm	TRUE
rRdhèVyaAǎbàVáDaBNSSfiSYjAdeAdPèWqèbhtrFlwoTOaèBěw	TRUE
cuKIáMDRěiBǎdcESldpOxdùgKvKuóàDRLTOrmDàxOHavèóTRRH	TRUE
xúǔMcWjkRCQdYǔScDǔnOzwǒyMǒcGbpǒyYěuiXdúǎmfNrwRǎSo	TRUE
ùǎónfyliònǒiUùvXGichnòóùLukhàAcapmSoWQCQqAnqTJkòàd	FALSE
áercrrCoTrtEPeMqérMwcEUùqlàamóqpùHVCáúEújxLcFfRědU	FALSE
éaBOABIlIaUáǔZòIàCbRQKHhconǔEBaHIJóidHǔjBmwJugMxèM	FALSE
óAǎvǒDèNcěiEyLǎàFOfOeycéuébùqBǒZUnWYCcYdypAcyRNPSD	FALSE
ǒoNbNUrǎcZǒcFǒkávlpRRésoùEhǎkkufCPbòjǒǔéPúordaOLNK	FALSE
BVVcxjérKqěfDèOqFfbfeAèRjdùJBvàhéóHùvssNoERRùJVdèb	FALSE
EòcǎěáamàEEWanǒdqgQbylUEIjXFBnMFSXrMhuváAydáTǎngTI	FALSE
GNQqúlùhqfIòaNylMlMòXMZgAzrWěHěbdooBawèDeoàJQeuQSN	FALSE
JùGRaLǎCcVFzHbèàǎówWEimácWzsweùLjSAbhsvhúNseGùhrZG	FALSE
LhNSWcgTQVyTcPbbénJNGǔKBUJFeǒNcwǔYndcsójIUjeuOKWòǎ	FALSE
OeftbvWhWóEyàczRIAěJEyWIOǎNcxrljTcáAdmoéPkiMuZPóVS	FALSE
RIDuútpDPpqǒBKgbFDǔǒAabaYsWFRvXǎNFEMòSpěYDúiàwVTHq	FALSE
TiLCnèúbógxyrLNFEEvvDWcTěǒwěfewbǒUHlGvaHdXaglǔàHUM	FALSE
WJOmǒAWPGbwqEóLnyvibǔdcNkQUyNmiUEóMlBxráHTEvěmèaSǒ	FALSE
ZúanTHPqVzǎdóLVbUZRDvwnwCFjxcYVIrUgáGnlùǔòiLTNgQat	FALSE
atucevùNTàLLWoěDVeOTJkkwWYàyoHàzùHYbdpSYDùvuěcAIsl	FALSE
cEgTQǎcCJòsALùqvSojzWJMúIúWLGhVdǔěěvoxebzwěsòòdFaE	FALSE
djchényàXuXàqqtrfEòòxOéEQǔqrFToKàBGFXǔWcúbǎThOWCDd	FALSE
gMòySǎaéfnǒEUúabAlkóTZúoàawéòOGǎUKYéATdùàgTKEvúUnW	FALSE
isCòeTsbpǒezǒeunrúCSklNVéòmykPàMczědáerpnLFbvTòfZG	FALSE
laáIWèàSSoěUDDacMQbMfrruOzùunMTkmRRtrGáDQjQaGTpsòr	FALSE
oHpZSXòRTǒiàHGsIHCcXIáúkKKjbstxxqǒUAKQcéEdnwDmlocx	FALSE
ròmTgrònlpLòccPhúEIERwuVGvrkpǔxsdQBepmrriBSntàúdrk	FALSE
uCcǔévmWhaúpIàéBODbráFPqCěNTělsyCAcoyècQdhZdàwòmVV	FALSE
wulclbGHpmWJBèiOFXKòěYXgXhPcàǒfòCxěMxcaVUSoàFbggza	FALSE
ùǎónfyliònǒiUùvXGichnòóùLukhàdAcapmSoWQCQqAnqTJkòàd	TRUE
áercrrCoTrtEPeMqérdwcEUùqlàamóqpùHVCáúEújxLcFfRědU	TRUE
éaBOABIlIaUáǔZòIàCbRQKHhconǔEBaHIJóidHǔjBmwJubMxèM	TRUE
óAǎvǒDèNcěiEyLǎàFOfOeycéuébùqdǒZUnWYCcYdypAcyRNPSD	TRUE
ǒoNbNUrǎcdǒcFǒkávlpRRésoùEhǎkkufCPbòjǒǔéPúordaOLNK	TRUE
BVVcxjérKqěfDèOqFfbfeAèRjdùJBvàhéóHùvsscNoERRùJVdèb	TRUE
EòcǎěáamàbEWanǒdqgQbylUEIjXFBnMFSXrMhuváAydáTǎngTI	TRUE
GNQqúlùhqfIòaNylMlMòXMZgAzrWěHěbdooBawèDeoàJQeuQSNb	TRUE
JùGRaLǎCcVFzHbèàǎówWaEimácWzsweùLjSAbhsvhúNseGùhrZG	TRUE
LhNSWcgTQVyTcPbbénJNGǔKBUJdeǒNcwǔYndcsójIUjeuOKWòǎ	TRUE
OeftbvWhWóEyàczRIAěJEyWIbOǎNcxrljTcáAdmoéPkiMuZPóVS	TRUE
RIDuútapDPpqǒBKgbFDǔǒAabaYsWFRvXǎNFEMòSpěYDúiàwVTHq	TRUE
TiLCnèúbógxyrLNFEEvvDWcTěǒwěfewbǒUHlGvaHdXaglǔàcUM	TRUE
WJOmǒAWPGbwqEóLnycvibǔdcNkQUyNmiUEóMlBxráHTEvěmèaSǒ	TRUE
ZúanTHPqVzǎdóLVbUZRDvwnwCFjxcYVIrUgáGnlùǔòiLTNgQatb	TRUE
atucevùNTàLLWoěDVeOTJkkwWYàyoHàzùHYbdpSYDùvuěcAIsd	TRUE
cEdTQǎcCJòsALùqvSojzWJMúIúWLGhVdǔěěvoxebzwěsòòdFaE	TRUE
djchényàXduXàqqtrfEòòxOéEQǔqrFToKàBGFXǔWcúbǎThOWCDd	TRUE
gMòySǎaéfnbǒEUúabAlkóTZúoàawéòOGǎUKYéATdùàgTKEvúUnW	TRUE
isCòeTsbpǒezǒeunrúCSklNVéòmykPàMczědáerpnLFbvcòfZG	TRUE
laáIWèàSSoěUDDacMQbMfrruOzùunMTkmRRtrGáDQjQaGTpbòr	TRUE
oHpZSXòbRTǒiàHGsIHCcXIáúkKKjbstxxqǒUAKQcéEdnwDmlocx	TRUE
ròmTgrònlpLòccPhúEIERwuVGvrkpǔxsdQcBepmrriBSntàúdrk	TRUE
uCcǔévmWhaúpIàéBODbrádFPqCěNTělsyCAcoyècQdhZdàwòmVV	TRUE
wulclbGHpmWJBèiOFXKòěYXgXhPcàǒfòCxěMxcaVUSoàFbcggza	TRUE
