ùáSdGQaNǔòBsYàJKxjàǎèEDóTkmhWBI	TRUE
áRDKièDǒdrCQwwáZùóKnǔEZvVkdNvqq	TRUE
éàéeóCótHdEWhvrrèpGórNhújgrúějt	TRUE
ěljKdaZPmujHàénaéENLUSGUDUCumgV	TRUE
ǒgKiczFùUOVrNúWlěúKDQbǎfúqǒTǎAb	TRUE
BLEIotikIǎdYOFsMbúágPrIjGǔgFiAo	TRUE
EòxǔxdáMgǔdǎdMáevTYlkkqǒsèǎOEJV	TRUE
GuWDéMWXózùTqQápKyèáfbvfǒLbEgIú	TRUE
JǒbáBTCwpILgcaYWWòFAèNòGTxyokTà	TRUE
LsfèfiKjclVobúnjeěàCzKJxòUmbapx	TRUE
OEuPevǎòyWurEěGěSagEòegYaWǒDqPT	TRUE
QpyKèěeCfàIudgǒCèmfDxActRShlwrà	TRUE
TúPTVóRòzbnQfBaTSZPějRXǔsǔmpàFé	TRUE
VGwiǔUòzWZPDhàGDjFéRMOrAězébfKt	TRUE
YǒhVèaOórnYgXYVJlòlHgǎěngxdWTRP	TRUE
aVTTPoStùDAVěGǎvòlyeaNtwèFFPQiq	TRUE
dǔgěLRPxyěQèEbWòMRrúqsOǎádwcújK	TRUE
fXǔcWǎaADùvHúfnMuSsVQǒàMPEèAUOR	TRUE
iSVIGaáZuGópEhBèZjDOXTBELuwXkkC	TRUE
kyBwuòuHzǔuyVDbùéxSPVPjVdkVvoeǎ	TRUE
nJcwkúǒiéQèfsFDcpgERéNFuFOflsTx	TRUE
praHIhDyDGiHcxuKhgDXNAFRwVDCóPs	TRUE
siucúAèEIhitttcoJMkFRUeéblùgTéǔ	TRUE
uzBlWbdùdaěNúwEQdrMNiúkéGGDzLUw	TRUE
xaCǎQdKXáódáùoSDàkHHJoBEfuWǔvZw	TRUE
ùáSdGQaNǔòBsYàJKxjàǎèEbóTkmhWBI	FALSE
áRDKièDǒdrCQwwáZùóKncǔEZvVkdNvqq	FALSE
écéeóCótHdEWhvrrèpGórNhújgrúějt	FALSE
ěljKdaZPmujHàénbaéENLUSGUDUCumgV	FALSE
ǒgKiczFùUOVrNúWlěúKDQbǎfdúqǒTǎAb	FALSE
BLEIotikIǎcdYOFsMbúágPrIjGǔgFiAo	FALSE
EòxcǔxdáMgǔdǎdMáevTYlkkqǒsèǎOEJV	FALSE
GuWDaéMWXózùTqQápKyèáfbvfǒLbEgIú	FALSE
JǒbáBTCwpILgcadYWWòFAèNòGTxyokTà	FALSE
LsfèfiKjclVobúnjaeěàCzKJxòUmbapx	FALSE
OEuPevǎòyWurEěGěSagEòegYaWǒDqPbT	FALSE
QpyKèěecCfàIudgǒCèmfDxActRShlwrà	FALSE
TúPaTVóRòzbnQfBaTSZPějRXǔsǔmpàFé	FALSE
aGwiǔUòzWZPDhàGDjFéRMOrAězébfKt	FALSE
YǒhVèaOórnYgXcVJlòlHgǎěngxdWTRP	FALSE
aVTTbPoStùDAVěGǎvòlyeaNtwèFFPQiq	FALSE
dǔgěLRcPxyěQèEbWòMRrúqsOǎádwcújK	FALSE
fXǔcWǎaAdùvHúfnMuSsVQǒàMPEèAUOR	FALSE
iSVIGaáZuGópEhBèbjDOXTBELuwXkkC	FALSE
kycwuòuHzǔuyVDbùéxSPVPjVdkVvoeǎ	FALSE
nJcwkúǒiéQèfsFDcpgERéNFuFOfdsTx	FALSE
praHIhDyDGiHcxuKbhgDXNAFRwVDCóPs	FALSE
siucúAèEIhidtttcoJMkFRUeéblùgTéǔ	FALSE
uzBlWbdùdaěNúwEQdrMNiúbéGGDzLUw	FALSE
xaCǎQdKXáódáùoSDàkbHHJoBEfuWǔvZw	FALSE
ùályKlvǎòRFGǎhwwǎMèhZdDIǒBBùlǔèn	TRUE
áǒLǎNXeLLgxlUqWLjrpfbBédLQvJYèèN	TRUE
ǎpHTGlFUěvSWOwběěǒGsǎdǒULOVuzbúu	TRUE
ěBcaLǒqKODnJAJòevzqěMWUTXHRjòivW	TRUE
òydjLsatòErkoOjPáEánùrUZúthQxàmǔ	TRUE
ALóùaéqOygǒvòvnYQkNaVlxoòtmQHBhV	TRUE
CpǒùèKzkQrLYJaReuOdHmàCúCAoòCUrP	TRUE
FǎyOVǎAFsgMéeaàqsiJOIXXSjgxlmrKh	TRUE
HiòáFusAOmFfLvéWSYùúVhxTngHXcmHj	TRUE
KBùBgROěqyúTcoLPǒàǒCàiěOǒúCèJWDò	TRUE
McofYXzWPAúCgǒóBniKTWèUDùKICySoN	TRUE
PàPuKKMInúbFQRpdéúehdBaFleóOǎàin	TRUE
RosOZLdkóeláǔbújYRizKQCěIúVRZùYi	TRUE
UgyoǒtJbErJABQMbkkNtúWOnwgCExaxU	TRUE
XIéèzTèLwǔMKyjOGzEZgǔòHǒzàAWóUQd	TRUE
aéáLeEútaaòTùnEoesHaWtVùVPzPǔjHl	TRUE
céYLPǎepDYScjúiTiáRcěóVAjEHwóéSY	TRUE
eúòFùǎVfxRǔxnǎiSXTRdnLVvXjNUjckX	TRUE
guGùOKSMcewlWKSóPǔòRbnEnRMwOirWè	TRUE
jmJyhùNdrèoómhJqCnǔeLhúZèbqxmZqX	TRUE
lroFIZaCFǎSKúvyhěsfjLeelXUnXézùX	TRUE
ocǒèXVěvácrǔNǒybèDòtǒmpLkúTáOSéV	TRUE
rREkoǔIuěèǎsǎbTBvúcèáEAótqgopmòp	TRUE
uMǔáóAuGTfEpJaǒaoSWúcàFórRRDnoeá	TRUE
xdógQéXǔóbSǒTVBKNGénGEǒbPKJWnqdh	TRUE
ùályKlvǎòRFGǎhwwǎMècZdDIǒBBùlǔèn	FALSE
áǒLǎNXeLLagxlUqWLjrpfbBédLQvJYèèN	FALSE
ǎpHcTGlFUěvSWOwběěǒGsǎdǒULOVuzbúu	FALSE
ěBcaLǒqKODnJbJòevzqěMWUTXHRjòivW	FALSE
òydjLsatòErkboOjPáEánùrUZúthQxàmǔ	FALSE
ALóùaéqOygǒvòvnYQkNaVlxboòtmQHBhV	FALSE
CpǒùèKzkQrLYJaReuOdHmàCúCAbòCUrP	FALSE
FǎyOVǎAFsgMéeaàqsiJOIXXSjgxlmrbh	FALSE
HiòáFusAOmFfLvéWSYùúVhxTngHXcdmHj	FALSE
KBùBgROěqyúTcoLPǒàǒCàiděOǒúCèJWDò	FALSE
McofYXzWPAúCgǒóBniKTWdUDùKICySoN	FALSE
PàPuKKMInúcFQRpdéúehdBaFleóOǎàin	FALSE
RosOZcdkóeláǔbújYRizKQCěIúVRZùYi	FALSE
UagyoǒtJbErJABQMbkkNtúWOnwgCExaxU	FALSE
XIéèzTèLwǔMKyjOGzEZgcǔòHǒzàAWóUQd	FALSE
aéáLeEútaaòTùbnEoesHaWtVùVPzPǔjHl	FALSE
céYdPǎepDYScjúiTiáRcěóVAjEHwóéSY	FALSE
eúòFùǎVfxRǔxnǎiSXTcdnLVvXjNUjckX	FALSE
guGùOKSMcewldKSóPǔòRbnEnRMwOirWè	FALSE
jmJyhùNdrèaoómhJqCnǔeLhúZèbqxmZqX	FALSE
lroFIZaCFǎSKúvyhěsfjLeelbXUnXézùX	FALSE
ocǒèXVěvácrǔNǒybèDòtdmpLkúTáOSéV	FALSE
rREkoǔIuěèǎsǎbTBvúcèáEAótqdopmòp	FALSE
uMǔáóAuGTfEpJaǒaoSWúcàFórRRDnodá	FALSE
xdógQéXǔóbaǒTVBKNGénGEǒbPKJWnqdh	FALSE
ùùNUgoǎnFiXGtAdǒQOLbwVUkwcuòjáàEU	TRUE
ǔyǎèěMTsùLMBPpYOáóéchfOoEkPzUbhgM	TRUE
ǎZCNJvcVexOLvLOpNKFáJbIMhQeFmrIcF	TRUE
ěàEOJXRóuěcNBàwǒYPjùGPuuDmǒaIyOwǔ	TRUE
òLBtgETGtuěùáǔǎcgpáyFóoKXwuNSuùYZ	TRUE
ACwhnsDuQǎvYKBoDAIxoǒFCqǒGùGáěbys	TRUE
DéúFJcúiòsRHóNZtǎrúurxRYǎWnQSyqjG	TRUE
GéEbéǎGVPZóǒlQicLYBqhXjǔhZBHnYNǒá	TRUE
IiASTTdZldaTISZVoáéNuwyLàHúsBùǔDk	TRUE
LHXnpQskGejWyMzdFKEFnGHyRNTyyPRCf	TRUE
NrPAsMeècyvFnQGóěáSXPmXBběKVFòtcJ	TRUE
QgjVěètGuèdbbsOèùjéèvPxVviùphúlXp	TRUE
TeRWvjǔfrdàQVòúYnbUrplzHugZèùJule	TRUE
WJéRVAqEzèfoFMkóáCHIHpqcOkWXxzjbC	TRUE
ZèéLjACOózoǎaUYZlJákèuèqXUwòVzveQ	TRUE
bFùǒggbyklùIdóéSizNheEhSNhUMBMáLp	TRUE
dYreòmNúwGILtHbáSiDxúvoTǒùtúdRIáG	TRUE
flOIzàQIauhjgkwǒcgèéèYHFkUJvlBZDt	TRUE
iǎQXPéRiséúcNǎyuMàkVúHmrDàXKMZòSO	TRUE
lǒRUQzRvLqndAypteXmxGKoóéBjpzeVPs	TRUE
nxQNndNkxlclfWPDzféIPryàwhtgPTóór	TRUE
qáptcElǎKMYiqBLuFyRěxeúěPSPǎRrQRm	TRUE
táPQùáyyMhWúeGxdEúbfráMXHlWNGlTaǎ	TRUE
vWPvgoSóCLIòTOAhòpFkUbaVJrMáǔǒcak	TRUE
xtPJijúVQMySTHóDJbdfEéhPhFFnwǎort	TRUE
ùùNUgaoǎnFiXGtAdǒQOLbwVUkwcuòjáàEU	FALSE
ǔyǎèěMTsùLMBPpYOáóéchfOoEkazUbhgM	FALSE
ǎZCNJvaVexOLvLOpNKFáJbIMhQeFmrIcF	FALSE
ěàEOJXRóuěcNBàwdǒYPjùGPuuDmǒaIyOwǔ	FALSE
òLBtgETGtuěùáǔǎcgdpáyFóoKXwuNSuùYZ	FALSE
ACwhnsDuQǎvYKBoDAIxoaFCqǒGùGáěbys	FALSE
DéúFJcúiòsRHóNZtǎrúdrxRYǎWnQSyqjG	FALSE
GéEbéǎGVPZóǒlQicLYBqhXjǔhZBdHnYNǒá	FALSE
IiAScTTdZldaTISZVoáéNuwyLàHúsBùǔDk	FALSE
LcXnpQskGejWyMzdFKEFnGHyRNTyyPRCf	FALSE
NrPAsMeècyvFnQGóěáSXPmdXBběKVFòtcJ	FALSE
QgjaěètGuèdbbsOèùjéèvPxVviùphúlXp	FALSE
TeRWvjǔfrdàQVòúYanbUrplzHugZèùJule	FALSE
WJéRVAqEzèfoFMkóáCHIHpqcOkaXxzjbC	FALSE
ZèéLjACOózoǎaUbYZlJákèuèqXUwòVzveQ	FALSE
bFùǒggbyclùIdóéSizNheEhSNhUMBMáLp	FALSE
cdYreòmNúwGILtHbáSiDxúvoTǒùtúdRIáG	FALSE
flOIzàQIauhjgkwǒcgèéèYHFkUJvldZDt	FALSE
iǎQXPéRiséúcNǎyuMàkVúdHmrDàXKMZòSO	FALSE
lǒRUQzcRvLqndAypteXmxGKoóéBjpzeVPs	FALSE
nxQNndNkxlclfWPDzféIPryàwhtgPdóór	FALSE
qáptcElǎKMYiqBLdFyRěxeúěPSPǎRrQRm	FALSE
táPQaùáyyMhWúeGxdEúbfráMXHlWNGlTaǎ	FALSE
vWPvgoSóCLIòTOAhòpFkUbaVJrMábǔǒcak	FALSE
xtPJijúVQMySTHóDcJbdfEéhPhFFnwǎort	FALSE
ùácZònBuAFiSKLZSOsǎDZExiaèAEWéHAFó	TRUE
áKhKpXéHICjùbMùFcààùǒlhNEònbUěFAHé	TRUE
éáèeWhbénǎsNCiàDdrTmAAòrxsmǒhhxmòY	TRUE
ěfyàThǔáǎzUcWDMYXtLBèUtCIèHyùnófzC	TRUE
ǒúǔPyběTóhzFZNLLMbGtJòèasgwěAùgWǎX	TRUE
BǒBjweFéèZVbCjyǎfGHuGPBeQàPODbyBLd	TRUE
DgèaAWhmsCoPCeHùrFdsKdòXàBcOuXKfnT	TRUE
GùWpQwUGàjFayvéélwáJqOFǔPPLfTAúmǒA	TRUE
ImǎWùómMRQAdRRéZPbmrgNKlnTwcmeemaX	TRUE
LLgwdXbTJéyàggLAyaHEtPZúùjjTěǒúmGJ	TRUE
NoFlúLSoǔGQozóǔQLdriiNXhpQgAbLOOqX	TRUE
PqDAǔxàWUVxúméQNǔěxNtbWlálǔtlUhzCd	TRUE
SRMmOWVqKwàvvQieXErsptNUQmfCydǎòèi	TRUE
VèmSTWáèmJwGnSCDBǒTúOJúlMzòlKbLGRJ	TRUE
XwJQěáNkdbxàuDYSWoěǎéXèhbGúruBèòéQ	TRUE
aKǒCóCxgkǔDfégKgWDVkTLwKèwvMěazqxi	TRUE
ciQpAǔòǎeǎzfjǔNSrUziǒRHZOTzSaTqéǒW	TRUE
fGWgdWúIùóbǎGàaáRKòmRNdoDluéóètXaú	TRUE
hmsèBRzměǒUKfWsNnDmǔMPQYòpmdAGáPcr	TRUE
kfhòhuSóYFtǒxGvǒttHNZtybNdPPHWàǎTú	TRUE
myFmHxùěLóvgòXěKtEudsxúfkèHKUWbFKR	TRUE
pCJǔjátbmxòPOZákHOktérlqOpsPjqZiEn	TRUE
rzclLàsuUǒqVRuUcDhGVxzjúvoXJJròYma	TRUE
uhBOcStgCkàtgTiěJnXpCXúOVmccImSeèY	TRUE
xJdeěwNjPèàpcNfpDXgpQéǎfěLǎEIZylòb	TRUE
ùácZònBuAFiSKLZSOsǎDZExiaèAEWéHAFbó	FALSE
áKhKpXéHICjùabMùFcààùǒlhNEònbUěFAHé	FALSE
céáèeWhbénǎsNCiàDdrTmAAòrxsmǒhhxmòY	FALSE
ěfyàThǔáǎzUcWDMYXtLBèUtCIèHdyùnófzC	FALSE
ǒúǔPyběTóhzFZaLLMbGtJòèasgwěAùgWǎX	FALSE
BǒBjweFéèZVbCjayǎfGHuGPBeQàPODbyBLd	FALSE
DgèaAWhmsCoPCbeHùrFdsKdòXàBcOuXKfnT	FALSE
GùWpQwUGàjFayvéélwáJqOFǔPPLfTAúmbA	FALSE
ImǎWùómMRQAcdRRéZPbmrgNKlnTwcmeemaX	FALSE
LLgwdXbTJéyàggLAyaHEtPZúùjjTěǒúmbGJ	FALSE
NoFlúLSoǔGQcozóǔQLdriiNXhpQgAbLOOqX	FALSE
PqDAǔxàWUVxúméQcNǔěxNtbWlálǔtlUhzCd	FALSE
SRMmOWVqKwàvvcieXErsptNUQmfCydǎòèi	FALSE
VèmSTWáèmJwGnSCDBǒTúaOJúlMzòlKbLGRJ	FALSE
XwJQěáNkdbxàuDYSWoěǎéXèahbGúruBèòéQ	FALSE
aKǒCóCxgkǔDfégKgWDbVkTLwKèwvMěazqxi	FALSE
ciQpAǔòǎeǎzfjdNSrUziǒRHZOTzSaTqéǒW	FALSE
fGWgdWúIùóbǎGàaáRKòmRNdoDluébóètXaú	FALSE
hmsèBRzměǒUKfWsNnDmǔMPQYòcpmdAGáPcr	FALSE
kahòhuSóYFtǒxGvǒttHNZtybNdPPHWàǎTú	FALSE
mycFmHxùěLóvgòXěKtEudsxúfkèHKUWbFKR	FALSE
pCJǔjáatbmxòPOZákHOktérlqOpsPjqZiEn	FALSE
rzclLàsdUǒqVRuUcDhGVxzjúvoXJJròYma	FALSE
uhBOcStgCkàtgTiěJnXpCXúOVmcdcImSeèY	FALSE
xJdeěwNjPèàpcNfpDXgpQéǎfěLaEIZylòb	FALSE
ùùObpǒJQeRózyRgvèjbKFlzóánPrnMbvZqǔ	TRUE
ájvzXoǔKěLtcxDCáǎFDòXSòtFDDaHùǒgWNC	TRUE
éQwLhǔOtkzEtgQarrDiudAKpǒGlmBàPòělk	TRUE
ěrWbéZOéùtOláěǔxbhkLNCuIǎyhǎnsUUZsà	TRUE
ǒéluuMrfVonǒùrewzqZjCěaomHUTydWúcùn	TRUE
AlJUTQǎǔNùmKòàuRóazgyFJgYdéIáUPypln	TRUE
DYnáxěbùULHbmjéVAaúRJxvúKuJAlǎHǔYDj	TRUE
GFZLWUBCQDWDtBkliRèXfxDQCuùlUqHǎsMb	TRUE
ITqdWGǔBIòTFhkǔJNMHNBdAEsASǔněònéWs	TRUE
KxDTCWKOaàWGOSNuVSARqLTcXzémVXfJYYL	TRUE
NmENCCùMjáǎǎGězaǒǔPdpIùKGSúONZúKxZú	TRUE
QfyhkUgYXytVUàkóóěptórXStwDwbKfúlwQ	TRUE
THjpEáHèAreIUgjNFǔólUùuèúsYLóěǔùdze	TRUE
VRěFǔrwbYOdútWsdRúYZóMhkyjoGFvBHtAO	TRUE
XdUJZQrEgQèiFéwNcWYòubúohtBSRiPOjMF	TRUE
aàèòAUBágNOvRxelOXUKgcièlnwFgBWOGòG	TRUE
cMEǔJyCVáěAGTèyqRDAeDuAEHKfHTspǎùND	TRUE
exeQYVixczAoRaóYsěyaaáZZrVYOPóEslTt	TRUE
hChOǔuIáGmOkxkMGǎèUZHaqáTǎDItciYùuu	TRUE
jeǒnUfzgrǔReGùXócézEóRlèCJIIHGESFZs	TRUE
mamiòpNAjòzYMdDóOxJaEzǒéEsdBuVhwCwH	TRUE
pVDmJtXèúǔOXKěsNoXgOfpaǔrAMdTaǒGFǔW	TRUE
sOJfkymCimHbghmGOzgěkaòpòàSGeěcnèQK	TRUE
ujfDRNHfbLUyFěFùiFtPvCèúcNéjOàKǎvuG	TRUE
xKOiluHOádbRYwfWzěMvéǎcuLEnTǎbǔzzwx	TRUE
ùùObpǒJQeRózyRgvèjbKFlaóánPrnMbvZqǔ	FALSE
ájvzXoǔKěLtcxDCáǎFDòXSòtFDDaHùdgWNC	FALSE
éQwLhǔOtkzEtgQarrDiucdAKpǒGlmBàPòělk	FALSE
ěrWbéZOéùtOláěaǔxbhkLNCuIǎyhǎnsUUZsà	FALSE
ǒéluuMrfVonǒùrewzqZjCěaomHUTydWúcùb	FALSE
AlJUTQǎǔNùmcòàuRóazgyFJgYdéIáUPypln	FALSE
DYnáxěbùULHbmjéVAaúRJxvbúKuJAlǎHǔYDj	FALSE
GFZLWUBCQDWDaBkliRèXfxDQCuùlUqHǎsMb	FALSE
ITqdWGǔBIòTFhkǔJNcMHNBdAEsASǔněònéWs	FALSE
KxDTCWKOaàWGOSNuVSARqLTcXzémVXfJYYb	FALSE
NmENCCùMcáǎǎGězaǒǔPdpIùKGSúONZúKxZú	FALSE
QfyhkUgYXytVUaàkóóěptórXStwDwbKfúlwQ	FALSE
THjpEáHèAreIUgjNFcólUùuèúsYLóěǔùdze	FALSE
VRěFcrwbYOdútWsdRúYZóMhkyjoGFvBHtAO	FALSE
XdUJZQrEgQèiFéwNcWYòubúohtBSRiPOdMF	FALSE
aàèòAUBágNOvRxelOXUKgbcièlnwFgBWOGòG	FALSE
cMEǔJyCdVáěAGTèyqRDAeDuAEHKfHTspǎùND	FALSE
exeQYVixczAoRdóYsěyaaáZZrVYOPóEslTt	FALSE
hChOǔuIáGmOkxkMGǎèUZHaqáTǎDItciYùubu	FALSE
jeǒnUfzgrǔReGùXócézEóRlèCJdIIHGESFZs	FALSE
mamiòpNAjbòzYMdDóOxJaEzǒéEsdBuVhwCwH	FALSE
pVDmJtXèúǔOXKěsNoXgOfpaǔrAMdTaǒGFbW	FALSE
sOJfkymCimHbghmGOzgěkaòpòàSGeěcndQK	FALSE
ujfaDRNHfbLUyFěFùiFtPvCèúcNéjOàKǎvuG	FALSE
xKOiluHOádbRYwfWzěMaéǎcuLEnTǎbǔzzwx	FALSE
ùàHrAiHGgòPHYbKóVXXjMdèKAndàQvlrGǔnp	TRUE
ákqdVekkJxGuyòcCpvyébOwIǒǒOCQǎBQHGCf	TRUE
ǎwvtKEGINLáiDDDLPvMcjtMáhalEaHEgcIzě	TRUE
ěeǎYgèCsMOadcèYWóskCOkrZàéxěxTXáaòLE	TRUE
ǒàSJPgCGANMJYBmeiǒCwVvUAeVfWEúObQCzI	TRUE
AlDOóbAéZúùqUoqifúgMòkVHmXboKnhRèWMY	TRUE
DUJAóasSZièOzaLifaFdiótAaCWFgèsitVdm	TRUE
GIFUosqfvàǒYyPYaBPǎVNaJdgHJéùcúqKáǒm	TRUE
IbIdwèLGXgJQǒoQJzxlqhOwaeZlvIevǔlpwu	TRUE
KqòěVQáSsdWMoBmXzáFBnwOKàěfZxZkBkMUd	TRUE
NlaVxùLLfqNMyrgPTnedǔRJWjqCGPǒcùJǔsv	TRUE
QbRǎCUeFTNjrjzSndLVcvQTGlJDMBWpVkelF	TRUE
SzTzyyáHDSivRqceáctqYMxnkQYBTlUémmǔB	TRUE
WǔZesàkyahvfǎfhOrRGatàCéfùǎEòWeXCKKD	TRUE
YKciKěbYuBòQzeYDObpSPlVNfǔáyzJcsiéuǔ	TRUE
amzHàHQUTqMjXǎdgevZVdrzcgAtòiepNVVNw	TRUE
dHaǔmǔvnJQSóHuòDimǎǎFYaǎkUúyVězULiEQ	TRUE
gOFyTLmYǎQvúAQdYbIJCdkHAiYxdLZunlasX	TRUE
jǔidǒěBuJNùúǒudNObúrGneKdRTOAmSPcóál	TRUE
lNoetoórǔtyJwSxccSYZWěfUfBráBDVháhCU	TRUE
nmǎeaéOZěpPàhnewNntVqXveBpójTEějkrcP	TRUE
pxqǔòuigRVMooWcHqHgYIMPTxXQGRnBaqèfI	TRUE
rrhqynTyBxháQbǔaòùkZcJùNeqoǔEoVHSùcZ	TRUE
uièJDhyjSrPqdsmrwdpLèAFfyOCaiFeAgXeò	TRUE
xGèeokGrpdyěEédfyXiwlMùSAgEXweSFoumX	TRUE
ùàHraiHGgòPHYbKóVXXjMdèKAndàQvlrGǔnp	FALSE
ákqdVekkJxGuyòcCpvyébOwdIǒǒOCQǎBQHGCf	FALSE
ǎwvtKEGINLáiDDDLPvMcjtMádhalEaHEgcIzě	FALSE
ěeǎYgèCsMOadcèYWóskCOkrZàéxěxTXbáaòLE	FALSE
ǒàSJaPgCGANMJYBmeiǒCwVvUAeVfWEúObQCzI	FALSE
AlaOóbAéZúùqUoqifúgMòkVHmXboKnhRèWMY	FALSE
DUJAóasSZièOzbaLifaFdiótAaCWFgèsitVdm	FALSE
GIFUosqfvàǒYyPYaBPǎVNaJdgHJéùcúqdKáǒm	FALSE
IbIdwèLGXgJQǒoQJzxlqhOwaeZlvIbevǔlpwu	FALSE
KqòěVQáSsdWMoBmXzáFBnwOKàěfZxZkBkMcUd	FALSE
NlaVxùLLfqNMyrgPTncdǔRJWjqCGPǒcùJǔsv	FALSE
QbRǎCUeFTNjrjzSndLVcvQTGlJDdBWpVkelF	FALSE
SzTzyyáHDSivRqceáctqYMxnkQYBTldémmǔB	FALSE
WǔZesàkyabhvfǎfhOrRGatàCéfùǎEòWeXCKKD	FALSE
YKciKěbYuBòQzeYDObpSPlVNfǔáydJcsiéuǔ	FALSE
amzHàHQUTqMjXǎdgevZcdrzcgAtòiepNVVNw	FALSE
dHaǔmǔvnJQSóHuòDimǎǎFYaǎkUúyVězULiEQb	FALSE
gOFyTLmYǎQvúAQdYbIJCdkHAiYxcdLZunlasX	FALSE
jǔidǒěBuJNùúǒudNObúrGceKdRTOAmSPcóál	FALSE
lNoetoórǔtyJwSxccSYZWěfUfBráBDVháhCUd	FALSE
nmǎeaéOZěpPàhnewNntVqXveBbpójTEějkrcP	FALSE
pxqǔòuigRVMooWcHqHgYIMPTxXQGRnBaqdèfI	FALSE
rrhqynTyBxháQbǔaòùkZcJùbNeqoǔEoVHSùcZ	FALSE
uièJDhycSrPqdsmrwdpLèAFfyOCaiFeAgXeò	FALSE
xGèeokGrpdyěEcdfyXiwlMùSAgEXweSFoumX	FALSE
ùǔMkEuěkQWAWtkjzzXOóúNYZRzVeLzàZnàaFd	TRUE
áUǎPJlWeZěwCóUmzfuèèSxěfiuKdùtcèrTNSú	TRUE
éàùwǎIùyybdySEmAxhimbAéGpwKnLDrNúXlET	TRUE
óèáYéSMòOvǔridxrOheucpDùseàǎlkbnknRPe	TRUE
ǒbwmobUmgBǒGaénqzluLvDhddqUIàPMYLUèXl	TRUE
BùětZtIuUUijlicXWgGQDětjPWYǒGNaPTgrié	TRUE
DcǔMóSfDQUkěXiCRhhlQyéuuPRézONǔRICofp	TRUE
GDZUQàHǒZàaDěKimSkvúxóDGEzěàXPdoEgèRè	TRUE
JEpùzǔJDItFdHQDkSàPxXgdZUUCǒófJxRnǎUq	TRUE
MǒèéZáEvUQáLófBqwTkgtèmeùiDǔNǔEglUbùr	TRUE
PùCXGlǎgnZHHrKamuxSzùMáYótnUóxwvgǔúDǔ	TRUE
RǒvrsúJéǒcxSǔDZfRááDúyOYsODǎLiyFQǎYFb	TRUE
TOVhWWedénCwySJrJNfpbpReTǎpWsHOéjsDwp	TRUE
WAgǒǎiWGòdǒYVKǒHOsáfuuùZǎEvǔDùanPYǔER	TRUE
YSRàtdolosùhdIZkwCcUgVFBQèYSuAòIeésYK	TRUE
artVzzMzJdǒBrFǒiofTúaǒYdTùwvmàpàycǒxL	TRUE
dòéSGcsYHexlCNsVWiAOáéěeKlrsiEowfNéfB	TRUE
fbomàěòáJBMhxáseěaúaDmKjciRkòzzhFZBàC	TRUE
iUYrCBWlqlbaQsalrNRBDHMMgòNHNqzOfFCJA	TRUE
kxpúZjUBvRrAHTMǎNTxQzòDbùkWBMǔtWojǎjl	TRUE
nmtLóWCàèěgǔsGLEeGNùPGubFbUsCólbUDnTZ	TRUE
qmHEpAaCRNàAlèjZWFaGaPytJylQYóMlěMqlN	TRUE
tǎKvǔLèǒváhóbEdtrPèfGCàNFMLIlUéǎHlMuN	TRUE
vZzùòGHJkFdIóáǒEúéúISvéxPJfHtwSRIPòRU	TRUE
xuIyUbǔùéZkxkuQBYkmflzǒzgvUamPLYgqHsM	TRUE
ùǔMkEuěkQWAWtkjzzXOóúcNYZRzVeLzàZnàaFd	FALSE
áUǎPJlWeZěwCóUmzfuèèSxěfiuKdùtcèdTNSú	FALSE
éàùwǎIùyybdaSEmAxhimbAéGpwKnLDrNúXlET	FALSE
óèácéSMòOvǔridxrOheucpDùseàǎlkbnknRPe	FALSE
ǒbwmobUmgBǒGaénczluLvDhddqUIàPMYLUèXl	FALSE
BùětZtIuUUijlicXWgGdQDětjPWYǒGNaPTgrié	FALSE
DcǔMóSfDQUkěXiCRhhlQyéuuPRézONǔRICofpd	FALSE
GDZUQàHǒZàaDěKimSkvúxóDGEzěàXPdboEgèRè	FALSE
cEpùzǔJDItFdHQDkSàPxXgdZUUCǒófJxRnǎUq	FALSE
MǒèéZáEaUQáLófBqwTkgtèmeùiDǔNǔEglUbùr	FALSE
PùCXGlǎgnZHHrKamuxSzùMáYótnUóxwvgǔbúDǔ	FALSE
RǒvrsúJéǒcxSǔDZfRááDúyOYsODǎLiyFQǎYFbd	FALSE
TOcVhWWedénCwySJrJNfpbpReTǎpWsHOéjsDwp	FALSE
WAgǒǎiWcGòdǒYVKǒHOsáfuuùZǎEvǔDùanPYǔER	FALSE
YSRàtdolosùhdIZkwCcUgVFdBQèYSuAòIeésYK	FALSE
artVzzMzJdǒBrFǒiofTbúaǒYdTùwvmàpàycǒxL	FALSE
dòéSGcsYHexlCNsVWiAOáéěeKlrsiEowfNédfB	FALSE
fbomàěòáJBMhxáseěaúaDmKjciRkbzzhFZBàC	FALSE
iUYrCBWlqlabaQsalrNRBDHMMgòNHNqzOfFCJA	FALSE
kxpúZjUBvRrAHTMǎNTxQzòDabùkWBMǔtWojǎjl	FALSE
nmtLóWCàèěgǔsGaEeGNùPGubFbUsCólbUDnTZ	FALSE
qmHEpAaCRNàAlèjZWFaGaPytJylQYóMlěMqbN	FALSE
tǎKvǔLèaǒváhóbEdtrPèfGCàNFMLIlUéǎHlMuN	FALSE
cvZzùòGHJkFdIóáǒEúéúISvéxPJfHtwSRIPòRU	FALSE
auIyUbǔùéZkxkuQBYkmflzǒzgvUamPLYgqHsM	FALSE
ùácYzwkixòEǔnjFvjbrěIwěsiBóMòZfGàWùHIn	TRUE
áVsWQACKuuàéKTáLGLZAvbBqXǒWbZNlwVUadlT	TRUE
ǎxIzeeěxámiagYdSjjáèápPsMmMZRzxugmmHók	TRUE
èuúhZLortIhcHFPpeeXLkBUACfJSréMwEúxkvo	TRUE
òoCoFHúúěpMdXfzRobYmqlnaxfAǔpMFBtéúsFǔ	TRUE
AOnǒaQACLnǔNLxPiěqVcxuáwYfCrXNzBBtatfC	TRUE
DòkUǔOMUoBjcrHjTpvòMyMǔǎèzěbiMGpEjGxtI	TRUE
FduǎéuQJákMsklDódPDWNAZgUozOhùGǒIlFyVs	TRUE
IéáǎǒèóuhnbRaTmUjàVAǎáJázLUMqYǎAFfweòL	TRUE
KmIoóaěàakDEjRhǔdcyhǎneúUǎyFitJknEáPěv	TRUE
NEtldwXuJrjUéSkSvmivIAǔóávEqNmPRMnlsWǔ	TRUE
PkUnyZúuiwǎpbLZPuoNbUgNaóvaGEBIEuSjáDó	TRUE
SQztfǎXcmLQòáhOòYPotIiLnhyuBUkCYmWgHón	TRUE
VPaAǒyèKRZwaǒsóHcjDGjBváDmuEúNMkùQěOtZ	TRUE
XpRTiQvHxǎúéRòúǔòMhCǒLHGmOaúHlrldxtùùd	TRUE
aOiCgCZOaógúecXvSéZehcfMkvǔTlSǎtDAXAPs	TRUE
cmRubeLCnDtYGsǒlTSycióvHNéěǎòUiipěroàP	TRUE
fPeoóěTòfbYMànRyXǎùǒJqBxhèóǎoeáòmVǒQBC	TRUE
hoóHzRgóENVxsDBlSJpéèTCqmóbùAJEdGhěbeX	TRUE
kSlvvǒZuEoVJòJǒKǔoaAkOèǒiòqyǒXqièèNMWG	TRUE
murzùZytVotswuRécrSKVEóMBvTbkjoUhǒMCyQ	TRUE
pdYqozǔbhàfFécǒJXZwEeWxvùǒGYbTvfWǒBaóa	TRUE
rqdSIAucrhǎNPáaRáESWǎBEUgmrpáPGorHhǒeg	TRUE
useHKzKǒjzTFfégvSZxònuVòffGGYòMWsLbǒFR	TRUE
xSXAqsPYHǔUQEMFáǎTIgěéběfIXZokREEváCmA	TRUE
aácYzwkixòEǔnjFvjbrěIwěsiBóMòZfGàWùHIn	FALSE
áVsWaACKuuàéKTáLGLZAvbBqXǒWbZNlwVUadlT	FALSE
ǎxIzeeěxámiagYcdSjjáèápPsMmMZRzxugmmHók	FALSE
èuúhZLortIhcHFPpeeXLkBUdCfJSréMwEúxkvo	FALSE
òoCoFHúúěpcMdXfzRobYmqlnaxfAǔpMFBtéúsFǔ	FALSE
AOnǒaQACLnǔNLxPiěqVcxuádwYfCrXNzBBtatfC	FALSE
DòkUǔOMUoBjcrHjTpvòMyMǔaǎèzěbiMGpEjGxtI	FALSE
FduǎéuQJckMsklDódPDWNAZgUozOhùGǒIlFyVs	FALSE
IéáǎǒèóuhnbRaTmUjbàVAǎáJázLUMqYǎAFfweòL	FALSE
KmIoóabàakDEjRhǔdcyhǎneúUǎyFitJknEáPěv	FALSE
NEctldwXuJrjUéSkSvmivIAǔóávEqNmPRMnlsWǔ	FALSE
PkUnyZúuiwǎapbLZPuoNbUgNaóvaGEBIEuSjáDó	FALSE
SQztfǎXcmLQòáhOòYPotIiLnhyuBUkCYdmWgHón	FALSE
VPaAǒyèKRZwaǒsóHcjDGjBváDmuEdNMkùQěOtZ	FALSE
XpRTiQvHxǎúéRòúǔòMhCǒLHGmOaúHbrldxtùùd	FALSE
aOiCgCZOaógúecXvSéZehcfMkvǔTlSǎtDAXbAPs	FALSE
cmRubeLCnDtYGsdǒlTSycióvHNéěǎòUiipěroàP	FALSE
aPeoóěTòfbYMànRyXǎùǒJqBxhèóǎoeáòmVǒQBC	FALSE
hoóHzRgóaENVxsDBlSJpéèTCqmóbùAJEdGhěbeX	FALSE
kSlvvǒZuEoVJòJǒKǔoaAkOèǒibòqyǒXqièèNMWG	FALSE
murzùZytVaotswuRécrSKVEóMBvTbkjoUhǒMCyQ	FALSE
pdYqozǔbhàfFécǒaJXZwEeWxvùǒGYbTvfWǒBaóa	FALSE
rqdSIAucrhǎNPáaRáESWǎBEUdgmrpáPGorHhǒeg	FALSE
useHKzKǒjzTFfégvSZxònuVòffGGYòMaWsLbǒFR	FALSE
xSXAqsPYHǔUQEMFáaTIgěéběfIXZokREEváCmA	FALSE
ùǔQwcǒcRxóǒIicùQckNWHsPMaDetviwàIéXvSAX	TRUE
áRAmeSCòùTTNàOfdóPlDHopgxRiěósgRǒgxTUUi	TRUE
ǎzCEKnzszPFnǔgxǔqúDJèáěáùfBPorWLCAIwwbk	TRUE
ěPéWLkYUgnLlfTǎBVSpwRnnùilLSlWRsòuIaúAf	TRUE
ǒSffTfǒxZgZUǎWMubvǎYàIsQDSYLLtàJfaúvWuB	TRUE
BòDJdǎmjnpMbqǎQàxRùiVGféPZytáiòòrUKqzòJ	TRUE
DoMSòàQVWarVéLZYdPCòóKòfSsAgXkUěYdsOVeú	TRUE
GkòWéOhyǎrExLgLzYYQSáudeKmaAVZùGětdHxUD	TRUE
JGRQEǔBqpsúàpTNvèceVHUóZóJèGóeèXWIbMMHy	TRUE
LOWaPMdJógpPòvOGosEwHěhěndiòNBPIGGmKKUè	TRUE
OèDUqqEPacóTZuqFǒéehmIKnFRufnqUóIùxDtáM	TRUE
QklTùǎHCossusvágTiJáevtqKfoOyiàXPGbúMóú	TRUE
TKBKPmnhGLdxPoPUNáCúáHoútWyòfùNurétǒoZX	TRUE
WéwJxZǎmfAáykRtPaOLwJǔTvlqlRNǔQxèvWfdzl	TRUE
YEcáěswètoaaryèYǎùITóXmáitXisǔHYUzqACMc	TRUE
acqéáYJěrǎLtétóIzǒoPrLótzGyOULGfDLfWhZZ	TRUE
dúEkHIǒgskDBceUiUKèhèùétSéwkrQeǒCPXǔGam	TRUE
fnZzJWCPhGXEcPXbpjQyUwXPòvGhATrOnmgmgyu	TRUE
iWuAgtááFbugQáúcqyiBúǒbmXnKecICkkyVQáxC	TRUE
kzVěTVqyúRhLáVYNǔDùééQdùFRǒráMGHeBzhEIZ	TRUE
oAIPfzvjXgtJTliǎYwiqèǔdIIdTrǎLGFAěVOxMO	TRUE
qhrHdxèBcoTǔSàMoáeáCfYZiVBBqauBHxRgEněg	TRUE
sjMrSaWèVFJúsyKělaHùnYMqHěRAKaàáOáRódcR	TRUE
uvgáVògYrbRáròmGxVqǎlPwTpDbzwPbyǔjobTVO	TRUE
xbGvsǎmRdoèòdsěòXNYLàTZfvEHěoVdPPcftnòD	TRUE
ùǔQwcǒcRxóǒIicùQckNWHsPMaDetviwàIéXvSdX	FALSE
áRAmeSCòùTTNàOcfdóPlDHopgxRiěósgRǒgxTUUi	FALSE
ǎzCEKnzszPFnǔgxǔqúDJèáěáùfBPaorWLCAIwwbk	FALSE
ěPéWLkYUgnLlfTǎBVSpwRnnùilLSlWRsòuIaúbf	FALSE
ǒSffTfǒxZgZUaǎWMubvǎYàIsQDSYLLtàJfaúvWuB	FALSE
BòDcJdǎmjnpMbqǎQàxRùiVGféPZytáiòòrUKqzòJ	FALSE
DoMSòàQVWarcéLZYdPCòóKòfSsAgXkUěYdsOVeú	FALSE
GkòcéOhyǎrExLgLzYYQSáudeKmaAVZùGětdHxUD	FALSE
JGRQEǔBqpsúàpTNvèceVHUóZóJèGóeèXWIdbMMHy	FALSE
LOWaPMdJócpPòvOGosEwHěhěndiòNBPIGGmKKUè	FALSE
OèDUqqEPacbTZuqFǒéehmIKnFRufnqUóIùxDtáM	FALSE
QklTùǎHCossusvágTiJáevtqKfoayiàXPGbúMóú	FALSE
TKcBKPmnhGLdxPoPUNáCúáHoútWyòfùNurétǒoZX	FALSE
WéwJxZǎmfAáykRtPaOLwJǔTblqlRNǔQxèvWfdzl	FALSE
YEcáěswètoaaryèYǎùITóbmáitXisǔHYUzqACMc	FALSE
acqéáYJěrǎLtétóIzǒoPrLótzGyOULGbDLfWhZZ	FALSE
dúEkHIǒgskDBceUiUKèhèùédSéwkrQeǒCPXǔGam	FALSE
fnZzJWCPhGXEcPXbpjdyUwXPòvGhATrOnmgmgyu	FALSE
iWuAgtááFbugQáúcqyiBúǒabmXnKecICkkyVQáxC	FALSE
kzVěTVqyúRhLáVYNǔDcùééQdùFRǒráMGHeBzhEIZ	FALSE
oAIPfzvjXgtcJTliǎYwiqèǔdIIdTrǎLGFAěVOxMO	FALSE
qhrHdxèBcoTǔSàMoáeáCfYZiVBBdauBHxRgEněg	FALSE
sjMrSaWèVFJúsyKblaHùnYMqHěRAKaàáOáRódcR	FALSE
uvgáVògYrbRáraòmGxVqǎlPwTpDbzwPbyǔjobTVO	FALSE
xbGvsǎmRdoèòdsěòXNYLàTZfvEHěoVdPPcftndD	FALSE
ùǔuKwèàCFěúpbceCàQhQvcqPKmpWGUaPGDcnteàu	TRUE
ájxYMQrcsúKeevxSWeùoDǔfsiAEjùnWlZCVpáynV	TRUE
éěNùRsPtfNBeoRoáCawyJǎoaèNòceZěSeQóAoèHC	TRUE
ěalDcNygysfTaYEǒoRFèTzpúùgYúTtqWqxfkZoJq	TRUE
òsqnQGCèlrCdhTVǔscIiéLQǔùkVěrFIxgptèUGúb	TRUE
AGCjivYyèùrHKchòǎěmSéIJǒHámXnǒyyTBJDáHCg	TRUE
CpIbaHòIúLTTXáRXHsgIIfááoǎmóJDéěVxéOǒAàD	TRUE
FQZwimwMJkóHàEóNZPUáaBiǔIAOàuHnckLàGSnǎǔ	TRUE
HlFAvOoHtzINXjVxpasWVězèǎiWJàhoiRásfILoV	TRUE
KUǎǒǔajQàKóBséjdkYùkJCMCoyrBsàFRáPcpDòKP	TRUE
NECculTiQoFòǎRlJnàBTFVoTqoyiSaěEDOqáèXCI	TRUE
PpZAàKNeèwgèvXǎTFGeIpwQǔIZEòNCǔdOgdzzzMO	TRUE
SXùYiqpKJOGTdBkhcNYǒtWoǎyiXGXJMǒTwipùAév	TRUE
VǒTxTqEéYarKJPcMpAòVyCDzDFgjépGeaěWcTRos	TRUE
XdONEDéIàCqǒYRnLótcuǔáoXDGOkOúhòXáFbFjVǎ	TRUE
aNúUyeNǒzRPBIDWlZáDjvúivIévHǒdmùezWXBMaK	TRUE
dǎéáEEhWéXbMHRZRbLǒaOǒZtǎorǔcKWkzózàNDér	TRUE
fjHZéMGZééoTjrnòXYhGSrfbqlbǎòGěchkùmcáWè	TRUE
iKǎkUYqnMwXěMeMceReófEqkáLYEXxVmvyGbBXqi	TRUE
kkvUNUEZlgǔlBXFàVAékhsbJHéZntJbbqNVNaèIǎ	TRUE
nPKqéSékóYtfAgyIOiXEaǒRtGrùhèaEryRutwHùx	TRUE
pooZMóhmaIHdópójòKěLxdlAǒhPrCèoǎRtdRoéòP	TRUE
sAuucbFXǔqàxAhlèPriyuwRVjyVfVIhrhoCùDbxF	TRUE
vùóNhBVhěàmzMVUwwékDFlhkèuùoEárèMLdrIBtW	TRUE
xepjOECpvNkwRmAǒSsdǎYWávǎgIzǔóuGXóDiitgA	TRUE
aùǔuKwèàCFěúpbceCàQhQvcqPKmpWGUaPGDcnteàu	FALSE
ájxYMQrcsúKeevxSWeùoDǔfsiAEjùnWlZCVpdynV	FALSE
éěNùRsPtfNBeoRoáCawyJǎoaèbNòceZěSeQóAoèHC	FALSE
ěalDbNygysfTaYEǒoRFèTzpúùgYúTtqWqxfkZoJq	FALSE
òsqnQGCèlrCdhTVǔscIiéLQǔùkVěrFIxgptèUdúb	FALSE
AGCjivYyèùrHKchòǎěmSéIJǒHámXnǒyyTBdDáHCg	FALSE
CpIbaHòIbúLTTXáRXHsgIIfááoǎmóJDéěVxéOǒAàD	FALSE
FQZwimwMJkóHàEóNZPUáaBiǔIAOàuHncbLàGSnǎǔ	FALSE
HlFAvOoHtzINXjVxpasWVězbǎiWJàhoiRásfILoV	FALSE
KUǎǒǔajQàKóBséjdkYùkJCMCoyrBsàFRáPcpDdòKP	FALSE
NECculTiQoFòǎRlJnàBTFVoTqoyiSaěEDObqáèXCI	FALSE
PpZAàKNeèwgèvXǎTFcGeIpwQǔIZEòNCǔdOgdzzzMO	FALSE
SXùYiqpKJOGTdBkhcNYǒtWoǎyiXGXJMǒTwipùAdév	FALSE
VǒTxTqEéYarKJPcMpAòVdCDzDFgjépGeaěWcTRos	FALSE
XdONEDéIàCqǒYRnLótcuǔáoXDGOkOúhòXádFbFjVǎ	FALSE
aNúUyeNǒzRPBcIDWlZáDjvúivIévHǒdmùezWXBMaK	FALSE
dǎéáEEaWéXbMHRZRbLǒaOǒZtǎorǔcKWkzózàNDér	FALSE
fjHZéMGZééoTjrnòXYhGSrfbqalbǎòGěchkùmcáWè	FALSE
iKǎkUYqnMawXěMeMceReófEqkáLYEXxVmvyGbBXqi	FALSE
kakvUNUEZlgǔlBXFàVAékhsbJHéZntJbbqNVNaèIǎ	FALSE
nPKqéSékóYtfAgyIOiXEaǒRtGrùhèaErbyRutwHùx	FALSE
pooZMóhmaIHdópójòKěLxdlAǒhPrCèoǎRtdRbéòP	FALSE
sAuucbFXǔaqàxAhlèPriyuwRVjyVfVIhrhoCùDbxF	FALSE
vùóNhBVhěàmzMVUwwékDFlhkèuùoEárècMLdrIBtW	FALSE
xecpjOECpvNkwRmAǒSsdǎYWávǎgIzǔóuGXóDiitgA	FALSE
ùùǔxáxèkpúgKǎOIdótjflùkàZboGsXgQrSDkqUidI	TRUE
áYLiàDǒBoshBMóéWREyǔbùAPyxěǔCMTIJǒLèaQFBè	TRUE
éěpLxvòxzSjMdsǒNPàúzVzzhoárAauxgWPnKFNAnM	TRUE
ěsTsqshépHEYxNkrǒEXóùǎáEèZdHWvóoáWòTǎjJoh	TRUE
ǒdùWěcYMùGówhroxwzKcEQǔysoOKunòyOlórWkblf	TRUE
BBxdvgfBAqVNeúiRXRrèQRàZikITFLxuXǔhiúWZUK	TRUE
EéKPaóJTèuúUrèDnIéwmjǎTFǎèmhWrTteZIDjzVáu	TRUE
GCUkyJùFqxRIyǎTfòoMGbGUMVpDqǎwGwàECǒúcéJl	TRUE
InVKgYWàJEGěVPhfNǒrsLùUXUdQázèǎùHNDhgvOBl	TRUE
LUPNqqvàdPBOdXMjRǒòéójiGlmúYUcfBYPkǔSpxpF	TRUE
NijYoZéBTIKNWmbQwHhBmúHzúOgYEUYOzaEǒnDsúO	TRUE
QdjóxaDúIěèpelOòvIhvIjLXtZMXpBlJúuWFněTsè	TRUE
TYUoNsnjngwLyáónóWvWSbeèMkLITfgOdcóOzpjKt	TRUE
VmǎXábeěpNqTzaBaAGahvPdUǔfèfhyPiǎSekmdqǒT	TRUE
YúdMymǔóXFVIěDGúFykRǔLoZGúbrqpaRěèJèBóTfm	TRUE
aQYvjHHXěfawBLjPFQZmQEzXrnzzqwàEtTNuNIvóA	TRUE
dDèGPZjélTóǎJǔGěhěoosHQczbGàTlùǎcbOxFZVfQ	TRUE
fitCWqěkQHjLWBXDǔěhtYòHBMymxfnórudEavgòèà	TRUE
iKwǔfgPǒOdóQEpEjěuPnrpOCZUNdHNSrbxzXBHpsK	TRUE
kYáòAjfXQKelbpTkzamQoxóVJyǒjeàUFFùKIrǒyiW	TRUE
nIúHYrHIúLgrRNgTtdjcéěaJwJANVaóNQjsLtCDyX	TRUE
pEQqbDyZJmXàVáCfSKazùfJjèeZonUSZdaWúBafkG	TRUE
rbeǎěKùzJeoEeTCYnàDAdsoDhMjQókOéfpúLùAtKO	TRUE
uUmǒYěXpRiHfǒHAblǒMjVQuBoAUězJeéPqdyXcKYJ	TRUE
xúTegMyKěhmlWwbGeLNJqéBěXkàdOMvuAJGxǎGHok	TRUE
ùùǔxáxèkpúgKǎOIdótjflùkàZbcoGsXgQrSDkqUidI	FALSE
áYLiàDaǒBoshBMóéWREyǔbùAPyxěǔCMTIJǒLèaQFBè	FALSE
éěpLxvòxzSjcMdsǒNPàúzVzzhoárAauxgWPnKFNAnM	FALSE
ěsTsqshépHEcxNkrǒEXóùǎáEèZdHWvóoáWòTǎjJoh	FALSE
ǒdùWěcaYMùGówhroxwzKcEQǔysoOKunòyOlórWkblf	FALSE
BBcdvgfBAqVNeúiRXRrèQRàZikITFLxuXǔhiúWZUK	FALSE
EéKPaóJTèuúUrèDnIéwmbǎTFǎèmhWrTteZIDjzVáu	FALSE
GCUkyJùaFqxRIyǎTfòoMGbGUMVpDqǎwGwàECǒúcéJl	FALSE
InVKgYWcàJEGěVPhfNǒrsLùUXUdQázèǎùHNDhgvOBl	FALSE
LUPNqqvàdPcBOdXMjRǒòéójiGlmúYUcfBYPkǔSpxpF	FALSE
NiajYoZéBTIKNWmbQwHhBmúHzúOgYEUYOzaEǒnDsúO	FALSE
QdjóxaDúIěèpelOòvIhvIjLXtZMXpBlJúuWFněTsbè	FALSE
TYUoNsnjngwLyácnóWvWSbeèMkLITfgOdcóOzpjKt	FALSE
VmǎXábeěpNqTzaBaAGahvPdcUǔfèfhyPiǎSekmdqǒT	FALSE
YúdMymǔóXFVIěDGúFykRǔLoZGaúbrqpaRěèJèBóTfm	FALSE
aQYvjHHXěfawBLjPFQZmQEzXrnzzqwàbtTNuNIvóA	FALSE
dDèGPZjéaTóǎJǔGěhěoosHQczbGàTlùǎcbOxFZVfQ	FALSE
fitCWqěkQHjLWBXDǔěhtYòHBMycmxfnórudEavgòèà	FALSE
iKwǔfgPǒOdóQEpEjěuPnapOCZUNdHNSrbxzXBHpsK	FALSE
kYáòAjfXQKelbpTkzamQoxóVJyǒjeàUFFùKIrbǒyiW	FALSE
nIúHYrHIúLgrRNgTtdjcéěaJwJANVaóNQjsLdCDyX	FALSE
pEQqcbDyZJmXàVáCfSKazùfJjèeZonUSZdaWúBafkG	FALSE
crbeǎěKùzJeoEeTCYnàDAdsoDhMjQókOéfpúLùAtKO	FALSE
uUcǒYěXpRiHfǒHAblǒMjVQuBoAUězJeéPqdyXcKYJ	FALSE
xúTegayKěhmlWwbGeLNJqéBěXkàdOMvuAJGxǎGHok	FALSE
ùùtzpoBhYjiteXzZaxHùHyUǔCPùDǎPZElpùmtsHNjU	TRUE
áosnúzlóJQnDOxSběsIrjnaPBèiQógHwRgBOZMǔúOx	TRUE
éóùxZVSlpLNvóghELyXHMfPLǔHRaéychaùyǔgáWCDw	TRUE
ěTáKFLOywGusVgáúóASòtNnLzMQPrùfádmNHhhwxAé	TRUE
òcBqLcézáàrgiMbxpuàmqchuiytcbsXavflQuOwǎwN	TRUE
úymHqzgwrǒquYYjoUfólvjǎàsěǔOrYEziLQkRébfRl	TRUE
CdvfúKESXaFLòALkfàdZgpgsnQqMwiǔAIywArOápMě	TRUE
FeNZIùLcqUhUéHkGuùàcDBQrěJaLIWXNělQQòUvEuu	TRUE
IIàěUǎsǒUoěéOàgawIxeMCglOnpDǎWJqQnCMúWaPǒà	TRUE
KbxúualsèmGCǎwKLòsoGpòkaúlqmMkAitpvùfXyOHL	TRUE
NúúàiiéjòAóMDHqQcJkRKswǔvymúěyUEwvwfòEhióǒ	TRUE
PJútěIVvMeǔFccXótrWKjùYòLAGFtuYqyDTZFuMUúU	TRUE
SGěSCtfGRúǎLPCOùBáYLEiwFJJcpgAháZkfxjùlěCǎ	TRUE
UnEGqúoOǎrrHyaIàjTykCeUànàeFóREJZFǔrgùYtyw	TRUE
XZSlWSwǎNlHLiuèUáPkáFwáCVIIònMqavevióaǔIMJ	TRUE
aédZúàWàòpWCHderjnqdaéKuHdlfUEWTVWLQyWPccU	TRUE
clèkkJhuYXéIYàjòěMvItUgclǔkzTwoHèùěùPgàVěl	TRUE
fImlGmEzèhUWùMwuFàgéDǔhúNàfJWsGYhjtwdKYllL	TRUE
hQdràQbHBhEàWóZNHZXàSSjrsMJuTWbeUgAsxiOjRb	TRUE
jvFmVSRUqRóObBùrWEYCnxAyDGàfOěbyàJqdstLYbI	TRUE
mXqTuNVYFěFúǎOèóuǎUǎKurolhPTBnPBbábPUěQRSb	TRUE
oséDdFEvIQoOòuFúfméuDbǔózQkdaeMdJUUTRdèǔVF	TRUE
rbHnPhLlKǒfXInAqcǎóVeoJzcNFmvgCèVWFWùHmtmY	TRUE
uǒsUkAeCWNQóbTBKGTèòǎbàKcOnkěqùlqweeCYSCxe	TRUE
wtCàéWyzhHxvXPRiaPCBnsFóQuùQSrseQENRSééòvK	TRUE
ùùtzpoBhYjiteXzZaxHùHyUbǔCPùDǎPZElpùmtsHNjU	FALSE
áosnúzlóJQnDOxSběsIrjnaPbèiQógHwRgBOZMǔúOx	FALSE
éóùxZVSlpLNvóghELyXHMfPLǔHRaéychaùyǔgábWCDw	FALSE
ěTáKFLcOywGusVgáúóASòtNnLzMQPrùfádmNHhhwxAé	FALSE
òcBqLcézáàrgiMbxpuàmqchuiytcbsXavfdlQuOwǎwN	FALSE
úymHqzgwrǒquYYjoUfólavjǎàsěǔOrYEziLQkRébfRl	FALSE
CdvcfúKESXaFLòALkfàdZgpgsnQqMwiǔAIywArOápMě	FALSE
FeNZIùLcqUhUéHkGuùàcDBQrěJadLIWXNělQQòUvEuu	FALSE
IIàěUǎsǒUoěéOàgawIxeMCglOnpDǎWJqQnCMúWaPbǒà	FALSE
KbxúualsèmGCǎwKLòsoGpòkaúlqmMkAitpvùfXybHL	FALSE
NúúàiiéjòAóMDHqQcJkRKswǔvymúěyUEwdwfòEhióǒ	FALSE
PJútěIVvMeǔFccXótrdKjùYòLAGFtuYqyDTZFuMUúU	FALSE
SGěSCtfGRúǎLPCOùBáYLEiwFJJcpgAháZkfxjùlěCd	FALSE
UnEGqúoOǎrrHyaIàjTykCeUànàeFóREJZFǔrbùYtyw	FALSE
XZSlWSwǎNlHLiuèUáPkáFwáCVIIònMqavevióabIMJ	FALSE
aédZúàWàòpWCHderjnbqdaéKuHdlfUEWTVWLQyWPccU	FALSE
clèkkJhuYXéIYàjòěMvItUgclǔkzTwoHèùěùPdàVěl	FALSE
fImlGmEzèhUWùMwuFàgéDǔhúNàfcWsGYhjtwdKYllL	FALSE
hQdràQbHBhEàWaZNHZXàSSjrsMJuTWbeUgAsxiOjRb	FALSE
jvFmVSRUqRóObBaùrWEYCnxAyDGàfOěbyàJqdstLYbI	FALSE
mXqTuNVYFěFúǎOèóuǎUǎKurolhPTBnPBbábPUěQaRSb	FALSE
oséDdFEvIQoOòuFúfméuDcbǔózQkdaeMdJUUTRdèǔVF	FALSE
rbHnPhLlKǒfXInAqcdǎóVeoJzcNFmvgCèVWFWùHmtmY	FALSE
uǒsUkAeCWaNQóbTBKGTèòǎbàKcOnkěqùlqweeCYSCxe	FALSE
wtCàéWyzhHxvXPRiaPCBnsFóQuùQSrsbQENRSééòvK	FALSE
ùǔòKpèSwǔyNtdiyNúMxàgkLSNsbàIQfcQkWàúKěàXXL	TRUE
álNuèMèCèKATxUEiúlyjiadQJadRwFcpóáùùBXpniva	TRUE
éTzDrmJqqqòuáCuwKtDóéǔdiXáCXOháUIvúǒècbvtpI	TRUE
óěWRlúQòdTXNJzTǔLDóSmBXbWYǔqElmdougBUssPjòU	TRUE
ǒeiǎFXúEkfcCRhóBMBSHIRXǎDWRNXSsBEDǎtgJtUHuQ	TRUE
BhYPLWóoǎumAǔǒhpEpMQeEuUMObxòjǒdVIǎsxiěZuǒó	TRUE
EǒòIwùdYǔOMùàDbBǒlfáWtBgéjCFCxXǔǔQqǔLcECbXu	TRUE
GnpZkpQWwrUnRátoJKWkEcumrSGěDbNSZDZukoǎSbRm	TRUE
JBTwjOànǎǎLVcCuècDWùSǔNàkffhòuuYgFiJěuWmVǎv	TRUE
LniOhJqIóěgPJLnséPJhzgTVǔuFMWdlètOMóǎǔqSizd	TRUE
OKǒEbzVcàeqǒWGEǎxZnǎygZpwùtBǒIKTPǒMòOgsòSùb	TRUE
QorYZYéOYóàrcǎtIàaWXiiICcEUGàóúCnaIQgeMccqI	TRUE
TǒBpazUdZfùvgENMáXmhHfTǔàVjúkgKxùZRMldozěWá	TRUE
VtVPiOPTqjojKSmWiúǒFěJQbiéǒkOúézmeyùkáMSYUT	TRUE
YOFmKzZéǎpbtuǔmtǒóOVfpjNtwhuGOǔYYmqAGǒaDUùr	TRUE
aléfùhǔZuuisczCBEjEsUXZUqiKFFljDgnqeQQRQóvx	TRUE
dǒUoKlǔXOgúfkxùpyfbBNAiiCxxupvCùRDRyTMXydbè	TRUE
fVèGHSnmTIednèójuǔáXZmzáSEGwavHrdRòúWCúhéěB	TRUE
iBòVPHěJhúqwNXQǎxVxWegùǎfEfàágGàdCàDXbymMdY	TRUE
kjIbMfxiédeZèdMǔàPNàpGLjdSzSQeZwBmépiuUgfKH	TRUE
nóraěóUuPTiCAfOxǎyònHldzoúZHvàBszXZrgEBtLRp	TRUE
qǒvvwTóóàcHǔTyANwisàùpuPFSIqgIaDQáHvàZngáòt	TRUE
shéTKKgrzáQáěbEǔCWluaoyAáVyGkzaCwQBQwWAóydx	TRUE
vNlktcúGPPbENxsBsKkfIéENoknàWyóǒekYCzhQCtrú	TRUE
xaGwúAWBUJòwkǒdBèúxUáUEQóSǔéSòdPVBvgmJeYùDa	TRUE
ùǔòKpèSwǔyNtdiyNúMxàgkLSNsbàIQfcQkWàúKědXXL	FALSE
álNuèMèCèKATxUEiúlyjiadQJbdRwFcpóáùùBXpniva	FALSE
aéTzDrmJqqqòuáCuwKtDóéǔdiXáCXOháUIvúǒècbvtpI	FALSE
óěWRlaúQòdTXNJzTǔLDóSmBXbWYǔqElmdougBUssPjòU	FALSE
ǒeiǎFXúEkfcCRhóBMBSHIRXǎDdRNXSsBEDǎtgJtUHuQ	FALSE
BhYPLWóoǎumAǔǒhcEpMQeEuUMObxòjǒdVIǎsxiěZuǒó	FALSE
EǒòIwùdYǔOMùàDbBǒlfáWtBgéjCFCxXǔǔQqǔLcECdbXu	FALSE
GnpZkpQWwrUnRáaoJKWkEcumrSGěDbNSZDZukoǎSbRm	FALSE
JBTwjOànǎǎLVcdCuècDWùSǔNàkffhòuuYgFiJěuWmVǎv	FALSE
LniOhJqIóěgPJLnséPJhzgcTVǔuFMWdlètOMóǎǔqSizd	FALSE
OKǒEbzVcàeqǒWGEǎxZnǎygZpwùtBaIKTPǒMòOgsòSùb	FALSE
QorYZYéOYóàrcǎtIàaWXiiICcEUGàóúCnaIQgeMccbI	FALSE
TǒBpazUdZfùvgENMáXmhHfTǔàVcjúkgKxùZRMldozěWá	FALSE
VtVPiOPTqjojKSmWiúǒFěaQbiéǒkOúézmeyùkáMSYUT	FALSE
YaOFmKzZéǎpbtuǔmtǒóOVfpjNtwhuGOǔYYmqAGǒaDUùr	FALSE
aléfùhǔZuuisczCBEjEsUXZUqiKFFljDgnqebQRQóvx	FALSE
dǒUoKlǔXOcgúfkxùpyfbBNAiiCxxupvCùRDRyTMXydbè	FALSE
fVèGHSncTIednèójuǔáXZmzáSEGwavHrdRòúWCúhéěB	FALSE
iBòVPHěJcúqwNXQǎxVxWegùǎfEfàágGàdCàDXbymMdY	FALSE
kjIbMfxiécdeZèdMǔàPNàpGLjdSzSQeZwBmépiuUgfKH	FALSE
nóraěóUuPTiCbAfOxǎyònHldzoúZHvàBszXZrgEBtLRp	FALSE
qǒvvwTóóàcHǔTyANwisàùpuPFSIqgIaDQáHvàZbngáòt	FALSE
shéTKKgrzáQáěbEǔCWluaoyAáVyGkzaCwQBQwWAóydbx	FALSE
vNlktcúGPPabENxsBsKkfIéENoknàWyóǒekYCzhQCtrú	FALSE
xabwúAWBUJòwkǒdBèúxUáUEQóSǔéSòdPVBvgmJeYùDa	FALSE
ùùTgZGzhcJRUéIsckoaOxEHIkSéSktErogBmáùUmzoTi	TRUE
áFPjEfCSzWUèdQDóOWùámoZGóCúvHJTuhepdoHvéhJDh	TRUE
ǎrycSApmókBgAxLcǎǎsRnJsSrhrfYkceaKǒvàhCVKǔcú	TRUE
ěJUwdóǒóDSRRwóUNZlxfrOqYxiòEfcHGVTHcǒczhěkIè	TRUE
ǒǎzDJPBsàHěVòraqǎaeèIDYExDwUAHfzàSTKNHKQQDyù	TRUE
AdtHfHGtuóxJóGYypYkmiQTEsjsqǔòoMpMCfbaǎiaznq	TRUE
DEUCwcòYYùrTAǎéoaGYVYWùàUòPDxjvjBǒoGBúYFEǎyF	TRUE
FnuYPGDòKQWrǒPéKjMmIóEjǒsxYbBayIHkxúSEaGVIrX	TRUE
IMwaCkěgPeIZǔBOédVcRlàVERTVgXOQHLwyUaaNVtRQF	TRUE
LéQPtClúBqùěkofdóivtòIóLàispYwòàáóHǎǒuòrTEkh	TRUE
NPWówqeùevCWbuDhFHOhlvBZBMdfRznpQsAOdkqUArWl	TRUE
QKwǎMiOaqáònBoDàTǎgǔǎMlKDNJuWGlOpttkòùérNysè	TRUE
TáHTUypbVtywLlqGǒBéztàávgOdwaqvTjuaBAàNyLMwè	TRUE
VkGHTGùJmaFrzmlfGuúgěCXAhǎRVCysLuBOQzYsWldtD	TRUE
YúyoděUfuctlVaoyáoOcQgAnTXQRèlFYPáfBoBózaáEE	TRUE
aQPVgQSfXAǎrWWòǒǒědaWúYhOLZǔrgèOsjǔvǔzdmqUjě	TRUE
cnóZGtTáWMqbhǔsSěseóFuùvwàHMkGihúgjmQFúJěehT	TRUE
fiǔéGObolBkróQOzáYAeoXǒeOjbNèWpYOwtúvzgóǒlòò	TRUE
iěaéZdJumzZBGWJěHXějzaùSwqwrTMvxhiLàMǔIOZpjr	TRUE
kiOCsócmCqCeóóXXěTTvnrXZuòlPKuoBZDRszFéèZqeg	TRUE
nVtéòGdAiúùěYlRQqXYúumqbǔUǎégJZHéVxNXHFáwdUI	TRUE
qètǎWèJràIdMkpTNbRfuùòàMUúTèèbWkFBXuyòsxpRǒG	TRUE
sněyWFúUUYvěAteCRmJXdoiWWmxgQjzjJiubEIRZcprò	TRUE
vKBRěqěèiǒXHSDeàkgwǒèJLYiǎQdQYběoòàzbfteTXóx	TRUE
xbtiFmǒWvMaHNvàCqúLùBxowúRqARmcóVrMùYYúPJumv	TRUE
ùùTgZGzhcJRUéIsckoaOxEHIkSéSktErogBmbáùUmzoTi	FALSE
áFPjEfCSzWUèdQDóOWùámoZGóCúvcJTuhepdoHvéhJDh	FALSE
ǎrycSApmókBgAxLcǎǎsRnJsSrhrfYkceaKǒvàhCVKǔcúd	FALSE
ěJUwdóǒóDSRRwóUNZlxfrOqYxiòEfcHGVTHcǒczhdkIè	FALSE
ǒǎzDJPBsàHěVòraqǎaeèIDYExDwUAbfzàSTKNHKQQDyù	FALSE
cAdtHfHGtuóxJóGYypYkmiQTEsjsqǔòoMpMCfbaǎiaznq	FALSE
DEUCwcòYYùrTAǎéoaGYbVYWùàUòPDxjvjBǒoGBúYFEǎyF	FALSE
FnuYPGDòKQWrǒaéKjMmIóEjǒsxYbBayIHkxúSEaGVIrX	FALSE
IMwaCkěgbPeIZǔBOédVcRlàVERTVgXOQHLwyUaaNVtRQF	FALSE
LéQPtClúcqùěkofdóivtòIóLàispYwòàáóHǎǒuòrTEkh	FALSE
NPWówqecùevCWbuDhFHOhlvBZBMdfRznpQsAOdkqUArWl	FALSE
QKwǎMiOaqáònBoDàTǎgǔǎMlKDNJuWGlbpttkòùérNysè	FALSE
aTáHTUypbVtywLlqGǒBéztàávgOdwaqvTjuaBAàNyLMwè	FALSE
VkGHTGùJmaFbrzmlfGuúgěCXAhǎRVCysLuBOQzYsWldtD	FALSE
YúyoděUfuctlVaoyáoOcQgAnTXQRèlFdYPáfBoBózaáEE	FALSE
aQPVgQScfXAǎrWWòǒǒědaWúYhOLZǔrgèOsjǔvǔzdmqUjě	FALSE
cnóZGtTáWMqbhǔsSěseóFuùvwàHMdkGihúgjmQFúJěehT	FALSE
fiǔéGObolBkróaOzáYAeoXǒeOjbNèWpYOwtúvzgóǒlòò	FALSE
iěaéZdJumzZBGWJěHXějzaùSwqwrTMvxhiLàbMǔIOZpjr	FALSE
kiOCsócmCqCeóóXXěTTvnrXZduòlPKuoBZDRszFéèZqeg	FALSE
nVtéòGdAiúùěYclRQqXYúumqbǔUǎégJZHéVxNXHFáwdUI	FALSE
qètǎWèJràIdMkpTNbRfuùòàaUúTèèbWkFBXuyòsxpRǒG	FALSE
sněyWFúcUYvěAteCRmJXdoiWWmxgQjzjJiubEIRZcprò	FALSE
vKBRěqěèiǒXHSDeckgwǒèJLYiǎQdQYběoòàzbfteTXóx	FALSE
xbtiFmǒWvMaHNvàCqúLùBxbowúRqARmcóVrMùYYúPJumv	FALSE
ùátévYhběXJjDóGuóTwdèbéJdǎcmHTFKDgǔFQpuSàxESy	TRUE
áqúǎErRjTJWàaǎwOhQjOUSJLXpzqGUlOCiùMIUpwrězKm	TRUE
éLUMrbnolXǔquèjěKrIómvygMcTktbTKPLCHcqnkùǎGBg	TRUE
ěgJJvpJoióóOQqBVèdQóRénFTIdóqDdǎDmsWHmidnyNYj	TRUE
ǒUYYbUrJSaépǎàWprXdnúǎtOUlnWiyCLXnǎRùKwKgmTyn	TRUE
AoLKhòlOéZuzVqHaElkGKóVhéàNWfpAcgnVULYTùǎlěKn	TRUE
DBXǎhéHXoqEUmsǎMmXFrAnuǔWgFThnKdAdBeJdèFdxMHe	TRUE
FZàgbBCNCumàhipzlDnyǒQGKTálAMàclTjJDPJvNGUyùù	TRUE
HtcAèIpóǒMBZxǔRhstGlTGWijCZkczILóxFFkewgzyziD	TRUE
KLdáMClDkbAcKQZtǒoùMCRwǔCGxELOěWéyàOvopTAFǒfB	TRUE
MvJaéLSExùtQsrSDóiwòQǒBòvdeèáeAUYuàáFozAdmHGM	TRUE
PSéQajOnnmPmVSǒgqKzRpǔusmxǎàWgZOGSdUoǔeIVOwRT	TRUE
SGTòǔJWAYCěSWfvoOjéOSAovcùfrAuǔésrYùmZNùèepJb	TRUE
UpopbáQcǔEàKuWoàFnslúǔǎaoycpLFGvJoyTOùAtrGàUB	TRUE
XAXáǔiháOáYWXcKCòJBólPùWUBNFQCvěNLxFsNbóWteTZ	TRUE
ZvqopRaàèDzGMWyaHHERǎDwNEUjZjuGMrólùsMSaǒtYWv	TRUE
cgúxBTúfyumóVOJtbáiáiHUWGRrǔoběxLáUrYúòàsáOuò	TRUE
fIhedFyàyNAciǔgfàTnGNěBmWǒltvCBQKtgRnéǎsPúLVà	TRUE
hZyNRjZHYtnǔbxxrZnUKpGrcámPtèEEúStǎEcvIiPěOlC	TRUE
kSDùXBùKlòAFQPbǔáCNTěrCfxfàuKkǒQVvidEwZHǎSVOk	TRUE
nbYSdhRkHPLsDàFXjǎéèkhVzèKxPzéJXukúwXnZlIpèvb	TRUE
qǎZfnvlEKXVrBNdúZJpitnkóMZWěLeùbMAtKpddVdǔàǔG	TRUE
sféamvTàBǔyHQeDpJmròiùcBAUǒPPJSSěJléhégyǒPZer	TRUE
uhxòYQpgpWMǒhhPWeWǒBǔGvgDwfvUpkGykDOlLllXdQgD	TRUE
xdrkRqtqCWGDméwkrDàEúuzIlgYMEXvSsqǔqTóǒlbIRzf	TRUE
ùátévYahběXJjDóGuóTwdèbéJdǎcmHTFKDgǔFQpuSàxESy	FALSE
áqúǎErRjTJWàaǎbwOhQjOUSJLXpzqGUlOCiùMIUpwrězKm	FALSE
éLUMrbnolXǔquèajěKrIómvygMcTktbTKPLCHcqnkùǎGBg	FALSE
ěgJJvpJoióóOQqBVèdQóRécnFTIdóqDdǎDmsWHmidnyNYj	FALSE
ǒUYYbUrJSaépǎàWcrXdnúǎtOUlnWiyCLXnǎRùKwKgmTyn	FALSE
AoLKhòlOéZuzVqHabElkGKóVhéàNWfpAcgnVULYTùǎlěKn	FALSE
DBXǎhéHXoqEUmsǎMmXFrAcnuǔWgFThnKdAdBeJdèFdxMHe	FALSE
aFZàgbBCNCumàhipzlDnyǒQGKTálAMàclTjJDPJvNGUyùù	FALSE
HtcAèIpóǒMBZxǔRhstGlTGWijCZkczILóxFFkewgzyzdiD	FALSE
KLdáMClDkbAcKQZtǒoùMCRwǔCGxELOěWéyàOdopTAFǒfB	FALSE
MvJaéLSExùtQsrSDóiwòQǒBcòvdeèáeAUYuàáFozAdmHGM	FALSE
PSéQajOnnmPmVSbgqKzRpǔusmxǎàWgZOGSdUoǔeIVOwRT	FALSE
SGTòǔJWAYCěSWfvaoOjéOSAovcùfrAuǔésrYùmZNùèepJb	FALSE
UpopbáQcǔEàKuWoàFnslúǔǎaoycpbFGvJoyTOùAtrGàUB	FALSE
XAXáǔiháOáYWXcKCòJBólPùWUaNFQCvěNLxFsNbóWteTZ	FALSE
ZvqopRaàèDzGMWyaHHERǎDwNEUjZjuGMrólùsbMSaǒtYWv	FALSE
cgúxBTúfyamóVOJtbáiáiHUWGRrǔoběxLáUrYúòàsáOuò	FALSE
fIhedFyàyNAciǔgfàTnGNěBdWǒltvCBQKtgRnéǎsPúLVà	FALSE
hZyNRjZHYtnǔbxxrZnUKpGrcámPtèEEúStǎEcvdIiPěOlC	FALSE
kSDùXBùKlòAFQcPbǔáCNTěrCfxfàuKkǒQVvidEwZHǎSVOk	FALSE
nbYSdhRkHPLsDaFXjǎéèkhVzèKxPzéJXukúwXnZlIpèvb	FALSE
qǎZfnvaEKXVrBNdúZJpitnkóMZWěLeùbMAtKpddVdǔàǔG	FALSE
sféamvTàBǔyHQeDpJmròiùcBAUǒPPJSSěJléhdégyǒPZer	FALSE
uhxòYQpgpWcǒhhPWeWǒBǔGvgDwfvUpkGykDOlLllXdQgD	FALSE
xdrkRqtqCWGDméwkrDàEúuzIlgYMEXvSasqǔqTóǒlbIRzf	FALSE
ùùókXIlwkFhELpWeIbPWmròòyèàùoǒHqMèrveǎINǔusDdo	TRUE
áòbkdǎoHiKpKgvWSEaPiNZoeLějLYClzABZcǎaéúsiZnyf	TRUE
ǎVluPbmCǔEfǒjLUZXrVgmèkDǔLfLAquǎéáLLVMòkhdYéBT	TRUE
ěóěègǎěmDjUaHxtUùCvIěRééěAJBEFazDléJJIéXxOdKnP	TRUE
òXnzCLǒWgJùèzJRpLJeAqRBáoǔJiǒdoEyFaWEImnòsùBUq	TRUE
AèGsjXGnEmIzzOòcaàHǒòKrAúHiùwxSJAgúvYWCyDigyǒG	TRUE
CyXFěUmnoǒujKedqDxzTEeBqwlpGAdJǎMyowavTUǎsxfHt	TRUE
FuónbPHZQHǒxògqEVèOáúWqcNetvZHójjTcIjMKàùmséPn	TRUE
IǒzěásócòxPEwOicxONZúrvkaěVEHpEáqeBKgUYèájJjBq	TRUE
LěaojZoxěmlJkǒóMyNǔPoMeUjozégBHYnFuNFáAQrzueqi	TRUE
NlyWtZaěúCuCměYàgImnhvwfgaǎBfcXqùvUThijúQXlOcé	TRUE
QtaěQxrDfWqpVnPMpsYùùfUnRǔóóoáuLNhdéKváDóZRǔjh	TRUE
TVWKHwZqoòRGEUoodExeGezgnoègOPDqkáRrgvóiYPfgju	TRUE
VzFioXtXdCBvsuZHátloFlPùIWgliAěYhNQǒsdVlàòiXóe	TRUE
YRGfocbmiKiúóCKǎuuExǎwFKXbáoòlǒxPEJówzpspyIMwB	TRUE
bùóycBgùyrúǔzIDgyǎfHOPqslòvQàoMLǔOkùPOAvgèikRS	TRUE
dyvfPYeqvXnùPaDFywHGPyàZyAOLMqNmtèwoDùQgéGvFut	TRUE
gnpSDvUVáǎvyrDkùùdXYBVUfXbwYBAmwJaclShMhénTEvt	TRUE
jěúTZddòóSóoeěEwlàeóKbsónzVoPiLFWáièpjùdùyzěxt	TRUE
lVROLCZFNqHuPkgéǒrwiFvtpossHnnoLmTúJJSuèdozmǒw	TRUE
ndMRxreǒisgXDDdXbjbmúhuùYàBtǒǎiAréDQOXyěswáhNP	TRUE
ptrmMsRWwvǒzbLáVINǔǔRDvWweXYǎàewknjIoNdyúúoHáH	TRUE
sBqAǔGMBUQWsvaàJgpkmúxliJMPǎòUquáThfArNOfCwòdG	TRUE
uaakyZaVWLùCHzRsúndTshúeYYTòUMúóToTàǎvhamnCYèX	TRUE
xJIdǒǔǔqYRólěaXBtSRAóceAABunpwáEXàHhXGEUěevCXǒ	TRUE
ùùókXIlwkFhELpWeIbPWcròòyèàùoǒHqMèrveǎINǔusDdo	FALSE
áòbkdǎoHiKpKgvWSEaPiNZoeLějLYClzABZcǎaéúsdZnyf	FALSE
ǎVluPbmCǔEfǒjLUZXrVgmèkDǔLfLAquǎéáLLVMòchdYéBT	FALSE
ěóěègǎěmDjUaHxtUùCvIěbééěAJBEFazDléJJIéXxOdKnP	FALSE
òXnzCLǒWgJcùèzJRpLJeAqRBáoǔJiǒdoEyFaWEImnòsùBUq	FALSE
AèGsjXGnEmIzzOòcaàHǒòKrAúHiùwxSJAgúvYWCyDigybǒG	FALSE
CyXFěUmnoǒujKedqDxzTEeBqwlpGAdJǎMyowavbUǎsxfHt	FALSE
FuónbPHZQHǒxògqEVèOáúWqcNetvZHójjTcIjMdàùmséPn	FALSE
IǒzěásócòxPEwOicxONZúrvkaěVEHpEáqeBKgUYèájJjbBq	FALSE
LěabojZoxěmlJkǒóMyNǔPoMeUjozégBHYnFuNFáAQrzueqi	FALSE
NlyWtZaěúCuCměYàgImnhvwfgaǎBfcXqùvUThijúQXdOcé	FALSE
QtaěQxrDbfWqpVnPMpsYùùfUnRǔóóoáuLNhdéKváDóZRǔjh	FALSE
TVWKHwZqoòRGEUcoodExeGezgnoègOPDqkáRrgvóiYPfgju	FALSE
VzFioXtXdCBvsuZHátloFlPùIWglcAěYhNQǒsdVlàòiXóe	FALSE
YRGfocbmiKiúóCKǎuuExǎwFdXbáoòlǒxPEJówzpspyIMwB	FALSE
bùóycBgùyrúǔzIDgydfHOPqslòvQàoMLǔOkùPOAvgèikRS	FALSE
dyvfPYeqvXnùPaDFywHGPyàZybAOLMqNmtèwoDùQgéGvFut	FALSE
gnpSDvUVáǎvyrDkùcùdXYBVUfXbwYBAmwJaclShMhénTEvt	FALSE
jěúTZddòóSóoeěEwlàeócbsónzVoPiLFWáièpjùdùyzěxt	FALSE
lVROLCZFNqHuPkgéǒrwiFvtpossHnnoLmTúJJcSuèdozmǒw	FALSE
ndMRxreǒiscgXDDdXbjbmúhuùYàBtǒǎiAréDQOXyěswáhNP	FALSE
ptrmMcRWwvǒzbLáVINǔǔRDvWweXYǎàewknjIoNdyúúoHáH	FALSE
sBqAǔGMBUQWsvaàJgpkmúxliJMPǎòUquáThfArNOfCwcdG	FALSE
uaakyZaVWLùCHzRsúndbTshúeYYTòUMúóToTàǎvhamnCYèX	FALSE
xJIdǒǔǔqYRólěaXBtSRAóceAABunpbáEXàHhXGEUěevCXǒ	FALSE
ùǔǔWLodjtYNZRMHolétQjòXǔnRóeveyKBǔnMZuMJCnWvbMě	TRUE
áYnkykérqéxcVOWǒuqXóqàIlMěIYǔoKXǎrǒěǎLpcTLióFòb	TRUE
éùTwqePasVuwyǒCgxZIúyTQIXCRXjaFyVpLYGPQàrwqRhTg	TRUE
ěgVóòlwiVLBsǔqèRWázGǔlòAWCQyXbIDuáèMjwTLsFHCóǒP	TRUE
ǒǔóhvQyrxlàfòdOsWkdzKCrLjRichsMNPGbàpnèWáǎLàbDs	TRUE
AVyǒBjBlNùaHStVéIUdLBonXpàóǒǔSGriqǎQáVéùynaKENa	TRUE
DSzǒéǔXmfaekkyVùnksxiGiKwShxOSSVBHóEBUcoEàwgaTZ	TRUE
GéNeKRoCwZǎVRèUsXǎNdQiezhlDYjZáàéròászáMǔAèBdéR	TRUE
IWǒpTyHCTFqDsKùàtiODJibIFccDLHLUèMgPWYǎtAkWcXAz	TRUE
KxoǎǎbEaǒJúNXeamtóúcZcKAàfǔulKOVAqEUcCJùJKyTisn	TRUE
NcǒKZppǔejǒaunòRPOùrAhPseBjlǒtsQgěáTFtiPBUDjBnK	TRUE
QTCLùéIóéEACejéěQàcVèàSěúNTmaMceǔùDOOnEúQùgzZàX	TRUE
TàzpneéělGdákFOMiemVòǒUúruVDuáByǎHvómzYiDàCZxLo	TRUE
VPzáBóǒrXRKNKWòGcRKMnéoDcòCiVióhvttUxRZCgXlYéQò	TRUE
YáDKGBSznùbeèádUxhCfPàjjeFIoYòQLáǔujWdQPnuEKSwà	TRUE
alwTqjǎéeIIWdStMǒMuwPDuěǎBOJnMwMTWxsIlòcMUDGyIn	TRUE
dékSQjdCEGAevLcIǎǔZòèoóVǒbgrkǒgLITpSRGuUBINǔJòR	TRUE
fYKeLóySfVǔITàbQuaLCǎálcyvJzPVCettxwFNfUeǔKoáòa	TRUE
iáAwáHvmltxrdtbpjùVǒfYCZRBXàPJxǒǒtPlIYmpLfáǎTSa	TRUE
kYyòyIǒònCuXEéúmEtfWàLCNKykNwòBoèAovBrBéòEdVuWt	TRUE
nKěDCErJěgFBFusǒǎějèBjnéXgQELbqEzgmcúágbOwxyXèf	TRUE
pzwCOhoHDahCaéyǒSiJdEylSlijOuZLlrMqsnùxeeǎfuyCT	TRUE
sRwHkoùhwtJUěgěNiùWMèMòwěnEqniòàrmduXóàLiSbeWUc	TRUE
vDwàdtGSCcDPhjFúéFXniNorIáSèUǒaiFpúFlBJǔǔpEóǎAy	TRUE
xPqIàǔEtcwurKXgléRMáUWJùhZIkylVCǔqqótCaónDaǒFoě	TRUE
ùǔǔWLodjtYNZaRMHolétQjòXǔnRóeveyKBǔnMZuMJCnWvbMě	FALSE
áYnkykérqéxcVOWǒuqXóqàIlMěIYǔodKXǎrǒěǎLpcTLióFòb	FALSE
éùTwqePasVuwyǒCgxZIúyTQIXCRXjaFyVpLYGPQàrwqRhTgb	FALSE
ěgVóòlwiVLBsǔqèRWázGǔlaAWCQyXbIDuáèMjwTLsFHCóǒP	FALSE
ǒǔóhvQyrxlàfòdOsWkdzKCrLjRichsMNPGbàpnèWdǎLàbDs	FALSE
AVyǒBjBlNùaHStVéIUdLBonXpàóǒǔSGriqǎQáVéùynaKENb	FALSE
DSzǒéǔXmfaekkyVùnksxiGiKwShxOSSVBHóEBUcodàwgaTZ	FALSE
GéNeKRoCwZcǎVRèUsXǎNdQiezhlDYjZáàéròászáMǔAèBdéR	FALSE
IWǒpTayHCTFqDsKùàtiODJibIFccDLHLUèMgPWYǎtAkWcXAz	FALSE
KxoǎǎbEaǒJúNXeamtóúcZcKAàfǔulKOVAqEUcdJùJKyTisn	FALSE
NcǒKZppǔejǒaubòRPOùrAhPseBjlǒtsQgěáTFtiPBUDjBnK	FALSE
QTCLùéIóéEACejéěQàcVèàSěúNTmaMceǔùDOOdEúQùgzZàX	FALSE
TàcpneéělGdákFOMiemVòǒUúruVDuáByǎHvómzYiDàCZxLo	FALSE
VPzáBóǒrXRKNKWòGcRdMnéoDcòCiVióhvttUxRZCgXlYéQò	FALSE
YáDKGcSznùbeèádUxhCfPàjjeFIoYòQLáǔujWdQPnuEKSwà	FALSE
alwbTqjǎéeIIWdStMǒMuwPDuěǎBOJnMwMTWxsIlòcMUDGyIn	FALSE
dékSQjdCEGAevLcIǎǔZòèoóVǒbgdkǒgLITpSRGuUBINǔJòR	FALSE
fYKeLóySfVǔITàbQuaLCǎálbyvJzPVCettxwFNfUeǔKoáòa	FALSE
icáAwáHvmltxrdtbpjùVǒfYCZRBXàPJxǒǒtPlIYmpLfáǎTSa	FALSE
kYyòyIǒcònCuXEéúmEtfWàLCNKykNwòBoèAovBrBéòEdVuWt	FALSE
nKěDCaErJěgFBFusǒǎějèBjnéXgQELbqEzgmcúágbOwxyXèf	FALSE
pzwCOhoHDahCaéyǒSiJdEylSblijOuZLlrMqsnùxeeǎfuyCT	FALSE
sRwHkoùhwtJUěgěNiùWMèMòwěnEqnciòàrmduXóàLiSbeWUc	FALSE
vDwàdtGSCcDPhjFúéFXniNorIáSdèUǒaiFpúFlBJǔǔpEóǎAy	FALSE
xPqIàǔEtcwurKXgléRMáUWJùdhZIkylVCǔqqótCaónDaǒFoě	FALSE
ùùhtQIěJJVwǔCPZáǎnǎGaWPtǒYmdùàlcúLěáLCYBùGGzòKMW	TRUE
áXkiǎlIwbUwaFnWúiérZùFnCvDqǔGWéneALKrxlnúǔáAKDxé	TRUE
éěrcOnBoqhǒáMǒùCXYGfělBHyóufDvěèèǎeěrUkkPtjbéyMy	TRUE
ěkJgoiDUykùvgǒMúIúWǔOodEPxMpCcQytfóFúNòlaoWSAyàI	TRUE
ǒDjIcéHKCVPfcmKGfFifvòfófriZGkètXjòUGzDFtOeZzOǔJ	TRUE
AxkǎxgveuDqIqLtoOjMRjQèZXpGvoàYrFNǔTHrWLbUPànyKG	TRUE
DPmǒQHypZgIWMNwWFXAùvkèXUzVbsxwwéùáoqàKLàààlnldh	TRUE
GITùBengUénGIhUsYXǒòfCěqZùZMéwóVbpQAreOEZyAYCsMV	TRUE
JávMójxFsnJXDóToNgngǔàzlxuǔEMdrxcssMYùocSbIceJfj	TRUE
LHpǒOTaSzedPtǎtǔttBuriDxwtèEzCpiTemqllVWTuTpólTé	TRUE
OPùIǒgòbáyUesFttmukxZFziEYTMqbKKjgùRnmrkdVjǔóEoI	TRUE
RèǔòFoVCQZvECmYPMkùnbVRyFàǔUeNǔmbYěaNKNàdXzělqtx	TRUE
TIǎéEsikMzFěeùXWexVlVbXiYxZJJTUZǔáǎVIvòFIhJwDMbi	TRUE
VOsbRòlwHLǎcgǎèáJnQòJNǔZYǔáqDKqèàáréǔvǔpRPKXwANY	TRUE
XhvDàùFGJXàùtElTHzUaHcZUDàJxòhjqQxóPgoOUJAèGòfǒú	TRUE
aKDfóswNWrktòyeòBuwXuzPeYAxzzSàǔiXyiECùYLPhnúěar	TRUE
cfyILNCwAèIUXkiXOmáBlNYáǎOgTwSǎfVrúfpǒbbJSóDOQRJ	TRUE
fTǎStùcChóCóòEOSgúòNIqéómWDSHúPxenghKqONYyòěkSùP	TRUE
hqlKdiQYbKèHilǎójlónyirHTHòboàFaKKCzòóKPáòáěRyBq	TRUE
kEgoDǒúSáěiksmǎDǒKsvlrvMbRdrxscGyoUúhXhQOSpcúpmé	TRUE
mvěúKúvnjwhcMLxQvqènIFpebSPNǎrDsvmjUKLifǒqRRbuPB	TRUE
pOóvNdCrxèswvvBjáěěkèmOAsǔaoǔzKùkùJuàLguWjirtǎIǒ	TRUE
sǎNòZkcexQPXJefNxAáUgzvǔéqràmgyHRqbUùùèKOǒggDRhZ	TRUE
uBSVTHRLǒpEúàYHwZtDQgFlSUbKIqGxPěéFbrUNnVèHrOáYz	TRUE
xèèEczěRěrUFsWěyěbǎjgòNhISfqfótrljéúIJèòáZúáéùoB	TRUE
ùùhtQIěJJVwcǔCPZáǎnǎGaWPtǒYmdùàlcúLěáLCYBùGGzòKMW	FALSE
áXkiǎlIwbUwaFnWúiébZùFnCvDqǔGWéneALKrxlnúǔáAKDxé	FALSE
éěrcdOnBoqhǒáMǒùCXYGfělBHyóufDvěèèǎeěrUkkPtjbéyMy	FALSE
ěkJgoiDUykùvgǒMúIúWǔOcodEPxMpCcQytfóFúNòlaoWSAyàI	FALSE
ǒDjIcéHKCVPfcmKGfFifvòfófriZGkètXjòUGzDFtOeZdzOǔJ	FALSE
AxkǎxgveuDqIqLtoOajMRjQèZXpGvoàYrFNǔTHrWLbUPànyKG	FALSE
DPmǒQHypZgIWMNwWFXAùvaèXUzVbsxwwéùáoqàKLàààlnldh	FALSE
GITùBengUénGIhUsYXǒòfCaqZùZMéwóVbpQAreOEZyAYCsMV	FALSE
JávMójxFsnJXDóTcNgngǔàzlxuǔEMdrxcssMYùocSbIceJfj	FALSE
LHpǒOTaSbzedPtǎtǔttBuriDxwtèEzCpiTemqllVWTuTpólTé	FALSE
OPùIǒgòbáyUeasFttmukxZFziEYTMqbKKjgùRnmrkdVjǔóEoI	FALSE
RèǔòFoVCQZvECmYPMkùnbVRyFàǔUeaǔmbYěaNKNàdXzělqtx	FALSE
TIǎéEsikMzFěeùXWexVlVbaiYxZJJTUZǔáǎVIvòFIhJwDMbi	FALSE
VOsbRòlwHLǎcgǎdèáJnQòJNǔZYǔáqDKqèàáréǔvǔpRPKXwANY	FALSE
XhvDàùFGJXàùtElTHzUaHcdUDàJxòhjqQxóPgoOUJAèGòfǒú	FALSE
aKDfóswNWrktòyeòBuwXuzPeYAxzzSàǔiXyiECùYLPhnúěarb	FALSE
cfyILNCwAèIUXkiXOmáBlNYáaOgTwSǎfVrúfpǒbbJSóDOQRJ	FALSE
fTǎStùcChóCóòEOSgúòNIqéómWDSHúdxenghKqONYyòěkSùP	FALSE
hqclKdiQYbKèHilǎójlónyirHTHòboàFaKKCzòóKPáòáěRyBq	FALSE
kEgoDǒúSáěiksmǎDǒKsvlrvMbRdrxscGyoUúhXdhQOSpcúpmé	FALSE
mvěúKúvnjwhcMLxQvqènIFpebSPNǎrDsvmjUKLifǒqdRRbuPB	FALSE
pOcvNdCrxèswvvBjáěěkèmOAsǔaoǔzKùkùJuàLguWjirtǎIǒ	FALSE
sǎNòZkcedQPXJefNxAáUgzvǔéqràmgyHRqbUùùèKOǒggDRhZ	FALSE
uBSVTHRLǒpEúàYHwaZtDQgFlSUbKIqGxPěéFbrUNnVèHrOáYz	FALSE
xèèEczěRěrUFsWěyěbǎjdgòNhISfqfótrljéúIJèòáZúáéùoB	FALSE
ùùlzkgéqQWzraqNZLvOTòqpzcjVmvZCJhDionqPVpOòhFSNTy	TRUE
áòzvzéLqcWáQYòVScCkePvyhǒwUcpUyěèYKeCmSncmQNzBkòo	TRUE
ǎSegLǎgclTgKqHbNtǔHěKKRwtáépApZTrfuVpWojhYWùAéYRI	TRUE
ěáǔpMpàAóXIǔàMYKǎěsàDGYOáóLaipxhIsàéNDVéUǒóCZFIHR	TRUE
òdDkxLmǔèVQOytIzCmnDQCCHZHELbWùZzcCYiáQpeCQǔJěNXj	TRUE
úuefòǔdmlAbVsoOGAqZTcékQàXtVzgYqKàrtsOFèǎvMQwiiWǒ	TRUE
DDfNAcuèqmBRUeVDBàEThPFRáuòěokNamǒaiyhLáJPiIáXwAi	TRUE
GèvCáǎKMdwFTBYXEjTùSpNpzdYéqMóypNzNjOFMáǔúyAibéQw	TRUE
IUòùwóéGáfǎHQIaUUpyDOTáòXtcWhrgPRǔgogúpvòTsHugwyN	TRUE
LDzòFkfúZtriéWěARDwLXHsOJjjncPOTpějviZznWmǎèààEZù	TRUE
NvNLYAeHénàòIXvutchuPVKAèéèSelǒZNéèpVbAzǒiOxpfgew	TRUE
QTéstQjEyjQDSZjeMKWSANǒCáZbiWNzgFéúwwǒSnǎǎǔXVVAxu	TRUE
SnAusSIùsQméQMuHUrNBwuXffèxgnWDùǒarVùDcNPLkvtJttá	TRUE
VHuáǒààtòFarWcGLǎJlmǔǔàCclyXWXOTéDIǒDqSEàxyuǎmèxò	TRUE
XihFWqhTTqqCBbOéTVsBgàdjLHckOKáYPsquRYúLsRrxFRHóC	TRUE
aREeWlgSècuǔhFàmunǎWǔHéANMKxóGǔiPGXVAHàwJczDùuhùx	TRUE
dúREwtwAnuKàóǎNCUǔCatjCiwcòsòWzLévhBZǒTaXMóáONàRl	TRUE
fcjMsAnWèàjOQINTQvONqOCOMHXrkNsúseMòwóàtvóǎqUèCwY	TRUE
iJǔnǒAúTwEsěùrBCLAtNéXomoòqzWbbUXAqbRRéAcVXuóàgám	TRUE
kUKCKgjváětHbJRXqUtOójyddéáaNuǔCoàVURóúJkxphMdOBI	TRUE
nDRwpxěàENbvèzQxsmómjYhěcJTVCJTěVrCubtVKVǎbEǒcAjé	TRUE
pwgFjǔzvSnLóFPtjkYSwlebMzlSTzòHQòcsJqlBRGSvxǒZGèe	TRUE
shgRMéěfIOxvNSRAVèuǎQǎhDRltáǎúRpFiqHěAéxbqPMráúrr	TRUE
vSWAbjǔDoúMSWèDWòyxmdWXvúdDVCnyQLúDuětrzǔaKRcseCP	TRUE
xOWoLáKǎnsozpjiuáóIhdyIbbaóKSCkSPàiIgǔzúóèráǎNEWò	TRUE
ùùlzkgéqQWzraqNZLvOTòqpzcjVmvZCbJhDionqPVpOòhFSNTy	FALSE
áòzvzéLqcWáQYòVScCkePvyhǒdUcpUyěèYKeCmSncmQNzBkòo	FALSE
ǎSegLǎgclTgKqHbNtǔHěKKRwtáépApZTrfuVpWdjhYWùAéYRI	FALSE
ěáǔpMpàAóXIǔàMYKǎěsàDGYOáóLaipxhIsàéNDVéUǒóCZFIbR	FALSE
òdDkxLmǔèVQOytIzCmnDQCCHZHELbWùZzcCYiáQpeCQdǔJěNXj	FALSE
úcuefòǔdmlAbVsoOGAqZTcékQàXtVzgYqKàrtsOFèǎvMQwiiWǒ	FALSE
DDfNAcuèqdBRUeVDBàEThPFRáuòěokNamǒaiyhLáJPiIáXwAi	FALSE
GèvCáǎKMdwFTBYXEjTùSpNpzdYéqMóypNzNjOFMáǔúyAabéQw	FALSE
IUòùwóéGáfǎHQIaUUpyDOTáòXtcWhrgPRǔgogúpvòTbsHugwyN	FALSE
LDzòFkfúZtriéWěARDwLXHsOJjjncPOTpějviZznWmǎdààEZù	FALSE
NvNLYAeHénàòIXvutchuPVKAèéèdSelǒZNéèpVbAzǒiOxpfgew	FALSE
QTésaQjEyjQDSZjeMKWSANǒCáZbiWNzgFéúwwǒSnǎǎǔXVVAxu	FALSE
SnAusSIùsQméQMuHUrNBwuXffèxgnWDùǒarVùDcNPLkvtJdttá	FALSE
VHuáǒààtòFarWcGLǎJlmǔǔàCclyXWXOTéDIǒdqSEàxyuǎmèxò	FALSE
XihFWqhTTqqCBbOéTVsBgàdjLHckOKáYPsquRdúLsRrxFRHóC	FALSE
aREeWlgSècuǔhFàmunǎWbHéANMKxóGǔiPGXVAHàwJczDùuhùx	FALSE
dúREwtwAnuKàóǎNCUǔCatjCiwcòsòWzdLévhBZǒTaXMóáONàRl	FALSE
fcjMsAnWèàjdOQINTQvONqOCOMHXrkNsúseMòwóàtvóǎqUèCwY	FALSE
iJǔnaAúTwEsěùrBCLAtNéXomoòqzWbbUXAqbRRéAcVXuóàgám	FALSE
kUKCKgjváětHbJRXqUtOójyddéáaNuǔCoàVURóúJcxphMdOBI	FALSE
nDRwpxěàENbvèzQxsmómjYhěcJTVCJTěVrCubtVKVabEǒcAjé	FALSE
pwgFjǔzvSnLóFPtjkYSwaebMzlSTzòHQòcsJqlBRGSvxǒZGèe	FALSE
shgRMéěfIOxvNSRAVèuǎQǎhDRltáǎúRpFaiqHěAéxbqPMráúrr	FALSE
vSWAbjǔDoúMSWèDWòyxmdWXvúdDVCnyQLúDuětrzǔaKRcseCb	FALSE
xOWoLáKǎnsozpjiuáóIhdaIbbaóKSCkSPàiIgǔzúóèráǎNEWò	FALSE
ùǔàááQzGKyFuKShnxiGgJZQHwZúlèzrXbLSRàJDáóòBKzáMòlv	TRUE
áěcúYěvòócCàBěòěóègqCUYtLǔsiKòúváoDADovMáQǎakQBfùá	TRUE
ǎzmpVPǒGjraǒěXVělBvZzEaǒuNAIúǎwXtùoKàYaéJuròǎBdsCE	TRUE
ěCoòefCJOòóAPáǎWXpǔewEdměVmNTemcǒúVQgúáiFygoUoěsNW	TRUE
òlrfRdèPǒLOYOICfKdKajFzmUpòòmxóZdǒKTZòSéBcaGBǒxèúp	TRUE
AszáGùièrtqWzKUMcsJyǒjúMiRbyúHǒXcOòVDfòJxzoeWhVǎUS	TRUE
DXJvAiarJàIFáYyěmútúsOEJUtěiidHjBěyaáheFdwǔDàcitOY	TRUE
FmàǒZoAǔVUJTIùòWRAsVHiPMvoGbfCwjVTjKFVxMúRVZdIYòBu	TRUE
IFEIDefmeǎekYexmSkxwoqfěàǒmuéiǒKSárDédàéCBIenKVgso	TRUE
KsSòchcáJXDYZkjhéJnscXEFRrBlCWJQfNzxpubaǔumtZTúàxS	TRUE
NKglMAázǎúdOfNxAxTbmaZCjcGámgctYTDrnOFAùàrǒeèDCFuǒ	TRUE
PYQaxúyTocěYPGǔOHóFHfLtPFpvùágjTzTJǎgXyvéziXusETǔt	TRUE
SDòRúmúZEeyǎùánnDòMdcLCgNoéèǒǒaqihhúnùKùmzFBTYrǔVY	TRUE
UjùjeòùReYnAiukFRTapSEYyAjLjfLùgFUpáZkǔǔóoOhEBiuqj	TRUE
WsNYYhvùQéoLaèGDrOěUǔzJQúxCdhmdOTSPWRúPaTxGyQnTPán	TRUE
ZHrDèULfeLúLyfúWGEgeYòǎpvKcgqàNUDòLEkOHhLFfcvTbUjl	TRUE
cèxkqCPzqwmjQTMGaTxMéeCqènRfórEiDhfVoraVǎONFMURHùě	TRUE
esEnEéáfHHWDsMDLǎlZDNHGrztbFtéZRSQǔJeKkQlrFéEséGfá	TRUE
hHuRèéRúdieàOHsUETqQSMTkdzLǔxwkàobǔTsbOlhrèLlòZAgp	TRUE
kéUyNckELsuzágIáǔjGXaMǔDvKJxeisxIaCCreTsisGAvETOOC	TRUE
mjáqàkùRúwFbYMZpqiMhbókQtteWEXIoVwlǎvòYèěxDdáhfNBE	TRUE
pùBárKvNLbQebòdmQorǒdKDeccéPCmùPpNemòǒemQJǔùmfhtóé	TRUE
rcpOGǒǒéGrizwiNHUuaTCCMOgSěǎkhWmwiBrpGJGtlóǒKúTLSe	TRUE
ukjàNKSiPHhleCGTuxáKutQdoǔsYDmdJQOXěCbelHPeFúrdǔSq	TRUE
xXXuzNóxùxcújèàoIóúPFǔojqàpYWjJOàQVRwyúSgPniWHóRyǒ	TRUE
ùǔàááQzGayFuKShnxiGgJZQHwZúlèzrXbLSRàJDáóòBKzáMòlv	FALSE
áěcúYěvòócCàBěòěóègqCUYtLǔsiKdúváoDADovMáQǎakQBfùá	FALSE
ǎzmpVPǒGjraǒěXVělBvZzEaǒuNAIúǎwXtùoKàYaéJuròǎBdsbE	FALSE
ěCoòefCJOòóAPáǎWXpǔewEdměVmNTemcǒúVQdgúáiFygoUoěsNW	FALSE
òclrfRdèPǒLOYOICfKdKajFzmUpòòmxóZdǒKTZòSéBcaGBǒxèúp	FALSE
AszáGùièrtqWzKUMcsJyǒjúMiRbyúHǒXcOòVDfòJdzoeWhVǎUS	FALSE
DXJvAiarJàIFáYyěmútúsOEJUtěibidHjBěyaáheFdwǔDàcitOY	FALSE
FmàǒZoAǔVUJTIùòWRAsVHiPMvoGbfCcjVTjKFVxMúRVZdIYòBu	FALSE
IFEIDefmeǎckYexmSkxwoqfěàǒmuéiǒKSárDédàéCBIenKVgso	FALSE
KsSòchcáJXDYZkjhéJnscXEdRrBlCWJQfNzxpubaǔumtZTúàxS	FALSE
NKglMAczǎúdOfNxAxTbmaZCjcGámgctYTDrnOFAùàrǒeèDCFuǒ	FALSE
PYQaxúyTocěYPGǔOHóFHfLtPFdvùágjTzTJǎgXyvéziXusETǔt	FALSE
SDòRúmúZEeyǎùánnDòMdcdLCgNoéèǒǒaqihhúnùKùmzFBTYrǔVY	FALSE
UjùjeòùReYnAiukFRTapSEYyAjLjfLùgFUpábkǔǔóoOhEBiuqj	FALSE
WsNYYhvùQéoLaèGDrOěUǔzcQúxCdhmdOTSPWRúPaTxGyQnTPán	FALSE
ZHrDèULfeLúLyfúWGEgeYòǎpvKcdgqàNUDòLEkOHhLFfcvTbUjl	FALSE
cèxkqCPzqwmjQTMGaTxMéeCqènRfórEiDhfVoraVǎONFMURHùěb	FALSE
esaEnEéáfHHWDsMDLǎlZDNHGrztbFtéZRSQǔJeKkQlrFéEséGfá	FALSE
hHuRèéRúdieàOaHsUETqQSMTkdzLǔxwkàobǔTsbOlhrèLlòZAgp	FALSE
kéUyNckELsuzágIáǔjGXaMǔDvKJdeisxIaCCreTsisGAvETOOC	FALSE
mjáqàkùRúwFbYMZpqiMhbókQttecEXIoVwlǎvòYèěxDdáhfNBE	FALSE
pùaBárKvNLbQebòdmQorǒdKDeccéPCmùPpNemòǒemQJǔùmfhtóé	FALSE
rcpOGǒǒéGrizwiNdUuaTCCMOgSěǎkhWmwiBrpGJGtlóǒKúTLSe	FALSE
ukjàNKSiPaHhleCGTuxáKutQdoǔsYDmdJQOXěCbelHPeFúrdǔSq	FALSE
xXXuzNóxùxcújèàoIóúPFǔojqàpYWjJOàQVRwyúSgdniWHóRyǒ	FALSE
