ùùòSFZJDGgITǒjYéFwJǒ	TRUE
ǔòWxJSCovGiecòWyòtyt	TRUE
áOhageXcèDXLqQAYòozǎ	TRUE
àZǎyóMoǎǒByǔòbějùlǔs	TRUE
ǎuFVxsAOWùefwUkgCǒVb	TRUE
èAHMNovOpxǎěǔtlgOǒbB	TRUE
ěFOkgFBéEGOwXerCTúka	TRUE
óWBxGnRQpBnǒppyNQOgg	TRUE
òrǔtCFApHxMutRátmYgl	TRUE
úGǒjocěLWófèǎrhòiBqI	TRUE
AbZAǔěpdDlHPYmcòǎǒvk	TRUE
CùLCjUWPyCzXwznNllCK	TRUE
DBHRzUǔRvpgdFókhzRzǎ	TRUE
EQepdmlASǎǔxGěpPPcfQ	TRUE
FkéXEEǎexnùwǒxZJáBEu	TRUE
HéRRRěIǒBMFlkáVějwòw	TRUE
IOnDvǔBcwSGaBwKóèTLY	TRUE
JpbXùfZXuwcòBqkXdIǔb	TRUE
LǒfàóZNAùTEyárFZQCMt	TRUE
MKQtiějFUùPCWnTǔààPS	TRUE
NqVHZùTòǒKEǔXIàBRJèm	TRUE
PóNwúàJJCwHlàòCǒowZs	TRUE
QHEHOamzěRAǒdcBǎvqOX	TRUE
RbIàěMxThǎtòǒǎúraUoà	TRUE
SpsnaózmmAjzújwDCxvq	TRUE
UIDàmDqISǎòàxrSQSLdè	TRUE
VbNOPekbuěòonòghdqso	TRUE
WoǔǔDMVCthiuzSEIzEBu	TRUE
YùNnUbaPZNKèówqáQnrY	TRUE
ZGydqKKfHTpPùùhIGqkǔ	TRUE
aděNǒùHjGaèlzMǒSeWwL	TRUE
bnVWfEVùárFùRxǔCǒDsm	TRUE
děhéTHRWóeSOtvSCoHáě	TRUE
egvIncBocHxǔArlsgiéù	TRUE
gǔráKeVxjOaywúOzuRèF	TRUE
hCYzmrNjhùlWdYRBUNvC	TRUE
iREawBvaàgǎRIVmDèhág	TRUE
jnúwcvǎgRzJKSHQáeóDs	TRUE
lèaǎyǔLCAekěMIHaEkOL	TRUE
mUòFAZOczVPYFytXaaùě	TRUE
nZZúXhIiyxINèCwRzěwY	TRUE
owVSicTòqoyRwfdckNtR	TRUE
qALYhùVUHEfbbúUAkRBm	TRUE
rfǒRNǒCǎěráPchbGfnrL	TRUE
tàuIéóobavjgAMImùěcT	TRUE
uàBizWDúubVoòaóNHfjs	TRUE
vóOéDslCVSKUHkhcXOVL	TRUE
wPQFVòùgǒbZǎAávfǔHfo	TRUE
xRBbchtKUmUAHoèELcch	TRUE
ydMTúJBIlUuYzXEpZòYH	TRUE
ùǔwzguNaYQzbVrUmǒeGD	FALSE
ǔDabèùúwYàDXvgáoFVop	FALSE
áeqqbNdSZaúwBKaqCbéO	FALSE
ǎTGemdgsHaǒbkUcúǔDuó	FALSE
égJpSaICGqrbyhIsJěóP	FALSE
ěCaDèpMTRùrEqxǒébNQg	FALSE
óaeèFHFdkǔvbtéLXNXoT	FALSE
ǒácpgYpqǔaztbSbbtóZr	FALSE
úNoǎzySǔBwděOnólàòdo	FALSE
AlOdǎwèdaRàzpèúTvǒjZ	FALSE
CòLIRvdbùjJdětSNfEje	FALSE
DajrbxzhLNmzùKFNdtQb	FALSE
EuavhycaǎùuǎCóéZbTJb	FALSE
GSqEdóòǔtwBkWǎdEDiúc	FALSE
HdKSaFQSNáhbOanLqnàě	FALSE
JěVaZUǎJyùAPaZbyùBqà	FALSE
KMVRxdDǔpQàaugdTQRòǎ	FALSE
LdhylhFeHmNMlKxYkEad	FALSE
MnSondàkdiláaóòcGèDg	FALSE
OTNUIwdCzdGaàèxEQKJL	FALSE
PdHJóRhǎFugTEdmvcEYB	FALSE
RàzhajppVeWhùbAbpǎqc	FALSE
SLvJeTTmptLSNLéaDbeY	FALSE
TlWdèadGZúhùfTOǎJgLh	FALSE
VJVqkabXJdNmXcraémtr	FALSE
WvaKbYFfèúukiFòùvACH	FALSE
YQdTPSadAIWlDéǒuzaǔè	FALSE
ZnSbnojLWQǔZòaTKbqcl	FALSE
aHCǒbIoPZygupCWLútpc	FALSE
acJOLYKmbǒPZQfeumiAS	FALSE
awRcTVuwYsbDǔBLVbAòD	FALSE
ctBǒtkZèúReCěaVPKzYb	FALSE
dMFLdltNyzFBéoèuXzuò	FALSE
ddeèúaBNKjxXszaěBMIN	FALSE
eǔBtèǔisiXAalǎHhZDbé	FALSE
fViáNziCtklRQFoyddiX	FALSE
gaSmTbEpEXwGùKǎòNwàW	FALSE
hxeXpuéMPaèfácobbipe	FALSE
jDózkòpWmmùòGNduGGZd	FALSE
kmaJkhKwriBZjibqEǒHò	FALSE
módsdlIjaMCjddBKèóQe	FALSE
nJXkòVTdaèhYódHeoòbG	FALSE
odxgsDLldùWNzèKǎypWe	FALSE
pvMBoGBaDgKǒHǎbLzxPB	FALSE
rAIrIsBfFtYHwxdrdqdw	FALSE
saWXnòzbmaBPáKBRbiMH	FALSE
uDuhfPaTǎǒfIhyafXbAw	FALSE
vdCwzkxAdèLBoFIAtnóO	FALSE
wqoLáFóSDnacRbQTBWji	FALSE
yNBFdpznnjNrhěGdWQàù	FALSE
ùùHWMèlWwvaaàQoYMGDnx	TRUE
ǔPAgGbzHahpagdRqoQhXU	TRUE
áhGMjǎòWdùXPióDjNzUlX	TRUE
àwdOxCàQCúèbHvRǒyWGme	TRUE
éGinUXjoèaCvHàCrzvFtw	TRUE
èaòKreBpGèěXuWlnógrtE	TRUE
ěefhVàààPúbèzumqóajvk	TRUE
ósFbdCKòTIfBxhWmòLCWp	TRUE
ǒDFYIáxZfGpòAyJLicYéǎ	TRUE
úTHgěridGǔqsUwPrjUvěH	TRUE
AUgUnWéISNèóMTXtLeóBd	TRUE
BgòrBoRpfhXjoènùxXbáh	TRUE
CtéǎàVeěskSAWEcKǔjSaH	TRUE
EAOfPsSqAWYyǒTǎMbúHMJ	TRUE
FSHCbvéúLRVólnUǒLNYfz	TRUE
GmzGAwBndfGSTqZqùQQYv	TRUE
IélFPhRséèBATkmIdFtNz	TRUE
JEjòEcaUkvkjnǔpKfFJnk	TRUE
KWjFZaǒlSJqvúgèSèUFnN	TRUE
LhHWTcmfBwSwKBGuiChsQ	TRUE
NòúYKǒocLluǔmZDQiaUùs	TRUE
OGemTCǎIèXYànǒǒúVúoRJ	TRUE
PZǎGPKADdhOHDXTAxàoqU	TRUE
QqWEèwBZLtIcùhDmǒIiiy	TRUE
SCrǎùǔWqczEwGSǔoóKAHw	TRUE
TcWsmVdtóFaBEHKZHjWěj	TRUE
UyKUxbùjbVmfPjTNNùIne	TRUE
WGvejIskgoofkùVBkfbXK	TRUE
XTJvgnúZRiAguLbFPRtLQ	TRUE
YmmmǎdtòFuòoABùSQráWà	TRUE
aáZèZoǔzkSpùrXǒzLZSsJ	TRUE
bdITBǔsmòNMsiNwògHàPà	TRUE
coèmTěòJDVVùGXàJJèùxú	TRUE
eNlMěoYsJǎcbAWvRsjhùM	TRUE
feóXMqtujèTntmqjEfNbt	TRUE
gvYVOOěDgSGLjVmSHrCMǒ	TRUE
iMùúàUvzànDRěHùFsbáoe	TRUE
jTtQfWvxbQylòxDújEglO	TRUE
kjàLfGyBsptozsSvmhùVk	TRUE
lscèěPjǎsBùrXAòPPfèRU	TRUE
nAWwWkZmysLBXTfXScGTK	TRUE
oRJvFówMNhBuEhMúNcxMá	TRUE
pfiòSIéóPJaXoQgTcgaiN	TRUE
qtúIùpOSàzhwdwKhPùǒtC	TRUE
súxxeǎlQSKNXWpIWéxQBY	TRUE
tOxpLnOáàVcAIòòFéǔHgC	TRUE
uXLRCiǒjJiFaWéòòRfQcú	TRUE
vuóèobrKOǒnóJxsdǎbuts	TRUE
xònDdckJZjMYxBRǒěhhFǎ	TRUE
yaVùfOAǎQOLúFoXXjPEáo	TRUE
ùùMQVǒHdNCirdLJXGáMXp	FALSE
ǔQgzóXsyavvXrOgHtHúèb	FALSE
ánJDWagqSnOgdbiSyfCZè	FALSE
ǎòdwǔmSmmYGYèdQòùsNéI	FALSE
éIáPGaéònombXoUqsUNfO	FALSE
èiMdfNqraeJèùQYbqUbWF	FALSE
óěóaDbxúóFYòcàwtèFaxo	FALSE
òUqLGAdǒdzvFXshOieòba	FALSE
ǒnùIotbpúdǔThǔvsCenPd	FALSE
AGǔpquOdLàAMUaaWupóWb	FALSE
BvsHówJvǔǔGxQHYGrǔddi	FALSE
DFdebdǔyazènEdCkOèspJ	FALSE
EdNWQdéBzbjSFcKFwúbòè	FALSE
GòùáwěyqDeYWaAUpchwbm	FALSE
HaǔjcQQOèJbQDvéylàSDA	FALSE
JáoáoskURSLudXdGváspǔ	FALSE
KayáphDYwbWisáUZuúYbo	FALSE
MóvòPBaQiKùybDǎqOyIxǒ	FALSE
NaPgbYnèyBàHUaNěěJjUo	FALSE
OyúnógrpeǎqWěyalJaábu	FALSE
QJaǎoVmúUSJálbLtWájst	FALSE
RazzěbGQòzgóJcúpoTyhf	FALSE
SxǎBAdáQUtLCdxTBMěěgT	FALSE
USKdǒóédAxóCaYbzUNúgr	FALSE
WùdBùKzBEělRděǔcIKBbs	FALSE
XYYGlgbprwQdvEodlEnvH	FALSE
YfIaàQXBmZuòhéXbPuIEJ	FALSE
aǔDCUGHùmHUftnóDkuàbi	FALSE
aNǎlnCǒlhbIǎobisCǒWBx	FALSE
agnbytALcpVǎJǔJǎMùKZk	FALSE
axKtTMXAebruLVǎKRZuéN	FALSE
cjCemauKqPvflKbláEIèF	FALSE
dGyWAádkwKsEznYDUhQBu	FALSE
ddrExhNMLEóYhǎpZéDqEà	FALSE
dxmDǔqnvJàNijVpLǔgbàd	FALSE
fSaqóǎOCbTpZúOUZěTXSU	FALSE
gtdPqdlzfkLoZeYxOabfU	FALSE
iHLukFaLèZMǔzáágksbǒh	FALSE
jOféRqǔllaáèyzbNóGúUǔ	FALSE
kzSóUoaláěgàbqRKTwRql	FALSE
mHWJmaělwFàPeFbUpúuHb	FALSE
nmHùǎaéPCòùzfbvwqgéZk	FALSE
pEdWgwdpYèFLèTéwFZXhǒ	FALSE
qijěaGJOCYbóYPJFeWóQe	FALSE
súèbikábeAHǔDnamUoJbn	FALSE
tMWjPZNMxfaEWyRvTNbóW	FALSE
ugFpSGepfaOóvnSbmCWùù	FALSE
vwIhǎrmayghQbcDrWOYHǔ	FALSE
xKbǎéǎáóabDáheGBóBZsN	FALSE
ykLdyZudòcpIXbyyǔémJE	FALSE
ùùRMWoIjekzhwhlVzzpúId	TRUE
ǔèGJQZRvSdQpLǔtIméǒBsm	TRUE
áVǒpUùòúpnjaKJàGzJědcZ	TRUE
ǎébKOeUmWrǒRPyHeoHLDCP	TRUE
éRDǒǔfqpEáJMǒEFǔSCLZZL	TRUE
èjJóOfqZSafèáHáxǒiVàce	TRUE
óǔPedgQmRávsstáNXJDXDx	TRUE
òNèǎBpQvJYLkzuCFNènwǎó	TRUE
ǒcnYsàǎSǎyXMádewIyòaěB	TRUE
úrwádrIvBwjùěauUgYèQAN	TRUE
AtSǎYKAFKGSZáǎěKWgfxúó	TRUE
CHWcófWèEAPóàúJěfQòTùy	TRUE
DYThRtvWǎyébOùúYlakXtà	TRUE
EjImOztáiUòoFQúzǎMGhgK	TRUE
FuFǎMáaFLáààNVkěTggKhI	TRUE
HǎBáàTucúBYFrlBngSáòpW	TRUE
IéqNQóYgUAHUùVVǎQQopèl	TRUE
JETùRosNWRAMUdHqtCKKmL	TRUE
KXLFZTkHDDvDyYDěvzxtzo	TRUE
LoQǔkaYCEkUnMUftěhOVIT	TRUE
NArkDxqbeEeJfiZlzXLJúr	TRUE
OeoBViUuXPDMGtaTmódàfR	TRUE
PzcǒoTxlevdhòàNCnWsrěM	TRUE
RMlXěùBsSqruǔFkBáOZEyk	TRUE
SdǒNbéVOiDnéòFsZjroPlu	TRUE
TròRàVTlEjahtǒGCǔuóLǒf	TRUE
VǔLǒxFVUAúóQóJRuoIǒWzP	TRUE
WEéUkUCToUBqyWFwzTiǒps	TRUE
XQèWnYǔISURcNYùsCáògéP	TRUE
YjNOloHmEzinDEdhehónhe	TRUE
ZuMMPePcDUEhtlvKqeùqěà	TRUE
bVDècOFTyòěgOBHPVKvsPf	TRUE
cfsIgBǒǔAáDlfnlàvAǔRév	TRUE
eǎYWóóEmkfKsoXfJbVVQOO	TRUE
fITpǒLaYZxqáwjóPDyàcRù	TRUE
gMopeIGBEJWNédDaàHéEIě	TRUE
hdyWCNsqqóěBfǒEǎQOSjbF	TRUE
inWKúYǔòKTGéVjowmcDyBD	TRUE
kéAKóNyYXèHǎbJlhEFYlkt	TRUE
lDfgCèóàBQWxarrěegmIrò	TRUE
mRǒSktǔLZtòǒákSyAzàcDǎ	TRUE
oùTjcàAYOùbTnFZVstxsVé	TRUE
pJábXKòléistyNzèápPǒúo	TRUE
qntTZúěǔQYwOòLuPZsFoBò	TRUE
rzhùLQzuFLBOrxhICkáěfa	TRUE
tǒzějtqCiDLfTJTaVFIùǒT	TRUE
uZRvxKóuGěútmKQèùAiMjG	TRUE
wúqQSměVmPNpUǎRlàPDgtG	TRUE
xOéǔǒréyóLóàGYVNRǒQúúD	TRUE
yalCiyVmTGPQvxooùRLxrj	TRUE
ùáqETjidǒzmUqRaDIuiDbr	FALSE
ǔraWàpbóàaBbúNǎrǒEPòéT	FALSE
àBafèPěǒXdbHQYoRǒoYsAP	FALSE
ǎaFdbxIQitǒútjBòóòàKǔǒ	FALSE
èúFihXbǒdRNVaIKàFDlLCb	FALSE
ěGOǎěàpOPwQǒHǒnóaoeQbI	FALSE
óapbúUVònióéwàMnMDPReH	FALSE
ǒòdSwúKèběQjòIJpSFàodN	FALSE
úJauWkIdQpádvúǒuoótóFw	FALSE
AdqěYIVoiQUávrèrNěsudv	FALSE
CóSadAùHadUofrkZjIyWUc	FALSE
DHpgqcǒVhAèèǒgRajOèbGm	FALSE
EYdFùXzCdwIxpùrDéòuOúP	FALSE
GàótloěcàVáQBBúaxgoIFb	FALSE
HJMVEpwJòvZmaGcHbbǔXPc	FALSE
IlpHyvMNWáXuIhwoódNYdb	FALSE
KòZCàfódòùSzéMdmòeáQmó	FALSE
LbàyKIzPCGaOuJpTgbpSNp	FALSE
NùoDfǒbzdnèWòeRwúQpPúd	FALSE
OBǔGfabóEHjveHrVùóSQXh	FALSE
PSawhXtqbáADpkvvArprVQ	FALSE
QeàyóxùàfeccBúemàLabLC	FALSE
SDcxMIElIqaRbrZBOCeěPZ	FALSE
TXòrǔégJaOLbVǒYduPDLEJ	FALSE
UmùqHedhpORnVnódZpàǔúF	FALSE
WRLrIǔsORdgùúldbpEyàqo	FALSE
XhrQbedeúEznTǔffvaódXQ	FALSE
ZJláyUóàvGúàRtaUeGàMPb	FALSE
aBvROTgkepaebYbguupFaO	FALSE
aaGvAPòwFbàlFdLTFGóZYk	FALSE
avAKHbòànNKOùXsOóǒUuWr	FALSE
cǒfbjfPpaáHbCzgkwǎLpRj	FALSE
dHěEGoTEvHzděWvjúlnǎèY	FALSE
dfMǔúHFArerLJhéudbUdFk	FALSE
eàrVóGCabSùDcǎMJLùUJJB	FALSE
fTPCDTaxVKmbúěrLiKzuHE	FALSE
geòáAáYKqbYGZtBeóBakzb	FALSE
hoMnYòtwGEùlKedpDsiHdn	FALSE
jRiǎKédJbòěoVdumMǒǎDkB	FALSE
lǔGjwùáúlnèǒCjdIzyaFèd	FALSE
mGóRBaUúunXueUbLfjldyò	FALSE
niǔóaPnQcwpSynOGǎǔyYSb	FALSE
pHéLǒběMHǔaWhbPaúWFhaS	FALSE
qaYTIótbJSZPWFáǎúLOvqn	FALSE
ruKLWizJOZLǔǒzpaQEvmbs	FALSE
tòrgrúyPabcǔCuǎttǔJGlg	FALSE
uLiKPZWDZùTXdYqXdyhùES	FALSE
vYqěPTáftdSmKùeúràVdbD	FALSE
xàméCddcnóGNErvEbxiBIm	FALSE
ydEqomezdYsERóApòDyóco	FALSE
ùùéEJěirTPmlKérlQnqKqTf	TRUE
ǔáiměKpfRFrxZldyoFWtùvf	TRUE
áHùpgAjJbHHcakǔǎEěòǔyZò	TRUE
àQCòóhgùǒLnfCgVvHóWNRAS	TRUE
ǎkgNOLǔHufihǔèlJUwWNjfà	TRUE
èúúHUNIHǒoǎNCixiǒtǒùUYn	TRUE
ěYolfEěTldvpILssIxxzhěh	TRUE
óuCDNdúwúhCTFIwxùMèFxml	TRUE
ǒQlùNóICùsSúBDvYóyvxFLè	TRUE
úoamVrkěJódSóQòDǎsWAukH	TRUE
BúzXǒhcádeoDOnpcabVFáLǎ	TRUE
CiyògGrpFùTábnHCEBLtTúé	TRUE
EéjWWàxQOáJúěyLexjUnUNé	TRUE
FNoEIǎDòMJOaJBrLǎGhzutv	TRUE
GbtWárIòPhavTUzoGiuxááD	TRUE
HktvùEoaWǒifOCQAùBIlàJǔ	TRUE
IvVZùhmóàèIANúGXNsóuDmB	TRUE
KǒJmZIàcQueòfwòsSWnqúQN	TRUE
LOàpǎVftGAǔcsOǔmxmpzǒKà	TRUE
MzKvZHáTlrHVúátLGwrpZéi	TRUE
OIpjBjXjQWEpJqVhPhhtmIl	TRUE
PNcxdùúHfòWmòwppnòFdrhw	TRUE
QlàpNáGuHrhTFǒqBQTyùQái	TRUE
RtSvJrVREòòBacrCUáěZcǎá	TRUE
SzziPHéinshwDebATǒButùE	TRUE
UOpgěáAhcZǔjwRójtàVqòóK	TRUE
VnóúfXcVzpNXyJdèrzǔcZoD	TRUE
XùRlzuZNRZjǔcaJioqBgmmE	TRUE
YKoCuPrQReyXóAuLǔFWDSfD	TRUE
ZekVtǎIǎxAKOqcGmaúěTuHh	TRUE
bàNChlRsvràbàBzJlépxǎùx	TRUE
cèpYáSCssǔhGQèNXfjJrJoY	TRUE
dDOHǎNXTǎocEHaDkIHkcfEj	TRUE
eduPěùOIeqòJèGjHBoeVǒMB	TRUE
fxZXávJNBITqNlYjacXòVKd	TRUE
hěhhkTàSBtEéPKtiùZZjùXx	TRUE
iPLNǔLLqAdqCKKntyisúYml	TRUE
jeàAOqFtuyrmHEETIBORqtà	TRUE
kqSGùtQqHNèHhrqUMYwzunU	TRUE
móOǒajBoGYdqxǔaǒfUAtHyv	TRUE
nWRIyYjqVTnáGsmrTvBéiOH	TRUE
olmòǔòHLPRùMUSPmfhetùnG	TRUE
pyùjdkkǔámXDòNDoSeEaSàC	TRUE
rKzHDMnyàBXgkyáYflòáegM	TRUE
seuQhHxdLùrFěJDǎJeǔǒUKW	TRUE
tpLXúUOofrTuRzqòWHmkCBě	TRUE
váTHKQCAǎosvHěRAǔèějMhM	TRUE
wEPǔkbTpòbhFVVPumkivFOP	TRUE
xXIQNěrHaeaNzcWTàùèàapw	TRUE
yrúDYwcáQcbzYPYYXGYvMhq	TRUE
ùǔObYóèujshLjasnEóéGbQm	FALSE
ǔFMsKtHùEdomTuMjGdFNoěI	FALSE
áQydGùBéùEUmInaddCAwiàk	FALSE
àfmGdCnfOòdwLYwòVsYVHqá	FALSE
ǎjarOkàèéXEdfBNVbzCwHOS	FALSE
èéaSHxaaǔeqòSzQǒbithTvl	FALSE
ěXaqQzdbXàziqóFOǎàNóèif	FALSE
ófnacàvéELZNáYǔpbPàógHò	FALSE
ǒAǎEChVhyBXaGFFRkěRddcr	FALSE
úVóDvQjǔWtkkRTtxaRYkbót	FALSE
ArAVMbǎyaPFǎbOòYvápǒXYó	FALSE
CǔabOGoKbòMGvZèKJǒǎdSQh	FALSE
DaácAuwSzǒQhùǔǒǔěFQibbD	FALSE
EoxéUhCMxjeKUéIldDódeqS	FALSE
GaIjbkmééòdBSNmuRmXziIM	FALSE
HrdUuTjpéYHqadáWkVSFrJo	FALSE
JOGratóPGubáěèùHJqtMoyl	FALSE
KsKmdáswqjSdLMBLIWǒfOzw	FALSE
MGěxcbmDRúOpIeàQRaEbTnL	FALSE
NfkydtQOVátdYZiJhěXUǎah	FALSE
PùtVVZatQYQQdbléaATBEqH	FALSE
QPvnNpPaOaRtěGùèYYSbrHC	FALSE
RyùAǒHzUQpwraXuzEHgùúpb	FALSE
TCZodóqLSdDXrakTAxRrdQU	FALSE
UgIJMBKpjvBEgsCFrúoaseb	FALSE
WáóVdwzPPwqgEYbqPYdpLeó	FALSE
XPpSUVuQDdefAWPdvefvmWX	FALSE
YhvdEDzlajMWIBgbèǒhkòDG	FALSE
aáFǒYzWxǒRóAUǒbCgWFxaFě	FALSE
aMárStLPbyAUAVèaǒòtxAsL	FALSE
aiDǎWYóNnóLkmzdwbzàyJMd	FALSE
bEGFDBzqYXqdadRèDoèFéZr	FALSE
dǎxsǔQPYdMFVitQExhkwǔxL	FALSE
dUWAJKPáHldXKyDúWJúOfǒr	FALSE
dqEúGDǔAMdGLpgETsKTMmWw	FALSE
euOàHǔǔWtdYmXPoZeCTGldX	FALSE
gBepkQqěAYeQsyddIǎXWéjy	FALSE
hdǔOWyCSbǎZAuHiHVědFaQé	FALSE
jAcǒbotaVWJPgvmLxMCébGC	FALSE
kaMCbQvAbpxTzěXàCRVtBzo	FALSE
mǔaXnqJUFBGùNwǎQhJSXkwb	FALSE
nafàXMbWCbsgǔKIBcùCfmLH	FALSE
péAóXaúcòbùǔáJtáàRwGaóù	FALSE
qUéǒErǔázmudrbódwJúmàzù	FALSE
rqàvGiPNdjKaCUXztbAqwrě	FALSE
tòDXHlmEaahǔoyUbRkǒwǒKS	FALSE
uVPDRùlsdgwsǔiuoGfndXxD	FALSE
vsgBfEdIǎRǎAhdgEèàèWébǎ	FALSE
xóGwyowvběTúèghóAúaQLbw	FALSE
yemeòxKmlvèòdxWdkeNfcwǎ	FALSE
ùǔsqcǔHHOxósuùZpkǎéJJǒvR	TRUE
ǔúěZúWczòCkNYppJáHKgòugě	TRUE
áNScjhSeFRǔěmǔBXHáZVòjǔz	TRUE
àZDfVQèàhhsWàaéLTásFUàRP	TRUE
ǎfNǔPviLwENRYqcdvěZcvsth	TRUE
énhjxBàóGbNWbcjdmTHjCǔcp	TRUE
ěáFcùuBoaúergVzgùàrKKVQR	TRUE
óSàáJlùJmSgQLAǎqoniupEèà	TRUE
òlLiGnJwDǒCmgPNvSbǒYmLBn	TRUE
úáQǔKèVXIyKLěMùchèIInKBè	TRUE
AIbYokéǎúHUeyfZsùfrSRCYh	TRUE
BcWQkOúeRjkAqMoǎCéǎǎLdId	TRUE
CtpfàǒgLYppMnòqǔǒWpHyRúR	TRUE
ELwFxODIXnrmjNwùgAEmHKdq	TRUE
FcxHsDùmAeáěPnóWmèszNEmK	TRUE
GwLxufénnsVURsùpéùRlWqěǔ	TRUE
IúPDXEujqònékOtYQXhdSUzJ	TRUE
JLpàsYéǒHRFaéoúOseàkmDám	TRUE
KdFtUǒlEDejúOUqkúénDZAnW	TRUE
MǔòjXGnQǒUǎěButrDáRRXqtq	TRUE
NǎhlEpnxZwCmFhlBvTVúJiID	TRUE
OcojúǒSsLEZWilmGPnZcTkYH	TRUE
PnnYwsPFmCMoXhXrcěvǒbVdX	TRUE
QxpRFófQjǒieúZZǔZcàQèVóǒ	TRUE
SKtzjóòakDtOIuScveQǎwmNj	TRUE
ThdijaOFiNMosySrcxzùCTée	TRUE
UyidbyWsǎOBslKPglèTrywUy	TRUE
WLPDojTfAsZěWǎsAIúUQesQr	TRUE
XgSgmzPjgebWyfnsiùkérVùD	TRUE
ZèyGfPódèufwgQtǔZAnǒYuóX	TRUE
aSIpOààùKǔúúopHxTwrtxqYc	TRUE
bqgěQSSòFEWMpBzǔgKúúDzòL	TRUE
dóxjěZwFnGbiQBXNksSTIùFg	TRUE
efděcéúúGJCCOxGEOePLsUan	TRUE
fvSěgóGtPLgWLùéǒmFǔwNúǎP	TRUE
hěeéwQPibkrjóHhsdlsIZVòp	TRUE
iMùIXxhrJòapfùBoafJǔkIaǒ	TRUE
jjòNéqewfNySTchrsOriCUnY	TRUE
kwwcVNZèěSdibEPZàyExipDI	TRUE
mOzqjoKPemnIUúlVALNáCfǎǔ	TRUE
nbvaYJòòSOǔIKKmòuRyVZTxY	TRUE
oeSfKYnǔyiFWjǔnWGǒěbǒáyU	TRUE
pswBvDovxLOgrnNONgWOYágN	TRUE
ròJZvlNiugòhTòRrHàGáSójL	TRUE
sYěqúxvhxdgTZréTǎCrctóéd	TRUE
ttMyněUuúAJágVmhuiéóKRdá	TRUE
vùGéNvCátSQAYwúǔlWXcFQHa	TRUE
wGùPkhèJZIěyxpyYWuòScóSs	TRUE
xUVàUàéWAREBǔyvMócsnzpmò	TRUE
yqOAYMnùèLnWOsJShpòUCNrQ	TRUE
ùààsQbZOabXocVxFKKkZzqlW	FALSE
ǔPKiùbGǔiǒjwIláGduMIedrJ	FALSE
ávMYCibjPdMědttGòQóbflàW	FALSE
ǎFBdxeDWjAjxěPrfPduImjJs	FALSE
éSajǒádjvgHdGéfùPgǎQnRNè	FALSE
èmyPúUqntnNjěHdMvǎsvdBuh	FALSE
óUòDkQaúUbPvufLxNRsǒbtMà	FALSE
òvBRGnBvlogaàMrSSnlbmèeù	FALSE
úJuJdUUědbòáakbNTmPxbYèS	FALSE
AaytYhkXiúczvpblèaGèqwCě	FALSE
BvUpTùsuRTxzVVkáwjddOnOú	FALSE
DFYXXdZBIódHdjCkYwélcKcJ	FALSE
EaGALTUkQUobduEdukjmXHHT	FALSE
GáóDjKoLǔVùóWaphuZFMVFgb	FALSE
HúeIqeLóWCllFibaAPwǎEjbJ	FALSE
IHrMúeòaGhrontVbvScéhVlu	FALSE
JlxDCkAdqQNskpùgǎúNdAnJL	FALSE
LByWxěNdUóogZwbfwTBodèCY	FALSE
MNúhqoǒhMǎXHéǒSxGǎOVpKdd	FALSE
NgděOjZtǔSYQǔTàCgYdISvúj	FALSE
PúòSatáóqRDysǔeYOwzbntHn	FALSE
QWVwqmkXatsbBuMJBDCàaGiH	FALSE
RdTBpQnàydzlǔMYátFtwvánZ	FALSE
SvGrNAdwěàZQdZwúIHXdAáóu	FALSE
UDpuFTyCdhsEadjRJTeDxgcǎ	FALSE
VVáěIàwZòYBMfMuQmRAdHdǔQ	FALSE
WspawdDPTòIàGùáDJaZLmòǒd	FALSE
YMǔkPtvnFjějUWdRkdvUUXwS	FALSE
ZdoaaùGqkMdSyQasjǒBuXXUd	FALSE
aIPWMòPǒMbmǔòGIiOuLzHKEǎ	FALSE
agǔbàháNYoclrqtPvhcAFkúo	FALSE
bOgAiégójjQddRRFěNtàANàt	FALSE
dèFdbvZJgxAUúyFyZdúVǔpOc	FALSE
dYUBQUjaoGWdWPCkuDGùzHěy	FALSE
eǔjqdpZYNǒdmmwIYHrwSvPùá	FALSE
fLIaifvEeúwbùyFEWáúMuùRy	FALSE
gfySNoOiáaWadáTDMMypuwdú	FALSE
huáHnXkCRěWěnudùwdQǔpOLa	FALSE
jDzacknbRnYùQCgyHèFZǔUtE	FALSE
kkWajqèKúqKVXRǒbpWJHnnoV	FALSE
múúzJǎpdǒSUttJùEdòtUfWnb	FALSE
nbmzdGùtHaZèQZzbiǎAxhòǎX	FALSE
ohùědSlPùùSMFakDfkbòrZóP	FALSE
pwkojEMGhFCJjzawBsfèbòkà	FALSE
rCuaeWksPEgDMUwdàqdhTVAI	FALSE
sgAZfófWzèddJQZVYGthZDUG	FALSE
uǎǔóZCQmwèrHPabmQMhUnLLD	FALSE
vateòYymǒXNPènuLhǒěbwSUy	FALSE
whǎELFzNPdXèiLdmjanTEogc	FALSE
yEkprYXahTabTúpMFòTMdEǔù	FALSE
ùùAbXJXHfùòGěkitoKAGRHknn	TRUE
ǔIeZWtOzWhOXKbzuUjGVijuBZ	TRUE
áYgkměXGùfHYZAròVákTUHqde	TRUE
ǎùǒCúenèccèaXdǒeLeTòéwnCO	TRUE
éDKtPjǒYCXěcyDiQeHkHUùérf	TRUE
èYsVbjYHzqbùJjcqwRAòrtàmT	TRUE
óǒóKQúmcYYfDBYExáùóěMóúLè	TRUE
òZrogDzgánUǔuTlTXgGnDPkPW	TRUE
ǒpwWèqhYGémqEgCaTpIQPárǒq	TRUE
úsbqòéfQKNQùǎCǎffCIáFMryu	TRUE
BáòkcdmSfHáLzmBěfFǎLPFGnL	TRUE
CǒKuàYegàwnWóèjZzkeNUPVqX	TRUE
DJvǔǒsrcOcEqlHargHYwyéèNR	TRUE
EaAwhCǎKYEáásQAnRúáYXEWGǒ	TRUE
FqonàWRòsvohRáadǎQHLYcrdó	TRUE
HERwSPùJHpplWdGqZVxùHDuvR	TRUE
ISAtnkgJNLděuOFKGfXqsǒAJV	TRUE
JmWkUPWUrùnCZOkTuǎéVěJPPj	TRUE
LúvǒzáctěǒáHphWyGcBàùyWná	TRUE
MPúloZáǔmIozBèZkoqzopiěpq	TRUE
NmKujiOTMzǎFGěSHbCsaùzCwW	TRUE
PáFUkkiòmvàbKoXsBbǎZopéLQ	TRUE
QHwYjOǎkHXmEósóNuócCySIvQ	TRUE
RfSFsjěúǔCtjOGRwEDnKsXret	TRUE
SzúhSqvoúJSnǒIayHěpIqirés	TRUE
UòcǒeèRAèQǒúBwjpSbmǒDòúQè	TRUE
VUfoǔhOvNsyòǎpúǒlcèUxwhKA	TRUE
WlóyQpàVùkvIsbgóLUSEXùǒZd	TRUE
YàTgpèpeMǔěfXhymujYBKUUge	TRUE
ZKCzVjEnPNOqaǎyòUICdBgAǔA	TRUE
bóHajmqJpéIHKKúrZluoRěmOG	TRUE
cYNEòAXRPwGóséRNKLUěBXFfJ	TRUE
daTEMkTnàcDéOuTWZLnákLvLf	TRUE
ezjsWKúǔeùěqcLfWjaxfhvoZǎ	TRUE
gòcIItoQbùinQwàDGYGNZkòMǒ	TRUE
hDQSQáǔngúěùRidKǔèClUkUNf	TRUE
iUIyoJiGéòmLfSóbsnòGHDtYk	TRUE
jnpǒIùzáóuVWhèúrevJZAFIrà	TRUE
kvTcTIzwùHKBJbeNxòoJgawGǔ	TRUE
mǒDDnOwjwaúóhQwzCgNWspěgS	TRUE
nKǔhǒmòIIPGHAùcIBUláiNbBn	TRUE
oRylúmdòCjyLzùómJqwòiTǔWp	TRUE
plúPcòúdBPINQóàǎòyTsMPoAd	TRUE
qxàvǎeQPRWYxǎPTUhGwùoHdeV	TRUE
sAZuvycèdPMNmkPgPeNèPeYUb	TRUE
tTSěiZUQàyWGgàfjùXkARAuKK	TRUE
urrětnúSòLkUWcAAVCéúXwéDc	TRUE
wòPXMfWáEBcLbBèGHWIhDpěèB	TRUE
xSXWGoixDyVLcVtluǔléEětdK	TRUE
yiVbKUfrhXmFuòcABKpLKEDUI	TRUE
ùùzrXǔWSPYHSbóaSàHLqEbiéD	FALSE
ǔLiédbyGǔěrèúUàTtRSédpóSP	FALSE
áVgxhǒnaTgvǒcwTcIúvJùHQbS	FALSE
àjQàdoOtǒLtIBHxPLéOàQfdLc	FALSE
éàǔUaèúlgpfVmgésOEryNZddè	FALSE
èóGgászàeaRbSCěuDxPkCférú	FALSE
ěVqGSàártUfdFfDFdIelWcúme	FALSE
òěLDWXóàusHdepqRdúqGSéSZz	FALSE
ǒaòTUóBGùgObsABBXàacymYEU	FALSE
úqxxajUuVMEbOVRàoRweJáclm	FALSE
BMeMfObpOSAxGBadúóFySobNW	FALSE
CeyIgdWdoùrgomfXqzGHbùeoU	FALSE
EǒVoSmaǎǒSèLhùObMlmmSpCYQ	FALSE
FWmǎidǎuBěLhdZpPuxOeǔúQjy	FALSE
GdHTLEnǔEdfMMoǔEqrǔWzmWBd	FALSE
IéèmgSǒmádnMueDmrDaVbUIhL	FALSE
JJSHSXròEBùdkBoTyóYdúGGhK	FALSE
KpǔqAERFDIieèYVOPasààbKCa	FALSE
MólnPùVzàgaǒyBbhMZFúAhpaǔ	FALSE
NbxyJpoZmLbdYtUNKfFdwEEMl	FALSE
OvhguYmTFAgZSixZXFiéFúabj	FALSE
QFTUèJoùRúBzajfRcVOtrúVbú	FALSE
RdsǎGpxNYtxděOlJhshúTwcoB	FALSE
SyéoEàVYGóypAuedBIqsWaCbr	FALSE
URdtǔáTNKRtfugèfòàpZàgdrG	FALSE
VcèxaFeJVLhTLábAFAwbeRòSJ	FALSE
WthdAVěZFaOtIcHtkbtEbEǔUY	FALSE
YRItdaSúóAOffXbETHhFsènáò	FALSE
ZdMVdáWYeUfhUJsMnfIBIfómV	FALSE
aKPiKTzOKbmEvyfùnFZúacLWe	FALSE
alEěDSóMQSǒjKfaéZiaDǒKbqE	FALSE
bNrxóúepWUǔCtabYBèkjYiUlx	FALSE
dàUBuPJèǒSOlBIQJdznlEYyVH	FALSE
dTYóěwDRIhoùtjVQZHUURdhUH	FALSE
dvǒHREúKeMèShgAbKdǎYcUjTà	FALSE
fáwQagjaùJbóXSFǎàěúEPvMuD	FALSE
gOHztxaěPgGLRlRxVbáetéěMV	FALSE
hgajěěuMǒǎihCOǔSOIPbURéSO	FALSE
jLyUéyiòaiFmjFECRùVqiXZkb	FALSE
kuGaùUrpjICnbqmbfpqMGdXIK	FALSE
mòóIddǔfYhqBjCIùIòSYYPAjv	FALSE
nMákJiDXěàUdèydùVGibòEHbǒ	FALSE
ohddnòYXòXXlLeécòVuYUKLKL	FALSE
qIùèěùjùdkSXLUqRrJKhàgdJé	FALSE
rgfdYáWXsXEbsGhOAèYsdmhld	FALSE
tBxgLWLbdZkpVùǒLfQdDVěáNQ	FALSE
uppAgefaUHrsěHóudQotsbMuh	FALSE
wòLuélfYWImdPxWPámLQThPdo	FALSE
xJvsQxarKùXHThpbmMOèukmuN	FALSE
yhdeXáègǎqqaiǎuydárZXWébW	FALSE
ùùsuěBèvǎjqáNtGtSèXsBwHMaK	TRUE
ǔSmúpǎǔFTàióyúùěQzbNAIPchq	TRUE
ásHLóUnReZlMecDOrYGqIsvUcG	TRUE
ǎFZVGZàxzyǔlixéAeòLWRxúoas	TRUE
éSěCáMeEYMTKzěǒZJúqEèCAòAG	TRUE
ènTkIfaKLDkTxSOǒZEgSèWpǔMR	TRUE
ěyAoPèplUbmWIQwúnCǒàOFcqúq	TRUE
ózógòEòyCjaěǔISVjKdfQXhACè	TRUE
ǒBlnTtǎIGcoyDVéwOǒQICAlzUL	TRUE
úEsKgxRBzGjZQKIasasEkVKSIe	TRUE
AcDmMOótKimzlZvxicúáJVóTKǔ	TRUE
BpcFJjJétAkuěBKByfáVQóWbór	TRUE
CzMXěéIIKOYiJFpqnheReěuXKu	TRUE
EòWmQBùjqJayJfùXgIEQZDkGút	TRUE
FPNTlFMNéAoskǎHqSMAMǔdSèzS	TRUE
GWsXIKyéNvèFàYwFLnTǒKOMèeJ	TRUE
HqQuòAnDiǔúévDmǒRiqǎǒoMěWm	TRUE
JěyoaMviiùhFUXELwwDfCjrdPW	TRUE
KKNkGzLDeUtZgáMFgJámYǒǒwup	TRUE
LbVDéDPZhJsHèEwYayHvIZDoNg	TRUE
MlXeWXAKcěǎǔYòaSHCseCaFǎhz	TRUE
OáryCOWtxAXZLSuǒóOPMVhEsFU	TRUE
PǒùLQxiěóhqQèàJěFlTMgtqEMh	TRUE
QOǒBUpqòeóHMTXfóVúǒWBRqdmǎ	TRUE
RdtXwkUlsKlěINoWlJMběwcJBE	TRUE
SolúxcKktGRòNqvBviASàeòHzg	TRUE
UǔqKZESwsROWjwlǔTvwqKCǔǒvr	TRUE
VEueheKwsbvSiTéóóMgèsòùLAè	TRUE
WXòYebělFyzqǔfJbinMFùùzZFK	TRUE
YěǔiFjwPNAbJOělèUaaZWlèIBò	TRUE
ZGMhcLǒixYUNPRoQòleGdLèěnb	TRUE
ajJèùsMLZCYRěpWErxǔùVǔHNSu	TRUE
cAydrLFgaGóJVAKKbKódDtǎěgd	TRUE
dgfKèàlúwSáYèkZùóyJYzvgYwh	TRUE
fèXgùówkIfeǒNYùèELǎqGOKKQò	TRUE
gcQYèdúDCWcOkMdYNYGhDrúivX	TRUE
htPMftRHBIJQBùáàbmcJàyxEzM	TRUE
jàtIaǒHmwIcèppcòxùidNcQlNé	TRUE
kYTQvmaIonúXmzrvòǒYNBLzàzǔ	TRUE
lkǎeLLiLBoBèGuXCTYMtwéUllF	TRUE
movibFòRyBJètVMXóEUǒěqgràO	TRUE
nytǒvmyèWPVacVxTàOàlVpVozǎ	TRUE
pBóGPǔlVbùùsàKFmáòPQktenJi	TRUE
qWùěSEhJòuQgúivFǔBJXJěSBvR	TRUE
sǔIoijúuHěKóKéLuuàUKQJáfiM	TRUE
teènNCDlǔwPSéjZOUqbUONXpuD	TRUE
unezoHbiXggòbnLhóǒgiZKnAǒè	TRUE
wFIhosJFNBuǒrlCYǒùfLqSDzTe	TRUE
xaDcUAIydWDOuěǒLaVwDHWvYnD	TRUE
ymUVázéUáháhúǒfxHoYriMGlnY	TRUE
ùǎéRùbhToGgeòOoénxdPǒBlQdó	FALSE
ǔaeEWUdtdAsCǎááǎgQOàIpDfáj	FALSE
ánxtVVobiarexDHAGtdèdyJGLd	FALSE
ǎCVKuhXHmzevDzHOUúigGEdAdc	FALSE
édJtMùQrUóYblqnkMaKgDIAkwd	FALSE
ěCyiALsàèzRYINObdCfepLldAu	FALSE
ódwúgCgsraèGyWRvdKskpyzUjT	FALSE
ǒàDàypBxxXaLfǒòbubWBDèeDnP	FALSE
úMLHǒDmbàKFmaUàbùDáóéVYùgB	FALSE
AuágwàGòlbaBylEěQAWxbǎsBPh	FALSE
CVúvòhóIǒrkléPdhwǔAjlQtQed	FALSE
DtOwtèlndǎbdBMqaHéXuudlòAS	FALSE
FNùQVLòRódDGBWèVǎXnǔabhtKZ	FALSE
GdkDmNéěOgiUlaaMúbǔqFVyNòn	FALSE
HpmOXùéjdYEaytCAwbNavǎǔUHé	FALSE
IybfáRHdJédxǔwwXFsynkyzObZ	FALSE
KCbOldztǔIoyxǔváPFtqsPdLvH	FALSE
LPpúybaRQǎKúGlbcMpGJNBǒnTb	FALSE
MdCdOODěrAmXgòWóUqmǔkOLBFD	FALSE
OKǒdTaLáCFeuEjmGǒZVksdERKù	FALSE
PaóEǎsdKqEàbJWEàOvàǒuuMKoC	FALSE
QikOXsKqdLZdnUóuUòèehspJGá	FALSE
SCCsmugòILěEéTòddZdáddwOpC	FALSE
TaNpQUǒlXQpdscoěúteǎbYIósI	FALSE
UqaèCCěbtxWxnEBáboùUxSKtóm	FALSE
VzOOěěDPéZGóVddWúǎǔǔanWKǒA	FALSE
XETéǒjàIiOZéutydpdXrfatKVI	FALSE
YkéTYǎaPCEJKDMoUkAeSbwǔèoS	FALSE
aùxdònékuFdXzGrúkVèBézféER	FALSE
aOǎjaàBDúNAufOfRǒUFbwkěqNR	FALSE
aiQWòNPYQDHbVaBxcYiNèjuYmq	FALSE
bmǔdCrekǔioǎOxCáèiOLdPòtJd	FALSE
dDlBAFPneBinhPTkXhieqmdMol	FALSE
dgtcuǎigaǎqùMtNyfnVYgèbHzá	FALSE
eQXjSěSljJDLtBibHAdzOdlpPL	FALSE
fkgVPSVadxlEǒAAMjáLqJfCdùx	FALSE
hDzAǔǒeyéóZblòǔczQapviUóXb	FALSE
iVTEeHIǔpùjdBDyowodvWkYvHA	FALSE
juIXCǎYjděkNoxéuèàyIǎdúDBr	FALSE
lJméGaFkdfúǎddáKáěnASZèUǎT	FALSE
mYbatKhoúZùóàéxòiznLPòobnS	FALSE
nwZWYmGtàPGabégéFQQcQcsysx	FALSE
pJOTyPOOUóěiEóanòúgùelSǎob	FALSE
qzilfZKaLětFUdrèEbTeVamúǒǎ	FALSE
sLlsNqKùàddZPndvonYmrhféAX	FALSE
tdaOěEPPGFXNvdMzaOsánTniBq	FALSE
ujènxaJoOZǎYeKZcmclGúbùlǒU	FALSE
wǎhnTNépuNaBGfIbNDaNèAYaxB	FALSE
xZrAfgtflDSolOéGmdLěRduěǔl	FALSE
yoàZmǒSdésXJǔEdnucqUUjèYàs	FALSE
ùùEǒkǔCuěaptTMeNAaBCKdvFPYj	TRUE
ǔǒssuDèwilǎóFFzcùOóFùiRVàcě	TRUE
áVǔESkASàBoǔsKZVlQxAQòOfVJe	TRUE
àsHTaLàùMùlǎCózDLAǎoúAUFScǔ	TRUE
éǎdpYǎCkeerpXaFahrtyCxRǎwáf	TRUE
èDiFcQCBmPdzUóùTAQWAAWqfffǒ	TRUE
ěJrùjqQèfeUtzǒóǎsLPěfàwOkvs	TRUE
ókàWújǔTWepXfěǒPFETCeóVNwGk	TRUE
ǒǔMbTxjpvAAnWdFWqYFJǎjóéIFx	TRUE
úLxVZàtWěmkWéYgvXYTùàmzafǎM	TRUE
AnvbItyěRòQúPǔZWpNtKNvSuFhY	TRUE
CCǒepGùFLOoòRqKQǎHǔxLěéNHCn	TRUE
DMǔúHAHxfJOXeLyAǎCrnHoKZFèB	TRUE
ElǎIrxPúáQyfTCǔqPòxáMZéwjvV	TRUE
FxKVcWysúùkǎpZájSvxjXrdusèé	TRUE
HóUtáDeKyLahppuUèEFllIMYwXQ	TRUE
ITlVDdnǒáLZàQJvVzǎxxHvJěBùt	TRUE
JnlDoyQràyQECOKSTayoGVsZMcW	TRUE
LInlgHyDCvTBbmgòKHgàéúHdbBh	TRUE
MglWOJùbZlsiLúeuFOzyéjPThiF	TRUE
OǒCYyvJHǒRSyJXaváCsnvǎUvupG	TRUE
PUǔQqJKolúPIziTjOCJqepWvbuJ	TRUE
QnZFNQùúràtgzHbWxYéLnDMWLjp	TRUE
SGéòoIRòimLYyRèPtdǔNNióNèàh	TRUE
TcQYogBYmqùkWàVYhuěǒPnúQlWm	TRUE
UrtHPúJKiEdèújUSXSòěòDetpUN	TRUE
WáUMOùpǎradtNècqFqènóéěxòqx	TRUE
XHáfMVSuùXKxSnaěMHfqòWóSéyQ	TRUE
YTPKDtVàYArNvRGcnPnVNQàhSsb	TRUE
ZftUowcgFHmgsBòbPóSKSttmBUU	TRUE
bòNYphǒogRJTVòteàùnàyRmvòGz	TRUE
cSěěZyogatYJRFNfHFxgWMSBSéè	TRUE
dvfZzbauecgàNǎRǒCaJXuQVéPfm	TRUE
fòméWǔQMlAXfHyRYjékAèdrEùXb	TRUE
gGqNMpBAFZyilAoNòYùvtUKlYòm	TRUE
hJgCCCqeZWmtévMHnSXNhéeFfuo	TRUE
iLFDfVèXCoBShtQOǔùOEoXjrzéá	TRUE
jUhjWRésòDùpIlǔGwFsEtLěèWHi	TRUE
kmJUYAǔVAUěJXòǒbTriXRoaApqC	TRUE
màěuNDéèszéobsèyněrǔúiZozgO	TRUE
nIcFàcMéùbùydàtfaZáǔIùsrhIu	TRUE
ofièmGbùYlyǎMFHùlmúcǒPòúxMJ	TRUE
peRbàxùMěfmvYPúOlDYjáwEjZZY	TRUE
qxxrBDOgBwIlBskáPMXtuáuzúBi	TRUE
sDsěvfMQFRjùQNóǔHzRCMeEfKtá	TRUE
tGUAUcEmWMáxYGBWáùwvJmGóZkv	TRUE
ukhNhòàFkClDCLtphihWàrusmdb	TRUE
wòHǒxiUěǔZnèpsTLVbdjyKUQZèF	TRUE
xOxggěhESuLZulKècPlZdXqECVO	TRUE
yfsbWmòKAòaChěBcuHXFejxvMIF	TRUE
ùùhsǒNwDùóOGopzQztdsdVhnxVd	FALSE
ǔLkFvOXuNtlykdJHXkJǎdoTFsac	FALSE
ánbAXóMYZsbóaGXYkèlELjbǎPǔp	FALSE
àyTWeǎdáeKdaúPwúzXògfǎIǒYAy	FALSE
éQtNǒnáèàUlnaJBùhmdtRdgBHFT	FALSE
ěèsarrSUèófDEèséJYmRJJěybóV	FALSE
óToEuvǔNHJXFaJmrgAbDkèabnTs	FALSE
ògaPòBbatbbRFVTBATZOwPúoUWV	FALSE
úFǎòxTlLJLaEpguUmbòHYakzhoS	FALSE
AbóFMabgvyéoTsMèóRNàeoKoogo	FALSE
BmyOPfmǔxúxbJázjYddJfàóòIdD	FALSE
DDeUbYkPkGUJǎmdéèaQIbqóivWF	FALSE
EXWIKRGLMTgLhraiKrMúMEbsxzǎ	FALSE
FgNuCdkjgLZIAdǎwRzWVHHhqóVc	FALSE
HùOzǎásssHBmJwZDGLaǎYXbOJPq	FALSE
IVwlkWEtHMéǔóHAàděNCCXfUàid	FALSE
JjàPBakzDǔéxCPMNbXxPJfOOùwX	FALSE
LèKrhéSJEsUpqòbQdnuIUmdMNFó	FALSE
MKdAXòfdNiHFnèZAnùEUTZEuóXa	FALSE
NXAùhqzcaRZHJzSPQaéùáxbGòLW	FALSE
OqjtLuéJJQHǎuiaúAzMVZbǎǔRxm	FALSE
QKwùkfǔnPabjFXòkáOtRěǎKàiDq	FALSE
RgMHoxSqkiàǒDseéfnfVBoabKác	FALSE
TóqbydGvqóòWOCqhfdTágFùěoTx	FALSE
UYùmǎLxàWOqhěPFàbyKCGiHdXdò	FALSE
VvpddwpYàánoǎTgáǔXtùǒeblùhS	FALSE
XMzǔXǒòáVHBFtUiTLYdLòjTmsǔd	FALSE
YWUdohéDuZPuOZiTtóáǎdYVólòq	FALSE
ZqiěnpěJSqdKàyùéKiJMèEspKsd	FALSE
aHnVPHqǔXiááHějjAěbáUrBLSir	FALSE
akOèǒXěqLbMVSFYlfBkaoǔEpfaO	FALSE
bQOMjàaSgMojUyEuCLfsbbfDhéǎ	FALSE
děǔáǒYzyLrsdPàPgicǔéòbBVYKT	FALSE
dZeVRàúTgXIdǒǔlLqSVPKSFPòDL	FALSE
eóPQàTRéàEěRaeftkcCGěElLTOb	FALSE
fmDUoabcOyXJaOjjTéaquTSOPCP	FALSE
húòBnsdǔèwsRldvaeyAUbqèjtCf	FALSE
iMjtǎMXóOsPSbóffaùèCbghsbvH	FALSE
jdldgrnVRPkpGǔuǒGtpoPmǎMǔAB	FALSE
lèsrfqèamCrxsaǎNbprEaOUZjǒú	FALSE
mJVqLáDéDYaútbnEúfCBVQJjtùN	FALSE
ndiPPJabCJsfǔqIIùpZzWǔhqwPd	FALSE
pàaxdwCèQbJALjTBènMàùFqǒúwò	FALSE
qLsAabOzòfUYMHaEáQIèPeGǒBIn	FALSE
rdEXXvwUùěnqxCDèldéAévvlHYh	FALSE
túAěeGTuǎaxoOTRbouLVaYfWòmS	FALSE
uTUmvxyoeOwèóǔáaVFpLjBùebzN	FALSE
vqZtxúFWyMCudXtfTTGsoǎledIU	FALSE
xEriǎYUafàǒmbùúVùUNǔèbeàziV	FALSE
yoáǎàOErùǒdwhwdVèohxLǔǎAsgX	FALSE
ùǔǎsVXEIwYèòLaXvǎvSOWQmuvJSd	TRUE
ùzLgFFtgyHónǒoVTvfPzàóbnFzYě	TRUE
áèWVJYzNǎYǒǔkJFKmJPaGrDvpùrV	TRUE
àWǒAUHiSZgmOháoěǎtrCTLYwlJǎj	TRUE
ǎpébèJZMHfáyRekéCPIěZZyXmRòI	TRUE
èǎhqaYAòégYVwénàrZsǒcNTUshvr	TRUE
ěUSWOFcEIHCTùěOǔfvCHUxGnfZdV	TRUE
óZyuybMJisGoWyVyNěùvKXuèxzvF	TRUE
òtRmhNoXPBóéHCòUkjHwyúJdQIRà	TRUE
úàǎlèGjHvǔhYěBdVmiyIqvxzebWJ	TRUE
AFZCiáùwNryAvGPWgěSPNzNDLMjv	TRUE
BiáAUlJkHRjxZlLùàósYyAZHèjnp	TRUE
DěKjRYèécJúEMGǒánǔkbogèrWúUb	TRUE
EHǒeTalDmIOáLNcVeIDpfJkeěnAs	TRUE
FgUeSóNelCVDěZyzYUáujdKéQèUH	TRUE
GxpJǒWSeFipeòyrSrQàIDkǎModKU	TRUE
HyfméyQLCHyrǒqUupǒZàjLǎgSPóǔ	TRUE
JQfióhéeyRoDǒhéGQUgqféuǔLhFh	TRUE
KmGPExtnxJZJZYòǒurfàAótóeNǒz	TRUE
LxRobvOǎeKàWnǒscoéIoqáòDUMfR	TRUE
NěWahàiùRNéóCsvxYmqcXJFúùIaJ	TRUE
OOFbpRǒgUóYSIgUǎwnQXpAYzLTǔn	TRUE
PióéBHXǔBglkJxRLBcoèǒUFǎhJar	TRUE
RěMbKSiětFKbgeQFjéócOwióGOiX	TRUE
SGmèTùdAsReYCPèúpbQDkhhZwòGu	TRUE
TODlFéozyLějkwFvqFluKlDECnkn	TRUE
UiTěyTwùvoPUYisnFeEóxoBQSpIv	TRUE
VróxEPèǎújBeKéexùEEwFáqtGVuh	TRUE
XASàQaǒcIǒveQByZdqeqeEOBvòeó	TRUE
YhbéEWYoòAOZBYTvPsOZXJmAOéúO	TRUE
ZwCZUUCNWobpǔHàBEfhFǒóoyuFné	TRUE
bPhcWzáPVAFMdiáRpTéreCFHoIaj	TRUE
ciUóZOOXlKgOEznǔIPiVSGlSlFpO	TRUE
eKdEcXmEuLxXCuqdnAQAVheftaex	TRUE
fpNlTcFJóNàGsSocǎòlěfzǎfQLvX	TRUE
hápOhypYCLErQzlnCseDhèNCnFéB	TRUE
iPKòEEbLǔomzéBěèNájEiáǔCǔMkp	TRUE
jZUqUEèAaXqcgqhèǔòpguLǎCdSNG	TRUE
knHRǎyJbúOgéBDègérVéWlèóJùIM	TRUE
mAgTóeRàoOszHyhǒDJJlnRAlAUVù	TRUE
nPmTrcAoZqnMGBájIeéyòětěQqCà	TRUE
ocěFóOYMUvóYJEHéáaǔYsGPWRBtj	TRUE
pwáùùjhvuLcsLqǔXIAiJlónjéWaa	TRUE
rQYlGigjaLǔàOIzfzàóIDvrHgkGi	TRUE
siLOLěNàxwpCDNxRPRCtLlEǎàknY	TRUE
tivniWSEOàHméKPVHSeaRtWIhàHF	TRUE
vùaSFásiqgCDXNHLjyiZpQaùRUóW	TRUE
wGPASòvXYùùkòéJdSòǔjWáVhúòKP	TRUE
xUghpQUǎáGBFedSNIzcTǒhuOHoYT	TRUE
yoNXvMqcZsDGFAKCTGmOcNQVèRng	TRUE
ùùNhHYéddoQǔèSQékoùErIgúbQěx	FALSE
ǔúrWZIObnòctGqùLGEqabTéhwHǎi	FALSE
áYzǔjǔAáWùórWdqǒWédǔrxQAQǎúG	FALSE
ǎùàHáǎeTdNlkwuYlZzVdcYgMVJab	FALSE
éòǎKMyǔaGvbǔbETyGNTzùwwBJsrJ	FALSE
èakujbiXekkaódòPWyyudYkSódNH	FALSE
óùóéFfWUalabhaPqlùeACZùVDbZz	FALSE
òeZPdétRgvZùOdvLBǒgLbáqoOCǔe	FALSE
ǒxèragMǔrréSElCEádCRnQdExPYB	FALSE
AZàZrsùCHěpVAuqgVǎXùdPpdqóDD	FALSE
BsfrúFJSǔapèdúLǎWpMùYbúyHPSw	FALSE
DòNQtaaRpWtLóKibeRàOGèǒBéXuj	FALSE
EagYGQTDCeDáJQZMEXěOobjGufac	FALSE
GáBdNIyRzZhdvèQùwnáǒmJUégpTi	FALSE
HQpBwHùyurDWfdLùHéeyFHpZpadD	FALSE
IhdMgXòjyóLkaCLsJtǒmGěqKàPbM	FALSE
KónXúKbyevèSAlZàóaXrùLbTqěCR	FALSE
LUaGòPsbhèTcIUěǔhsùRDTvHǔqǎf	FALSE
MwádPièiěKǒdOLàoHǒSúiTquOPàG	FALSE
ODlLTQěHKaJEYNdǎǎWrXděáǔwFZQ	FALSE
PaóóèDéoikEèúúúqúBělǒMsàbHUS	FALSE
QySQJěoeXwvyUCáQfTXqjòdbdòAp	FALSE
SBSúuWQnWúaNhhyPHTóQbkrǎvAiY	FALSE
TfTqJhYjTmfMRuajrbTAǔFZVOdYV	FALSE
UmvěwEahbhKwyKGmǒlzxwLúOraěè	FALSE
WéúzpdeeHrsawRejǔDngbeBbPCwn	FALSE
XHaJrftdzbbèYǒmErnùvIuZáèOCY	FALSE
YlXhwSWeúNaǔvrTXywmuǎoUBbDvz	FALSE
aùImSAfIaXǔkéàbpKZTùǔGeHmklB	FALSE
aPqvPKVPfFmNJeXiBekdndSézúbú	FALSE
aoPUVboTAWZàHDZiDèfEzZùAàThu	FALSE
bjHWèedàúmHùaYlXldúIzqxtǒǎJw	FALSE
dDGNPUzrCAbdFIwpbVEkAOYdOosó	FALSE
ddpáHǔùzVqzGúurRfsiVolGPLgoc	FALSE
eFDèzfjaezPbàiaǔNZPqaféfuOCB	FALSE
feDEǒuǒvyNGměUambvcUBIHLwNZg	FALSE
gziDWVqElPtftvUdJJHàúZgDudZL	FALSE
iòKGeSdYAǒVǒKSOónǎNǒdGXǒzBnC	FALSE
jHelJauaoàXèQKéFúǎhsbRbimmpè	FALSE
kSJmǒEubbéQaǒèfPbaZwScQqykUT	FALSE
mùdfuVXQiIfósGóèěwXjdYjnòóiS	FALSE
naysdòúravVbPxZNAcCiáWóELǔóó	FALSE
otěstvMjVáàPTéQszúlQoeTdzùsd	FALSE
qDEiVdzùàoXVòEJUDdEjNurqáqdC	FALSE
rqúHláAǔúSúsòYXzěPIaEziSbówJ	FALSE
tLEǒcOgeYǎcInZSAémwcpNózEabI	FALSE
uwDalèKgěIlvCrùóbJqbaJroònóǒ	FALSE
wOYravTkXMLǔeJezèQoPsSYbéBUv	FALSE
xamSDěKYUYPYpbxIsMpbdicérǔyR	FALSE
yltGéNqiaNpbhWxdMùskuElxXBès	FALSE
ùùAyesIUèàVncúvrGěAFzGáNaáólR	TRUE
ǔKKOIeròogFMbpěméBysǔLvSaOfòN	TRUE
ásxYIQòPuyqWklǎgǎrooDLbinrIsp	TRUE
ǎǒfúJxjlepAUoKntVxKSKpTrMúúeV	TRUE
éSOěZrqSunVpSěiGDQeTájsokjěhò	TRUE
ècfJkǔqBiàOùóibǎoIáJmJZwLvaFn	TRUE
ěxhffáóNóbpxxKTaǔkxHhoLnóBFrù	TRUE
òágáCPésNtYIfSTHQNPiwnLUtyDǎP	TRUE
ǒHmǎǔǎPMrqvjúskENuYinzOtxmrRu	TRUE
úXYifTzàvFIvLLSùdRYiaCfteěNBn	TRUE
AhQWMAàuzWsqYaHùǒMXZqMKcYcvOq	TRUE
BudAQǔoúuXwǔnINJcLJRrjnUMGeAp	TRUE
DFOèuXXSJBqNFjUèOhzKfUjqYtTyp	TRUE
ESyoRvùAúUǔtzRPóǔáwhxNCòktfàh	TRUE
FrWědZpLǎXFèòOEEZWnDòjTmrfCnù	TRUE
HùbnWèoOQbǔVàKtgòRǒeLeDXàUqFě	TRUE
IKuleSyúGHZDQjmxǎVnOnǔúeMobAG	TRUE
JeExGCwTgiEǎfróiAúAfvJǎbBETól	TRUE
KsllZMbUYVcyFmúEnwrcómmXaQagq	TRUE
MèDlTqVZǎYězúcDaTóCjKJpUUOQqp	TRUE
NKuóEXǎpiàKuxNàsUVùgZòNLNnTQR	TRUE
OfEahoáVjKsnZCzǔVrúRJWpHHGyúj	TRUE
PXeHTòrxIJaèJùwIlHtWlQóàóocSg	TRUE
QkYGǔǒénpOmXDWOBJQCcRqkuefbnv	TRUE
RwbLTXOTUlFědúpsòmOPypWnúojlS	TRUE
TIbXǎhùQpjètSAiyMFJzNxzLgJmAC	TRUE
UpépǎàéfcjfGsLFPǎfnHjDZAáWDfk	TRUE
WéLGLThTFhiǒpPělFQfSwànmWǔAXe	TRUE
XOWfXeRpNvéáSXúiyIǔáSVjǒNPLui	TRUE
YcNKyIoójèvwNCJaCquhDgPOěofCQ	TRUE
ZqwjfJyjoSDteúéKePJldEàWHgtrN	TRUE
bCGFúMIiAocwSZKUUtHóJPDDpuǔkJ	TRUE
cOěyTcéJúTgàYIXIojwaàcRàCxCSR	TRUE
eáTqǒJjěNMběyGHǒKHóXhuqWbftRW	TRUE
fCUKAJfǎéqHPPkOxZyLfSBNlQǔSpd	TRUE
gVrUFsrTANàzIPoùECqQNěpWUasJj	TRUE
iǔBSàMnMJgtQéěXUZAXEhǎHuDOMjF	TRUE
jMXáólzAfCvqPLòàeJRCnXwKzygQd	TRUE
kaòoJkèQbéuǒǎYNPuǎSjrúóèòRácd	TRUE
ltéVxWzHYúQEXwúUyáVdpèzoòWcèe	TRUE
nòCóxXEóRèYVNfCPvNǔooaIùykdYǔ	TRUE
oOsNǔgéuUwgEéOUcZSòIxRkSCQOùW	TRUE
pblhEuàNQòklàPmPJOùjzgkàǔVIUU	TRUE
qwwJUCEKNWěQPKWZxQUbǎwhEcěǒgR	TRUE
sJfèZapLHNUtxMJFJMFXJVyiZCèQG	TRUE
tMènGCǔràPzzéǎFwcWOǎkǔùvbǒújk	TRUE
umelqJgDYèoEóeotGSZpUDPXfèúáO	TRUE
wǔěcěnWLawRSYlyywàDPlLYVSàǎIT	TRUE
xMcHXYONelpVHmótIwRGndCWóeěsY	TRUE
yjUYBEYOàbQGàERqpRXBVxHarOKAB	TRUE
ùùACddYdtjǎhKIǔémèwPrsGLszsEn	FALSE
ǔXAURNàdvJálodǎéǒxSLTWrgRssum	FALSE
áwOViǔkapTàFWLbzóEVVQiOshWnfM	FALSE
ǎPCòpLMUZoYvFùjOayǒGǎgǒsòèqjb	FALSE
éjpFDAJCNWNhoJlXFAdMMYSHèrdOR	FALSE
ěùOlǒúěDjàRZěEzzdbdǎTMǒhcémOE	FALSE
óBirhMMrHBubDEòdyùsmàPOdòiCWB	FALSE
òadabuZDáeXuěMYPWWhDǎètOKJǒBH	FALSE
úùkVGYuLYGxoVùcahàwsQGbùSlCěp	FALSE
ACàfjanaAEàbriArSoávqZKevVxZv	FALSE
BddKcZNjWXájáácVLTvlèóyùvèkes	FALSE
DèǔBZdkáUěbuúdDhPYundrúáGúKàá	FALSE
EGàKuKFèbiwlaSBcmDlùAYsZvhbWè	FALSE
FbóvzQaPOoedbóXùHcYvplSyhBaMǒ	FALSE
HèòJQmrǒmXzFKùdfstledyxHnnémé	FALSE
IIpISFzIsaJBHRYcbAǎsGDWfWwFvw	FALSE
JwmědjoUàXyèOXòJIěUNreiAQXdJL	FALSE
LTIToAFdIPàdbskIHHGyVàPpúOZwW	FALSE
MsFeàAmPaJWoQFZJGAFàbéyVǎwGRa	FALSE
OǒXUBaIopuAydòiájdhùJjùHjXNdL	FALSE
PXerQtòNtjmfOGydKáNaHxùmPzsbz	FALSE
QrkúJniafòàaòdHzngZHvTxzgbvgU	FALSE
SPVǎLNmlRagrhdǎBoigwdnMcQLèZè	FALSE
TkòmúěNylbDnodwǎPógbRdKYYHIrL	FALSE
VéXEQCúDdéHEylSNdnStrqòTyBkiH	FALSE
WWdokràdàAjnhLVòaRAǔfZyArTWbǎ	FALSE
YùGVfuULbáZFPpyplkvdlòédàzNzY	FALSE
ZQQyhcOfaPUszWyYòckLfóKrxèbàr	FALSE
aAKTqJMlDJbjFvxIgěKHULǔgWrLǒx	FALSE
adéGoùPdCJvBjiiòvyLùénvǒNwàzc	FALSE
bBuròGEndgálLzSNZdaoiqRWLGsTY	FALSE
dóFiólJybWǔeoESUòMdVǔbrǔzVpoE	FALSE
dapzVóRǎbjóHKPéYùòqUXiZpEirùf	FALSE
eǒNbàaPMGkTYcNòKXVvSXVAòGBévb	FALSE
fXQEawCyTǔyǒQxIhúvntbwvRoKTwg	FALSE
gzqzèdúndǔGQBǎTOoQǔYàkOIrcwCu	FALSE
ièObMjòdjdtnRPyIRcèmúòGgsrYqa	FALSE
jHfDàBQbXhyKǔwoěgHǔdnǒdUTóuáz	FALSE
kaǎsxbFTYEYLzádóFSXleJéPòYjvl	FALSE
llxayùobpmLlǎPǒězòIpSYSǎzWYút	FALSE
mqhNKrAaiAqètCGvěNxMbXJztVoVá	FALSE
oùZtcEǔgNsòkébqZYǔIIeIAuaHQJb	FALSE
pLYódSóǔùduùyFBdljhusBHgCéLùg	FALSE
qWQZZzVYaxUdXKPěǎAúWXǎdMěǔěoQ	FALSE
rgòVbMvàmúǒdvOpzOIxheHgáeCIád	FALSE
tǒèKJpnAPIccRJjjFǎBǔTfKNjBWab	FALSE
uSDPwayxěYQúXWRtǔAnbUEEmNPjgs	FALSE
vezptáiGdmtHsjUNSéfsófǒMédcru	FALSE
wzzBaUqyqzcǒbNKLùáguOooéTaFqz	FALSE
yCfKRémEnZCràWOpfgUúpFqéddofU	FALSE
